DATETIME,GAS,COAL,NUCLEAR,WIND,HYDRO,IMPORTS,BIOMASS,OTHER,SOLAR,STORAGE,GENERATION,CARBON_INTENSITY,LOW_CARBON,ZERO_CARBON,RENEWABLE,FOSSIL
2021-01-01 00:00:00+00,11338,0,5955,5488,383,3428,3116,192,0,0,29900,176,14942,11826,5871,11338
2021-01-01 00:30:00+00,11497,0,5951,5353,379,3572,3115,184,0,0,30051,180,14798,11683,5732,11497
2021-01-01 01:00:00+00,10863,0,5947,5274,349,3570,3105,191,0,0,29299,176,14675,11570,5623,10863
2021-01-01 01:30:00+00,10248,0,5951,5292,334,3568,3114,186,0,0,28693,171,14691,11577,5626,10248
2021-01-01 02:00:00+00,9656,0,5951,5407,328,3512,3116,185,0,0,28155,165,14802,11686,5735,9656
2021-01-01 02:30:00+00,9172,0,5952,5530,327,3524,3116,192,0,0,27813,160,14925,11809,5857,9172
2021-01-01 03:00:00+00,9246,0,5948,5492,320,3148,3115,192,0,0,27461,161,14875,11760,5812,9246
2021-01-01 03:30:00+00,8721,0,5948,5512,315,3134,3116,190,0,0,26936,157,14891,11775,5827,8721
2021-01-01 04:00:00+00,8300,0,5946,5651,315,3096,3117,187,0,0,26612,152,15029,11912,5966,8300
2021-01-01 04:30:00+00,7948,0,5948,5702,315,3064,3121,186,0,0,26284,148,15086,11965,6017,7948
2021-01-01 05:00:00+00,7742,0,5949,5904,314,3084,3108,183,0,0,26284,145,15275,12167,6218,7742
2021-01-01 05:30:00+00,7625,0,5943,5894,314,3104,3120,185,0,0,26185,144,15271,12151,6208,7625
2021-01-01 06:00:00+00,8137,0,5948,5821,320,3234,3118,188,0,0,26766,149,15207,12089,6141,8137
2021-01-01 06:30:00+00,8427,0,5945,5853,343,3224,3118,192,0,0,27102,151,15259,12141,6196,8427
2021-01-01 07:00:00+00,8198,0,5955,5944,388,3094,3114,184,0,0,26877,146,15401,12287,6332,8198
2021-01-01 07:30:00+00,8334,0,5949,5946,389,3114,3114,190,0,0,27036,148,15398,12284,6335,8334
2021-01-01 08:00:00+00,8698,93,5945,6049,402,3172,3113,189,0,0,27661,154,15509,12396,6451,8791
2021-01-01 08:30:00+00,9325,260,5953,6167,404,3120,3117,195,39,0,28580,163,15680,12563,6610,9585
2021-01-01 09:00:00+00,10263,368,5957,6212,419,3426,3115,185,199,0,30144,172,15902,12787,6830,10631
2021-01-01 09:30:00+00,11370,617,5959,6230,420,3394,3117,184,351,0,31642,185,16077,12960,7001,11987
2021-01-01 10:00:00+00,12487,693,5950,6166,426,3490,3115,190,525,0,33042,194,16182,13067,7117,13180
2021-01-01 10:30:00+00,13502,691,5940,6209,425,3466,3115,188,729,0,34265,198,16418,13303,7363,14193
2021-01-01 11:00:00+00,14873,523,5935,5997,413,3514,3115,185,951,0,35506,203,16411,13296,7361,15396
2021-01-01 11:30:00+00,15645,459,5934,5844,412,3570,3109,184,1080,0,36237,206,16379,13270,7336,16104
2021-01-01 12:00:00+00,16356,565,5934,5814,409,3622,3113,184,1109,0,37106,212,16379,13266,7332,16921
2021-01-01 12:30:00+00,16523,784,5932,5928,414,3562,3113,184,1148,0,37588,216,16535,13422,7490,17307
2021-01-01 13:00:00+00,16647,1125,5930,5722,431,3550,3112,185,1089,0,37791,224,16284,13172,7242,17772
2021-01-01 13:30:00+00,16442,1412,5931,5597,426,3542,3108,184,997,0,37639,230,16059,12951,7020,17854
2021-01-01 14:00:00+00,16777,1447,5927,5416,395,3496,3108,185,773,0,37524,234,15619,12511,6584,18224
2021-01-01 14:30:00+00,17083,1251,5928,5349,406,3498,3078,184,470,0,37247,234,15231,12153,6225,18334
2021-01-01 15:00:00+00,17618,1237,5922,5207,440,3410,3076,187,173,0,37270,238,14818,11742,5820,18855
2021-01-01 15:30:00+00,18297,1123,5929,5194,466,3400,3078,262,28,40,37817,240,14695,11617,5688,19420
2021-01-01 16:00:00+00,18821,980,5928,5307,593,3326,3077,362,0,786,39180,233,14905,11828,5900,19801
2021-01-01 16:30:00+00,20057,1318,5925,5368,609,3334,3079,367,0,1062,41119,242,14981,11902,5977,21375
2021-01-01 17:00:00+00,20443,1450,5933,5095,666,3206,3078,483,0,1196,41550,245,14772,11694,5761,21893
2021-01-01 17:30:00+00,20557,1451,5926,4937,666,3190,3080,515,0,944,41266,249,14609,11529,5603,22008
2021-01-01 18:00:00+00,20004,1325,5931,5130,623,3056,3077,376,0,884,40406,243,14761,11684,5753,21329
2021-01-01 18:30:00+00,19735,1051,5927,4633,619,3024,3077,328,0,792,39186,240,14256,11179,5252,20786
2021-01-01 19:00:00+00,19251,1191,5930,4443,521,3112,3037,327,0,60,37872,248,13931,10894,4964,20442
2021-01-01 19:30:00+00,18313,1088,5937,4292,508,3170,3046,273,0,0,36627,244,13783,10737,4800,19401
2021-01-01 20:00:00+00,17875,729,5928,4074,485,3206,3050,204,0,0,35551,237,13537,10487,4559,18604
2021-01-01 20:30:00+00,17081,567,5930,3921,482,3210,3051,196,0,16,34454,231,13384,10333,4403,17648
2021-01-01 21:00:00+00,16171,482,5925,3929,478,3018,3081,190,0,44,33318,223,13413,10332,4407,16653
2021-01-01 21:30:00+00,14938,427,5926,4116,432,3002,3082,186,0,72,32181,214,13556,10474,4548,15365
2021-01-01 22:00:00+00,14128,188,5925,4117,423,3036,3053,185,0,0,31055,205,13518,10465,4540,14316
2021-01-01 22:30:00+00,13274,0,5927,4197,442,3134,2787,184,0,0,29945,196,13353,10566,4639,13274
2021-01-01 23:00:00+00,11893,0,5924,4134,415,3188,2463,187,0,14,28218,188,12936,10473,4549,11893
2021-01-01 23:30:00+00,11330,0,5924,3869,393,3058,2465,187,0,0,27226,184,12651,10186,4262,11330
2021-01-02 00:00:00+00,11194,0,5923,3932,363,3022,2465,191,0,0,27090,184,12684,10218,4296,11194
2021-01-02 00:30:00+00,11373,0,5923,4056,351,3090,2463,194,0,0,27450,186,12793,10330,4407,11373
2021-01-02 01:00:00+00,11266,0,5926,3871,337,2900,2461,193,0,44,26998,186,12595,10134,4208,11266
2021-01-02 01:30:00+00,10764,0,5930,4120,337,2916,2464,187,0,0,26718,181,12851,10387,4457,10764
2021-01-02 02:00:00+00,10408,0,5929,4388,333,2872,2483,185,0,0,26598,176,13134,10650,4722,10408
2021-01-02 02:30:00+00,10052,0,5931,4339,309,2872,2466,192,0,0,26161,173,13045,10579,4648,10052
2021-01-02 03:00:00+00,10160,0,5930,4210,313,2872,2447,190,0,0,26122,175,12900,10453,4523,10160
2021-01-02 03:30:00+00,9742,0,5935,4316,312,2854,2489,185,0,0,25833,170,13052,10563,4628,9742
2021-01-02 04:00:00+00,9753,0,5926,4349,299,2780,2493,186,0,0,25786,170,13067,10574,4648,9753
2021-01-02 04:30:00+00,9478,0,5929,4489,288,2780,2494,187,0,0,25645,167,13200,10706,4777,9478
2021-01-02 05:00:00+00,9641,0,5927,4612,295,2856,2491,184,0,0,26006,168,13325,10834,4907,9641
2021-01-02 05:30:00+00,9614,0,5925,4877,283,2856,2497,186,0,0,26238,166,13582,11085,5160,9614
2021-01-02 06:00:00+00,9954,0,5925,5270,314,2856,2497,186,0,0,27002,166,14006,11509,5584,9954
2021-01-02 06:30:00+00,10621,0,5921,4966,320,2856,2497,187,0,0,27368,173,13704,11207,5286,10621
2021-01-02 07:00:00+00,11150,129,5929,4848,323,3002,2459,183,0,0,28023,181,13559,11100,5171,11279
2021-01-02 07:30:00+00,11412,244,5925,4976,326,3004,2431,184,0,0,28502,186,13658,11227,5302,11656
2021-01-02 08:00:00+00,12794,229,5923,4695,349,3004,2443,193,0,0,29630,197,13410,10967,5044,13023
2021-01-02 08:30:00+00,14312,320,5924,4347,368,3028,2480,194,151,0,31124,210,13270,10790,4866,14632
2021-01-02 09:00:00+00,15158,703,5930,4472,377,3004,2477,184,653,0,32958,219,13909,11432,5502,15861
2021-01-02 09:30:00+00,15345,1106,5926,4625,378,3004,2478,195,1207,188,34452,222,14614,12136,6210,16451
2021-01-02 10:00:00+00,16178,1268,5925,4463,418,3004,2484,198,1697,14,35649,228,14987,12503,6578,17446
2021-01-02 10:30:00+00,17026,1362,5926,4049,420,3000,2484,192,1813,0,36272,236,14692,12208,6282,18388
2021-01-02 11:00:00+00,17485,1485,5933,3916,409,2712,2489,192,2101,102,36824,239,14848,12359,6426,18970
2021-01-02 11:30:00+00,17726,1500,5927,3960,423,2714,2490,201,2252,302,37495,238,15052,12562,6635,19226
2021-01-02 12:00:00+00,17881,1528,5931,3882,434,3094,2482,205,2333,500,38270,238,15062,12580,6648,19409
2021-01-02 12:30:00+00,18262,1527,5931,3932,433,3106,2480,326,2221,344,38562,241,14997,12517,6586,19789
2021-01-02 13:00:00+00,18564,1571,5924,4111,433,3220,2455,326,1867,284,38755,246,14790,12335,6411,20135
2021-01-02 13:30:00+00,18961,1610,5932,4019,431,3132,2462,299,1197,2,38045,254,14041,11579,5647,20571
2021-01-02 14:00:00+00,19158,1664,5931,4132,415,3166,2463,198,747,0,37874,258,13688,11225,5294,20822
2021-01-02 14:30:00+00,19183,1820,5924,4449,415,3104,2461,185,506,0,38047,260,13755,11294,5370,21003
2021-01-02 15:00:00+00,19900,1935,5924,4584,437,2672,2466,185,216,0,38319,266,13627,11161,5237,21835
2021-01-02 15:30:00+00,20325,2025,5928,4623,458,2654,2466,184,34,0,38697,270,13509,11043,5115,22350
2021-01-02 16:00:00+00,21142,2001,5926,4501,522,3018,2453,254,0,460,40277,269,13402,10949,5023,23143
2021-01-02 16:30:00+00,21910,2040,5929,4663,569,3046,2442,521,0,1178,42298,266,13603,11161,5232,23950
2021-01-02 17:00:00+00,22215,2143,5922,4825,662,3024,2455,530,0,1406,43182,266,13864,11409,5487,24358
2021-01-02 17:30:00+00,22207,2128,5931,4977,662,3024,2465,528,0,1382,43304,265,14035,11570,5639,24335
2021-01-02 18:00:00+00,21842,2110,5936,4977,619,3024,2465,495,0,946,42414,266,13997,11532,5596,23952
2021-01-02 18:30:00+00,21342,1979,5937,5143,619,3024,2466,415,0,714,41639,263,14165,11699,5762,23321
2021-01-02 19:00:00+00,21267,1508,5929,5315,528,3024,2465,280,0,242,40558,257,14237,11772,5843,22775
2021-01-02 19:30:00+00,20308,1216,5935,5304,506,3024,2459,170,0,0,38922,249,14204,11745,5810,21524
2021-01-02 20:00:00+00,19247,1281,5933,5276,429,3024,2454,164,0,0,37808,247,14092,11638,5705,20528
2021-01-02 20:30:00+00,18058,1179,5932,5349,419,3024,2379,166,0,0,36506,240,14079,11700,5768,19237
2021-01-02 21:00:00+00,17047,771,5937,5740,405,3004,2378,175,0,0,35457,225,14460,12082,6145,17818
2021-01-02 21:30:00+00,15793,531,5930,5823,404,3004,2375,176,0,0,34036,214,14532,12157,6227,16324
2021-01-02 22:00:00+00,14729,110,5934,5791,363,3004,2372,165,0,0,32468,199,14460,12088,6154,14839
2021-01-02 22:30:00+00,13339,0,5935,5917,358,3004,2358,150,0,0,31061,187,14568,12210,6275,13339
2021-01-02 23:00:00+00,11824,0,5923,5844,347,3004,2352,157,0,6,29457,177,14466,12114,6191,11824
2021-01-02 23:30:00+00,11015,0,5930,5875,339,3002,2348,145,0,0,28654,170,14492,12144,6214,11015
2021-01-03 00:00:00+00,10306,0,5932,6080,292,3092,2351,150,0,0,28203,164,14655,12304,6372,10306
2021-01-03 00:30:00+00,10430,0,5923,6015,292,3176,2354,155,0,0,28345,166,14584,12230,6307,10430
2021-01-03 01:00:00+00,10105,0,5930,6018,277,3134,2364,160,0,0,27988,165,14589,12225,6295,10105
2021-01-03 01:30:00+00,9379,0,5927,6079,277,3104,2368,164,0,0,27298,158,14651,12283,6356,9379
2021-01-03 02:00:00+00,8710,0,5933,6264,272,3080,2371,164,0,0,26794,151,14840,12469,6536,8710
2021-01-03 02:30:00+00,8583,0,5933,6179,271,3118,2370,164,0,0,26618,151,14753,12383,6450,8583
2021-01-03 03:00:00+00,8083,0,5935,6585,267,3122,2370,183,0,0,26545,144,15157,12787,6852,8083
2021-01-03 03:30:00+00,7607,0,5936,6624,258,2974,2383,165,0,0,25947,137,15201,12818,6882,7607
2021-01-03 04:00:00+00,7738,0,5938,6790,270,2724,2388,165,0,0,26013,137,15386,12998,7060,7738
2021-01-03 04:30:00+00,7630,0,5928,6656,272,2706,2393,176,0,0,25761,137,15249,12856,6928,7630
2021-01-03 05:00:00+00,8252,0,5934,6407,304,2608,2393,168,0,0,26066,144,15038,12645,6711,8252
2021-01-03 05:30:00+00,8370,0,5928,6405,309,2608,2390,166,0,0,26176,145,15032,12642,6714,8370
2021-01-03 06:00:00+00,8269,0,5930,6806,328,2856,2391,171,0,0,26751,141,15455,13064,7134,8269
2021-01-03 06:30:00+00,8701,0,5918,6802,327,2848,2390,178,0,0,27164,145,15437,13047,7129,8701
2021-01-03 07:00:00+00,9290,122,5922,6850,327,2941,2432,167,0,0,28051,153,15531,13099,7177,9412
2021-01-03 07:30:00+00,9429,230,5922,6888,329,2943,2459,163,0,0,28363,157,15598,13139,7217,9659
2021-01-03 08:00:00+00,9836,229,5925,6617,335,3097,2484,163,0,0,28686,162,15361,12877,6952,10065
2021-01-03 08:30:00+00,10929,229,5920,6763,343,3239,2554,164,73,0,30214,171,15653,13099,7179,11158
2021-01-03 09:00:00+00,12054,368,5918,6993,388,3225,2761,172,399,6,32284,178,16459,13698,7780,12422
2021-01-03 09:30:00+00,13203,586,5920,6855,372,3169,2949,176,862,30,34121,187,16958,14009,8089,13789
2021-01-03 10:00:00+00,14036,973,5918,6966,398,3065,2990,166,1257,0,35769,197,17529,14539,8621,15009
2021-01-03 10:30:00+00,14483,1299,5909,6808,404,3047,3009,169,1678,122,36928,204,17808,14799,8890,15782
2021-01-03 11:00:00+00,15638,1459,5910,6394,407,3037,3024,164,1841,14,37888,215,17576,14552,8642,17097
2021-01-03 11:30:00+00,16344,1495,5905,6090,422,3021,3047,167,1749,22,38262,221,17213,14166,8261,17839
2021-01-03 12:00:00+00,17174,1499,5908,5673,429,2975,3055,169,2093,26,39001,225,17158,14103,8195,18673
2021-01-03 12:30:00+00,17380,1464,5915,6039,408,2956,3052,184,2020,0,39418,225,17434,14382,8467,18844
2021-01-03 13:00:00+00,17479,1299,5909,6125,419,2919,3047,177,1962,78,39414,221,17462,14415,8506,18778
2021-01-03 13:30:00+00,17390,1234,5906,6435,419,2901,3040,174,1527,140,39166,220,17327,14287,8381,18624
2021-01-03 14:00:00+00,17550,1422,5909,6674,419,2898,3034,160,1130,0,39196,226,17166,14132,8223,18972
2021-01-03 14:30:00+00,17797,1353,5904,7000,420,2882,3039,163,656,0,39215,226,17019,13980,8076,19150
2021-01-03 15:00:00+00,18283,1165,5907,7679,430,2916,3028,160,275,0,39843,223,17319,14291,8384,19448
2021-01-03 15:30:00+00,18408,1168,5904,8125,439,2906,3038,165,63,176,40392,222,17569,14531,8627,19576
2021-01-03 16:00:00+00,18975,1418,5909,8126,502,3001,3082,196,0,952,42161,224,17619,14537,8628,20393
2021-01-03 16:30:00+00,20070,1497,5912,8439,536,3051,3080,383,0,888,43855,229,17967,14887,8975,21567
2021-01-03 17:00:00+00,20177,1500,5910,8935,654,3038,3082,470,0,814,44580,226,18581,15499,9589,21677
2021-01-03 17:30:00+00,20130,1500,5904,8960,675,3024,3092,260,0,888,44433,225,18631,15539,9635,21630
2021-01-03 18:00:00+00,19589,1380,5911,8664,613,3024,3090,163,0,868,43302,222,18278,15188,9277,20969
2021-01-03 18:30:00+00,18506,1267,5911,9201,590,3024,3095,169,0,668,42431,214,18797,15702,9791,19773
2021-01-03 19:00:00+00,17414,1228,5908,9354,485,3024,3089,160,0,136,40798,211,18836,15747,9839,18642
2021-01-03 19:30:00+00,16009,740,5909,9872,465,3022,3084,173,0,34,39308,194,19330,16246,10337,16749
2021-01-03 20:00:00+00,14962,477,5905,9898,399,3014,3081,167,0,240,38143,182,19283,16202,10297,15439
2021-01-03 20:30:00+00,13908,258,5905,9795,393,3014,3075,163,0,120,36631,173,19168,16093,10188,14166
2021-01-03 21:00:00+00,12856,30,5912,9523,377,3002,3081,178,0,310,35269,162,18893,15812,9900,12886
2021-01-03 21:30:00+00,11682,0,5903,9249,374,2992,3090,171,0,264,33725,155,18616,15526,9623,11682
2021-01-03 22:00:00+00,11065,0,5905,9272,339,2412,3080,162,0,136,32371,153,18596,15516,9611,11065
2021-01-03 22:30:00+00,9865,0,5904,9262,351,2402,3080,168,0,0,31032,144,18597,15517,9613,9865
2021-01-03 23:00:00+00,8079,0,5902,9371,342,2474,3078,164,0,0,29410,129,18693,15615,9713,8079
2021-01-03 23:30:00+00,7021,0,5901,9450,333,2432,3077,169,0,0,28383,118,18761,15684,9783,7021
2021-01-04 00:00:00+00,6974,0,5899,9245,289,2451,3075,168,0,0,28101,120,18508,15433,9534,6974
2021-01-04 00:30:00+00,7045,0,5905,9246,290,2569,3076,153,0,0,28285,122,18517,15441,9536,7045
2021-01-04 01:00:00+00,7102,0,5906,9383,275,2602,3091,141,0,0,28500,123,18655,15564,9658,7102
2021-01-04 01:30:00+00,6808,0,5902,9382,288,2640,2937,209,0,0,28166,121,18509,15572,9670,6808
2021-01-04 02:00:00+00,6609,0,5903,9340,289,2513,2849,274,0,0,27777,118,18381,15532,9629,6609
2021-01-04 02:30:00+00,6513,0,5911,9424,288,2479,2851,290,0,0,27755,117,18474,15623,9712,6513
2021-01-04 03:00:00+00,6549,0,5907,9502,287,2325,2850,287,0,0,27707,116,18546,15696,9789,6549
2021-01-04 03:30:00+00,6257,0,5910,9669,286,2299,2854,224,0,0,27499,111,18719,15865,9955,6257
2021-01-04 04:00:00+00,6184,0,5910,9543,283,2173,2847,183,0,0,27123,112,18583,15736,9826,6184
2021-01-04 04:30:00+00,6272,0,5913,9787,286,2169,2847,174,0,0,27447,111,18833,15986,10073,6272
2021-01-04 05:00:00+00,6530,0,5914,10110,304,2197,2851,141,0,0,28047,113,19179,16328,10414,6530
2021-01-04 05:30:00+00,6998,0,5910,10448,303,2262,2853,144,0,0,28918,117,19514,16661,10751,6998
2021-01-04 06:00:00+00,8815,0,5911,10337,302,2365,2845,142,0,0,30717,134,19395,16550,10639,8815
2021-01-04 06:30:00+00,10943,0,5905,10375,302,2346,2844,141,0,0,32856,150,19426,16582,10677,10943
2021-01-04 07:00:00+00,14333,134,5907,10315,301,2371,2843,144,0,0,36348,175,19366,16523,10616,14467
2021-01-04 07:30:00+00,15753,548,5899,10304,303,2332,2844,145,0,0,38129,191,19350,16506,10607,16301
2021-01-04 08:00:00+00,17345,1075,5897,10348,331,2355,2800,145,0,0,40296,209,19376,16576,10679,18420
2021-01-04 08:30:00+00,18061,1469,5892,10447,335,2370,2823,160,69,162,41789,217,19566,16743,10851,19530
2021-01-04 09:00:00+00,18588,1794,5901,10412,413,2380,2845,150,230,106,42819,224,19801,16956,11055,20382
2021-01-04 09:30:00+00,18972,1900,5894,10419,351,2391,2847,234,430,168,43607,226,19941,17094,11200,20872
2021-01-04 10:00:00+00,19350,1959,5900,10275,391,2476,2834,444,666,190,44484,228,20066,17232,11332,21309
2021-01-04 10:30:00+00,19733,1950,5899,10239,394,2484,2830,443,973,106,45051,229,20335,17505,11606,21683
2021-01-04 11:00:00+00,20257,1847,5907,10242,395,2584,2811,412,1088,10,45554,229,20443,17632,11725,22104
2021-01-04 11:30:00+00,20565,1772,5900,10236,404,2597,2612,372,1158,116,45732,228,20310,17698,11798,22337
2021-01-04 12:00:00+00,20560,1807,5904,10157,408,2593,2618,388,1068,174,45677,229,20155,17537,11633,22367
2021-01-04 12:30:00+00,20809,1808,5908,10115,392,2602,2620,434,987,148,45824,231,20022,17402,11494,22617
2021-01-04 13:00:00+00,20927,1807,5912,10310,397,2634,2619,420,866,0,45892,231,20104,17485,11573,22734
2021-01-04 13:30:00+00,20881,1805,5905,10409,407,2644,2610,336,719,32,45749,231,20050,17440,11535,22686
2021-01-04 14:00:00+00,21106,1815,5910,10664,407,2642,2619,256,539,20,45978,231,20139,17520,11610,22921
2021-01-04 14:30:00+00,21205,1811,5907,10526,411,2655,2626,154,367,78,45740,232,19837,17211,11304,23016
2021-01-04 15:00:00+00,21539,1812,5907,10514,419,2600,2771,208,183,0,45953,235,19794,17023,11116,23351
2021-01-04 15:30:00+00,21386,1814,5904,10793,420,2617,2823,290,34,16,46097,234,19974,17151,11247,23200
2021-01-04 16:00:00+00,20894,1813,5898,10799,507,2838,2825,339,0,242,46155,230,20029,17204,11306,22707
2021-01-04 16:30:00+00,21193,1809,5903,10809,578,2864,2820,437,0,836,47249,228,20110,17290,11387,23002
2021-01-04 17:00:00+00,21588,1813,5902,10608,649,3005,2824,482,0,862,47732,230,19983,17159,11257,23401
2021-01-04 17:30:00+00,21493,1813,5899,10383,648,3010,2814,462,0,902,47424,231,19744,16930,11031,23306
2021-01-04 18:00:00+00,21237,1814,5898,10322,548,3025,2788,427,0,906,46965,230,19556,16768,10870,23051
2021-01-04 18:30:00+00,21040,1807,5897,10240,534,3043,2806,323,0,632,46322,231,19477,16671,10774,22847
2021-01-04 19:00:00+00,20607,1814,5905,10215,494,3021,2808,191,0,8,45063,232,19422,16614,10709,22421
2021-01-04 19:30:00+00,19043,1783,5902,10336,472,3053,2816,163,0,10,43578,225,19526,16710,10808,20826
2021-01-04 20:00:00+00,17556,1355,5906,10237,431,2991,2817,152,0,0,41445,213,19391,16574,10668,18911
2021-01-04 20:30:00+00,16818,850,5896,10121,406,3008,2816,155,0,46,40116,201,19239,16423,10527,17668
2021-01-04 21:00:00+00,15932,463,5901,9989,387,2924,2824,157,0,6,38584,190,19101,16277,10376,16395
2021-01-04 21:30:00+00,14422,314,5905,10094,379,2940,2701,150,0,0,36905,178,19079,16378,10473,14736
2021-01-04 22:00:00+00,13130,265,5904,10058,347,2576,2339,152,0,0,34771,172,18648,16309,10405,13395
2021-01-04 22:30:00+00,11924,1,5899,9798,359,2568,2208,156,0,28,32941,159,18264,16056,10157,11925
2021-01-04 23:00:00+00,10627,0,5899,9893,355,2694,1911,151,0,0,31530,148,18058,16147,10248,10627
2021-01-04 23:30:00+00,9737,0,5902,9929,348,2696,1455,152,0,0,30219,141,17634,16179,10277,9737
2021-01-05 00:00:00+00,9991,0,5896,9756,309,2574,1400,155,0,0,30081,146,17361,15961,10065,9991
2021-01-05 00:30:00+00,10481,0,5903,9645,307,2575,1405,153,0,0,30469,150,17260,15855,9952,10481
2021-01-05 01:00:00+00,10305,0,5901,9623,275,2554,1412,153,0,0,30223,149,17211,15799,9898,10305
2021-01-05 01:30:00+00,10320,0,5901,9491,274,2552,1414,157,0,0,30109,150,17080,15666,9765,10320
2021-01-05 02:00:00+00,10309,0,5904,9587,274,2588,1413,152,0,0,30227,149,17178,15765,9861,10309
2021-01-05 02:30:00+00,9941,0,5907,9745,274,2588,1416,150,0,0,30021,146,17342,15926,10019,9941
2021-01-05 03:00:00+00,9529,11,5906,9773,274,2602,1410,154,0,0,29659,142,17363,15953,10047,9540
2021-01-05 03:30:00+00,8900,28,5908,9927,274,2602,1416,152,0,0,29207,137,17525,16109,10201,8928
2021-01-05 04:00:00+00,8816,68,5905,9807,271,2564,1417,155,0,0,29003,137,17400,15983,10078,8884
2021-01-05 04:30:00+00,8773,94,5910,9860,269,2578,1419,152,0,0,29055,138,17458,16039,10129,8867
2021-01-05 05:00:00+00,9314,193,5905,9842,271,2254,1417,154,0,0,29350,147,17435,16018,10113,9507
2021-01-05 05:30:00+00,9798,325,5911,9944,293,2242,1418,152,0,0,30083,154,17566,16148,10237,10123
2021-01-05 06:00:00+00,10939,554,5906,10043,345,2454,1446,152,0,0,31839,167,17740,16294,10388,11493
2021-01-05 06:30:00+00,12507,795,5908,10222,348,2374,1533,155,0,0,33842,181,18011,16478,10570,13302
2021-01-05 07:00:00+00,14240,1357,5897,10041,362,1900,1753,164,0,132,35846,204,18053,16300,10403,15597
2021-01-05 07:30:00+00,16246,2070,5903,9798,372,1824,1775,154,0,0,38142,229,17848,16073,10170,18316
2021-01-05 08:00:00+00,18290,2670,5899,9686,385,1180,1841,161,1,70,40183,251,17812,15971,10072,20960
2021-01-05 08:30:00+00,19132,3018,5898,9581,379,1172,1880,222,94,194,41570,259,17832,15952,10054,22150
2021-01-05 09:00:00+00,19549,3153,5904,9202,380,1678,1960,320,395,96,42637,262,17841,15881,9977,22702
2021-01-05 09:30:00+00,20048,3195,5901,8988,399,1684,1978,350,834,188,43565,262,18100,16122,10221,23243
2021-01-05 10:00:00+00,20336,3162,5892,8741,389,1276,1972,381,1399,326,43874,261,18393,16421,10529,23498
2021-01-05 10:30:00+00,20379,3197,5887,8712,388,1274,1970,363,1880,478,44528,258,18837,16867,10980,23576
2021-01-05 11:00:00+00,20517,3205,5887,8882,393,1228,2125,351,2545,134,45267,256,19832,17707,11820,23722
2021-01-05 11:30:00+00,20538,3027,5887,8608,406,1352,2162,256,2679,468,45383,251,19742,17580,11693,23565
2021-01-05 12:00:00+00,20937,2794,5888,8557,409,1364,2166,259,2662,490,45526,249,19682,17516,11628,23731
2021-01-05 12:30:00+00,20997,2687,5890,8776,388,1454,2147,408,2466,430,45643,247,19667,17520,11630,23684
2021-01-05 13:00:00+00,20634,2671,5884,8903,389,2170,2161,378,2074,392,45656,245,19411,17250,11366,23305
2021-01-05 13:30:00+00,20647,2661,5891,9099,395,2176,2184,244,1617,300,45214,246,19186,17002,11111,23308
2021-01-05 14:00:00+00,20697,2666,5891,9347,394,2338,2182,178,1042,138,44873,249,18856,16674,10783,23363
2021-01-05 14:30:00+00,20819,2736,5881,9492,377,2334,2045,171,724,114,44693,253,18519,16474,10593,23555
2021-01-05 15:00:00+00,21176,2847,5884,9595,428,1832,2051,185,310,712,45020,256,18268,16217,10333,24023
2021-01-05 15:30:00+00,21341,2936,5884,9539,440,1844,2245,334,65,604,45232,260,18173,15928,10044,24277
2021-01-05 16:00:00+00,21453,2997,5884,9311,537,2724,2347,368,0,764,46385,259,18079,15732,9848,24450
2021-01-05 16:30:00+00,22004,3012,5882,9253,561,2740,2428,513,0,802,47195,260,18124,15696,9814,25016
2021-01-05 17:00:00+00,22293,3014,5885,8875,612,2488,2584,544,0,1154,47449,261,17956,15372,9487,25307
2021-01-05 17:30:00+00,22016,3020,5877,8812,614,2490,2599,558,0,1464,47450,258,17902,15303,9426,25036
2021-01-05 18:00:00+00,22311,3024,5882,8384,596,2806,2600,481,0,1232,47316,263,17462,14862,8980,25335
2021-01-05 18:30:00+00,22175,3004,5881,8169,519,2812,2596,347,0,994,46497,265,17165,14569,8688,25179
2021-01-05 19:00:00+00,21344,2957,5875,8306,490,2840,2494,322,0,814,45442,261,17165,14671,8796,24301
2021-01-05 19:30:00+00,21232,2917,5880,8107,488,2840,2458,185,0,58,44165,265,16933,14475,8595,24149
2021-01-05 20:00:00+00,20396,2784,5887,7968,470,2810,2465,156,0,88,43024,261,16790,14325,8438,23180
2021-01-05 20:30:00+00,19818,2472,5888,7776,446,2800,2318,151,0,34,41703,257,16428,14110,8222,22290
2021-01-05 21:00:00+00,18932,2199,5884,7364,371,2196,2255,159,0,194,39554,254,15874,13619,7735,21131
2021-01-05 21:30:00+00,17437,2010,5889,7146,364,2180,2264,152,0,184,37626,246,15663,13399,7510,19447
2021-01-05 22:00:00+00,16337,1776,5889,7184,349,1588,2260,154,0,0,35537,241,15682,13422,7533,18113
2021-01-05 22:30:00+00,15201,1538,5889,7019,349,1582,2043,153,0,0,33774,233,15300,13257,7368,16739
2021-01-05 23:00:00+00,14235,1540,5887,6881,338,1764,1813,153,0,0,32611,230,14919,13106,7219,15775
2021-01-05 23:30:00+00,13793,1537,5885,6905,338,1776,1818,156,0,0,32208,227,14946,13128,7243,15330
2021-01-06 00:00:00+00,13467,1538,5884,6835,305,2304,1813,153,0,0,32299,225,14837,13024,7140,15005
2021-01-06 00:30:00+00,13931,1546,5878,6887,305,2322,1603,154,0,0,32626,228,14673,13070,7192,15477
2021-01-06 01:00:00+00,13033,1696,5881,6797,306,2884,1453,155,0,0,32205,225,14437,12984,7103,14729
2021-01-06 01:30:00+00,12512,1733,5882,6838,306,2894,1452,151,0,0,31768,223,14478,13026,7144,14245
2021-01-06 02:00:00+00,12063,1745,5884,6946,306,2757,1447,153,0,0,31301,220,14583,13136,7252,13808
2021-01-06 02:30:00+00,11640,1746,5880,6946,307,2760,1451,153,0,0,30883,218,14584,13133,7253,13386
2021-01-06 03:00:00+00,11862,1792,5881,6895,307,2655,1454,154,0,0,31000,221,14537,13083,7202,13654
2021-01-06 03:30:00+00,11570,1771,5885,6779,306,2658,1455,150,0,0,30575,219,14425,12970,7085,13341
2021-01-06 04:00:00+00,11813,1746,5885,6589,307,2612,1455,151,0,0,30558,222,14236,12781,6896,13559
2021-01-06 04:30:00+00,11834,1767,5882,6591,320,2605,1455,159,0,0,30613,222,14248,12793,6911,13601
2021-01-06 05:00:00+00,12775,1855,5882,6497,322,2584,1604,157,0,0,31676,230,14305,12701,6819,14630
2021-01-06 05:30:00+00,13538,1951,5883,6238,341,2566,1800,156,0,0,32473,237,14262,12462,6579,15489
2021-01-06 06:00:00+00,15340,2405,5889,6235,353,2089,1898,155,0,0,34364,255,14375,12477,6588,17745
2021-01-06 06:30:00+00,17037,2765,5883,6068,387,2026,1986,161,0,0,36312,270,14324,12338,6455,19802
2021-01-06 07:00:00+00,18452,2529,5887,5863,470,1939,2338,157,0,0,37635,271,14558,12220,6333,20981
2021-01-06 07:30:00+00,19839,2568,5883,5913,509,1948,2731,158,0,30,39579,273,15036,12305,6422,22407
2021-01-06 08:00:00+00,20971,2924,5885,5506,530,2694,2799,178,0,200,41687,282,14720,11921,6036,23895
2021-01-06 08:30:00+00,21452,3521,5883,4913,683,2724,2804,337,42,300,42659,294,14325,11521,5638,24973
2021-01-06 09:00:00+00,21592,3603,5883,4015,711,2972,2807,313,251,584,42731,297,13667,10860,4977,25195
2021-01-06 09:30:00+00,22109,3449,5878,3747,718,2983,2813,354,646,626,43323,295,13802,10989,5111,25558
2021-01-06 10:00:00+00,22366,3456,5885,4013,736,2995,2713,409,1013,386,43972,293,14360,11647,5762,25822
2021-01-06 10:30:00+00,22630,3538,5880,3725,771,3000,2585,398,1357,512,44396,294,14318,11733,5853,26168
2021-01-06 11:00:00+00,22681,3650,5884,3611,733,3015,2712,417,1553,812,45068,293,14493,11781,5897,26331
2021-01-06 11:30:00+00,22737,3597,5880,3198,717,3024,2826,441,1856,1194,45470,291,14477,11651,5771,26334
2021-01-06 12:00:00+00,23107,3424,5887,3253,845,2857,2824,458,2351,1074,46079,286,15160,12336,6449,26531
2021-01-06 12:30:00+00,23186,3330,5883,3647,803,2859,2797,426,2309,716,45956,286,15439,12642,6759,26516
2021-01-06 13:00:00+00,22812,3282,5883,4244,617,2880,2622,409,2115,848,45712,282,15481,12859,6976,26094
2021-01-06 13:30:00+00,22589,3127,5885,4198,582,2886,2599,241,1643,1212,44962,280,14907,12308,6423,25716
2021-01-06 14:00:00+00,22687,3112,5881,3880,695,3031,2685,232,1506,1014,44723,283,14647,11962,6081,25799
2021-01-06 14:30:00+00,22667,3244,5889,4231,631,3032,2565,235,1107,666,44268,289,14423,11858,5969,25911
2021-01-06 15:00:00+00,22410,3329,5878,4265,678,3028,2717,189,550,1358,44402,288,14088,11371,5493,25739
2021-01-06 15:30:00+00,22650,3539,5884,4284,803,3108,2683,269,114,1382,44716,294,13768,11085,5201,26189
2021-01-06 16:00:00+00,22872,3585,5882,3903,869,3261,2568,381,0,1550,44871,297,13222,10654,4772,26457
2021-01-06 16:30:00+00,23761,3720,5877,3870,891,3225,2713,464,0,1858,46379,299,13351,10638,4761,27481
2021-01-06 17:00:00+00,24000,3763,5882,4034,1030,3122,2819,479,0,1802,46930,297,13765,10946,5064,27763
2021-01-06 17:30:00+00,24145,3814,5887,4005,903,3088,2831,640,0,1826,47139,300,13626,10795,4908,27959
2021-01-06 18:00:00+00,23242,3703,5886,4648,979,3081,2814,642,0,1694,46688,292,14327,11513,5627,26945
2021-01-06 18:30:00+00,23025,3574,5881,4870,904,3075,2693,618,0,1776,46416,289,14348,11655,5774,26599
2021-01-06 19:00:00+00,22351,3754,5882,5104,648,3040,2802,582,0,1108,45271,292,14436,11634,5752,26105
2021-01-06 19:30:00+00,22161,3785,5879,5055,527,3022,2819,414,0,478,44140,297,14280,11461,5582,25946
2021-01-06 20:00:00+00,21700,3718,5885,5006,416,2994,2836,208,0,0,42763,299,14143,11307,5422,25418
2021-01-06 20:30:00+00,20870,3550,5887,4946,389,2974,2793,155,0,0,41564,295,14015,11222,5335,24420
2021-01-06 21:00:00+00,20351,2977,5882,4952,364,2232,2737,158,0,54,39707,287,13935,11198,5316,23328
2021-01-06 21:30:00+00,19172,2765,5893,5145,343,2202,2498,150,0,0,38168,280,13879,11381,5488,21937
2021-01-06 22:00:00+00,18204,2608,5884,5012,347,1698,2029,155,0,16,35953,280,13272,11243,5359,20812
2021-01-06 22:30:00+00,16966,2217,5888,4945,346,1698,1934,152,0,0,34146,269,13113,11179,5291,19183
2021-01-06 23:00:00+00,16384,1915,5885,4616,339,2167,1765,153,0,0,33223,263,12605,10840,4955,18299
2021-01-06 23:30:00+00,15888,1824,5886,4568,339,2174,1774,153,0,0,32605,260,12567,10793,4907,17712
2021-01-07 00:00:00+00,15477,1736,5891,4741,325,2275,1755,150,0,0,32350,255,12712,10957,5066,17213
2021-01-07 00:30:00+00,15947,1679,5892,4504,319,2279,1763,152,0,0,32535,257,12478,10715,4823,17626
2021-01-07 01:00:00+00,15850,1687,5875,4308,319,2373,1780,155,0,0,32347,259,12282,10502,4627,17537
2021-01-07 01:30:00+00,15346,1733,5876,4353,317,2376,1793,152,0,0,31946,257,12339,10546,4670,17079
2021-01-07 02:00:00+00,14889,1857,5870,4225,317,2361,1823,153,0,0,31495,259,12235,10412,4542,16746
2021-01-07 02:30:00+00,14493,1951,5873,4317,317,2363,1844,153,0,0,31311,258,12351,10507,4634,16444
2021-01-07 03:00:00+00,13584,1979,5876,4344,317,2318,1849,152,0,0,30419,255,12386,10537,4661,15563
2021-01-07 03:30:00+00,13411,1979,5873,4172,318,2305,1873,153,0,0,30084,255,12236,10363,4490,15390
2021-01-07 04:00:00+00,14491,1979,5877,4048,331,2151,1885,155,0,0,30917,262,12141,10256,4379,16470
2021-01-07 04:30:00+00,14979,2086,5880,3636,331,2142,1883,154,0,0,31091,270,11730,9847,3967,17065
2021-01-07 05:00:00+00,15756,2522,5893,3475,329,1933,2043,151,0,0,32102,283,11740,9697,3804,18278
2021-01-07 05:30:00+00,16595,2800,5887,3731,329,1959,2076,150,0,0,33527,289,12023,9947,4060,19395
2021-01-07 06:00:00+00,19724,3061,5886,3504,359,1892,2231,151,0,0,36808,304,11980,9749,3863,22785
2021-01-07 06:30:00+00,21267,3075,5884,3529,377,1963,2688,191,0,0,38974,307,12478,9790,3906,24342
2021-01-07 07:00:00+00,21998,3084,5885,3558,488,2161,2965,206,0,0,40345,306,12896,9931,4046,25082
2021-01-07 07:30:00+00,22622,3297,5878,3275,684,2277,2990,255,0,404,41681,309,12827,9837,3959,25919
2021-01-07 08:00:00+00,22487,3321,5884,3462,800,2501,3007,336,1,280,42079,306,13154,10147,4263,25808
2021-01-07 08:30:00+00,22624,3283,5879,3552,823,2637,3005,437,85,552,42877,303,13344,10339,4460,25907
2021-01-07 09:00:00+00,22867,3384,5880,3704,835,2261,3004,378,466,796,43575,299,13889,10885,5005,26251
2021-01-07 09:30:00+00,23014,3419,5876,3682,821,2144,3010,436,901,828,44131,297,14290,11280,5404,26433
2021-01-07 10:00:00+00,23035,3383,5875,3558,781,2282,3030,387,1310,784,44425,295,14554,11524,5649,26418
2021-01-07 10:30:00+00,23259,3395,5865,3523,797,2266,3044,410,1666,412,44637,295,14895,11851,5986,26654
2021-01-07 11:00:00+00,23027,3300,5862,3652,801,2618,2846,425,1968,820,45319,288,15129,12283,6421,26327
2021-01-07 11:30:00+00,22835,3447,5852,3400,801,2720,2929,414,2106,820,45324,291,15088,12159,6307,26282
2021-01-07 12:00:00+00,22823,3482,5852,3621,787,2988,3055,408,2114,378,45508,290,15429,12374,6522,26305
2021-01-07 12:30:00+00,22567,3416,5860,3935,789,2992,3129,401,2196,156,45441,287,15909,12780,6920,25983
2021-01-07 13:00:00+00,22450,3419,5862,3896,786,3140,3057,329,2205,322,45466,286,15806,12749,6887,25869
2021-01-07 13:30:00+00,22530,3367,5860,3970,773,3218,3011,231,1903,86,44949,289,15517,12506,6646,25897
2021-01-07 14:00:00+00,22704,3403,5862,4243,654,3254,3096,251,1435,86,44988,292,15290,12194,6332,26107
2021-01-07 14:30:00+00,22789,3327,5856,4136,657,3234,3139,356,1006,258,44758,292,14794,11655,5799,26116
2021-01-07 15:00:00+00,22727,3445,5864,4059,819,2756,3140,355,510,944,44619,294,14392,11252,5388,26172
2021-01-07 15:30:00+00,22459,3436,5861,4170,937,2806,3109,396,108,1448,44730,291,14185,11076,5215,25895
2021-01-07 16:00:00+00,22733,3314,5858,4185,982,3212,3135,480,1,1824,45724,286,14161,11026,5168,26047
2021-01-07 16:30:00+00,23633,3437,5858,4029,1029,3212,3150,624,0,2012,46984,289,14066,10916,5058,27070
2021-01-07 17:00:00+00,24009,3505,5864,4423,978,3206,3152,668,0,1896,47701,289,14417,11265,5401,27514
2021-01-07 17:30:00+00,23943,3530,5858,4262,1031,3210,3148,683,0,2034,47699,290,14299,11151,5293,27473
2021-01-07 18:00:00+00,23581,3477,5862,4339,916,3170,3151,630,0,1934,47060,289,14268,11117,5255,27058
2021-01-07 18:30:00+00,23469,3116,5855,4608,899,3234,3023,544,0,1938,46686,282,14385,11362,5507,26585
2021-01-07 19:00:00+00,23557,3156,5863,4695,907,3270,3049,547,0,852,45896,289,14514,11465,5602,26713
2021-01-07 19:30:00+00,22769,3290,5863,4696,696,3144,3136,363,0,182,44139,295,14391,11255,5392,26059
2021-01-07 20:00:00+00,22358,3310,5862,4680,562,2204,3134,317,0,250,42677,300,14238,11104,5242,25668
2021-01-07 20:30:00+00,21844,3312,5856,4621,490,2002,3081,171,0,174,41551,300,14048,10967,5111,25156
2021-01-07 21:00:00+00,21505,3266,5863,4766,436,1098,2754,152,0,20,39860,304,13819,11065,5202,24771
2021-01-07 21:30:00+00,20771,3125,5866,4767,334,1002,2245,151,0,0,38261,303,13212,10967,5101,23896
2021-01-07 22:00:00+00,19718,2718,5864,4856,347,900,2235,152,0,30,36820,294,13302,11067,5203,22436
2021-01-07 22:30:00+00,18333,2340,5863,4839,341,880,2244,156,0,0,34996,283,13287,11043,5180,20673
2021-01-07 23:00:00+00,17314,2255,5866,4963,307,894,2080,159,0,0,33838,278,13216,11136,5270,19569
2021-01-07 23:30:00+00,16077,2302,5868,4995,305,1094,2029,149,0,0,32819,276,13197,11168,5300,18379
2021-01-08 00:00:00+00,15648,2272,5870,4954,303,1438,2029,149,0,0,32663,274,13156,11127,5257,17920
2021-01-08 00:30:00+00,15950,2373,5859,4905,304,1570,2033,150,0,0,33144,278,13101,11068,5209,18323
2021-01-08 01:00:00+00,15784,2484,5862,5166,300,1546,2028,149,0,0,33319,278,13356,11328,5466,18268
2021-01-08 01:30:00+00,14731,2486,5865,5700,299,1560,2024,149,0,0,32814,270,13888,11864,6000,17217
2021-01-08 02:00:00+00,14174,2412,5851,5819,298,1382,2040,162,0,0,32138,265,14008,11968,6117,16586
2021-01-08 02:30:00+00,14273,2209,5852,5718,297,1344,2035,154,0,0,31882,261,13902,11867,6015,16482
2021-01-08 03:00:00+00,14158,1936,5847,5713,296,1358,2037,162,0,0,31507,255,13893,11856,6009,16094
2021-01-08 03:30:00+00,13950,1936,5848,5616,295,1296,2040,163,0,0,31144,255,13799,11759,5911,15886
2021-01-08 04:00:00+00,14387,1936,5851,5564,295,1336,2030,161,0,0,31560,258,13740,11710,5859,16323
2021-01-08 04:30:00+00,14546,1945,5848,5447,293,1442,2025,166,0,0,31712,260,13613,11588,5740,16491
2021-01-08 05:00:00+00,15997,2290,5864,5695,306,934,2000,149,0,0,33235,274,13865,11865,6001,18287
2021-01-08 05:30:00+00,16733,2436,5861,5602,306,898,1997,150,0,0,33983,280,13766,11769,5908,19169
2021-01-08 06:00:00+00,18624,2802,5867,5573,312,816,2028,150,0,0,36172,294,13780,11752,5885,21426
2021-01-08 06:30:00+00,20044,2473,5859,5495,315,768,2522,155,0,0,37631,291,14191,11669,5810,22517
2021-01-08 07:00:00+00,20315,2305,5861,5427,356,878,3006,155,0,0,38303,289,14650,11644,5783,22620
2021-01-08 07:30:00+00,21457,2608,5861,5323,404,906,2991,205,0,144,39899,296,14579,11588,5727,24065
2021-01-08 08:00:00+00,22213,3056,5862,5151,430,1154,2996,267,0,84,41213,306,14439,11443,5581,25269
2021-01-08 08:30:00+00,22785,3096,5859,4964,450,1168,3032,406,52,382,42194,306,14357,11325,5466,25881
2021-01-08 09:00:00+00,22665,3095,5856,4979,463,2410,3007,415,221,210,43321,300,14526,11519,5663,25760
2021-01-08 09:30:00+00,22916,3094,5860,4826,518,2488,2994,422,473,208,43799,299,14671,11677,5817,26010
2021-01-08 10:00:00+00,22442,3095,5852,4694,415,3334,3025,361,666,340,44224,293,14652,11627,5775,25537
2021-01-08 10:30:00+00,22890,3097,5851,4298,408,3324,3073,416,851,280,44488,296,14481,11408,5557,25987
2021-01-08 11:00:00+00,23016,3095,5851,4039,457,3506,3071,436,929,286,44686,296,14347,11276,5425,26111
2021-01-08 11:30:00+00,22897,3094,5851,4194,494,3546,3058,450,973,416,44974,293,14570,11512,5662,25991
2021-01-08 12:00:00+00,22985,3095,5845,4257,522,3686,3066,436,1032,604,45528,289,14722,11656,5811,26080
2021-01-08 12:30:00+00,23039,3095,5844,4237,530,3672,3073,468,971,482,45411,291,14655,11582,5738,26134
2021-01-08 13:00:00+00,23086,3084,5852,4139,554,3660,3070,498,947,590,45480,291,14562,11492,5640,26170
2021-01-08 13:30:00+00,23073,3080,5852,3855,475,3594,3074,532,825,406,44766,295,14081,11007,5155,26153
2021-01-08 14:00:00+00,23189,3051,5851,3594,516,3674,3079,521,605,326,44406,299,13645,10566,4715,26240
2021-01-08 14:30:00+00,23295,3090,5852,3559,535,3568,3096,491,420,216,44122,302,13462,10366,4514,26385
2021-01-08 15:00:00+00,22853,2920,5849,3502,666,3560,3106,476,201,1018,44151,294,13324,10218,4369,25773
2021-01-08 15:30:00+00,22874,2850,5855,3487,684,3630,3114,534,38,1328,44394,293,13178,10064,4209,25724
2021-01-08 16:00:00+00,23324,3115,5851,3359,723,3482,3119,514,0,1304,44791,298,13052,9933,4082,26439
2021-01-08 16:30:00+00,23595,3291,5848,3237,966,3558,3147,596,0,1738,45976,298,13198,10051,4203,26886
2021-01-08 17:00:00+00,23893,3305,5844,3044,1003,3612,3149,621,0,1858,46329,299,13040,9891,4047,27198
2021-01-08 17:30:00+00,23897,3266,5847,3062,1033,3566,3149,614,0,1754,46188,299,13091,9942,4095,27163
2021-01-08 18:00:00+00,23653,3188,5841,3105,1025,3468,3120,507,0,1904,45811,295,13091,9971,4130,26841
2021-01-08 18:30:00+00,23689,3010,5840,2935,1019,3305,3121,465,0,1716,45100,294,12915,9794,3954,26699
2021-01-08 19:00:00+00,23812,2999,5842,2747,971,3191,3123,411,0,1112,44208,299,12683,9560,3718,26811
2021-01-08 19:30:00+00,23486,2996,5844,2487,642,3147,3121,402,0,280,42405,307,12094,8973,3129,26482
2021-01-08 20:00:00+00,22908,2991,5841,2292,448,3163,3120,341,0,144,41248,309,11701,8581,2740,25899
2021-01-08 20:30:00+00,22676,2693,5838,1949,377,3171,3121,242,0,174,40240,307,11285,8164,2326,25369
2021-01-08 21:00:00+00,22515,2139,5843,1862,335,3019,3077,254,0,496,39540,297,11117,8040,2197,24654
2021-01-08 21:30:00+00,21981,1803,5839,1922,304,3042,2820,272,0,186,38170,292,10885,8065,2226,23784
2021-01-08 22:00:00+00,20847,1802,5842,1951,284,2953,2731,187,0,522,37119,287,10808,8077,2235,22649
2021-01-08 22:30:00+00,19783,1622,5835,2092,299,3026,2075,173,0,652,35557,281,10301,8226,2391,21405
2021-01-08 23:00:00+00,17696,1323,5826,2367,299,3161,1757,170,0,0,32599,271,10249,8492,2666,19019
2021-01-08 23:30:00+00,16942,1428,5827,2549,297,3149,1496,166,0,0,31854,270,10169,8673,2846,18370
2021-01-09 00:00:00+00,16786,1273,5847,2559,292,3163,1495,167,0,0,31582,265,10193,8698,2851,18059
2021-01-09 00:30:00+00,17005,1463,5858,2692,291,3241,1525,162,0,0,32237,269,10366,8841,2983,18468
2021-01-09 01:00:00+00,17004,1396,5861,2915,291,3229,1594,153,0,0,32443,265,10661,9067,3206,18400
2021-01-09 01:30:00+00,16435,1224,5862,2941,273,3204,1691,153,0,0,31783,258,10767,9076,3214,17659
2021-01-09 02:00:00+00,15990,1229,5857,2922,257,3187,1602,155,0,0,31199,257,10638,9036,3179,17219
2021-01-09 02:30:00+00,15707,1227,5863,3050,255,3187,1564,152,0,0,31005,255,10732,9168,3305,16934
2021-01-09 03:00:00+00,15310,1062,5860,3038,254,3139,1567,156,0,0,30386,250,10719,9152,3292,16372
2021-01-09 03:30:00+00,15047,714,5860,3155,254,3127,1545,154,0,0,29856,240,10814,9269,3409,15761
2021-01-09 04:00:00+00,14580,687,5859,3535,254,3006,1497,155,0,0,29573,234,11145,9648,3789,15267
2021-01-09 04:30:00+00,14158,689,5861,3854,254,3004,1498,154,0,0,29472,229,11467,9969,4108,14847
2021-01-09 05:00:00+00,14036,744,5860,4020,253,3004,1498,154,0,0,29569,229,11631,10133,4273,14780
2021-01-09 05:30:00+00,14305,677,5861,4100,254,3004,1499,156,0,0,29856,228,11714,10215,4354,14982
2021-01-09 06:00:00+00,15064,1021,5861,4230,271,2944,1501,153,0,0,31045,239,11863,10362,4501,16085
2021-01-09 06:30:00+00,15030,1639,5859,4398,270,2908,1701,154,0,0,31959,251,12228,10527,4668,16669
2021-01-09 07:00:00+00,15015,2033,5859,4587,271,2150,1850,162,0,0,31927,261,12567,10717,4858,17048
2021-01-09 07:30:00+00,14887,2159,5855,4880,308,2140,1753,160,0,0,32142,261,12796,11043,5188,17046
2021-01-09 08:00:00+00,15240,2089,5859,5179,333,2874,1740,161,3,0,33478,255,13114,11374,5515,17329
2021-01-09 08:30:00+00,16267,2239,5857,5520,333,2838,1834,162,137,0,35187,258,13681,11847,5990,18506
2021-01-09 09:00:00+00,16950,2394,5850,5667,360,3004,1833,164,578,162,36962,257,14288,12455,6605,19344
2021-01-09 09:30:00+00,17622,2656,5848,5628,347,3004,1831,161,1082,174,38353,261,14736,12905,7057,20278
2021-01-09 10:00:00+00,18300,2767,5840,5606,339,3004,1808,197,1463,22,39346,264,15056,13248,7408,21067
2021-01-09 10:30:00+00,18475,2815,5828,5841,331,3004,1803,281,1727,0,40105,263,15530,13727,7899,21290
2021-01-09 11:00:00+00,18582,2912,5822,5986,340,2902,1803,305,1927,0,40579,263,15878,14075,8253,21494
2021-01-09 11:30:00+00,18622,2937,5818,6126,345,2900,1817,309,2134,30,41038,261,16240,14423,8605,21559
2021-01-09 12:00:00+00,18692,2935,5821,6030,360,3002,1822,327,2496,134,41619,258,16529,14707,8886,21627
2021-01-09 12:30:00+00,18793,2892,5831,5907,376,3004,1814,375,2606,118,41716,258,16534,14720,8889,21685
2021-01-09 13:00:00+00,18848,2853,5834,6039,376,3004,1823,391,2418,8,41594,259,16490,14667,8833,21701
2021-01-09 13:30:00+00,18690,2853,5837,6121,383,3004,1824,388,2184,0,41284,259,16349,14525,8688,21543
2021-01-09 14:00:00+00,18627,2850,5841,6505,393,2892,1792,272,1810,0,40982,259,16341,14549,8708,21477
2021-01-09 14:30:00+00,18767,2839,5838,6725,395,2882,1706,193,1223,0,40568,262,15887,14181,8343,21606
2021-01-09 15:00:00+00,19417,2809,5842,6892,415,2412,1818,193,604,34,40436,268,15571,13753,7911,22226
2021-01-09 15:30:00+00,20230,2824,5844,6934,399,2416,1812,192,146,0,40797,274,15135,13323,7479,23054
2021-01-09 16:00:00+00,20812,2846,5843,6871,435,3010,1830,245,2,332,42226,272,14981,13151,7308,23658
2021-01-09 16:30:00+00,21677,2851,5841,6948,448,3024,1837,574,0,876,44076,272,15074,13237,7396,24528
2021-01-09 17:00:00+00,21927,2802,5839,7070,486,3024,1837,646,0,1464,45095,268,15232,13395,7556,24729
2021-01-09 17:30:00+00,21964,2909,5834,7179,652,3024,1833,636,0,1550,45581,267,15498,13665,7831,24873
2021-01-09 18:00:00+00,21867,2914,5828,7317,515,3024,1711,613,0,1414,45203,268,15371,13660,7832,24781
2021-01-09 18:30:00+00,21726,2760,5826,7269,505,3024,1527,562,0,908,44107,268,15127,13600,7774,24486
2021-01-09 19:00:00+00,21203,2277,5823,7393,473,3024,1498,456,0,258,42405,262,15187,13689,7866,23480
2021-01-09 19:30:00+00,20825,1877,5813,7551,455,3024,1373,265,0,140,41323,255,15192,13819,8006,22702
2021-01-09 20:00:00+00,20162,1838,5819,7659,396,3024,1195,220,0,48,40361,253,15069,13874,8055,22000
2021-01-09 20:30:00+00,19213,1535,5817,7649,341,3020,1194,215,0,0,38984,244,15001,13807,7990,20748
2021-01-09 21:00:00+00,17831,1533,5814,7618,341,2710,1196,221,0,78,37342,239,14969,13773,7959,19364
2021-01-09 21:30:00+00,16502,1635,5819,7320,344,2710,1194,214,0,40,35778,238,14677,13483,7664,18137
2021-01-09 22:00:00+00,15251,1519,5821,7173,292,2900,1194,214,0,0,34364,231,14480,13286,7465,16770
2021-01-09 22:30:00+00,14044,1041,5834,7075,285,2932,1194,221,0,0,32626,216,14388,13194,7360,15085
2021-01-09 23:00:00+00,12469,864,5835,7051,288,3060,1194,220,0,4,30985,202,14368,13174,7339,13333
2021-01-09 23:30:00+00,11588,853,5843,7034,290,3012,1193,216,0,0,30029,196,14360,13167,7324,12441
2021-01-10 00:00:00+00,11578,728,5844,6797,287,2988,1193,218,0,0,29633,194,14121,12928,7084,12306
2021-01-10 00:30:00+00,11681,784,5845,6878,295,3013,1195,219,0,2,29912,196,14213,13018,7173,12465
2021-01-10 01:00:00+00,11573,784,5840,6984,297,2904,1192,214,0,0,29788,195,14313,13121,7281,12357
2021-01-10 01:30:00+00,11347,687,5829,7037,285,2920,1193,218,0,0,29516,191,14344,13151,7322,12034
2021-01-10 02:00:00+00,11457,672,5835,6475,283,2898,1194,222,0,0,29036,195,13787,12593,6758,12129
2021-01-10 02:30:00+00,11417,730,5837,6340,282,2882,1196,219,0,0,28902,197,13654,12458,6622,12147
2021-01-10 03:00:00+00,11079,732,5833,6180,282,2934,1196,224,0,0,28460,196,13491,12295,6462,11811
2021-01-10 03:30:00+00,11099,731,5837,5821,288,2858,1195,227,0,0,28056,198,13141,11946,6109,11830
2021-01-10 04:00:00+00,11320,627,5834,5411,293,2872,1195,233,0,0,27785,200,12733,11538,5704,11947
2021-01-10 04:30:00+00,11600,652,5831,5105,296,2872,1196,275,0,0,27827,205,12428,11232,5401,12252
2021-01-10 05:00:00+00,11410,717,5831,5029,318,2950,1195,223,0,0,27673,206,12373,11178,5347,12127
2021-01-10 05:30:00+00,11256,730,5834,5166,366,2970,1195,220,0,0,27737,204,12561,11366,5532,11986
2021-01-10 06:00:00+00,11221,1048,5836,5109,379,3132,1195,217,0,0,28137,212,12519,11324,5488,12269
2021-01-10 06:30:00+00,11691,1420,5839,4976,390,3140,1193,218,0,0,28867,225,12398,11205,5366,13111
2021-01-10 07:00:00+00,12240,1728,5841,5123,404,3054,1194,221,0,0,29805,234,12562,11368,5527,13968
2021-01-10 07:30:00+00,12414,2127,5837,5202,363,3092,1194,198,0,0,30427,244,12596,11402,5565,14541
2021-01-10 08:00:00+00,12475,2471,5839,5022,391,3122,1195,159,5,0,30679,253,12452,11257,5418,14946
2021-01-10 08:30:00+00,13566,2707,5837,4975,409,3172,1189,156,104,0,32115,263,12514,11325,5488,16273
2021-01-10 09:00:00+00,14968,2846,5836,5055,431,3066,1181,160,287,0,33830,268,12790,11609,5773,17814
2021-01-10 09:30:00+00,16574,2761,5834,4981,432,3018,1179,161,486,0,35426,271,12912,11733,5899,19335
2021-01-10 10:00:00+00,17505,2844,5832,5093,449,3034,1176,168,633,16,36750,274,13183,12007,6175,20349
2021-01-10 10:30:00+00,17550,2861,5832,5479,453,3018,1176,328,855,168,37720,269,13795,12619,6787,20411
2021-01-10 11:00:00+00,17931,2865,5840,5968,440,2918,1176,327,1155,38,38658,266,14579,13403,7563,20796
2021-01-10 11:30:00+00,18309,2867,5831,6185,450,2918,1176,226,1260,30,39252,265,14902,13726,7895,21176
2021-01-10 12:00:00+00,18669,2863,5834,6506,462,3004,1177,268,1082,290,40155,263,15061,13884,8050,21532
2021-01-10 12:30:00+00,19136,2865,5850,6634,461,3004,1177,229,1135,320,40811,263,15257,14080,8230,22001
2021-01-10 13:00:00+00,19366,2864,5844,6826,450,3004,1232,266,904,12,40768,266,15256,14024,8180,22230
2021-01-10 13:30:00+00,19495,2862,5835,7006,454,3004,1299,237,729,0,40921,267,15323,14024,8189,22357
2021-01-10 14:00:00+00,19610,2862,5840,7029,466,3004,1518,195,548,0,41072,267,15401,13883,8043,22472
2021-01-10 14:30:00+00,19690,2850,5841,7066,467,3004,1747,189,403,0,41257,267,15524,13777,7936,22540
2021-01-10 15:00:00+00,20086,2842,5842,7266,497,3004,1797,190,194,0,41718,267,15596,13799,7957,22928
2021-01-10 15:30:00+00,20450,2841,5839,7524,511,3006,1808,195,33,0,42207,268,15715,13907,8068,23291
2021-01-10 16:00:00+00,20764,2918,5841,7783,544,3088,1819,207,0,822,43786,264,15987,14168,8327,23682
2021-01-10 16:30:00+00,21108,2990,5834,8058,602,3298,1828,415,0,1324,45457,262,16322,14494,8660,24098
2021-01-10 17:00:00+00,21100,2994,5843,8679,597,3166,1840,467,0,1062,45748,260,16959,15119,9276,24094
2021-01-10 17:30:00+00,20995,2717,5834,9024,599,3112,1842,394,0,1170,45687,253,17299,15457,9623,23712
2021-01-10 18:00:00+00,20654,2539,5836,9070,583,2590,1842,372,0,1000,44486,250,17331,15489,9653,23193
2021-01-10 18:30:00+00,19995,2475,5837,8921,562,2528,1841,244,0,378,42781,251,17161,15320,9483,22470
2021-01-10 19:00:00+00,18046,2259,5835,9780,558,2904,1839,228,0,0,41449,237,18012,16173,10338,20305
2021-01-10 19:30:00+00,16535,1572,5837,10646,547,2856,1753,219,0,0,39965,214,18783,17030,11193,18107
2021-01-10 20:00:00+00,16090,988,5827,10954,491,2634,1622,213,0,4,38823,200,18894,17272,11445,17078
2021-01-10 20:30:00+00,14572,954,5829,11491,453,2664,1312,225,0,0,37500,190,19085,17773,11944,15526
2021-01-10 21:00:00+00,12930,745,5830,11971,432,2824,1189,211,0,0,36132,176,19422,18233,12403,13675
2021-01-10 21:30:00+00,11590,347,5831,12163,434,2768,1187,210,0,0,34530,157,19615,18428,12597,11937
2021-01-10 22:00:00+00,10315,250,5830,12479,412,1862,1188,227,0,0,32563,148,19909,18721,12891,10565
2021-01-10 22:30:00+00,9082,0,5827,12474,404,1894,1185,218,0,0,31084,133,19890,18705,12878,9082
2021-01-10 23:00:00+00,6383,0,5835,12822,402,2756,1170,218,0,0,29586,105,20229,19059,13224,6383
2021-01-10 23:30:00+00,6548,0,5833,12617,401,2712,1155,217,0,0,29483,107,20006,18851,13018,6548
2021-01-11 00:00:00+00,6712,0,5835,13028,401,1916,1155,216,0,0,29263,106,20419,19264,13429,6712
2021-01-11 00:30:00+00,6932,0,5834,13304,378,1978,1158,217,0,0,29801,108,20674,19516,13682,6932
2021-01-11 01:00:00+00,6587,0,5836,13416,348,2114,1158,200,0,0,29659,105,20758,19600,13764,6587
2021-01-11 01:30:00+00,5963,0,5840,13674,344,2078,1156,163,0,0,29218,98,21014,19858,14018,5963
2021-01-11 02:00:00+00,6034,0,5833,13713,344,1586,1155,182,0,0,28847,100,21045,19890,14057,6034
2021-01-11 02:30:00+00,6149,0,5829,13510,342,1542,1155,172,0,0,28699,102,20836,19681,13852,6149
2021-01-11 03:00:00+00,6819,0,5836,13417,345,530,1138,164,0,0,28249,108,20736,19598,13762,6819
2021-01-11 03:30:00+00,6652,0,5834,13354,349,472,1139,168,0,0,27968,106,20676,19537,13703,6652
2021-01-11 04:00:00+00,6949,0,5837,13228,353,546,1134,165,0,0,28212,112,20552,19418,13581,6949
2021-01-11 04:30:00+00,6759,23,5833,13341,371,610,1143,170,0,0,28250,111,20688,19545,13712,6782
2021-01-11 05:00:00+00,6174,215,5829,13487,373,1348,1310,176,0,0,28912,113,20999,19689,13860,6389
2021-01-11 05:30:00+00,6270,277,5833,13587,374,1404,1626,170,0,0,29541,116,21420,19794,13961,6547
2021-01-11 06:00:00+00,8119,479,5832,13564,375,1082,1787,171,0,0,31409,138,21558,19771,13939,8598
2021-01-11 06:30:00+00,10224,556,5832,14016,383,1056,1830,169,0,0,34066,153,22061,20231,14399,10780
2021-01-11 07:00:00+00,12941,495,5833,14298,420,702,1829,177,0,184,36879,167,22380,20551,14718,13436
2021-01-11 07:30:00+00,14711,623,5836,14424,458,792,1833,179,0,264,39120,179,22551,20718,14882,15334
2021-01-11 08:00:00+00,15733,977,5836,14543,504,1012,1832,178,4,376,40995,190,22719,20887,15051,16710
2021-01-11 08:30:00+00,16195,1520,5837,14495,520,1014,1835,268,97,588,42369,201,22784,20949,15112,17715
2021-01-11 09:00:00+00,16331,1876,5842,14686,539,1498,1831,353,248,574,43778,204,23146,21315,15473,18207
2021-01-11 09:30:00+00,16287,1949,5842,14809,550,1504,1832,353,425,596,44147,204,23458,21626,15784,18236
2021-01-11 10:00:00+00,16729,1951,5828,14824,537,1354,1832,345,639,572,44612,204,23660,21828,16000,18680
2021-01-11 10:30:00+00,16858,1937,5817,14947,543,1362,1827,294,782,756,45123,202,23916,22089,16272,18795
2021-01-11 11:00:00+00,16937,1955,5816,15018,543,1410,1802,207,897,646,45231,202,24076,22274,16458,18892
2021-01-11 11:30:00+00,17110,1957,5814,15116,555,1450,1788,171,1180,226,45367,203,24453,22665,16851,19067
2021-01-11 12:00:00+00,17424,1957,5810,15085,555,1168,1785,208,1046,48,45086,207,24281,22496,16686,19381
2021-01-11 12:30:00+00,17388,1952,5817,15127,549,1166,1786,249,1077,0,45111,207,24356,22570,16753,19340
2021-01-11 13:00:00+00,16823,1809,5814,15364,554,1412,1785,170,1030,0,44761,200,24547,22762,16948,18632
2021-01-11 13:30:00+00,16396,1633,5812,15356,557,1402,1827,167,834,0,43984,196,24386,22559,16747,18029
2021-01-11 14:00:00+00,16434,1549,5810,15296,543,1288,1770,182,694,0,43566,195,24113,22343,16533,17983
2021-01-11 14:30:00+00,16410,1599,5812,15329,545,1326,1818,180,433,0,43452,197,23937,22119,16307,18009
2021-01-11 15:00:00+00,16485,1883,5816,15462,562,1444,1829,183,231,0,43896,202,23900,22071,16255,18368
2021-01-11 15:30:00+00,16813,1926,5820,15472,561,1530,1838,184,48,214,44405,204,23739,21901,16081,18739
2021-01-11 16:00:00+00,17065,1893,5816,15271,558,1709,1843,210,0,312,44677,203,23488,21645,15829,18958
2021-01-11 16:30:00+00,17365,1752,5816,15113,578,1890,1840,324,0,966,45644,200,23347,21507,15691,19117
2021-01-11 17:00:00+00,17478,1779,5817,14733,576,1963,1841,451,0,1014,45653,202,22967,21126,15309,19257
2021-01-11 17:30:00+00,17426,1908,5821,14814,581,2016,1840,346,0,676,45428,205,23056,21216,15395,19334
2021-01-11 18:00:00+00,17235,1924,5817,14571,595,2036,1838,362,0,824,45201,205,22821,20983,15166,19159
2021-01-11 18:30:00+00,16955,1928,5822,14466,586,2003,1838,294,0,402,44294,206,22712,20874,15052,18883
2021-01-11 19:00:00+00,16551,1753,5818,14417,584,2253,1836,209,0,252,43673,202,22655,20819,15001,18304
2021-01-11 19:30:00+00,16003,1544,5820,14142,583,2147,1838,215,0,296,42587,196,22383,20545,14725,17547
2021-01-11 20:00:00+00,15462,1259,5820,13513,534,2223,1685,200,0,338,41035,192,21552,19867,14047,16721
2021-01-11 20:30:00+00,14586,1159,5821,13141,557,2238,1493,206,0,356,39558,187,21012,19519,13698,15745
2021-01-11 21:00:00+00,13653,1301,5839,12675,595,2386,1503,219,0,504,38676,188,20612,19109,13270,14954
2021-01-11 21:30:00+00,12401,1275,5857,12167,639,2449,1498,296,0,444,37026,183,20161,18663,12806,13676
2021-01-11 22:00:00+00,11150,1049,5871,11706,619,2485,1496,233,0,0,34609,175,19692,18196,12325,12199
2021-01-11 22:30:00+00,9981,789,5868,11646,597,2665,1497,183,0,120,33345,161,19608,18111,12243,10770
2021-01-11 23:00:00+00,9111,745,5873,11085,577,2546,1492,183,0,52,31663,156,19027,17535,11662,9856
2021-01-11 23:30:00+00,8532,767,5872,10745,578,2330,1410,179,0,0,30414,151,18605,17195,11323,9299
2021-01-12 00:00:00+00,8376,765,5869,10621,543,2274,1398,181,0,0,30027,149,18431,17033,11164,9141
2021-01-12 00:30:00+00,8321,693,5868,10203,541,2474,1397,178,0,0,29674,149,18009,16612,10744,9014
2021-01-12 01:00:00+00,8107,719,5875,9907,507,2598,1394,178,0,0,29285,150,17683,16289,10414,8826
2021-01-12 01:30:00+00,7455,662,5880,10419,504,2736,1394,178,0,0,29228,141,18197,16803,10923,8117
2021-01-12 02:00:00+00,6680,629,5875,10680,504,2668,1394,178,0,0,28608,132,18453,17059,11184,7309
2021-01-12 02:30:00+00,6693,630,5872,10431,504,2624,1403,187,0,0,28344,133,18210,16807,10935,7323
2021-01-12 03:00:00+00,7142,668,5871,9629,503,2722,1398,179,0,0,28112,141,17401,16003,10132,7810
2021-01-12 03:30:00+00,7003,669,5874,9666,504,2618,1396,177,0,0,27907,139,17440,16044,10170,7672
2021-01-12 04:00:00+00,6683,693,5877,9746,503,2572,1401,180,0,0,27656,137,17527,16126,10249,7376
2021-01-12 04:30:00+00,7054,771,5879,9500,503,2545,1399,180,0,0,27832,144,17281,15882,10003,7825
2021-01-12 05:00:00+00,7612,790,5878,9304,500,2422,1404,180,0,0,28090,150,17086,15682,9804,8402
2021-01-12 05:30:00+00,7954,1248,5874,9135,498,2401,1400,178,0,0,28689,166,16907,15507,9633,9202
2021-01-12 06:00:00+00,10065,2059,5881,9029,517,2546,1401,180,0,0,31678,202,16828,15427,9546,12124
2021-01-12 06:30:00+00,12321,2643,5875,8579,516,2431,1392,180,0,0,33937,230,16362,14970,9095,14964
2021-01-12 07:00:00+00,16422,2908,5892,8265,534,2032,1464,178,0,10,37705,256,16155,14691,8799,19330
2021-01-12 07:30:00+00,18237,3240,5888,8074,541,1926,1495,181,0,0,39583,268,15998,14503,8615,21477
2021-01-12 08:00:00+00,18795,3701,5891,7720,578,1863,1628,210,1,16,40403,281,15818,14190,8299,22496
2021-01-12 08:30:00+00,19081,3843,5891,6960,573,1967,1785,409,91,500,41100,285,15300,13515,7624,22924
2021-01-12 09:00:00+00,18747,3821,5898,6701,571,2897,1785,435,507,120,41482,282,15462,13677,7779,22568
2021-01-12 09:30:00+00,19123,3823,5912,6526,559,2938,1771,427,1007,14,42101,281,15775,14004,8092,22946
2021-01-12 10:00:00+00,19159,3860,5930,6006,560,2932,1772,242,1475,66,42002,282,15743,13971,8041,23019
2021-01-12 10:30:00+00,19484,3821,5940,5755,567,2984,1771,241,1979,262,42804,279,16012,14241,8301,23305
2021-01-12 11:00:00+00,19605,3690,5951,5459,744,2973,1768,221,2265,14,42690,278,16187,14419,8468,23295
2021-01-12 11:30:00+00,19892,3606,5957,5408,810,2969,1744,227,2428,20,43062,276,16347,14603,8646,23498
2021-01-12 12:00:00+00,20260,3807,5956,5290,644,2968,1755,386,2544,76,43686,281,16189,14434,8478,24067
2021-01-12 12:30:00+00,20356,3816,5951,5442,552,2891,1752,381,2557,0,43698,281,16254,14502,8551,24172
2021-01-12 13:00:00+00,20190,3808,5889,5464,566,2845,1763,337,2157,0,43018,284,15839,14076,8187,23998
2021-01-12 13:30:00+00,19882,3695,5834,5609,575,2731,1759,278,2022,0,42385,281,15799,14040,8206,23577
2021-01-12 14:00:00+00,20491,3214,5724,5570,578,2822,1760,224,1488,180,42051,279,15120,13360,7636,23705
2021-01-12 14:30:00+00,20720,3193,5827,5722,576,2794,1761,318,862,0,41773,283,14748,12987,7160,23913
2021-01-12 15:00:00+00,20981,3192,5825,5577,589,3186,1760,220,380,586,42296,283,14131,12371,6546,24173
2021-01-12 15:30:00+00,21203,2957,5826,5253,617,3384,1763,431,76,1324,42834,280,13535,11772,5946,24160
2021-01-12 16:00:00+00,21522,2867,5831,5349,743,3570,1762,402,1,1770,43817,276,13686,11924,6093,24389
2021-01-12 16:30:00+00,22395,2897,5831,4997,1021,3724,1775,505,0,2064,45209,279,13624,11849,6018,25292
2021-01-12 17:00:00+00,23060,3070,5841,4867,955,3692,1779,617,0,2102,45983,285,13442,11663,5822,26130
2021-01-12 17:30:00+00,22943,3139,5842,4923,986,3658,1778,609,0,2080,45958,285,13529,11751,5909,26082
2021-01-12 18:00:00+00,22246,3149,5841,5123,931,3548,1778,551,0,2064,45231,282,13673,11895,6054,25395
2021-01-12 18:30:00+00,21983,3155,5840,5074,923,3624,1778,447,0,1780,44604,283,13615,11837,5997,25138
2021-01-12 19:00:00+00,21778,3178,5848,4981,993,3870,1769,323,0,1160,43900,287,13591,11822,5974,24956
2021-01-12 19:30:00+00,21112,3177,5842,4816,880,3726,1766,297,0,918,42534,288,13304,11538,5696,24289
2021-01-12 20:00:00+00,20943,3195,5842,4615,561,3630,1753,189,0,440,41168,294,12771,11018,5176,24138
2021-01-12 20:30:00+00,20008,3222,5845,4416,515,3340,1748,181,0,308,39583,294,12524,10776,4931,23230
2021-01-12 21:00:00+00,19427,3196,5845,4140,467,2758,1747,233,0,162,37975,296,12199,10452,4607,22623
2021-01-12 21:30:00+00,18518,3215,5840,4015,460,2652,1748,157,0,0,36605,296,12063,10315,4475,21733
2021-01-12 22:00:00+00,17871,3124,5835,3859,429,2176,1740,161,0,0,35195,296,11863,10123,4288,20995
2021-01-12 22:30:00+00,16295,2874,5821,3877,441,2188,1745,157,0,0,33398,287,11884,10139,4318,19169
2021-01-12 23:00:00+00,14457,2936,5774,3856,440,2822,1723,164,0,0,32172,279,11793,10070,4296,17393
2021-01-12 23:30:00+00,13684,2947,5769,3758,444,2978,1706,159,0,0,31445,278,11677,9971,4202,16631
2021-01-13 00:00:00+00,13377,2945,5772,3727,450,3122,1714,157,0,0,31264,276,11663,9949,4177,16322
2021-01-13 00:30:00+00,13553,2947,5769,3770,448,3280,1716,157,0,0,31640,278,11703,9987,4218,16500
2021-01-13 01:00:00+00,13670,2823,5778,3718,447,3286,1716,156,0,0,31594,276,11659,9943,4165,16493
2021-01-13 01:30:00+00,13386,2680,5776,3724,445,3247,1714,157,0,0,31129,271,11659,9945,4169,16066
2021-01-13 02:00:00+00,12842,2534,5781,3800,445,3343,1715,157,0,0,30617,266,11741,10026,4245,15376
2021-01-13 02:30:00+00,12749,2404,5776,3816,444,3335,1723,157,0,0,30404,262,11759,10036,4260,15153
2021-01-13 03:00:00+00,12437,2403,5778,3792,443,3334,1737,157,0,0,30081,262,11750,10013,4235,14840
2021-01-13 03:30:00+00,12295,2408,5769,3770,429,3342,1716,157,0,0,29886,262,11684,9968,4199,14703
2021-01-13 04:00:00+00,12037,2407,5762,3715,410,3260,1719,158,0,0,29468,262,11606,9887,4125,14444
2021-01-13 04:30:00+00,12239,2403,5759,3657,407,3287,1716,156,0,0,29624,264,11539,9823,4064,14642
2021-01-13 05:00:00+00,12873,2382,5768,3625,408,3202,1719,157,0,0,30134,267,11520,9801,4033,15255
2021-01-13 05:30:00+00,12903,2574,5765,3605,410,3167,1720,161,0,0,30305,271,11500,9780,4015,15477
2021-01-13 06:00:00+00,15142,2914,5768,3667,413,3240,1744,163,0,0,33051,285,11592,9848,4080,18056
2021-01-13 06:30:00+00,17087,3007,5772,3798,442,3153,1782,158,0,0,35199,291,11794,10012,4240,20094
2021-01-13 07:00:00+00,19406,3088,5779,3864,482,3425,1773,159,0,48,38024,298,11898,10125,4346,22494
2021-01-13 07:30:00+00,20621,3130,5777,3995,533,3498,1772,174,0,192,39693,300,12077,10305,4528,23751
2021-01-13 08:00:00+00,20840,3148,5771,3997,558,3837,1770,164,1,306,40392,300,12097,10327,4556,23988
2021-01-13 08:30:00+00,21222,3207,5778,3962,594,3893,1771,309,58,690,41484,299,12163,10392,4614,24429
2021-01-13 09:00:00+00,21344,3235,5780,3831,843,3922,1729,418,227,676,42005,298,12410,10681,4901,24579
2021-01-13 09:30:00+00,21435,3239,5771,3813,875,3927,1746,430,442,872,42551,295,12647,10901,5130,24674
2021-01-13 10:00:00+00,21525,3231,5767,3897,845,3931,1736,512,559,980,42983,293,12804,11068,5301,24756
2021-01-13 10:30:00+00,21692,3231,5752,3869,786,3941,1741,522,615,940,43088,294,12763,11022,5270,24923
2021-01-13 11:00:00+00,21683,3245,5750,3935,808,3952,1771,520,707,998,43369,293,12971,11200,5450,24928
2021-01-13 11:30:00+00,21627,3244,5749,3951,801,3952,1772,534,779,1276,43686,290,13052,11280,5531,24871
2021-01-13 12:00:00+00,21855,3216,5753,3895,887,3930,1773,533,689,1630,44161,288,12997,11224,5471,25071
2021-01-13 12:30:00+00,21631,3181,5750,3965,920,3927,1776,520,597,1362,43629,289,13008,11232,5482,24812
2021-01-13 13:00:00+00,21654,3164,5749,4058,946,3912,1770,483,502,1174,43413,291,13025,11255,5506,24818
2021-01-13 13:30:00+00,21309,3183,5750,3991,889,3910,1767,491,470,1346,43106,290,12867,11100,5350,24492
2021-01-13 14:00:00+00,21441,3165,5748,3981,924,3910,1789,476,419,1270,43123,291,12861,11072,5324,24606
2021-01-13 14:30:00+00,21436,3210,5754,4049,831,3910,1793,483,270,1176,42912,294,12697,10904,5150,24646
2021-01-13 15:00:00+00,21549,3248,5752,4082,868,3910,1794,389,124,1178,42894,295,12620,10826,5074,24797
2021-01-13 15:30:00+00,21211,3243,5752,4065,888,3910,1810,330,24,1322,42555,295,12539,10729,4977,24454
2021-01-13 16:00:00+00,21932,3243,5754,4115,1022,3928,1827,369,1,1032,43223,297,12719,10892,5138,25175
2021-01-13 16:30:00+00,22319,3250,5754,4280,1092,3928,1828,463,0,1568,44482,293,12954,11126,5372,25569
2021-01-13 17:00:00+00,22703,3281,5758,4356,1091,3928,1828,621,0,1770,45336,294,13033,11205,5447,25984
2021-01-13 17:30:00+00,22281,3281,5742,4614,1092,3928,1825,609,0,1796,45168,291,13273,11448,5706,25562
2021-01-13 18:00:00+00,21890,3251,5580,4795,1092,3928,1830,541,0,1724,44631,288,13297,11467,5887,25141
2021-01-13 18:30:00+00,22113,3243,5548,4620,1077,3880,1830,506,0,1510,44327,291,13075,11245,5697,25356
2021-01-13 19:00:00+00,21673,3222,5585,4553,1056,3828,1830,420,0,470,42637,296,13024,11194,5609,24895
2021-01-13 19:30:00+00,21179,2930,5575,4542,1045,3564,1826,367,0,776,41804,287,12988,11162,5587,24109
2021-01-13 20:00:00+00,20882,3140,5577,4507,911,3346,1820,323,0,358,40864,294,12815,10995,5418,24022
2021-01-13 20:30:00+00,20126,3172,5575,4355,626,3140,1816,256,0,90,39156,296,12372,10556,4981,23298
2021-01-13 21:00:00+00,18567,3145,5574,4436,528,3242,1803,182,0,30,37507,293,12341,10538,4964,21712
2021-01-13 21:30:00+00,16919,3024,5580,4503,499,3194,1797,162,0,0,35678,286,12379,10582,5002,19943
2021-01-13 22:00:00+00,15626,2837,5664,4430,455,2956,1782,163,0,0,33913,277,12331,10549,4885,18463
2021-01-13 22:30:00+00,14355,2990,5817,4676,474,2990,1792,164,0,0,33258,272,12759,10967,5150,17345
2021-01-13 23:00:00+00,13104,2854,5838,4736,491,3130,1649,183,0,0,31985,264,12714,11065,5227,15958
2021-01-13 23:30:00+00,12292,2818,5838,4674,489,3312,1453,158,0,0,31034,262,12454,11001,5163,15110
2021-01-14 00:00:00+00,11803,2820,5845,4858,490,3310,1451,193,0,0,30770,258,12644,11193,5348,14623
2021-01-14 00:30:00+00,11930,2798,5851,4999,494,3508,1444,160,0,0,31184,258,12788,11344,5493,14728
2021-01-14 01:00:00+00,11641,2829,5848,5039,482,3396,1391,167,0,0,30793,257,12760,11369,5521,14470
2021-01-14 01:30:00+00,11051,2644,5854,5104,455,3478,1389,183,0,0,30157,251,12802,11413,5559,13695
2021-01-14 02:00:00+00,10779,2335,5850,5254,442,3403,1423,186,0,0,29672,241,12969,11546,5696,13114
2021-01-14 02:30:00+00,10376,2334,5857,5436,423,3309,1448,161,0,0,29344,237,13164,11716,5859,12710
2021-01-14 03:00:00+00,9764,2328,5851,5866,420,3228,1446,172,0,0,29075,230,13583,12137,6286,12092
2021-01-14 03:30:00+00,9174,2176,5856,6361,417,3192,1439,158,0,0,28773,219,14073,12634,6778,11350
2021-01-14 04:00:00+00,9023,1869,5853,6647,416,3001,1434,159,0,0,28402,209,14350,12916,7063,10892
2021-01-14 04:30:00+00,8944,1771,5850,6891,416,3029,1436,160,0,0,28497,205,14593,13157,7307,10715
2021-01-14 05:00:00+00,10175,2116,5848,7147,445,2357,1388,159,0,0,29635,221,14828,13440,7592,12291
2021-01-14 05:30:00+00,10235,2340,5846,7827,446,2283,1409,158,0,0,30544,221,15528,14119,8273,12575
2021-01-14 06:00:00+00,11806,2378,5842,8603,472,2249,1444,183,0,0,32978,224,16361,14917,9075,14184
2021-01-14 06:30:00+00,13300,2442,5847,9095,486,2374,1440,190,0,0,35174,229,16868,15428,9581,15742
2021-01-14 07:00:00+00,16094,2505,5743,9464,480,2098,1590,168,0,0,38142,241,17277,15687,9944,18599
2021-01-14 07:30:00+00,17521,2594,5627,9700,453,2100,1702,176,0,0,39874,247,17482,15780,10153,20115
2021-01-14 08:00:00+00,18506,2817,5621,9843,447,2212,1700,205,0,26,41377,254,17611,15911,10290,21323
2021-01-14 08:30:00+00,19213,3082,5622,9806,447,2303,1755,188,13,10,42439,261,17643,15888,10266,22295
2021-01-14 09:00:00+00,19372,3141,5627,9839,440,2219,1711,172,79,0,42600,261,17696,15985,10358,22513
2021-01-14 09:30:00+00,19799,3132,5633,9907,462,2247,1678,177,178,0,43213,262,17858,16180,10547,22931
2021-01-14 10:00:00+00,19521,3146,5627,9866,498,2183,1720,162,277,0,43001,260,17988,16268,10641,22667
2021-01-14 10:30:00+00,19782,3146,5633,9861,519,2169,1614,180,402,40,43346,260,18029,16415,10782,22928
2021-01-14 11:00:00+00,20050,3145,5634,9774,511,2217,1470,160,524,12,43496,262,17913,16443,10809,23195
2021-01-14 11:30:00+00,20496,3148,5632,9624,520,2288,1524,194,554,0,43980,264,17854,16330,10698,23644
2021-01-14 12:00:00+00,20797,3144,5678,9460,566,2638,1561,391,563,0,44798,265,17828,16267,10589,23941
2021-01-14 12:30:00+00,20767,3142,5807,9165,568,2628,1554,441,669,0,44741,265,17763,16209,10402,23909
2021-01-14 13:00:00+00,20972,3142,5839,8985,632,2442,1522,456,658,0,44648,268,17636,16114,10275,24114
2021-01-14 13:30:00+00,20761,3145,5850,8735,674,2348,1550,459,512,0,44034,269,17321,15771,9921,23906
2021-01-14 14:00:00+00,20369,3137,5859,8481,680,2528,1417,403,428,0,43302,270,16865,15448,9589,23506
2021-01-14 14:30:00+00,20698,3143,5853,8153,689,2442,1333,251,326,0,42888,273,16354,15021,9168,23841
2021-01-14 15:00:00+00,20078,3095,5853,8150,688,3212,1459,160,220,46,42961,267,16370,14911,9058,23173
2021-01-14 15:30:00+00,19954,3055,5861,7915,744,3386,1658,172,90,78,42913,268,16268,14610,8749,23009
2021-01-14 16:00:00+00,20478,3079,5856,7637,821,3586,1660,274,7,434,43832,269,15981,14321,8465,23557
2021-01-14 16:30:00+00,21090,3112,5865,7427,847,3532,1656,458,0,944,44931,269,15795,14139,8274,24202
2021-01-14 17:00:00+00,21070,3271,5857,7229,932,3620,1656,515,0,1314,45464,270,15674,14018,8161,24341
2021-01-14 17:30:00+00,21078,3274,5861,6851,948,3627,1627,544,0,1676,45486,270,15287,13660,7799,24352
2021-01-14 18:00:00+00,21329,3148,5860,6384,939,3492,1639,521,0,1548,44859,272,14822,13183,7323,24477
2021-01-14 18:30:00+00,21198,3165,5862,6058,1078,3380,1679,450,0,1408,44278,274,14677,12998,7136,24363
2021-01-14 19:00:00+00,21223,3163,5860,5510,948,3426,1662,437,0,1004,43232,281,13980,12318,6458,24386
2021-01-14 19:30:00+00,21274,3244,5863,4876,921,3169,1665,424,0,410,41846,290,13325,11660,5797,24518
2021-01-14 20:00:00+00,21106,3263,5860,4656,829,3025,1694,317,0,34,40784,294,13039,11345,5485,24369
2021-01-14 20:30:00+00,20052,3263,5750,4485,693,3022,1741,260,0,12,39279,294,12669,10928,5178,23315
2021-01-14 21:00:00+00,19139,3264,5642,4180,539,3004,1778,193,0,154,37893,294,12139,10361,4719,22403
2021-01-14 21:30:00+00,17987,3269,5641,3918,535,3002,1801,195,0,30,36378,294,11895,10094,4453,21256
2021-01-14 22:00:00+00,16413,3264,5639,3806,519,2988,1853,183,0,74,34739,290,11817,9964,4325,19677
2021-01-14 22:30:00+00,15170,2934,5646,3599,529,2986,1989,163,0,0,33016,281,11763,9774,4128,18104
2021-01-14 23:00:00+00,14638,2425,5663,3651,527,2856,1975,182,0,0,31917,269,11816,9841,4178,17063
2021-01-14 23:30:00+00,13833,2420,5796,3498,513,2856,1923,164,0,0,31003,266,11730,9807,4011,16253
2021-01-15 00:00:00+00,13940,2420,5857,3190,500,3000,1976,189,0,0,31072,269,11523,9547,3690,16360
2021-01-15 00:30:00+00,14607,2419,5875,3090,494,3002,1977,180,0,0,31644,272,11436,9459,3584,17026
2021-01-15 01:00:00+00,14618,2420,5894,3006,493,2913,1952,163,0,0,31460,273,11345,9393,3499,17038
2021-01-15 01:30:00+00,13917,2422,5909,2965,494,2921,1951,159,0,0,30739,270,11319,9368,3459,16339
2021-01-15 02:00:00+00,13714,2422,5916,2932,498,3009,1950,167,0,0,30608,270,11296,9346,3430,16136
2021-01-15 02:30:00+00,13612,2421,5926,2797,504,3004,1954,171,0,0,30388,270,11181,9227,3301,16033
2021-01-15 03:00:00+00,13947,2411,5943,2748,499,2405,1808,188,0,0,29949,275,10998,9190,3247,16358
2021-01-15 03:30:00+00,13714,2422,5958,2632,491,2403,1617,164,0,0,29401,276,10698,9081,3123,16136
2021-01-15 04:00:00+00,13032,2425,5971,2577,491,2761,1616,166,0,0,29038,273,10655,9039,3068,15457
2021-01-15 04:30:00+00,13027,2406,5970,2472,491,2753,1659,175,0,0,28953,273,10592,8933,2963,15433
2021-01-15 05:00:00+00,13867,2630,5976,2357,491,2212,1884,168,0,0,29585,283,10708,8824,2848,16497
2021-01-15 05:30:00+00,14121,2769,5982,2235,490,2236,2245,166,0,0,30243,287,10952,8707,2725,16890
2021-01-15 06:00:00+00,17537,2927,5991,2124,501,2133,2397,223,0,0,33834,303,11013,8616,2625,20464
2021-01-15 06:30:00+00,19507,3154,5998,2018,489,2091,2408,190,0,46,35901,313,10913,8505,2507,22661
2021-01-15 07:00:00+00,20520,3296,5893,1939,523,2171,2415,171,0,18,36947,319,10770,8355,2462,23816
2021-01-15 07:30:00+00,21722,3289,5807,1827,676,2361,2424,348,0,40,38494,322,10734,8310,2503,25011
2021-01-15 08:00:00+00,21725,3306,5802,1913,687,3425,2400,381,4,390,40033,316,10806,8406,2604,25031
2021-01-15 08:30:00+00,22293,3312,5804,1975,892,3684,2395,391,118,644,41508,313,11184,8789,2985,25605
2021-01-15 09:00:00+00,22543,3297,5808,2021,931,3859,2394,488,371,1108,42821,308,11525,9131,3323,25840
2021-01-15 09:30:00+00,22816,3244,5809,2183,920,3898,2395,401,634,930,43230,306,11941,9546,3737,26060
2021-01-15 10:00:00+00,22799,3194,5815,2218,931,3887,2417,499,968,962,43690,303,12349,9932,4117,25993
2021-01-15 10:30:00+00,22779,3234,5911,2342,883,3804,2417,504,1302,998,44175,299,12855,10438,4527,26013
2021-01-15 11:00:00+00,22803,3262,6001,2519,688,3933,2417,355,1481,882,44341,299,13106,10689,4688,26065
2021-01-15 11:30:00+00,22678,3311,6011,2757,570,3933,2411,443,1641,884,44639,297,13390,10979,4968,25989
2021-01-15 12:00:00+00,22691,3269,6012,3078,737,3910,2409,419,1717,882,45124,293,13953,11544,5532,25960
2021-01-15 12:30:00+00,22440,3196,6021,3278,837,3910,2403,338,1827,1176,45426,287,14366,11963,5942,25636
2021-01-15 13:00:00+00,21874,2996,6025,3563,800,3910,2422,278,1836,1162,44867,281,14646,12224,6199,24870
2021-01-15 13:30:00+00,21527,2865,6026,3804,804,3911,2417,205,1659,890,44108,279,14710,12293,6267,24392
2021-01-15 14:00:00+00,21618,2855,6030,3971,752,3882,2406,173,1358,680,43724,282,14517,12111,6081,24473
2021-01-15 14:30:00+00,21416,2852,6038,4190,774,3862,2407,178,994,568,43279,282,14403,11996,5958,24268
2021-01-15 15:00:00+00,21359,2855,6041,4510,800,3732,2405,258,559,362,42881,284,14315,11910,5869,24214
2021-01-15 15:30:00+00,21043,2851,6046,4976,887,3734,2407,281,214,696,43135,279,14530,12123,6077,23894
2021-01-15 16:00:00+00,21163,2898,6041,5393,997,3850,2409,277,17,972,44017,276,14857,12448,6407,24061
2021-01-15 16:30:00+00,21793,2938,6044,5810,1078,3850,2408,430,0,1704,46055,272,15340,12932,6888,24731
2021-01-15 17:00:00+00,22255,2866,6056,6216,1093,3778,2408,541,0,1766,46979,271,15773,13365,7309,25121
2021-01-15 17:30:00+00,21813,2837,6054,6730,1102,3776,2407,491,0,1960,47170,265,16293,13886,7832,24650
2021-01-15 18:00:00+00,21450,2879,6057,7105,1038,3606,2407,401,0,1768,46711,263,16607,14200,8143,24329
2021-01-15 18:30:00+00,20868,2859,6060,7380,932,3596,2392,505,0,866,45458,265,16764,14372,8312,23727
2021-01-15 19:00:00+00,19644,2863,6056,7774,849,3182,2388,427,0,532,43715,262,17067,14679,8623,22507
2021-01-15 19:30:00+00,18464,2840,6059,8322,827,3170,2379,195,0,284,42540,255,17587,15208,9149,21304
2021-01-15 20:00:00+00,16997,2838,6059,8416,724,3424,2259,180,0,30,40927,251,17458,15199,9140,19835
2021-01-15 20:30:00+00,15175,2855,6062,8891,560,3410,2203,160,0,0,39316,243,17716,15513,9451,18030
2021-01-15 21:00:00+00,14495,2429,6058,9183,509,2464,2153,161,0,0,37452,235,17903,15750,9692,16924
2021-01-15 21:30:00+00,13399,1930,6062,9592,500,2426,2061,158,0,0,36128,218,18215,16154,10092,15329
2021-01-15 22:00:00+00,12707,1334,6068,9853,462,1544,1948,159,0,0,34075,204,18331,16383,10315,14041
2021-01-15 22:30:00+00,11480,1308,6065,9982,458,1606,1438,184,0,68,32589,196,17943,16505,10440,12788
2021-01-15 23:00:00+00,8742,1103,6077,9855,457,3310,1088,169,0,0,30801,170,17477,16389,10312,9845
2021-01-15 23:30:00+00,7439,1041,6073,10016,429,3294,1085,158,0,0,29535,156,17603,16518,10445,8480
2021-01-16 00:00:00+00,6831,1009,6074,10333,426,3262,1082,158,0,0,29175,149,17915,16833,10759,7840
2021-01-16 00:30:00+00,6981,965,6070,10609,424,3258,1079,166,0,0,29552,148,18182,17103,11033,7946
2021-01-16 01:00:00+00,6627,741,6071,10980,425,3086,1069,158,0,0,29157,135,18545,17476,11405,7368
2021-01-16 01:30:00+00,5829,544,6072,11753,423,2966,1067,159,0,0,28813,118,19315,18248,12176,6373
2021-01-16 02:00:00+00,5490,538,6083,12462,423,2606,1068,161,0,0,28831,111,20036,18968,12885,6028
2021-01-16 02:30:00+00,5026,494,6079,12885,422,2540,1080,165,0,0,28691,104,20466,19386,13307,5520
2021-01-16 03:00:00+00,5518,312,6077,13189,422,1226,1070,189,0,0,28003,105,20758,19688,13611,5830
2021-01-16 03:30:00+00,5060,316,6076,13535,408,1072,1069,165,0,0,27701,98,21088,20019,13943,5376
2021-01-16 04:00:00+00,5518,315,6075,13859,406,512,1071,177,0,0,27933,103,21411,20340,14265,5833
2021-01-16 04:30:00+00,5333,315,6078,14110,404,468,1071,181,0,0,27960,100,21663,20592,14514,5648
2021-01-16 05:00:00+00,5541,316,6077,14367,403,492,1069,176,0,0,28441,101,21916,20847,14770,5857
2021-01-16 05:30:00+00,5481,315,6082,14667,404,504,1069,162,0,0,28684,100,22222,21153,15071,5796
2021-01-16 06:00:00+00,5040,310,6072,14647,407,888,1069,169,0,0,28602,95,22195,21126,15054,5350
2021-01-16 06:30:00+00,5286,316,6075,14734,469,1000,1069,166,0,0,29115,98,22347,21278,15203,5602
2021-01-16 07:00:00+00,5682,288,6077,14921,492,1320,1072,175,0,0,30027,100,22562,21490,15413,5970
2021-01-16 07:30:00+00,6122,432,6077,15066,496,1282,1074,164,0,0,30713,107,22713,21639,15562,6554
2021-01-16 08:00:00+00,6462,507,6077,15124,465,2018,1053,169,0,0,31875,109,22719,21666,15589,6969
2021-01-16 08:30:00+00,7324,519,6071,15177,490,2186,1084,185,8,340,33384,116,22830,21746,15675,7843
2021-01-16 09:00:00+00,8074,646,6074,15640,526,2848,1082,175,81,262,35408,121,23403,22321,16247,8720
2021-01-16 09:30:00+00,8655,811,6073,15878,536,2900,1082,179,220,228,36562,129,23789,22707,16634,9466
2021-01-16 10:00:00+00,9411,1078,6077,15968,474,2654,1081,180,559,330,37812,140,24159,23078,17001,10489
2021-01-16 10:30:00+00,9646,1419,6078,16103,458,2646,1068,179,1087,116,38800,147,24794,23726,17648,11065
2021-01-16 11:00:00+00,8782,1497,6080,16325,498,3424,1069,171,1551,0,39397,140,25523,24454,18374,10279
2021-01-16 11:30:00+00,8688,1430,6077,16329,505,3564,1026,187,2085,44,39935,137,26022,24996,18919,10118
2021-01-16 12:00:00+00,8907,1498,6081,16173,508,3672,1075,183,2296,90,40483,141,26133,25058,18977,10405
2021-01-16 12:30:00+00,9327,1330,6089,16149,513,3616,1080,171,2149,6,40430,141,25980,24900,18811,10657
2021-01-16 13:00:00+00,10621,1172,6088,15745,522,2636,1073,178,1793,50,39878,148,25221,24148,18060,11793
2021-01-16 13:30:00+00,10658,1170,6084,15323,529,2406,1078,179,1510,46,38983,150,24524,23446,17362,11828
2021-01-16 14:00:00+00,11609,1245,6087,14385,542,2010,1082,178,1166,76,38380,162,23262,22180,16093,12854
2021-01-16 14:30:00+00,12168,1448,6088,13776,549,1852,1089,179,726,230,38105,172,22228,21139,15051,13616
2021-01-16 15:00:00+00,12835,1733,6089,13212,563,1662,1096,245,301,450,38186,187,21261,20165,14076,14568
2021-01-16 15:30:00+00,13284,1809,6088,12679,585,1732,1095,406,105,370,38153,196,20552,19457,13369,15093
2021-01-16 16:00:00+00,13438,1811,6087,12285,600,2834,1094,400,5,430,38984,195,20071,18977,12890,15249
2021-01-16 16:30:00+00,14814,1812,6083,11866,685,2890,1096,441,0,1442,41129,198,19730,18634,12551,16626
2021-01-16 17:00:00+00,15739,1813,6083,11408,692,3372,1100,502,0,1638,42347,204,19283,18183,12100,17552
2021-01-16 17:30:00+00,15815,1812,6084,11875,678,3308,1095,488,0,1478,42633,202,19732,18637,12553,17627
2021-01-16 18:00:00+00,15522,1809,6084,12097,661,3138,1088,446,0,1454,42299,199,19930,18842,12758,17331
2021-01-16 18:30:00+00,14807,1814,6091,12441,675,3120,1105,270,0,978,41301,195,20312,19207,13116,16621
2021-01-16 19:00:00+00,14069,1814,6093,12818,672,3048,1104,169,0,50,39837,194,20687,19583,13490,15883
2021-01-16 19:30:00+00,13119,1647,6100,13059,669,2938,1097,166,0,0,38795,185,20925,19828,13728,14766
2021-01-16 20:00:00+00,12138,1002,6096,13547,654,2522,1068,174,0,0,37201,165,21365,20297,14201,13140
2021-01-16 20:30:00+00,10597,766,6096,13945,639,2648,1052,172,0,26,35941,150,21732,20680,14584,11363
2021-01-16 21:00:00+00,9147,613,6102,13913,631,2682,1065,170,0,0,34323,137,21711,20646,14544,9760
2021-01-16 21:30:00+00,8298,362,6094,13611,618,2622,1067,180,0,28,32880,125,21390,20323,14229,8660
2021-01-16 22:00:00+00,7443,312,6090,13283,603,2224,1062,174,0,258,31449,117,21038,19976,13886,7755
2021-01-16 22:30:00+00,6174,313,6098,13824,596,2200,1067,164,0,0,30436,104,21585,20518,14420,6487
2021-01-16 23:00:00+00,5428,315,6115,13537,589,1932,1067,168,0,0,29151,99,21308,20241,14126,5743
2021-01-16 23:30:00+00,4673,315,6124,13777,589,1868,1066,163,0,0,28575,89,21556,20490,14366,4988
2021-01-17 00:00:00+00,4526,314,6132,13784,600,2024,1068,161,0,0,28609,86,21584,20516,14384,4840
2021-01-17 00:30:00+00,4970,314,6128,13752,586,2008,1067,163,0,0,28988,91,21533,20466,14338,5284
2021-01-17 01:00:00+00,4813,314,6138,13586,583,1928,1066,164,0,0,28592,89,21373,20307,14169,5127
2021-01-17 01:30:00+00,4303,315,6146,13562,581,1896,1064,161,0,0,28028,83,21353,20289,14143,4618
2021-01-17 02:00:00+00,4115,314,6149,13596,560,1600,1065,161,0,0,27560,80,21370,20305,14156,4429
2021-01-17 02:30:00+00,3791,315,6157,13415,545,1578,1067,172,0,0,27040,77,21184,20117,13960,4106
2021-01-17 03:00:00+00,4076,314,6156,13387,536,1316,1068,165,0,0,27019,80,21147,20079,13923,4390
2021-01-17 03:30:00+00,3830,315,6161,13388,527,1352,1068,168,0,0,26809,77,21144,20076,13915,4145
2021-01-17 04:00:00+00,3547,315,6159,13337,554,1267,1069,169,0,0,26417,74,21119,20050,13891,3862
2021-01-17 04:30:00+00,3594,315,6162,13021,553,1290,1068,163,0,0,26166,75,20804,19736,13574,3909
2021-01-17 05:00:00+00,3620,315,6162,13019,552,1606,1067,160,0,0,26502,76,20800,19733,13571,3935
2021-01-17 05:30:00+00,3895,315,6163,12913,552,1638,1068,160,0,0,26704,80,20696,19628,13465,4210
2021-01-17 06:00:00+00,4300,315,6163,12965,553,1759,1067,168,0,0,27290,84,20748,19681,13518,4615
2021-01-17 06:30:00+00,4911,314,6156,12539,553,1784,1069,181,0,0,27507,92,20317,19248,13092,5225
2021-01-17 07:00:00+00,6150,315,6153,12286,566,1771,1068,169,0,94,28572,106,20073,19005,12852,6465
2021-01-17 07:30:00+00,7045,315,6157,11827,567,1813,1067,171,0,128,29090,116,19618,18551,12394,7360
2021-01-17 08:00:00+00,7049,315,6157,11596,566,2268,1067,168,34,26,29245,117,19420,18353,12196,7364
2021-01-17 08:30:00+00,8014,314,6161,11532,564,2431,1064,164,461,0,30704,126,19782,18718,12557,8328
2021-01-17 09:00:00+00,8428,295,6158,11736,575,2599,1071,171,1324,0,32357,124,20864,19793,13635,8723
2021-01-17 09:30:00+00,9490,326,6153,11423,594,2716,1069,170,2254,0,34196,131,21493,20424,14271,9816
2021-01-17 10:00:00+00,10047,636,6149,11129,605,2651,1075,175,2764,0,35232,141,21722,20647,14498,10683
2021-01-17 10:30:00+00,10496,1070,6137,10493,591,2715,1081,170,3202,26,35981,155,21504,20423,14286,11566
2021-01-17 11:00:00+00,11247,1422,6141,10543,575,2433,1075,173,3359,22,36990,166,21693,20618,14477,12669
2021-01-17 11:30:00+00,11726,1706,6142,10258,574,2465,1085,176,3275,66,37474,176,21334,20249,14107,13432
2021-01-17 12:00:00+00,12411,1810,6143,9905,587,2661,1080,191,2859,310,37957,184,20574,19494,13351,14221
2021-01-17 12:30:00+00,13077,1810,6145,9690,715,2714,1106,262,2396,350,38265,190,20052,18946,12801,14887
2021-01-17 13:00:00+00,13224,1798,6145,9745,716,2766,1127,225,1787,636,38169,192,19520,18393,12248,15022
2021-01-17 13:30:00+00,13690,1803,6151,9894,623,2722,1130,231,1367,354,37964,198,19164,18034,11884,15493
2021-01-17 14:00:00+00,14157,1806,6144,9795,622,2840,1129,190,1071,138,37892,204,18761,17632,11488,15963
2021-01-17 14:30:00+00,14679,1807,6143,9421,631,2812,1129,215,767,298,37902,209,18091,16962,10819,16486
2021-01-17 15:00:00+00,15786,1810,6137,8994,754,2722,1132,170,441,618,38564,216,17458,16326,10189,17596
2021-01-17 15:30:00+00,16518,1783,6142,8844,757,2744,1131,168,134,936,39157,219,17008,15877,9735,18301
2021-01-17 16:00:00+00,17383,1739,6139,9328,800,2854,1134,182,6,1174,40739,220,17407,16273,10134,19122
2021-01-17 16:30:00+00,18183,1807,6135,10000,806,3024,1136,341,0,1456,42888,221,18077,16941,10806,19990
2021-01-17 17:00:00+00,18368,1808,6140,10391,998,3078,1135,430,0,1406,43754,218,18664,17529,11389,20176
2021-01-17 17:30:00+00,18248,1805,6133,10609,977,3008,1136,416,0,1288,43620,217,18855,17719,11586,20053
2021-01-17 18:00:00+00,17938,1694,6134,11101,802,2706,1135,272,0,982,42764,213,19172,18037,11903,19632
2021-01-17 18:30:00+00,17070,1610,6134,11279,797,2682,1124,177,0,868,41741,207,19334,18210,12076,18680
2021-01-17 19:00:00+00,16175,1593,6140,11467,795,2548,1103,167,0,268,40256,205,19505,18402,12262,17768
2021-01-17 19:30:00+00,14977,1421,6139,11271,693,2550,1098,173,0,0,38322,199,19201,18103,11964,16398
2021-01-17 20:00:00+00,13904,1149,6140,11378,694,2718,1097,164,0,4,37248,186,19309,18212,12072,15053
2021-01-17 20:30:00+00,12476,888,6139,11590,609,2764,1101,165,0,0,35732,172,19439,18338,12199,13364
2021-01-17 21:00:00+00,10850,709,6139,11395,558,3088,1098,166,0,160,34163,159,19190,18092,11953,11559
2021-01-17 21:30:00+00,9753,480,6144,11491,544,3100,1096,162,0,6,32776,146,19275,18179,12035,10233
2021-01-17 22:00:00+00,8312,314,6141,11648,536,2810,1094,174,0,88,31117,128,19419,18325,12184,8626
2021-01-17 22:30:00+00,6800,313,6139,11696,539,2766,1096,173,0,142,29664,114,19470,18374,12235,7113
2021-01-17 23:00:00+00,6394,314,6142,11503,527,1868,1098,182,0,62,28090,112,19270,18172,12030,6708
2021-01-17 23:30:00+00,5870,314,6142,11572,526,1854,1097,173,0,0,27548,106,19337,18240,12098,6184
2021-01-18 00:00:00+00,6189,314,6146,11673,506,1576,1098,167,0,0,27669,110,19423,18325,12179,6503
2021-01-18 00:30:00+00,6460,314,6146,11649,501,1698,1098,239,0,0,28105,115,19394,18296,12150,6774
2021-01-18 01:00:00+00,5966,314,6142,11691,514,2146,1118,213,0,0,28104,110,19465,18347,12205,6280
2021-01-18 01:30:00+00,5628,314,6145,11950,507,2018,1127,162,0,0,27851,104,19729,18602,12457,5942
2021-01-18 02:00:00+00,5879,313,6141,11926,504,1516,1127,166,0,0,27572,105,19698,18571,12430,6192
2021-01-18 02:30:00+00,5836,314,6140,12144,503,1516,1125,173,0,0,27751,104,19912,18787,12647,6150
2021-01-18 03:00:00+00,5564,314,6141,12481,505,1332,1129,165,0,0,27631,100,20256,19127,12986,5878
2021-01-18 03:30:00+00,5378,314,6141,12506,506,1348,1128,169,0,0,27490,99,20281,19153,13012,5692
2021-01-18 04:00:00+00,5557,314,6142,12213,513,972,1124,167,0,0,27002,103,19992,18868,12726,5871
2021-01-18 04:30:00+00,5883,313,6140,12132,514,916,1120,167,0,0,27185,107,19906,18786,12646,6196
2021-01-18 05:00:00+00,6211,313,6143,12577,524,908,1123,160,0,0,27959,111,20367,19244,13101,6524
2021-01-18 05:30:00+00,6220,314,6141,12954,562,1002,1127,160,0,0,28480,111,20784,19657,13516,6534
2021-01-18 06:00:00+00,8408,312,6145,12827,609,1126,1126,161,0,0,30714,134,20707,19581,13436,8720
2021-01-18 06:30:00+00,10851,314,6144,12774,598,1050,1127,158,0,0,33016,153,20644,19516,13372,11165
2021-01-18 07:00:00+00,13890,314,6137,13149,626,534,1128,175,0,0,35953,170,21040,19912,13775,14204
2021-01-18 07:30:00+00,15627,393,6138,13099,625,464,1127,183,0,162,37818,180,20989,19862,13724,16020
2021-01-18 08:00:00+00,17081,703,6136,12843,634,924,1127,179,29,284,39940,194,20769,19642,13506,17784
2021-01-18 08:30:00+00,17718,1189,6137,12770,627,894,1129,222,206,792,41684,203,20869,19740,13603,18907
2021-01-18 09:00:00+00,17965,1364,6139,12867,768,998,1127,214,417,298,42157,206,21318,20191,14052,19329
2021-01-18 09:30:00+00,18120,1499,6141,12691,866,1000,1127,212,684,222,42562,209,21509,20382,14241,19619
2021-01-18 10:00:00+00,18203,1533,6149,12622,849,1000,1130,247,1015,16,42764,209,21765,20635,14486,19736
2021-01-18 10:30:00+00,18234,1435,6134,12715,897,1000,1133,326,1319,58,43251,206,22198,21065,14931,19669
2021-01-18 11:00:00+00,17952,1402,6136,12569,835,1530,1140,262,1305,62,43193,203,21985,20845,14709,19354
2021-01-18 11:30:00+00,18001,1463,6135,12754,809,1564,1149,163,1283,62,43383,203,22130,20981,14846,19464
2021-01-18 12:00:00+00,18189,1616,6137,12884,734,2004,1159,169,1225,80,44197,205,22139,20980,14843,19805
2021-01-18 12:30:00+00,18192,1791,6142,12972,707,2104,1159,167,1273,102,44609,207,22253,21094,14952,19983
2021-01-18 13:00:00+00,17570,1814,6139,12849,613,2884,1162,171,1288,42,44532,204,22051,20889,14750,19384
2021-01-18 13:30:00+00,17210,1756,6148,12982,603,2972,1149,184,1029,0,44033,202,21911,20762,14614,18966
2021-01-18 14:00:00+00,17383,1666,6138,12758,702,2640,1143,177,783,56,43446,204,21524,20381,14243,19049
2021-01-18 14:30:00+00,17956,1793,6138,12200,721,2636,1143,173,534,0,43294,212,20736,19593,13455,19749
2021-01-18 15:00:00+00,18906,1813,6142,12021,739,2028,1146,171,318,22,43306,220,20366,19220,13078,20719
2021-01-18 15:30:00+00,19154,1812,6140,11500,769,2038,1147,242,86,348,43236,224,19642,18495,12355,20966
2021-01-18 16:00:00+00,19310,1811,6145,11201,855,2760,1147,302,2,320,43853,223,19350,18203,12058,21121
2021-01-18 16:30:00+00,20038,1808,6147,10985,857,2786,1147,407,0,744,44919,225,19136,17989,11842,21846
2021-01-18 17:00:00+00,20110,1812,6143,10939,999,2772,1148,477,0,1484,45884,222,19229,18081,11938,21922
2021-01-18 17:30:00+00,20231,1807,6140,10853,1002,2770,1149,435,0,1486,45873,223,19144,17995,11855,22038
2021-01-18 18:00:00+00,20253,1812,6146,10999,857,2572,1147,431,0,1402,45619,224,19149,18002,11856,22065
2021-01-18 18:30:00+00,19726,1810,6145,10779,851,2568,1148,320,0,1096,44443,224,18923,17775,11630,21536
2021-01-18 19:00:00+00,19114,1758,6153,10893,842,2308,1130,313,0,286,42797,225,19018,17888,11735,20872
2021-01-18 19:30:00+00,18509,1560,6147,10719,830,2304,1133,170,0,0,41372,222,18829,17696,11549,20069
2021-01-18 20:00:00+00,17529,1356,6150,10348,765,2122,1130,167,0,44,39611,216,18393,17263,11113,18885
2021-01-18 20:30:00+00,16409,1097,6148,10179,659,2120,1131,170,0,0,37913,208,18117,16986,10838,17506
2021-01-18 21:00:00+00,14698,849,6154,10356,637,2332,1133,159,0,12,36330,194,18280,17147,10993,15547
2021-01-18 21:30:00+00,12652,683,6153,10583,635,2466,1130,156,0,0,34458,178,18501,17371,11218,13335
2021-01-18 22:00:00+00,11670,348,6151,10266,599,1944,1127,158,0,0,32263,168,18143,17016,10865,12018
2021-01-18 22:30:00+00,9843,315,6154,10184,595,2210,1129,175,0,0,30605,156,18062,16933,10779,10158
2021-01-18 23:00:00+00,7976,315,6150,10004,556,2690,1133,164,0,0,28988,139,17843,16710,10560,8291
2021-01-18 23:30:00+00,6741,314,6148,9974,551,2632,1132,161,0,0,27653,126,17805,16673,10525,7055
2021-01-19 00:00:00+00,6652,315,6148,9828,531,2802,1132,163,0,0,27571,123,17639,16507,10359,6967
2021-01-19 00:30:00+00,6827,315,6148,9920,531,3014,1134,168,0,0,28057,126,17733,16599,10451,7142
2021-01-19 01:00:00+00,6768,314,6146,9785,539,2964,1132,162,0,0,27810,126,17602,16470,10324,7082
2021-01-19 01:30:00+00,6719,315,6142,9752,538,2928,1143,160,0,0,27697,125,17575,16432,10290,7034
2021-01-19 02:00:00+00,6725,314,6142,9659,537,2946,1162,164,0,0,27649,126,17500,16338,10196,7039
2021-01-19 02:30:00+00,6460,315,6143,9736,533,2904,1174,157,0,0,27422,123,17586,16412,10269,6775
2021-01-19 03:00:00+00,6283,296,6145,9814,517,2912,1216,157,0,0,27340,120,17692,16476,10331,6579
2021-01-19 03:30:00+00,6059,276,6145,9713,512,2822,1275,159,0,0,26961,117,17645,16370,10225,6335
2021-01-19 04:00:00+00,6086,277,6143,9614,512,2795,1349,161,0,0,26937,118,17618,16269,10126,6363
2021-01-19 04:30:00+00,6271,276,6147,9316,511,2682,1419,163,0,0,26785,120,17393,15974,9827,6547
2021-01-19 05:00:00+00,6566,273,6152,9230,516,2044,1537,158,0,0,26476,129,17435,15898,9746,6839
2021-01-19 05:30:00+00,6907,277,6150,9512,501,1970,1786,171,0,0,27274,131,17949,16163,10013,7184
2021-01-19 06:00:00+00,9277,305,6147,9721,513,1456,2177,158,0,0,29754,153,18558,16381,10234,9582
2021-01-19 06:30:00+00,10952,314,6150,9659,511,1280,2543,159,0,0,31568,165,18863,16320,10170,11266
2021-01-19 07:00:00+00,14579,415,6151,9463,542,1188,2694,166,0,0,35198,191,18850,16156,10005,14994
2021-01-19 07:30:00+00,15856,755,6148,9166,545,1214,2954,178,0,38,36854,206,18813,15859,9711,16611
2021-01-19 08:00:00+00,16973,1251,6145,8916,569,1310,3064,186,1,32,38447,222,18695,15631,9486,18224
2021-01-19 08:30:00+00,17544,1617,6142,8935,574,1430,2949,251,65,122,39629,231,18665,15716,9574,19161
2021-01-19 09:00:00+00,17366,1651,6144,8829,700,1734,2844,163,229,78,39738,227,18746,15902,9758,19017
2021-01-19 09:30:00+00,17548,1583,6140,8713,713,1718,2835,167,444,100,39961,225,18845,16010,9870,19131
2021-01-19 10:00:00+00,17526,1629,6137,8395,713,2270,2774,166,616,34,40260,224,18635,15861,9724,19155
2021-01-19 10:30:00+00,17691,1684,6129,8160,713,2278,2701,172,837,0,40365,226,18540,15839,9710,19375
2021-01-19 11:00:00+00,17628,1640,6126,8241,656,2386,2854,165,879,30,40605,224,18756,15902,9776,19268
2021-01-19 11:30:00+00,17099,1572,6129,9218,649,2370,2831,167,1058,0,41093,215,19885,17054,10925,18671
2021-01-19 12:00:00+00,16901,1467,6123,10025,686,2758,2768,177,946,70,41921,207,20548,17780,11657,18368
2021-01-19 12:30:00+00,17180,1564,6090,9907,688,2770,2742,170,734,64,41909,212,20161,17419,11329,18744
2021-01-19 13:00:00+00,17164,1742,5383,10161,701,2442,2787,181,590,320,41471,218,19622,16835,11452,18906
2021-01-19 13:30:00+00,17157,1690,5365,10095,700,2244,2947,186,473,14,40871,219,19580,16633,11268,18847
2021-01-19 14:00:00+00,17805,1549,5364,10046,600,1718,3007,189,320,12,40610,222,19337,16330,10966,19354
2021-01-19 14:30:00+00,17670,1540,5368,10379,601,1670,2996,186,194,246,40850,219,19538,16542,11174,19210
2021-01-19 15:00:00+00,17405,1566,5372,10568,615,1954,3000,243,76,416,41215,216,19631,16631,11259,18971
2021-01-19 15:30:00+00,17542,1630,5363,10564,631,2046,3000,233,16,352,41377,219,19574,16574,11211,19172
2021-01-19 16:00:00+00,17180,1635,5337,10592,652,2952,3007,246,1,498,42100,213,19589,16582,11245,18815
2021-01-19 16:30:00+00,17405,1785,5335,10687,928,3080,3002,409,0,978,43609,213,19952,16950,11615,19190
2021-01-19 17:00:00+00,18039,1804,5351,10770,1008,3054,2990,473,0,980,44469,215,20119,17129,11778,19843
2021-01-19 17:30:00+00,18161,1791,5393,10820,1012,3018,2912,405,0,950,44462,215,20137,17225,11832,19952
2021-01-19 18:00:00+00,17821,1805,5418,10912,877,2812,2949,355,0,938,43887,214,20156,17207,11789,19626
2021-01-19 18:30:00+00,17496,1808,5436,10941,723,2812,2901,273,0,688,43078,214,20001,17100,11664,19304
2021-01-19 19:00:00+00,16933,1802,5450,10984,685,3020,2809,178,0,6,41867,214,19928,17119,11669,18735
2021-01-19 19:30:00+00,15358,1729,5469,11029,678,3020,2836,163,0,0,40282,205,20012,17176,11707,17087
2021-01-19 20:00:00+00,13820,1528,5471,11098,603,3022,2812,204,0,0,38558,194,19984,17172,11701,15348
2021-01-19 20:30:00+00,12789,1081,5472,11091,586,3020,2812,194,0,12,37057,180,19961,17149,11677,13870
2021-01-19 21:00:00+00,11640,614,5475,11109,526,3000,2838,183,0,0,35385,163,19948,17110,11635,12254
2021-01-19 21:30:00+00,10176,313,5472,11161,522,2992,2780,161,0,0,33577,146,19935,17155,11683,10489
2021-01-19 22:00:00+00,8742,307,5467,11128,521,2532,2800,175,0,0,31672,136,19916,17116,11649,9049
2021-01-19 22:30:00+00,7379,306,5470,11043,515,2522,2602,167,0,0,30004,124,19630,17028,11558,7685
2021-01-19 23:00:00+00,6078,314,5470,10961,490,2410,2357,157,0,0,28237,113,19278,16921,11451,6392
2021-01-19 23:30:00+00,5225,313,5462,10901,482,2408,2324,157,0,0,27272,104,19169,16845,11383,5538
2021-01-20 00:00:00+00,5391,313,5467,10876,448,2266,2326,156,0,0,27243,105,19117,16791,11324,5704
2021-01-20 00:30:00+00,5865,314,5459,10805,443,2264,2317,164,0,0,27631,111,19024,16707,11248,6179
2021-01-20 01:00:00+00,5991,313,5462,10731,429,2266,2311,160,0,0,27663,112,18933,16622,11160,6304
2021-01-20 01:30:00+00,5741,313,5464,10675,425,2266,2287,156,0,0,27327,110,18851,16564,11100,6054
2021-01-20 02:00:00+00,6084,314,5460,10619,408,2264,2293,165,0,0,27607,114,18780,16487,11027,6398
2021-01-20 02:30:00+00,5746,314,5425,10564,408,2264,2299,156,0,0,27176,111,18696,16397,10972,6060
2021-01-20 03:00:00+00,5639,313,5310,10501,406,2262,2293,160,0,0,26884,110,18510,16217,10907,5952
2021-01-20 03:30:00+00,5574,312,5326,10290,405,2264,2298,157,0,0,26626,110,18319,16021,10695,5886
2021-01-20 04:00:00+00,5719,309,5337,10060,405,2264,2278,164,0,0,26536,113,18080,15802,10465,6028
2021-01-20 04:30:00+00,6050,311,5345,9790,406,2264,2278,166,0,0,26610,117,17819,15541,10196,6361
2021-01-20 05:00:00+00,6089,311,5354,9367,406,2264,2280,155,0,0,26226,120,17407,15127,9773,6400
2021-01-20 05:30:00+00,7003,311,5354,9016,409,2272,2229,161,0,0,26755,131,17008,14779,9425,7314
2021-01-20 06:00:00+00,8579,310,5353,8703,441,2846,2353,161,0,22,28768,145,16850,14497,9144,8889
2021-01-20 06:30:00+00,10271,310,5352,8679,438,2854,2669,166,0,0,30739,158,17138,14469,9117,10581
2021-01-20 07:00:00+00,12993,278,5354,8611,539,2904,2824,164,0,14,33681,176,17328,14504,9150,13271
2021-01-20 07:30:00+00,14623,361,5356,8664,563,2904,2867,169,0,0,35507,188,17450,14583,9227,14984
2021-01-20 08:00:00+00,16882,623,5355,8578,465,2934,2831,165,0,0,37833,206,17229,14398,9043,17505
2021-01-20 08:30:00+00,17648,1139,5352,8581,466,2932,2859,259,6,180,39422,218,17264,14405,9053,18787
2021-01-20 09:00:00+00,17864,1496,5348,8638,533,2724,2856,237,35,218,39949,225,17410,14554,9206,19360
2021-01-20 09:30:00+00,18151,1670,5356,8539,565,2724,2769,411,93,486,40764,229,17322,14553,9197,19821
2021-01-20 10:00:00+00,18202,1726,5280,8385,702,2890,2741,470,156,570,41122,230,17264,14523,9243,19928
2021-01-20 10:30:00+00,18274,1546,5150,8375,783,2892,2830,466,215,908,41439,225,17353,14523,9373,19820
2021-01-20 11:00:00+00,18545,1483,5168,8391,794,3000,2943,442,292,706,41764,224,17588,14645,9477,20028
2021-01-20 11:30:00+00,18687,1482,5158,8497,785,3002,2966,445,288,618,41928,225,17694,14728,9570,20169
2021-01-20 12:00:00+00,19089,1484,5158,8557,781,3000,2945,496,290,1274,43074,223,17731,14786,9628,20573
2021-01-20 12:30:00+00,19405,1485,5161,8834,768,3002,2914,491,254,1396,43710,222,17931,15017,9856,20890
2021-01-20 13:00:00+00,19773,1482,5165,9057,656,3002,2924,448,221,898,43626,226,18023,15099,9934,21255
2021-01-20 13:30:00+00,19625,1473,5166,9357,606,3002,2939,319,258,464,43209,227,18326,15387,10221,21098
2021-01-20 14:00:00+00,19782,1475,5171,9274,622,3002,2911,255,167,284,42944,230,18146,15234,10064,21257
2021-01-20 14:30:00+00,19748,1469,5176,9082,643,3002,2924,275,92,234,42645,231,17917,14993,9817,21217
2021-01-20 15:00:00+00,19304,1478,5191,9054,680,3002,2971,244,45,170,42139,229,17941,14970,9779,20782
2021-01-20 15:30:00+00,19521,1472,5199,8880,829,3002,2990,282,10,156,42341,230,17908,14918,9719,20993
2021-01-20 16:00:00+00,19613,1483,5208,8747,913,3022,2968,314,1,896,43165,227,17837,14869,9661,21096
2021-01-20 16:30:00+00,20054,1496,5214,8751,990,3022,2969,518,0,1182,44196,227,17924,14955,9741,21550
2021-01-20 17:00:00+00,20274,1496,5226,8758,1017,3020,2972,564,0,1750,45077,225,17973,15001,9775,21770
2021-01-20 17:30:00+00,20118,1494,5231,9092,999,3020,2970,558,0,1758,45240,224,18292,15322,10091,21612
2021-01-20 18:00:00+00,19679,1488,5242,9446,976,3020,2972,548,0,1274,44645,222,18636,15664,10422,21167
2021-01-20 18:30:00+00,19453,1486,5245,9749,980,3020,2969,484,0,796,44182,221,18943,15974,10729,20939
2021-01-20 19:00:00+00,18541,1493,5250,9911,788,3022,2974,353,0,28,42360,221,18923,15949,10699,20034
2021-01-20 19:30:00+00,17232,1496,5250,9917,657,3022,2974,221,0,242,41011,214,18798,15824,10574,18728
2021-01-20 20:00:00+00,16270,1454,5251,9872,536,3020,2975,206,0,138,39722,211,18634,15659,10408,17724
2021-01-20 20:30:00+00,14764,1085,5252,10072,538,3020,2959,205,0,0,37895,196,18821,15862,10610,15849
2021-01-20 21:00:00+00,13371,567,5243,10195,491,3000,2958,188,0,12,36025,177,18887,15929,10686,13938
2021-01-20 21:30:00+00,11855,177,5252,10562,487,3000,2948,161,0,0,34442,157,19249,16301,11049,12032
2021-01-20 22:00:00+00,10144,0,5252,11004,479,2864,2656,158,0,0,32557,139,19391,16735,11483,10144
2021-01-20 22:30:00+00,8925,0,5250,11614,474,2846,1940,161,0,0,31210,127,19278,17338,12088,8925
2021-01-20 23:00:00+00,8075,0,5244,11692,415,2412,1595,172,0,172,29777,120,18946,17351,12107,8075
2021-01-20 23:30:00+00,7157,0,5248,11559,400,2420,1659,156,0,0,28599,112,18866,17207,11959,7157
2021-01-21 00:00:00+00,6686,0,5252,11955,373,2260,1695,155,0,0,28376,106,19275,17580,12328,6686
2021-01-21 00:30:00+00,6673,0,5247,12366,356,2300,1714,158,0,0,28814,105,19683,17969,12722,6673
2021-01-21 01:00:00+00,6073,0,5254,12820,354,2428,1595,155,0,0,28678,99,20022,18428,13174,6073
2021-01-21 01:30:00+00,5504,0,5265,13216,353,2408,1448,156,0,0,28350,91,20282,18834,13569,5504
2021-01-21 02:00:00+00,5389,0,5268,13596,337,2172,1403,159,0,0,28324,87,20604,19201,13933,5389
2021-01-21 02:30:00+00,5180,0,5271,13978,337,2106,1348,155,0,0,28375,83,20934,19586,14315,5180
2021-01-21 03:00:00+00,5351,0,5266,14280,337,1626,1353,165,0,0,28378,85,21236,19883,14617,5351
2021-01-21 03:30:00+00,4943,0,5263,14478,337,1618,1354,165,0,0,28158,80,21432,20078,14815,4943
2021-01-21 04:00:00+00,4771,0,5262,14585,337,1620,1353,161,0,0,28089,78,21537,20184,14922,4771
2021-01-21 04:30:00+00,4681,12,5267,14681,337,1620,1355,162,0,0,28115,77,21640,20285,15018,4692
2021-01-21 05:00:00+00,4567,23,5265,14799,337,1842,1366,162,0,0,28361,76,21767,20401,15136,4590
2021-01-21 05:30:00+00,5046,49,5270,14981,303,1866,1517,162,0,0,29194,81,22071,20554,15284,5095
2021-01-21 06:00:00+00,5618,182,5279,14974,303,2750,1839,158,0,0,31103,91,22395,20556,15277,5800
2021-01-21 06:30:00+00,5995,372,5280,15162,304,2726,2379,166,0,0,32384,99,23125,20746,15466,6367
2021-01-21 07:00:00+00,7576,521,5279,15217,311,2856,2874,160,0,0,34794,116,23681,20807,15528,8097
2021-01-21 07:30:00+00,9106,459,5279,15484,344,2948,2976,160,0,0,36756,126,24083,21107,15828,9565
2021-01-21 08:00:00+00,10789,310,5285,15608,434,3042,2910,238,47,0,38663,133,24284,21374,16089,11099
2021-01-21 08:30:00+00,11058,307,5279,15788,549,3154,2947,338,393,146,39959,134,24956,22009,16730,11365
2021-01-21 09:00:00+00,11442,289,5278,15958,557,3076,2998,418,1103,0,41119,133,25894,22896,17618,11731
2021-01-21 09:30:00+00,11179,296,5274,16288,525,3000,2963,356,1860,0,41741,127,26910,23947,18673,11475
2021-01-21 10:00:00+00,10585,295,5265,16474,419,2900,2787,162,2439,0,41326,120,27384,24597,19332,10880
2021-01-21 10:30:00+00,10257,309,5254,16668,435,2900,2803,161,2894,0,41681,117,28054,25251,19997,10566
2021-01-21 11:00:00+00,10978,308,5253,16646,396,3000,2807,165,3182,0,42735,121,28284,25477,20224,11286
2021-01-21 11:30:00+00,11593,310,5255,16447,396,3002,2809,165,2753,0,42730,126,27660,24851,19596,11903
2021-01-21 12:00:00+00,12373,310,5254,16360,372,2994,2915,174,2822,0,43574,131,27723,24808,19554,12683
2021-01-21 12:30:00+00,12415,312,5252,16432,351,2992,2974,167,2586,0,43481,132,27595,24621,19369,12727
2021-01-21 13:00:00+00,12056,314,5252,16409,353,3000,2972,171,2103,0,42630,132,27089,24117,18865,12370
2021-01-21 13:30:00+00,12132,314,5251,16260,370,3000,2958,167,1626,0,42078,134,26465,23507,18256,12446
2021-01-21 14:00:00+00,12027,405,5219,16381,376,3000,2949,169,1476,0,42002,135,26401,23452,18233,12432
2021-01-21 14:30:00+00,12579,703,5191,16002,395,3002,2919,193,1146,0,42130,147,25653,22734,17543,13282
2021-01-21 15:00:00+00,13344,1080,5193,15797,496,3002,2850,165,656,0,42583,160,24992,22142,16949,14424
2021-01-21 15:30:00+00,13798,1428,5192,15370,555,3002,2840,164,269,0,42618,172,24226,21386,16194,15226
2021-01-21 16:00:00+00,14287,1653,5185,15039,647,3022,2877,218,36,6,42970,180,23784,20907,15722,15940
2021-01-21 16:30:00+00,15182,1769,5176,14796,661,3022,2882,333,0,1004,44825,184,23515,20633,15457,16951
2021-01-21 17:00:00+00,16574,1792,5185,14373,827,3022,2940,548,0,1408,46669,191,23325,20385,15200,18366
2021-01-21 17:30:00+00,16941,1790,5186,14096,835,3018,3006,553,0,1372,46797,194,23123,20117,14931,18731
2021-01-21 18:00:00+00,17051,1792,5186,13731,829,2772,3037,551,0,1334,46283,196,22783,19746,14560,18843
2021-01-21 18:30:00+00,16720,1802,5187,13176,827,2772,3054,523,0,1096,45157,198,22244,19190,14003,18522
2021-01-21 19:00:00+00,16332,1841,5192,12861,825,3018,3059,421,0,272,43821,201,21937,18878,13686,18173
2021-01-21 19:30:00+00,15619,1818,5190,12504,668,3020,3026,297,0,0,42142,201,21388,18362,13172,17437
2021-01-21 20:00:00+00,14726,1629,5184,12299,465,3018,3038,181,0,40,40580,195,20986,17948,12764,16355
2021-01-21 20:30:00+00,13827,1183,5182,12436,434,3018,3038,161,0,22,39301,181,21090,18052,12870,15010
2021-01-21 21:00:00+00,12192,697,5191,12960,421,2988,3034,156,0,0,37639,160,21606,18572,13381,12889
2021-01-21 21:30:00+00,10472,349,5192,13444,401,2986,2870,167,0,0,35881,139,21907,19037,13845,10821
2021-01-21 22:00:00+00,8876,314,5187,13724,375,2706,2615,161,0,2,33960,126,21901,19286,14099,9190
2021-01-21 22:30:00+00,7435,311,5188,13951,385,2704,2424,162,0,0,32560,114,21948,19524,14336,7746
2021-01-21 23:00:00+00,6015,312,5187,14105,372,2414,2387,167,0,0,30959,101,22051,19664,14477,6327
2021-01-21 23:30:00+00,4738,277,5194,14400,345,2410,2301,153,0,0,29818,86,22240,19939,14745,5015
2021-01-22 00:00:00+00,4359,309,5193,14629,309,2412,2349,153,0,0,29713,85,22480,20131,14938,4668
2021-01-22 00:30:00+00,4380,315,5190,14673,292,2410,2363,168,0,0,29791,85,22518,20155,14965,4695
2021-01-22 01:00:00+00,4341,313,5183,14748,291,2412,2375,167,0,0,29830,84,22597,20222,15039,4654
2021-01-22 01:30:00+00,4264,315,5188,14815,289,2426,2354,154,0,0,29805,84,22646,20292,15104,4579
2021-01-22 02:00:00+00,4129,314,5186,14754,271,2424,2305,155,0,0,29538,82,22516,20211,15025,4443
2021-01-22 02:30:00+00,3976,312,5187,14578,272,2424,2301,155,0,0,29205,81,22338,20037,14850,4288
2021-01-22 03:00:00+00,3980,315,5122,14634,272,2280,2294,156,0,0,29053,81,22322,20028,14906,4295
2021-01-22 03:30:00+00,3978,308,5099,14383,272,2280,2299,159,0,0,28778,82,22053,19754,14655,4286
2021-01-22 04:00:00+00,4008,300,5103,14255,272,2280,2291,156,0,0,28665,82,21921,19630,14527,4308
2021-01-22 04:30:00+00,4199,307,5099,13959,272,2278,2300,164,0,0,28578,85,21630,19330,14231,4506
2021-01-22 05:00:00+00,4624,457,5098,13982,271,2310,2315,153,0,0,29210,94,21666,19351,14253,5081
2021-01-22 05:30:00+00,5530,522,5099,13634,278,2314,2351,156,0,0,29884,106,21362,19011,13912,6052
2021-01-22 06:00:00+00,6812,665,5098,13234,283,2598,2358,167,0,0,31215,123,20973,18615,13517,7477
2021-01-22 06:30:00+00,9077,773,5104,12917,287,2600,2382,172,0,0,33312,145,20690,18308,13204,9850
2021-01-22 07:00:00+00,11780,792,5102,12526,314,2744,2376,170,0,0,35804,165,20318,17942,12840,12572
2021-01-22 07:30:00+00,13967,1001,5104,12075,328,2744,2383,166,0,104,37872,184,19890,17507,12403,14968
2021-01-22 08:00:00+00,15170,1447,5104,11789,461,2860,2388,265,48,240,39772,199,19790,17402,12298,16617
2021-01-22 08:30:00+00,15564,1607,5110,11434,631,2860,2388,509,575,212,40890,203,20138,17750,12640,17171
2021-01-22 09:00:00+00,15912,1762,5109,11168,649,2976,2366,528,1643,136,42249,204,20935,18569,13460,17674
2021-01-22 09:30:00+00,16468,1787,5107,10411,656,2980,2309,523,2748,50,43039,205,21231,18922,13815,18255
2021-01-22 10:00:00+00,16866,1793,5108,9656,640,3004,2341,374,3648,116,43546,206,21393,19052,13944,18659
2021-01-22 10:30:00+00,17280,1794,5110,9187,482,3002,2217,373,4406,0,43851,208,21402,19185,14075,19074
2021-01-22 11:00:00+00,16798,1709,5106,8591,435,2926,2200,222,4709,208,42904,204,21041,18841,13735,18507
2021-01-22 11:30:00+00,16943,1769,5121,8176,418,2928,2289,200,5079,0,42923,207,21083,18794,13673,18712
2021-01-22 12:00:00+00,17036,1715,5191,8436,400,3002,2316,178,5055,0,43329,205,21398,19082,13891,18751
2021-01-22 12:30:00+00,17012,1580,5253,8170,400,3002,2315,186,4894,0,42812,204,21032,18717,13464,18592
2021-01-22 13:00:00+00,17040,1711,5255,7795,401,3002,2320,190,4406,44,42164,211,20177,17857,12602,18751
2021-01-22 13:30:00+00,17381,1698,5251,7599,407,3002,2311,186,3643,14,41492,217,19211,16900,11649,19079
2021-01-22 14:00:00+00,17724,1790,5249,7307,486,3002,2261,180,2681,36,40716,226,17984,15723,10474,19514
2021-01-22 14:30:00+00,18381,1823,5251,6818,509,3002,2315,166,1956,0,40221,236,16849,14534,9283,20204
2021-01-22 15:00:00+00,18468,1837,5260,6727,591,3002,2324,283,1100,0,39592,242,16002,13678,8418,20305
2021-01-22 15:30:00+00,19417,1878,5255,6433,621,3002,2363,472,406,0,39847,253,15078,12715,7460,21295
2021-01-22 16:00:00+00,20119,1855,5262,6213,658,3022,2394,406,39,448,40416,257,14566,12172,6910,21974
2021-01-22 16:30:00+00,20922,1934,5257,5976,816,3022,2405,523,0,1202,42057,257,14454,12049,6792,22856
2021-01-22 17:00:00+00,21461,2075,5258,6026,943,3020,2421,488,0,1900,43592,256,14648,12227,6969,23536
2021-01-22 17:30:00+00,21728,2072,5154,6091,981,3020,2446,501,0,1918,43911,257,14672,12226,7072,23800
2021-01-22 18:00:00+00,21549,2090,5060,6171,873,3020,2459,460,0,1826,43508,257,14563,12104,7044,23639
2021-01-22 18:30:00+00,21297,2065,5054,6047,860,3020,2462,447,0,1716,42968,258,14423,11961,6907,23362
2021-01-22 19:00:00+00,21171,1791,5057,5771,683,3022,2466,425,0,796,41182,260,13977,11511,6454,22962
2021-01-22 19:30:00+00,20227,1788,5052,5539,662,3022,2464,399,0,256,39409,261,13717,11253,6201,22015
2021-01-22 20:00:00+00,19489,1787,5049,5244,509,3020,2456,500,0,330,38384,261,13258,10802,5753,21276
2021-01-22 20:30:00+00,18831,1786,5052,5078,472,4002,2465,383,0,436,38505,254,13067,10602,5550,20617
2021-01-22 21:00:00+00,17951,1792,5054,4840,379,3982,2471,321,0,128,36918,256,12744,10273,5219,19743
2021-01-22 21:30:00+00,16691,1793,5053,4511,374,3982,2473,262,0,76,35215,253,12411,9938,4885,18484
2021-01-22 22:00:00+00,15584,1792,4806,4610,333,3984,2472,219,0,4,33804,250,12221,9749,4943,17376
2021-01-22 22:30:00+00,14297,1753,4809,4744,327,3982,2470,154,0,0,32536,242,12350,9880,5071,16050
2021-01-22 23:00:00+00,12718,1773,4810,4875,326,3984,2472,161,0,0,31119,234,12483,10011,5201,14491
2021-01-22 23:30:00+00,11990,1789,4810,4418,323,3984,2469,160,0,0,29943,234,12020,9551,4741,13779
2021-01-23 00:00:00+00,11937,1791,4857,4108,323,3984,2452,155,0,0,29607,233,11740,9288,4431,13728
2021-01-23 00:30:00+00,12009,1792,4908,4372,322,3984,2449,154,0,0,29990,231,12051,9602,4694,13801
2021-01-23 01:00:00+00,12099,1794,4955,4297,321,3984,2448,219,0,0,30117,233,12021,9573,4618,13893
2021-01-23 01:30:00+00,11720,1792,4956,4528,303,4004,2449,214,0,0,29966,229,12236,9787,4831,13512
2021-01-23 02:00:00+00,11556,1777,4969,4356,303,4001,2450,169,0,0,29581,229,12078,9628,4659,13333
2021-01-23 02:30:00+00,11890,1638,4979,4126,303,3997,2452,204,0,0,29589,229,11860,9408,4429,13528
2021-01-23 03:00:00+00,12048,1257,4999,3957,302,3996,2452,247,0,0,29258,222,11710,9258,4259,13305
2021-01-23 03:30:00+00,11929,1254,5014,3750,296,3991,2454,224,0,0,28911,223,11514,9060,4046,13183
2021-01-23 04:00:00+00,11484,1180,5055,3899,260,3987,2471,188,0,0,28525,217,11685,9214,4159,12664
2021-01-23 04:30:00+00,11410,1175,5052,3853,260,3984,2400,167,0,0,28301,216,11565,9165,4113,12585
2021-01-23 05:00:00+00,11678,1208,5050,3681,260,3986,2543,156,0,0,28562,220,11534,8991,3941,12886
2021-01-23 05:30:00+00,12118,1121,5068,3650,260,3986,2446,155,0,0,28804,221,11424,8978,3910,13239
2021-01-23 06:00:00+00,13014,1201,5093,3384,260,3986,2684,156,0,0,29778,229,11421,8737,3644,14215
2021-01-23 06:30:00+00,13549,1235,5099,3354,260,3984,2839,160,0,0,30480,232,11552,8713,3614,14784
2021-01-23 07:00:00+00,13763,1206,5125,3271,274,3886,3005,159,0,0,30689,233,11675,8670,3545,14969
2021-01-23 07:30:00+00,14481,1205,5128,3479,279,3886,2940,156,0,0,31554,235,11826,8886,3758,15686
2021-01-23 08:00:00+00,15734,1159,5123,3378,296,3956,2888,165,32,0,32731,240,11717,8829,3706,16893
2021-01-23 08:30:00+00,16948,1045,5127,3438,302,3958,3070,164,279,192,34523,239,12216,9146,4019,17993
2021-01-23 09:00:00+00,17807,1525,5129,3515,350,3984,3072,159,734,0,36275,250,12800,9728,4599,19332
2021-01-23 09:30:00+00,18063,1987,5130,3625,346,3986,2938,159,1252,0,37486,255,13291,10353,5223,20050
2021-01-23 10:00:00+00,18352,2154,5115,3379,327,3986,2971,191,1863,72,38410,257,13655,10684,5569,20506
2021-01-23 10:30:00+00,18516,2277,5101,3127,324,3986,3059,254,2475,0,39119,258,14086,11027,5926,20793
2021-01-23 11:00:00+00,18651,2291,5104,2992,297,3986,3057,212,2873,40,39503,256,14323,11266,6162,20942
2021-01-23 11:30:00+00,18723,2303,5136,3034,295,3986,3062,173,3254,6,39972,254,14780,11718,6582,21026
2021-01-23 12:00:00+00,18625,2340,5158,2905,309,3986,3067,179,3281,280,40130,253,14720,11653,6495,20965
2021-01-23 12:30:00+00,18598,2340,5184,3255,312,3984,3069,161,3357,0,40260,252,15177,12108,6924,20938
2021-01-23 13:00:00+00,18694,2299,5203,3284,329,3984,3073,166,3139,0,40171,252,15028,11955,6752,20993
2021-01-23 13:30:00+00,18568,2289,5216,3501,332,3984,2937,161,3027,0,40015,251,15013,12076,6860,20857
2021-01-23 14:00:00+00,18667,2285,5223,3497,333,3984,2877,163,2555,0,39584,255,14485,11608,6385,20952
2021-01-23 14:30:00+00,18443,2291,5252,3832,356,3984,2891,163,2069,0,39281,255,14400,11509,6257,20734
2021-01-23 15:00:00+00,18658,2285,5272,3795,371,3986,3067,168,1350,0,38952,260,13855,10788,5516,20943
2021-01-23 15:30:00+00,19102,2287,5285,3870,421,3986,3089,172,542,0,38754,267,13207,10118,4833,21389
2021-01-23 16:00:00+00,20187,2287,5293,3982,517,4004,3001,169,147,30,39617,271,12940,9939,4646,22474
2021-01-23 16:30:00+00,20764,2293,5304,4278,575,4004,3001,309,0,784,41312,267,13158,10157,4853,23057
2021-01-23 17:00:00+00,21457,2292,5318,4160,940,4004,3083,551,0,1786,43591,262,13501,10418,5100,23749
2021-01-23 17:30:00+00,21982,2295,5331,4001,1002,4006,3107,549,0,1978,44251,264,13441,10334,5003,24277
2021-01-23 18:00:00+00,21970,2294,5338,3913,981,4004,3102,519,0,1678,43799,266,13334,10232,4894,24264
2021-01-23 18:30:00+00,21711,2291,5341,3741,954,4004,3102,485,0,1394,43023,268,13138,10036,4695,24002
2021-01-23 19:00:00+00,21382,2291,5346,3620,658,4004,3109,468,0,830,41708,272,12733,9624,4278,23673
2021-01-23 19:30:00+00,20741,2289,5343,3732,588,4004,3109,466,0,0,40272,274,12772,9663,4320,23030
2021-01-23 20:00:00+00,20190,2166,5348,3825,396,4004,3105,358,0,82,39474,270,12674,9569,4221,22356
2021-01-23 20:30:00+00,19607,1739,5344,4065,327,4004,3098,194,0,0,38378,260,12834,9736,4392,21346
2021-01-23 21:00:00+00,18404,1214,5343,3894,293,3984,3097,159,0,8,36396,247,12627,9530,4187,19618
2021-01-23 21:30:00+00,17631,689,5341,3646,292,3984,3088,177,0,258,35106,234,12367,9279,3938,18320
2021-01-23 22:00:00+00,16682,341,5348,3654,274,3984,3087,284,0,0,33654,225,12363,9276,3928,17023
2021-01-23 22:30:00+00,15284,314,5349,3904,262,3984,3084,211,0,0,32392,215,12598,9514,4166,15598
2021-01-23 23:00:00+00,14111,315,5352,4072,247,3986,3097,157,0,0,31337,206,12768,9671,4319,14426
2021-01-23 23:30:00+00,13191,314,5353,4085,247,3986,3091,157,0,0,30424,200,12776,9685,4332,13505
2021-01-24 00:00:00+00,13288,315,5361,3750,247,3986,3097,159,0,0,30203,203,12455,9358,3997,13603
2021-01-24 00:30:00+00,13709,315,5364,3660,246,3986,3100,157,0,0,30537,206,12370,9270,3906,14024
2021-01-24 01:00:00+00,13091,311,5399,3890,246,3986,3101,155,0,0,30179,200,12636,9535,4136,13402
2021-01-24 01:30:00+00,12819,315,5411,3777,231,3986,3101,159,0,0,29799,199,12520,9419,4008,13134
2021-01-24 02:00:00+00,12831,314,5447,3558,225,3984,3098,163,0,0,29620,201,12328,9230,3783,13145
2021-01-24 02:30:00+00,12668,315,5452,3553,223,3982,3095,162,0,0,29450,200,12323,9228,3776,12983
2021-01-24 03:00:00+00,12474,306,5462,3443,222,3986,3093,161,0,0,29147,199,12220,9127,3665,12780
2021-01-24 03:30:00+00,12455,315,5473,3259,222,3986,3093,157,0,0,28960,200,12047,8954,3481,12770
2021-01-24 04:00:00+00,12346,306,5480,3068,221,3986,3093,158,0,0,28658,201,11862,8769,3289,12652
2021-01-24 04:30:00+00,12195,305,5489,2823,221,3986,3094,162,0,0,28275,201,11627,8533,3044,12500
2021-01-24 05:00:00+00,12435,314,5496,2722,226,4000,3092,155,0,0,28440,204,11536,8444,2948,12749
2021-01-24 05:30:00+00,12593,315,5504,2677,229,4002,3016,158,0,0,28494,205,11426,8410,2906,12908
2021-01-24 06:00:00+00,13234,315,5515,2664,232,4002,3053,156,0,0,29171,209,11464,8411,2896,13549
2021-01-24 06:30:00+00,13571,464,5518,2583,247,4012,3135,156,0,0,29686,215,11483,8348,2830,14035
2021-01-24 07:00:00+00,13457,739,5514,2467,288,4136,3139,160,0,0,29900,223,11408,8269,2755,14196
2021-01-24 07:30:00+00,13693,1094,5517,2391,290,4228,3134,157,0,0,30504,234,11332,8198,2681,14787
2021-01-24 08:00:00+00,14815,1572,5517,2330,308,3628,3143,175,11,0,31499,251,11309,8166,2649,16387
2021-01-24 08:30:00+00,16166,1885,5520,2158,306,3654,3140,168,94,0,33091,265,11218,8078,2558,18051
2021-01-24 09:00:00+00,17541,1918,5520,2191,318,3968,3142,164,366,0,35128,265,11537,8395,2875,19459
2021-01-24 09:30:00+00,18469,2167,5521,2087,322,4062,3141,170,689,0,36628,272,11760,8619,3098,20636
2021-01-24 10:00:00+00,19112,2291,5528,2175,321,4034,3140,162,1217,0,37980,271,12381,9241,3713,21403
2021-01-24 10:30:00+00,19552,2296,5533,2234,322,4100,3141,163,1423,14,38778,271,12653,9512,3979,21848
2021-01-24 11:00:00+00,19955,2295,5534,2373,293,4130,3141,165,1508,100,39494,270,12849,9708,4174,22250
2021-01-24 11:30:00+00,20198,2291,5540,2688,291,4240,3125,192,1660,186,40411,268,13304,10179,4639,22489
2021-01-24 12:00:00+00,20593,2294,5542,3203,325,4078,3117,240,1571,278,41241,266,13758,10641,5099,22887
2021-01-24 12:30:00+00,20416,2295,5544,3550,329,4028,3092,303,1573,242,41372,263,14088,10996,5452,22711
2021-01-24 13:00:00+00,20346,2294,5543,3701,333,4162,2910,351,1675,198,41513,262,14162,11252,5709,22640
2021-01-24 13:30:00+00,20435,2294,5540,3638,345,4118,2844,366,1416,0,40996,266,13783,10939,5399,22729
2021-01-24 14:00:00+00,20755,2289,5543,3656,345,4120,2940,222,1038,0,40908,269,13522,10582,5039,23044
2021-01-24 14:30:00+00,20745,2299,5545,3647,346,4016,3015,162,854,0,40629,270,13407,10392,4847,23044
2021-01-24 15:00:00+00,20862,2349,5545,3856,358,3986,2850,168,597,104,40675,272,13206,10356,4811,23211
2021-01-24 15:30:00+00,21159,2403,5549,4050,403,3986,2803,212,325,204,41094,273,13130,10327,4778,23562
2021-01-24 16:00:00+00,20999,2488,5547,4140,571,4050,2827,380,48,906,41956,270,13133,10306,4759,23487
2021-01-24 16:30:00+00,21691,2595,5544,4261,912,4158,2929,402,0,1446,43938,268,13646,10717,5173,24286
2021-01-24 17:00:00+00,22587,2594,5550,4382,884,4052,3060,409,0,1542,45060,269,13876,10816,5266,25181
2021-01-24 17:30:00+00,22065,2593,5549,4645,819,4006,3065,414,0,1750,44906,265,14078,11013,5464,24658
2021-01-24 18:00:00+00,21341,2555,5554,5010,825,4006,3066,490,0,1506,44353,261,14455,11389,5835,23896
2021-01-24 18:30:00+00,20201,2381,5557,5581,817,4006,3064,415,0,1506,43528,252,15019,11955,6398,22582
2021-01-24 19:00:00+00,19784,2297,5553,5884,594,4004,3049,248,0,1118,42531,249,15080,12031,6478,22081
2021-01-24 19:30:00+00,18931,2121,5555,6137,553,4004,3050,187,0,600,41138,245,15295,12245,6690,21052
2021-01-24 20:00:00+00,18241,2169,5552,6305,401,4006,3052,165,0,62,39953,246,15310,12258,6706,20410
2021-01-24 20:30:00+00,16956,1899,5557,6523,347,4004,3044,164,0,6,38500,235,15471,12427,6870,18855
2021-01-24 21:00:00+00,15457,1921,5550,6749,292,3938,3048,160,0,0,37115,228,15639,12591,7041,17378
2021-01-24 21:30:00+00,14176,1485,5549,6910,276,3934,3047,167,0,8,35552,213,15782,12735,7186,15661
2021-01-24 22:00:00+00,12612,918,5555,7200,252,3984,3035,157,0,4,33717,190,16042,13007,7452,13530
2021-01-24 22:30:00+00,11554,389,5551,7418,264,3984,3031,162,0,0,32353,170,16264,13233,7682,11943
2021-01-24 23:00:00+00,10064,313,5546,7604,260,3984,3030,156,0,0,30957,157,16440,13410,7864,10377
2021-01-24 23:30:00+00,8801,314,5547,8110,239,3984,3026,156,0,0,30177,144,16922,13896,8349,9115
2021-01-25 00:00:00+00,8828,313,5554,7829,180,3984,3033,170,0,0,29891,150,16596,13563,8009,9141
2021-01-25 00:30:00+00,9473,313,5556,7904,178,3984,3035,158,0,0,30601,154,16673,13638,8082,9786
2021-01-25 01:00:00+00,8876,313,5553,8366,176,3984,3105,157,0,0,30530,147,17200,14095,8542,9189
2021-01-25 01:30:00+00,8048,314,5558,8738,173,3984,3023,155,0,0,29993,139,17492,14469,8911,8362
2021-01-25 02:00:00+00,7879,314,5562,8861,172,3984,2953,156,0,0,29881,137,17548,14595,9033,8193
2021-01-25 02:30:00+00,7679,314,5567,9091,172,3982,2840,161,0,0,29806,134,17670,14830,9263,7993
2021-01-25 03:00:00+00,7097,314,5568,9414,173,3932,2671,163,0,0,29332,128,17826,15155,9587,7411
2021-01-25 03:30:00+00,7012,319,5560,9606,173,3928,2430,161,0,0,29189,126,17769,15339,9779,7331
2021-01-25 04:00:00+00,7134,331,5562,9450,172,3548,2794,159,0,0,29150,129,17978,15184,9622,7465
2021-01-25 04:30:00+00,6871,492,5567,9585,171,3474,3051,155,0,0,29366,130,18374,15323,9756,7363
2021-01-25 05:00:00+00,8164,794,5566,9811,171,1672,3120,157,0,0,29455,153,18668,15548,9982,8958
2021-01-25 05:30:00+00,8285,1379,5567,10111,170,1518,2965,155,0,0,30150,168,18813,15848,10281,9664
2021-01-25 06:00:00+00,10877,2037,5567,9978,176,110,3036,168,0,40,31989,207,18757,15721,10154,12914
2021-01-25 06:30:00+00,13094,2484,5569,9875,202,50,3110,158,0,0,34542,229,18756,15646,10077,15578
2021-01-25 07:00:00+00,16811,2864,5568,9654,265,0,3097,161,0,218,38638,252,18584,15487,9919,19675
2021-01-25 07:30:00+00,18125,3417,5569,9782,268,0,3109,211,0,120,40601,266,18728,15619,10050,21542
2021-01-25 08:00:00+00,17958,3564,5572,10030,316,604,3114,231,58,142,41589,263,19090,15976,10404,21522
2021-01-25 08:30:00+00,18509,3821,5572,10026,334,716,3116,259,486,218,43057,265,19534,16418,10846,22330
2021-01-25 09:00:00+00,18740,3759,5571,9842,328,1212,3116,432,1292,152,44444,259,20149,17033,11462,22499
2021-01-25 09:30:00+00,18760,3783,5573,9767,354,1232,3095,444,2127,0,45135,256,20916,17821,12248,22543
2021-01-25 10:00:00+00,18808,3770,5574,9940,540,1052,3077,467,2869,0,46097,250,22000,18923,13349,22578
2021-01-25 10:30:00+00,18510,3683,5567,9982,537,1060,3081,450,3534,0,46404,244,22701,19620,14053,22193
2021-01-25 11:00:00+00,17896,3695,5558,9995,468,1476,3076,242,4146,0,46552,238,23243,20167,14609,21591
2021-01-25 11:30:00+00,17786,3694,5559,10054,291,1484,3072,166,4554,0,46660,236,23530,20458,14899,21480
2021-01-25 12:00:00+00,17575,3785,5558,10283,337,1574,3070,161,4800,0,47143,233,24048,20978,15420,21360
2021-01-25 12:30:00+00,17158,3794,5560,10593,341,1572,3069,160,4730,0,46977,231,24293,21224,15664,20952
2021-01-25 13:00:00+00,17047,3647,5559,10379,342,1296,3059,164,4521,0,46014,231,23860,20801,15242,20694
2021-01-25 13:30:00+00,16744,3534,5560,10527,341,1294,3070,162,4185,8,45425,229,23683,20613,15053,20278
2021-01-25 14:00:00+00,17094,3400,5556,10684,341,1316,3073,167,3510,0,45141,231,23164,20091,14535,20494
2021-01-25 14:30:00+00,17527,3336,5556,10704,348,1098,3073,167,2489,34,44332,238,22170,19097,13541,20863
2021-01-25 15:00:00+00,17995,3296,5555,10517,370,1764,3085,168,1462,84,44296,242,20989,17904,12349,21291
2021-01-25 15:30:00+00,18627,3416,5558,10423,472,1802,3088,238,639,196,44459,250,20180,17092,11534,22043
2021-01-25 16:00:00+00,18180,3466,5558,10223,620,2820,3088,298,108,0,44361,250,19597,16509,10951,21646
2021-01-25 16:30:00+00,19207,3519,5562,9769,685,2908,3074,382,0,624,45730,253,19090,16016,10454,22726
2021-01-25 17:00:00+00,19484,3527,5561,9454,714,3690,3067,529,0,1060,47086,251,18796,15729,10168,23011
2021-01-25 17:30:00+00,19601,3529,5561,9129,719,3722,3062,522,0,1410,47255,251,18471,15409,9848,23130
2021-01-25 18:00:00+00,19723,3510,5561,8817,724,3704,3057,513,0,982,46591,255,18159,15102,9541,23233
2021-01-25 18:30:00+00,19762,3369,5558,8860,718,3706,3063,422,0,612,46070,255,18199,15136,9578,23131
2021-01-25 19:00:00+00,19569,2917,5561,8772,670,3816,3056,263,0,220,44844,249,18059,15003,9442,22486
2021-01-25 19:30:00+00,19015,2370,5557,8672,588,3824,3051,176,0,0,43253,240,17868,14817,9260,21385
2021-01-25 20:00:00+00,18244,1944,5554,8574,539,3824,3062,167,0,104,42012,231,17729,14667,9113,20188
2021-01-25 20:30:00+00,17582,1488,5555,8545,369,3824,3069,164,0,56,40652,222,17538,14469,8914,19070
2021-01-25 21:00:00+00,16576,1188,5554,8197,387,3714,3072,156,0,96,38940,213,17210,14138,8584,17764
2021-01-25 21:30:00+00,15525,873,5556,7935,390,3668,3071,175,0,0,37193,205,16952,13881,8325,16398
2021-01-25 22:00:00+00,15179,629,5556,7867,339,2288,3073,181,0,90,35202,203,16835,13762,8206,15808
2021-01-25 22:30:00+00,13538,542,5559,7894,322,2274,3077,159,0,38,33402,192,16852,13774,8216,14080
2021-01-25 23:00:00+00,10810,560,5559,7808,319,3502,2983,164,0,0,31705,172,16669,13686,8127,11370
2021-01-25 23:30:00+00,9549,573,5561,7691,319,3554,3071,156,0,0,30474,164,16642,13571,8010,10122
2021-01-26 00:00:00+00,9441,564,5560,7394,301,3962,2987,156,0,0,30365,164,16242,13255,7695,10005
2021-01-26 00:30:00+00,9993,558,5563,7209,296,4088,3075,157,0,0,30939,170,16143,13068,7505,10551
2021-01-26 01:00:00+00,10075,570,5567,7209,300,4170,2946,156,0,0,30993,171,16022,13076,7509,10645
2021-01-26 01:30:00+00,9683,567,5563,6992,302,4266,2983,158,0,0,30514,170,15840,12857,7294,10250
2021-01-26 02:00:00+00,9901,580,5568,6468,302,4264,3079,160,0,0,30322,175,15417,12338,6770,10481
2021-01-26 02:30:00+00,10053,581,5574,6230,205,4351,3085,158,0,0,30237,178,15094,12009,6435,10634
2021-01-26 03:00:00+00,10100,578,5575,5886,117,4294,3087,160,0,0,29798,182,14665,11578,6003,10678
2021-01-26 03:30:00+00,10098,576,5571,5490,129,4405,3091,164,0,0,29524,186,14281,11190,5619,10674
2021-01-26 04:00:00+00,10237,576,5574,5028,128,4387,3092,162,0,0,29184,192,13822,10730,5156,10813
2021-01-26 04:30:00+00,10303,570,5571,4887,129,4441,3083,165,0,0,29149,194,13670,10587,5016,10873
2021-01-26 05:00:00+00,10490,577,5573,4860,147,4283,3068,161,0,0,29160,197,13648,10580,5007,11067
2021-01-26 05:30:00+00,12007,682,5573,4376,147,4193,3068,157,0,28,30231,212,13164,10096,4523,12689
2021-01-26 06:00:00+00,15115,1060,5568,3982,205,3636,3068,162,0,252,33048,241,12823,9755,4187,16175
2021-01-26 06:30:00+00,17729,1508,5568,3289,213,3511,3078,303,0,178,35377,267,12148,9070,3502,19237
2021-01-26 07:00:00+00,20702,1874,5572,3240,230,3331,3080,357,0,342,38728,284,12122,9042,3470,22576
2021-01-26 07:30:00+00,22104,2139,5570,3159,277,3282,3075,443,0,362,40411,291,12081,9006,3436,24243
2021-01-26 08:00:00+00,22152,2381,5569,3369,317,4409,3076,341,23,236,41873,287,12354,9278,3709,24533
2021-01-26 08:30:00+00,22546,2551,5569,3824,327,4541,3078,289,156,446,43326,285,12954,9876,4307,25097
2021-01-26 09:00:00+00,22730,2590,5573,4123,328,4719,3048,234,364,384,44093,283,13436,10388,4815,25320
2021-01-26 09:30:00+00,22807,2593,5573,4448,309,4668,3046,334,602,152,44532,281,13978,10932,5359,25400
2021-01-26 10:00:00+00,23004,2593,5551,4716,292,4406,3039,222,746,52,44621,280,14344,11305,5754,25597
2021-01-26 10:30:00+00,22986,2542,5546,4935,296,4421,3036,289,809,0,44860,278,14622,11586,6040,25528
2021-01-26 11:00:00+00,22717,2566,5546,5044,263,4489,3007,265,842,280,45019,274,14702,11695,6149,25283
2021-01-26 11:30:00+00,22595,2594,5555,5331,259,4507,3003,272,806,258,45180,273,14954,11951,6396,25189
2021-01-26 12:00:00+00,22628,2599,5563,6021,325,4334,3037,267,849,578,46201,266,15795,12758,7195,25227
2021-01-26 12:30:00+00,22561,2582,5564,6572,317,4273,3051,292,811,366,46389,263,16315,13264,7700,25143
2021-01-26 13:00:00+00,22328,2502,5561,7114,313,4114,3051,287,773,178,46221,259,16812,13761,8200,24830
2021-01-26 13:30:00+00,22079,2447,5564,7372,315,4026,3079,195,603,0,45680,257,16933,13854,8290,24526
2021-01-26 14:00:00+00,22377,2458,5560,7773,326,3174,3082,178,479,0,45407,260,17220,14138,8578,24835
2021-01-26 14:30:00+00,22212,2534,5563,7653,324,3122,3079,162,375,0,45024,262,16994,13915,8352,24746
2021-01-26 15:00:00+00,22352,2529,5558,7531,332,3096,3078,180,188,10,44854,264,16687,13609,8051,24881
2021-01-26 15:30:00+00,22300,2487,5560,7705,371,3144,3076,260,69,74,45046,263,16781,13705,8145,24787
2021-01-26 16:00:00+00,22127,2451,5560,7581,464,3926,3078,290,10,0,45487,259,16693,13615,8055,24578
2021-01-26 16:30:00+00,22490,2491,5561,7433,502,3924,3080,385,0,468,46334,259,16576,13496,7935,24981
2021-01-26 17:00:00+00,22820,2568,5564,7212,598,3288,3078,470,0,1326,46924,260,16452,13374,7810,25388
2021-01-26 17:30:00+00,22749,2577,5567,7314,628,3268,3080,451,0,1356,46990,259,16589,13509,7942,25326
2021-01-26 18:00:00+00,22583,2583,5565,7662,638,3404,3077,444,0,766,46722,259,16942,13865,8300,25166
2021-01-26 18:30:00+00,21900,2567,5566,8135,599,3412,3080,367,0,246,45872,257,17380,14300,8734,24467
2021-01-26 19:00:00+00,20684,2389,5563,8509,456,3816,3078,232,0,72,44799,249,17606,14528,8965,23073
2021-01-26 19:30:00+00,19753,2163,5568,8367,414,3836,3069,166,0,18,43354,243,17418,14349,8781,21916
2021-01-26 20:00:00+00,18950,1765,5567,8061,301,3852,3063,162,0,0,41721,236,16992,13929,8362,20715
2021-01-26 20:30:00+00,18092,1193,5565,7880,272,3856,3056,160,0,16,40090,223,16773,13717,8152,19285
2021-01-26 21:00:00+00,16811,591,5567,7915,270,4016,3062,155,0,0,38387,206,16814,13752,8185,17402
2021-01-26 21:30:00+00,15171,358,5565,7991,266,3956,2991,154,0,0,36452,193,16813,13822,8257,15529
2021-01-26 22:00:00+00,12951,300,5562,8259,224,3982,3037,164,0,66,34545,177,17082,14045,8483,13251
2021-01-26 22:30:00+00,11236,299,5560,8295,221,3980,2998,165,0,42,32796,165,17074,14076,8516,11535
2021-01-26 23:00:00+00,9829,301,5558,7924,217,3880,2930,175,0,198,31012,157,16629,13699,8141,10130
2021-01-26 23:30:00+00,9027,300,5561,7962,201,3880,3022,154,0,0,30107,151,16746,13724,8163,9327
2021-01-27 00:00:00+00,8872,301,5560,7896,185,3880,3018,155,0,0,29867,150,16659,13641,8081,9173
2021-01-27 00:30:00+00,9290,301,5559,7766,169,3880,3045,156,0,0,30166,154,16539,13494,7935,9591
2021-01-27 01:00:00+00,9167,301,5563,7672,166,3880,3043,154,0,0,29946,154,16444,13401,7838,9468
2021-01-27 01:30:00+00,9110,301,5564,7377,162,3878,3040,156,0,0,29588,155,16143,13103,7539,9411
2021-01-27 02:00:00+00,9394,294,5567,6933,143,3864,3009,159,0,0,29363,159,15652,12643,7076,9688
2021-01-27 02:30:00+00,9818,300,5573,6558,143,3867,2987,157,0,0,29403,165,15261,12274,6701,10118
2021-01-27 03:00:00+00,9743,300,5577,6549,143,3829,2992,155,0,0,29288,164,15261,12269,6692,10043
2021-01-27 03:30:00+00,9563,302,5580,6340,140,3826,3012,155,0,0,28917,164,15072,12060,6480,9865
2021-01-27 04:00:00+00,9674,326,5580,5995,138,3705,3044,157,0,0,28618,168,14757,11713,6133,10000
2021-01-27 04:30:00+00,9966,383,5579,5790,137,3700,3042,155,0,0,28752,173,14548,11506,5927,10349
2021-01-27 05:00:00+00,9989,433,5580,5499,137,3683,3036,154,0,0,28511,177,14252,11216,5636,10422
2021-01-27 05:30:00+00,10776,550,5582,5517,138,3678,2900,154,0,0,29296,186,14137,11237,5655,11326
2021-01-27 06:00:00+00,13047,807,5581,5612,161,3306,3018,158,0,0,31689,207,14372,11354,5773,13854
2021-01-27 06:30:00+00,15213,1221,5579,5623,165,3278,2984,156,0,0,34219,228,14351,11367,5788,16434
2021-01-27 07:00:00+00,19137,2024,5580,5311,186,2740,2938,159,0,0,38074,264,14015,11077,5497,21161
2021-01-27 07:30:00+00,20543,2772,5581,4915,216,2754,3004,161,0,0,39946,283,13716,10712,5131,23315
2021-01-27 08:00:00+00,20755,3109,5577,4555,294,3393,3045,171,52,18,40969,287,13523,10478,4901,23864
2021-01-27 08:30:00+00,21588,3486,5573,4160,294,3433,3107,174,151,24,41989,296,13285,10178,4605,25074
2021-01-27 09:00:00+00,21861,3656,5558,3938,317,3438,3096,288,354,182,42687,299,13263,10167,4608,25517
2021-01-27 09:30:00+00,21849,3799,5542,3561,328,3452,3094,427,585,246,42883,301,13110,10016,4474,25648
2021-01-27 10:00:00+00,21588,3791,5540,3780,383,3769,3104,557,816,86,43414,297,13623,10519,4979,25379
2021-01-27 10:30:00+00,21823,3821,5542,3507,368,3776,3090,336,974,0,43238,299,13482,10392,4849,25644
2021-01-27 11:00:00+00,22143,3804,5552,3148,396,3776,3080,357,1189,42,43487,300,13365,10285,4733,25947
2021-01-27 11:30:00+00,22322,3806,5557,2984,394,3783,3084,485,1330,156,43901,300,13349,10265,4708,26128
2021-01-27 12:00:00+00,22257,3815,5561,3065,416,3994,3088,466,1400,288,44349,297,13529,10441,4881,26072
2021-01-27 12:30:00+00,22142,3818,5562,3058,417,3997,3085,480,1266,530,44355,296,13388,10303,4741,25960
2021-01-27 13:00:00+00,22150,3812,5563,2942,371,3898,3084,352,1322,512,44007,297,13283,10199,4635,25962
2021-01-27 13:30:00+00,22082,3587,5564,2864,360,3898,3072,339,1296,128,43190,297,13156,10084,4520,25669
2021-01-27 14:00:00+00,22009,3509,5564,2487,370,3982,3047,345,924,254,42491,300,12392,9345,3781,25518
2021-01-27 14:30:00+00,22257,3393,5566,2269,393,3984,3021,346,729,82,42040,303,11978,8957,3391,25650
2021-01-27 15:00:00+00,22297,3254,5567,2339,398,3984,3019,427,434,0,41719,305,11757,8738,3171,25551
2021-01-27 15:30:00+00,22000,3295,5569,2456,413,3984,2984,497,198,680,42076,301,11620,8636,3067,25295
2021-01-27 16:00:00+00,22208,3282,5571,2580,523,4004,2971,433,47,888,42507,300,11692,8721,3150,25490
2021-01-27 16:30:00+00,22744,3457,5589,2607,612,4004,2972,495,0,1186,43666,301,11780,8808,3219,26201
2021-01-27 17:00:00+00,23002,3435,5594,2447,942,4004,2973,552,0,1844,44793,295,11956,8983,3389,26437
2021-01-27 17:30:00+00,23243,3215,5593,2296,938,4002,2986,595,0,1752,44620,294,11813,8827,3234,26458
2021-01-27 18:00:00+00,23155,3191,5593,2404,634,3890,3035,592,0,1492,43986,297,11666,8631,3038,26346
2021-01-27 18:30:00+00,22775,2999,5596,2600,629,3930,3029,574,0,1150,43282,294,11854,8825,3229,25774
2021-01-27 19:00:00+00,22353,2907,5597,2749,576,4094,3035,376,0,770,42457,292,11957,8922,3325,25260
2021-01-27 19:30:00+00,21846,2906,5595,2712,529,4022,3047,221,0,0,40878,296,11883,8836,3241,24752
2021-01-27 20:00:00+00,21110,2447,5593,2878,397,4048,3033,158,0,138,39802,287,11901,8868,3275,23557
2021-01-27 20:30:00+00,19759,1806,5596,3305,361,4172,3040,155,0,0,38194,270,12302,9262,3666,21565
2021-01-27 21:00:00+00,18058,1260,5594,3889,305,4386,3046,155,0,74,36767,250,12834,9788,4194,19318
2021-01-27 21:30:00+00,16113,813,5594,4400,291,4432,3047,153,0,28,34871,230,13332,10285,4691,16926
2021-01-27 22:00:00+00,14333,617,5593,4732,242,4386,3030,149,0,0,33082,215,13597,10567,4974,14950
2021-01-27 22:30:00+00,12009,616,5592,5421,239,4423,2925,158,0,0,31383,198,14177,11252,5660,12625
2021-01-27 23:00:00+00,10226,618,5590,6034,228,4268,2555,150,0,24,29693,184,14407,11852,6262,10844
2021-01-27 23:30:00+00,9021,622,5593,6345,224,4418,2206,148,0,0,28577,176,14368,12162,6569,9643
2021-01-28 00:00:00+00,8290,622,5589,6878,209,4516,2127,150,0,0,28381,167,14803,12676,7087,8912
2021-01-28 00:30:00+00,8063,621,5590,7331,209,4624,2248,152,0,0,28838,163,15378,13130,7540,8684
2021-01-28 01:00:00+00,7572,619,5590,7708,173,4384,2278,150,0,0,28474,157,15749,13471,7881,8191
2021-01-28 01:30:00+00,7060,620,5591,7966,167,4370,2233,149,0,0,28156,152,15957,13724,8133,7680
2021-01-28 02:00:00+00,7246,619,5592,8104,167,4300,2223,154,0,0,28405,152,16086,13863,8271,7865
2021-01-28 02:30:00+00,7127,618,5595,8251,166,4240,2263,150,0,0,28410,149,16275,14012,8417,7745
2021-01-28 03:00:00+00,6511,620,5596,8555,165,4170,2263,150,0,0,28030,141,16579,14316,8720,7131
2021-01-28 03:30:00+00,5671,618,5597,9042,170,4002,2281,150,0,0,27531,129,17090,14809,9212,6289
2021-01-28 04:00:00+00,5461,618,5598,9398,186,3470,2323,150,0,0,27204,127,17505,15182,9584,6079
2021-01-28 04:30:00+00,5441,617,5596,9298,185,3326,2437,159,0,0,27059,126,17516,15079,9483,6058
2021-01-28 05:00:00+00,5724,617,5595,9851,200,3044,2490,152,0,0,27673,128,18136,15646,10051,6341
2021-01-28 05:30:00+00,6130,565,5594,10428,203,2966,2483,153,0,0,28522,127,18708,16225,10631,6695
2021-01-28 06:00:00+00,7655,723,5590,10243,207,2720,2615,162,0,0,29915,147,18655,16040,10450,8378
2021-01-28 06:30:00+00,9488,1014,5592,9916,239,2560,2559,150,0,0,31518,168,18306,15747,10155,10502
2021-01-28 07:00:00+00,12161,1316,5592,9740,289,1844,2944,162,0,24,34072,196,18564,15620,10028,13477
2021-01-28 07:30:00+00,13570,1527,5589,10050,305,1788,2996,154,0,2,35981,206,18940,15944,10355,15097
2021-01-28 08:00:00+00,14371,1483,5587,9978,369,2894,2973,174,31,136,37996,203,18938,15965,10378,15854
2021-01-28 08:30:00+00,15052,1451,5591,9969,384,3048,3022,344,181,118,39160,206,19147,16125,10534,16503
2021-01-28 09:00:00+00,14914,1637,5589,9631,359,3994,3020,348,474,86,40052,204,19073,16053,10464,16551
2021-01-28 09:30:00+00,15080,1934,5589,9183,380,3996,3019,406,1129,24,40740,209,19300,16281,10692,17014
2021-01-28 10:00:00+00,15134,2073,5595,8912,383,3982,2997,407,1141,0,40624,213,19028,16031,10436,17207
2021-01-28 10:30:00+00,15201,2279,5591,8435,397,3982,3007,404,1557,44,40897,217,18987,15980,10389,17480
2021-01-28 11:00:00+00,15229,2451,5594,8221,386,4040,3025,403,1639,0,40988,221,18865,15840,10246,17680
2021-01-28 11:30:00+00,15326,2416,5591,7958,390,4186,3026,408,1559,32,40892,224,18524,15498,9907,17742
2021-01-28 12:00:00+00,15940,2376,5590,8103,425,4260,3028,378,1433,42,41575,225,18579,15551,9961,18316
2021-01-28 12:30:00+00,15882,2242,5589,8093,420,4300,3029,415,1232,134,41336,224,18363,15334,9745,18124
2021-01-28 13:00:00+00,15917,2039,5593,7798,397,4252,3027,393,1220,644,41280,219,18035,15008,9415,17956
2021-01-28 13:30:00+00,16146,1994,5590,6983,384,4210,3027,388,1434,494,40650,223,17418,14391,8801,18140
2021-01-28 14:00:00+00,16646,2110,5593,6562,392,4122,3023,468,1289,46,40251,233,16859,13836,8243,18756
2021-01-28 14:30:00+00,16849,2116,5587,6415,373,4186,3025,429,1081,52,40113,236,16481,13456,7869,18965
2021-01-28 15:00:00+00,17484,2238,5589,6195,354,4146,3029,171,800,376,40382,242,15967,12938,7349,19722
2021-01-28 15:30:00+00,18007,2579,5587,6026,391,4246,3051,165,245,272,40569,255,15300,12249,6662,20586
2021-01-28 16:00:00+00,18444,2637,5587,6286,472,4472,3052,229,49,78,41306,258,15446,12394,6807,21081
2021-01-28 16:30:00+00,19255,2621,5584,6210,562,4564,3056,365,0,748,42965,257,15412,12356,6772,21876
2021-01-28 17:00:00+00,19554,2785,5585,5815,596,4512,3062,536,0,1758,44203,257,15058,11996,6411,22339
2021-01-28 17:30:00+00,19657,2903,5587,5866,597,4608,3068,528,0,1732,44546,260,15118,12050,6463,22560
2021-01-28 18:00:00+00,19563,2975,5586,6050,585,4252,3013,375,0,1462,43861,264,15234,12221,6635,22538
2021-01-28 18:30:00+00,19139,2948,5587,5851,587,4186,3050,300,0,1204,42852,265,15075,12025,6438,22087
2021-01-28 19:00:00+00,18240,2983,5587,6092,563,4150,3065,252,0,568,41500,265,15307,12242,6655,21223
2021-01-28 19:30:00+00,17123,2939,5588,6529,477,3944,2966,158,0,30,39754,260,15560,12594,7006,20062
2021-01-28 20:00:00+00,15440,2526,5587,7224,367,4548,2488,156,0,24,38360,243,15666,13178,7591,17966
2021-01-28 20:30:00+00,13941,2036,5589,7759,331,4650,2291,161,0,52,36810,225,15970,13679,8090,15977
2021-01-28 21:00:00+00,12132,1844,5596,8413,324,4506,2320,155,0,30,35320,208,16653,14333,8737,13976
2021-01-28 21:30:00+00,10096,1606,5591,9022,319,4420,2189,162,0,24,33429,187,17121,14932,9341,11702
2021-01-28 22:00:00+00,8536,1494,5591,9039,270,4346,2171,156,0,110,31713,176,17071,14900,9309,10030
2021-01-28 22:30:00+00,7341,1400,5589,9184,265,4246,1975,154,0,0,30154,164,17013,15038,9449,8741
2021-01-28 23:00:00+00,6490,1330,5587,9314,263,3804,1668,156,0,42,28654,156,16832,15164,9577,7820
2021-01-28 23:30:00+00,5239,1245,5590,9605,259,3740,1667,150,0,0,27495,140,17121,15454,9864,6484
2021-01-29 00:00:00+00,5225,1283,5588,9815,256,3232,1665,150,0,0,27214,137,17324,15659,10071,6508
2021-01-29 00:30:00+00,5064,1289,5589,10523,255,3308,1660,150,0,0,27838,133,18027,16367,10778,6353
2021-01-29 01:00:00+00,4745,1309,5588,10962,221,2966,1663,155,0,0,27609,126,18434,16771,11183,6054
2021-01-29 01:30:00+00,4393,1309,5586,11007,219,2964,1665,151,0,0,27294,122,18477,16812,11226,5702
2021-01-29 02:00:00+00,4296,1302,5590,11285,181,3048,1664,157,0,0,27523,120,18720,17056,11466,5598
2021-01-29 02:30:00+00,3998,1315,5592,11605,173,3010,1665,154,0,0,27512,116,19035,17370,11778,5313
2021-01-29 03:00:00+00,3873,1310,5588,11493,173,2910,1666,162,0,0,27175,115,18920,17254,11666,5183
2021-01-29 03:30:00+00,3731,1225,5592,11532,173,2916,1660,151,0,0,26980,111,18957,17297,11705,4956
2021-01-29 04:00:00+00,3698,1202,5589,11808,173,2350,1640,157,0,0,26617,111,19210,17570,11981,4900
2021-01-29 04:30:00+00,3977,1260,5591,11402,173,2370,1646,159,0,0,26578,118,18812,17166,11575,5237
2021-01-29 05:00:00+00,4022,1260,5590,11187,193,2848,1649,153,0,0,26902,120,18619,16970,11380,5282
2021-01-29 05:30:00+00,4273,1327,5587,11178,193,3032,1762,165,0,0,27517,126,18720,16958,11371,5600
2021-01-29 06:00:00+00,4506,1424,5583,11184,197,3632,2205,270,0,0,29001,134,19169,16964,11381,5930
2021-01-29 06:30:00+00,6160,1597,5588,11160,213,3336,2883,248,0,246,31431,152,19844,16961,11373,7757
2021-01-29 07:00:00+00,8122,1714,5588,10979,277,3650,3050,219,0,112,33711,169,19894,16844,11256,9836
2021-01-29 07:30:00+00,9738,1698,5588,10950,331,3568,3051,221,0,0,35145,179,19920,16869,11281,11436
2021-01-29 08:00:00+00,10987,1627,5588,11119,447,3548,3001,393,99,0,36809,183,20254,17253,11665,12614
2021-01-29 08:30:00+00,12074,1637,5589,11228,450,3416,2935,402,370,0,38101,186,20572,17637,12048,13711
2021-01-29 09:00:00+00,13397,1637,5588,11198,433,3126,2960,175,789,0,39303,188,20968,18008,12420,15034
2021-01-29 09:30:00+00,13679,1639,5594,11285,409,3002,2935,157,1332,0,40032,186,21555,18620,13026,15318
2021-01-29 10:00:00+00,13905,1691,5582,11180,394,3002,2706,163,2011,0,40634,186,21873,19167,13585,15596
2021-01-29 10:30:00+00,14153,1785,5574,10991,381,3002,2629,159,2353,0,41027,189,21928,19299,13725,15938
2021-01-29 11:00:00+00,14284,1814,5572,10719,380,3056,2547,161,2629,6,41168,190,21847,19300,13728,16098
2021-01-29 11:30:00+00,14295,1806,5573,10460,382,3010,2629,164,2967,4,41290,189,22011,19382,13809,16101
2021-01-29 12:00:00+00,15013,1850,5571,9757,405,3156,2725,166,3108,10,41761,197,21566,18841,13270,16863
2021-01-29 12:30:00+00,15331,1918,5574,9141,411,3186,2849,159,2585,0,41154,205,20560,17711,12137,17249
2021-01-29 13:00:00+00,15341,1909,5577,9079,371,3046,3017,156,2383,0,40879,205,20427,17410,11833,17250
2021-01-29 13:30:00+00,15081,1888,5575,9252,355,3002,3022,157,1951,0,40283,205,20155,17133,11558,16969
2021-01-29 14:00:00+00,15466,1897,5569,9119,388,3002,3004,162,1475,0,40082,210,19555,16551,10982,17363
2021-01-29 14:30:00+00,15509,1914,5572,8840,405,3002,2977,162,1146,0,39527,213,18940,15963,10391,17423
2021-01-29 15:00:00+00,15975,2187,5569,8628,410,3002,2980,167,709,0,39627,224,18296,15316,9747,18162
2021-01-29 15:30:00+00,16408,2553,5568,8068,430,3000,2992,163,315,0,39497,238,17373,14381,8813,18961
2021-01-29 16:00:00+00,16750,2612,5572,7933,463,3022,3000,225,56,52,39685,242,17024,14024,8452,19362
2021-01-29 16:30:00+00,17668,2347,5568,7294,544,3022,3002,424,0,938,40807,240,16408,13406,7838,20015
2021-01-29 17:00:00+00,19259,2198,5566,6953,630,3022,3055,513,0,1572,42768,241,16204,13149,7583,21457
2021-01-29 17:30:00+00,19838,2194,5567,6520,636,3022,3056,569,0,1646,43048,245,15779,12723,7156,22032
2021-01-29 18:00:00+00,19638,2219,5567,6293,642,3022,3077,491,0,1550,42499,247,15579,12502,6935,21857
2021-01-29 18:30:00+00,18980,2076,5574,6336,646,3158,3036,374,0,1112,41292,245,15592,12556,6982,21056
2021-01-29 19:00:00+00,18481,1934,5571,6568,588,3468,3040,277,0,438,40365,245,15767,12727,7156,20415
2021-01-29 19:30:00+00,17734,1530,5572,6639,552,3740,3030,184,0,24,39005,238,15793,12763,7191,19264
2021-01-29 20:00:00+00,15957,830,5570,6938,461,4866,2980,163,0,0,37765,213,15949,12969,7399,16787
2021-01-29 20:30:00+00,15338,318,5572,6902,379,4898,2689,158,0,4,36258,200,15542,12852,7280,15656
2021-01-29 21:00:00+00,14702,9,5571,6878,283,4768,2285,159,0,200,34855,190,15017,12732,7161,14711
2021-01-29 21:30:00+00,13607,0,5590,6937,256,4744,2209,152,0,10,33505,184,14992,12783,7193,13607
2021-01-29 22:00:00+00,12136,0,5582,7266,236,4874,1896,150,0,0,32140,174,14980,13084,7502,12136
2021-01-29 22:30:00+00,10676,0,5573,7566,237,4898,1478,155,0,0,30583,163,14854,13376,7803,10676
2021-01-29 23:00:00+00,9994,0,5571,7965,237,3796,1125,161,0,0,28849,161,14898,13773,8202,9994
2021-01-29 23:30:00+00,8540,0,5567,8343,228,3762,1172,156,0,4,27772,147,15310,14138,8571,8540
2021-01-30 00:00:00+00,8063,0,5566,8830,210,3762,1170,153,0,0,27754,141,15776,14606,9040,8063
2021-01-30 00:30:00+00,8126,0,5570,9344,201,3762,1169,150,0,0,28322,139,16284,15115,9545,8126
2021-01-30 01:00:00+00,7254,0,5568,9992,179,3466,1166,151,0,0,27776,129,16905,15739,10171,7254
2021-01-30 01:30:00+00,6181,0,5567,10358,179,3464,1169,151,0,0,27069,117,17273,16104,10537,6181
2021-01-30 02:00:00+00,5916,0,5575,10894,173,3464,1166,151,0,0,27339,112,17808,16642,11067,5916
2021-01-30 02:30:00+00,5237,0,5572,11394,171,3464,1167,151,0,0,27156,102,18304,17137,11565,5237
2021-01-30 03:00:00+00,4439,0,5574,12258,171,3074,1155,155,0,0,26826,91,19158,18003,12429,4439
2021-01-30 03:30:00+00,3950,0,5574,12603,171,3060,949,154,0,0,26461,84,19297,18348,12774,3950
2021-01-30 04:00:00+00,3990,0,5575,12664,171,2582,859,151,0,0,25992,84,19269,18410,12835,3990
2021-01-30 04:30:00+00,3901,0,5573,12673,171,2542,861,150,0,0,25871,83,19278,18417,12844,3901
2021-01-30 05:00:00+00,4407,0,5572,13108,171,2090,1047,155,0,0,26550,89,19898,18851,13279,4407
2021-01-30 05:30:00+00,4353,0,5572,13304,173,2086,1169,153,0,0,26810,87,20218,19049,13477,4353
2021-01-30 06:00:00+00,5256,0,5573,13542,211,2174,1171,152,0,0,28079,96,20497,19326,13753,5256
2021-01-30 06:30:00+00,5537,0,5573,13730,214,2174,1163,152,0,0,28543,99,20680,19517,13944,5537
2021-01-30 07:00:00+00,5359,0,5570,13868,255,2606,1051,152,0,0,28861,95,20744,19693,14123,5359
2021-01-30 07:30:00+00,5853,0,5570,13986,279,2650,983,164,0,0,29485,100,20818,19835,14265,5853
2021-01-30 08:00:00+00,6630,0,5565,13934,330,2768,1137,164,4,0,30532,107,20970,19833,14268,6630
2021-01-30 08:30:00+00,7866,0,5571,14048,332,2804,1181,167,71,24,32064,117,21203,20022,14451,7866
2021-01-30 09:00:00+00,8488,0,5571,14081,385,3874,1175,159,222,0,33955,120,21434,20259,14688,8488
2021-01-30 09:30:00+00,9203,0,5566,14008,387,3908,1172,169,407,0,34820,126,21540,20368,14802,9203
2021-01-30 10:00:00+00,10422,88,5569,13953,389,3646,1175,158,580,0,35980,136,21666,20491,14922,10510
2021-01-30 10:30:00+00,10932,224,5567,13749,366,3642,1172,172,805,42,36671,143,21659,20487,14920,11156
2021-01-30 11:00:00+00,11579,229,5571,13771,362,3596,1172,161,985,0,37426,146,21861,20689,15118,11808
2021-01-30 11:30:00+00,11904,230,5567,13743,362,3476,1173,177,1072,36,37740,147,21917,20744,15177,12134
2021-01-30 12:00:00+00,11848,230,5568,13857,360,4274,1172,162,1099,24,38594,145,22056,20884,15316,12078
2021-01-30 12:30:00+00,11974,229,5569,13813,360,4292,1167,171,1052,68,38695,145,21961,20794,15225,12203
2021-01-30 13:00:00+00,12018,369,5573,13654,307,4414,1165,155,979,80,38714,150,21678,20513,14940,12387
2021-01-30 13:30:00+00,11783,331,5577,13431,296,4352,1166,158,928,0,38022,148,21398,20232,14655,12114
2021-01-30 14:00:00+00,11871,230,5577,13242,290,4418,1164,159,757,24,37732,147,21030,19866,14289,12101
2021-01-30 14:30:00+00,12064,233,5581,13074,291,4344,1167,157,581,0,37492,149,20694,19527,13946,12297
2021-01-30 15:00:00+00,12694,238,5576,12809,295,3870,1171,166,391,0,37210,158,20242,19071,13495,12932
2021-01-30 15:30:00+00,13400,230,5573,12423,298,3884,1181,157,206,0,37352,165,19681,18500,12927,13630
2021-01-30 16:00:00+00,13959,280,5576,12309,306,4192,1185,159,63,0,38029,169,19439,18254,12678,14239
2021-01-30 16:30:00+00,15309,373,5572,12098,407,4356,1186,177,3,122,39603,180,19266,18080,12508,15682
2021-01-30 17:00:00+00,16570,494,5570,11888,512,4596,1201,324,0,930,42085,185,19171,17970,12400,17064
2021-01-30 17:30:00+00,17190,497,5568,11718,515,4462,1215,360,0,900,42425,188,19016,17801,12233,17687
2021-01-30 18:00:00+00,17124,500,5568,11612,511,4278,1219,188,0,980,41980,186,18910,17691,12123,17624
2021-01-30 18:30:00+00,16286,500,5570,11565,511,4220,1220,174,0,854,40900,182,18866,17646,12076,16786
2021-01-30 19:00:00+00,15888,363,5568,11441,482,4262,1213,158,0,312,39687,180,18704,17491,11923,16251
2021-01-30 19:30:00+00,15522,29,5572,11287,441,4214,1210,158,0,20,38453,174,18510,17300,11728,15551
2021-01-30 20:00:00+00,14627,0,5574,11002,316,4220,1211,157,0,0,37107,171,18103,16892,11318,14627
2021-01-30 20:30:00+00,13859,0,5573,10662,244,4028,1211,162,0,194,35933,166,17690,16479,10906,13859
2021-01-30 21:00:00+00,13015,0,5574,10341,226,4000,1210,151,0,126,34643,163,17351,16141,10567,13015
2021-01-30 21:30:00+00,12181,0,5573,10078,227,3996,1208,156,0,54,33473,159,17086,15878,10305,12181
2021-01-30 22:00:00+00,11211,0,5574,9812,184,4212,1208,155,0,32,32388,155,16778,15570,9996,11211
2021-01-30 22:30:00+00,10374,0,5574,9520,180,4228,1207,150,0,0,31233,150,16481,15274,9700,10374
2021-01-30 23:00:00+00,9403,0,5575,9159,180,4184,1209,155,0,0,29865,142,16123,14914,9339,9403
2021-01-30 23:30:00+00,8735,0,5571,9074,166,4028,1208,150,0,0,28932,135,16019,14811,9240,8735
2021-01-31 00:00:00+00,8717,0,5574,8880,138,4150,1209,150,0,0,28818,137,15801,14592,9018,8717
2021-01-31 00:30:00+00,9234,0,5569,8764,136,4250,1209,151,0,0,29313,144,15678,14469,8900,9234
2021-01-31 01:00:00+00,9410,0,5570,8618,134,3884,1208,152,0,0,28976,148,15530,14322,8752,9410
2021-01-31 01:30:00+00,9047,0,5566,8303,120,3948,1207,150,0,0,28341,147,15196,13989,8423,9047
2021-01-31 02:00:00+00,9152,0,5562,7939,119,4070,1206,159,0,0,28207,148,14826,13620,8058,9152
2021-01-31 02:30:00+00,9395,0,5564,7741,119,4122,1204,154,0,0,28299,152,14628,13424,7860,9395
2021-01-31 03:00:00+00,9185,0,5566,7623,118,4162,1207,151,0,0,28012,151,14514,13307,7741,9185
2021-01-31 03:30:00+00,8736,0,5569,7659,118,4180,1237,151,0,0,27650,147,14583,13346,7777,8736
2021-01-31 04:00:00+00,8532,0,5567,7451,118,4202,1277,157,0,0,27304,146,14413,13136,7569,8532
2021-01-31 04:30:00+00,8310,0,5568,7444,118,4196,1306,151,0,0,27093,144,14436,13130,7562,8310
2021-01-31 05:00:00+00,8295,0,5569,7404,118,4326,1344,153,0,0,27209,146,14435,13091,7522,8295
2021-01-31 05:30:00+00,8339,0,5567,7122,123,4392,1518,151,0,0,27212,148,14330,12812,7245,8339
2021-01-31 06:00:00+00,8265,0,5568,7227,153,4592,1724,150,0,0,27679,146,14672,12948,7380,8265
2021-01-31 06:30:00+00,8614,0,5573,7439,168,4582,1808,151,0,0,28335,148,14988,13180,7607,8614
2021-01-31 07:00:00+00,9707,0,5571,7644,185,4356,1812,151,0,0,29426,155,15212,13400,7829,9707
2021-01-31 07:30:00+00,9867,0,5572,7842,194,4332,1736,157,0,0,29700,155,15344,13608,8036,9867
2021-01-31 08:00:00+00,10630,0,5570,8270,203,4148,1615,173,202,0,30811,159,15860,14245,8675,10630
2021-01-31 08:30:00+00,11271,0,5568,8419,208,4214,1554,159,674,0,32067,161,16423,14869,9301,11271
2021-01-31 09:00:00+00,12277,0,5573,8498,286,4414,1547,157,1056,0,33808,163,16960,15413,9840,12277
2021-01-31 09:30:00+00,13256,0,5569,8562,273,4476,1679,162,1415,12,35404,167,17498,15819,10250,13256
2021-01-31 10:00:00+00,13938,70,5572,8650,318,4438,1757,161,1882,10,36796,170,18179,16422,10850,14008
2021-01-31 10:30:00+00,14729,219,5563,8673,319,4484,1694,173,1764,0,37618,178,18013,16319,10756,14948
2021-01-31 11:00:00+00,15546,232,5561,8733,301,4482,1810,167,1615,0,38447,182,18020,16210,10649,15778
2021-01-31 11:30:00+00,16561,321,5564,8836,296,4310,1811,166,1395,0,39260,189,17902,16091,10527,16882
2021-01-31 12:00:00+00,17276,481,5564,8967,276,4298,1796,182,1374,58,40272,195,17977,16181,10617,17757
2021-01-31 12:30:00+00,17605,498,5565,8978,263,4336,1792,181,1284,244,40746,196,17882,16090,10525,18103
2021-01-31 13:00:00+00,17960,500,5570,8955,286,4316,1802,210,1229,314,41142,198,17842,16040,10470,18460
2021-01-31 13:30:00+00,18120,500,5569,8915,272,4170,1803,185,1172,0,40706,200,17731,15928,10359,18620
2021-01-31 14:00:00+00,18157,499,5569,8893,226,4210,1797,157,1024,0,40532,201,17509,15712,10143,18656
2021-01-31 14:30:00+00,18176,497,5569,9110,226,4126,1747,159,743,0,40353,201,17395,15648,10079,18673
2021-01-31 15:00:00+00,18815,567,5568,9330,226,3728,1774,159,479,0,40646,205,17377,15603,10035,19382
2021-01-31 15:30:00+00,19024,632,5564,9512,228,3802,1734,164,244,0,40904,208,17282,15548,9984,19656
2021-01-31 16:00:00+00,19703,791,5564,9764,326,3940,1750,164,57,0,42059,215,17461,15711,10147,20494
2021-01-31 16:30:00+00,20363,855,5563,9982,435,4202,1757,231,1,188,43577,218,17738,15981,10418,21218
2021-01-31 17:00:00+00,20600,970,5561,10145,546,4474,1676,339,0,1144,45455,214,17928,16252,10691,21570
2021-01-31 17:30:00+00,20789,1001,5562,10265,618,4274,1668,441,0,1294,45912,213,18113,16445,10883,21790
2021-01-31 18:00:00+00,20683,990,5562,10152,540,4122,1703,345,0,890,44987,214,17957,16254,10692,21673
2021-01-31 18:30:00+00,20025,937,5561,10060,529,4016,1763,249,0,360,43500,213,17913,16150,10589,20962
2021-01-31 19:00:00+00,18846,857,5561,9940,486,4090,1805,156,0,14,41755,208,17792,15987,10426,19703
2021-01-31 19:30:00+00,17767,623,5559,9675,447,4042,1738,160,0,0,40011,201,17419,15681,10122,18390
2021-01-31 20:00:00+00,16974,636,5561,9446,339,4096,1673,170,0,0,38895,199,17019,15346,9785,17610
2021-01-31 20:30:00+00,15806,735,5562,9230,226,4056,1789,155,0,0,37559,196,16807,15018,9456,16541
2021-01-31 21:00:00+00,14796,466,5566,9010,198,4158,1792,151,0,0,36137,187,16566,14774,9208,15262
2021-01-31 21:30:00+00,13598,506,5563,8768,194,4174,1792,151,0,20,34766,182,16317,14525,8962,14104
2021-01-31 22:00:00+00,12290,518,5564,8338,147,4250,1793,151,0,0,33051,178,15842,14049,8485,12808
2021-01-31 22:30:00+00,11529,462,5564,8093,157,4128,1796,151,0,0,31880,172,15610,13814,8250,11991
2021-01-31 23:00:00+00,10766,465,5568,7785,156,3640,1794,151,0,0,30325,169,15303,13509,7941,11231
2021-01-31 23:30:00+00,10389,466,5565,7371,155,3606,1791,151,0,0,29494,168,14882,13091,7526,10855
2021-02-01 00:00:00+00,10294,465,5564,7108,138,3608,1792,153,0,0,29122,172,14602,12810,7246,10759
2021-02-01 00:30:00+00,10892,563,5559,6787,138,3608,1792,171,0,0,29510,181,14276,12484,6925,11455
2021-02-01 01:00:00+00,10713,680,5565,6360,154,3804,1790,287,0,0,29353,186,13869,12079,6514,11393
2021-02-01 01:30:00+00,10497,716,5563,6004,179,3804,1789,333,0,0,28885,188,13535,11746,6183,11213
2021-02-01 02:00:00+00,10421,718,5561,5585,188,3780,1791,343,0,0,28387,190,13125,11334,5773,11139
2021-02-01 02:30:00+00,10496,685,5560,5181,238,3780,1790,343,0,0,28073,192,12769,10979,5419,11181
2021-02-01 03:00:00+00,10615,808,5560,4934,414,3802,1796,342,0,0,28271,197,12704,10908,5348,11423
2021-02-01 03:30:00+00,10762,968,5559,4717,189,3802,1794,344,0,0,28135,205,12259,10465,4906,11730
2021-02-01 04:00:00+00,11054,1007,5559,4489,189,3804,1792,343,0,0,28237,209,12029,10237,4678,12061
2021-02-01 04:30:00+00,11373,1092,5563,4300,189,3804,1795,333,0,0,28449,215,11847,10052,4489,12465
2021-02-01 05:00:00+00,11444,1177,5564,4170,161,4012,1801,161,0,0,28490,216,11696,9895,4331,12621
2021-02-01 05:30:00+00,12367,1288,5562,4076,145,4012,1824,151,0,0,29425,225,11607,9783,4221,13655
2021-02-01 06:00:00+00,14145,1600,5560,4032,186,3987,1845,160,0,0,31514,242,11623,9778,4218,15745
2021-02-01 06:30:00+00,16069,2008,5564,3970,188,3981,1865,161,0,0,33806,259,11587,9722,4158,18077
2021-02-01 07:00:00+00,19373,2184,5223,3927,171,3316,1900,166,0,106,36366,280,11221,9321,4098,21557
2021-02-01 07:30:00+00,20878,2180,5227,3964,177,3316,1922,255,0,0,37919,285,11290,9368,4141,23058
2021-02-01 08:00:00+00,21870,2182,5225,3977,180,3970,1977,367,69,14,39831,284,11428,9451,4226,24052
2021-02-01 08:30:00+00,22789,2187,5225,3964,212,4082,2106,479,341,214,41599,283,11848,9742,4517,24976
2021-02-01 09:00:00+00,23003,2211,5227,3798,218,4116,2065,509,638,920,42705,279,11946,9881,4654,25214
2021-02-01 09:30:00+00,23140,2253,5225,3536,224,4122,2063,484,915,1142,43104,278,11963,9900,4675,25393
2021-02-01 10:00:00+00,23335,2279,5221,3245,221,4156,2065,452,1230,1148,43352,279,11982,9917,4696,25614
2021-02-01 10:30:00+00,23440,2280,5220,3072,221,4178,2201,487,1458,978,43535,280,12172,9971,4751,25720
2021-02-01 11:00:00+00,23405,2274,5216,2879,233,4084,2404,470,1604,920,43489,279,12336,9932,4716,25679
2021-02-01 11:30:00+00,23380,2279,5222,2713,239,4166,2449,488,1757,1072,43765,278,12380,9931,4709,25659
2021-02-01 12:00:00+00,23494,2279,5218,2744,282,4236,2455,467,1702,1266,44143,277,12401,9946,4728,25773
2021-02-01 12:30:00+00,23555,2261,5220,2814,283,4286,2458,474,1721,832,43904,280,12496,10038,4818,25816
2021-02-01 13:00:00+00,23352,1970,5218,2925,310,4316,2457,418,1797,1040,43803,273,12707,10250,5032,25322
2021-02-01 13:30:00+00,23450,1941,5217,2767,324,4250,2457,397,1689,1146,43638,274,12454,9997,4780,25391
2021-02-01 14:00:00+00,23513,2062,5216,2737,307,4214,2454,401,1594,900,43398,278,12308,9854,4638,25575
2021-02-01 14:30:00+00,23450,2054,5217,2770,302,4218,2453,344,1181,614,42603,282,11923,9470,4253,25504
2021-02-01 15:00:00+00,23411,1947,5226,2779,350,4146,2452,323,798,1122,42554,279,11605,9153,3927,25358
2021-02-01 15:30:00+00,23336,2031,5235,2893,397,4190,2454,312,504,1698,43050,277,11483,9029,3794,25367
2021-02-01 16:00:00+00,23324,2126,5225,2990,454,4386,2455,422,138,1724,43244,281,11262,8807,3582,25450
2021-02-01 16:30:00+00,23555,2152,5217,3116,634,4436,2477,446,3,1884,43920,280,11447,8970,3753,25707
2021-02-01 17:00:00+00,24060,2313,5214,3342,776,4560,2478,544,0,2050,45337,283,11810,9332,4118,26373
2021-02-01 17:30:00+00,23996,2273,5218,3968,846,4590,2457,555,0,2056,45959,278,12489,10032,4814,26269
2021-02-01 18:00:00+00,23515,2083,5215,4588,806,4590,2472,518,0,1808,45595,270,13081,10609,5394,25598
2021-02-01 18:30:00+00,23226,2027,5212,4882,772,4590,2502,384,0,1794,45389,267,13368,10866,5654,25253
2021-02-01 19:00:00+00,22839,2151,5213,5066,398,4650,2523,359,0,642,43841,276,13200,10677,5464,24990
2021-02-01 19:30:00+00,21910,2173,5211,5260,349,4798,2519,201,0,50,42471,276,13339,10820,5609,24083
2021-02-01 20:00:00+00,20723,2157,5211,5536,226,4854,2516,168,0,38,41429,271,13489,10973,5762,22880
2021-02-01 20:30:00+00,19288,2118,5215,5703,179,4854,2515,153,0,0,40025,265,13612,11097,5882,21406
2021-02-01 21:00:00+00,17489,2049,5214,5992,141,4740,2503,155,0,50,38333,255,13850,11347,6133,19538
2021-02-01 21:30:00+00,15816,1713,5213,6186,137,4622,2409,151,0,0,36247,241,13945,11536,6323,17529
2021-02-01 22:00:00+00,14127,1256,5215,6641,125,4676,2309,146,0,0,34495,222,14290,11981,6766,15383
2021-02-01 22:30:00+00,12698,933,5215,6879,135,4500,2210,150,0,0,32720,205,14439,12229,7014,13631
2021-02-01 23:00:00+00,11340,678,5217,7322,132,4410,1738,148,0,0,30985,189,14409,12671,7454,12018
2021-02-01 23:30:00+00,10629,262,5222,7619,132,4640,1247,146,0,0,29897,176,14220,12973,7751,10891
2021-02-02 00:00:00+00,10436,45,5216,7986,129,4660,1075,147,0,0,29694,164,14406,13331,8115,10481
2021-02-02 00:30:00+00,10500,0,5217,8471,132,4660,1077,147,0,0,30204,161,14897,13820,8603,10500
2021-02-02 01:00:00+00,10061,0,5236,8941,143,4662,1103,149,0,0,30295,155,15423,14320,9084,10061
2021-02-02 01:30:00+00,8889,0,5219,9341,143,4660,1102,150,0,0,29504,143,15805,14703,9484,8889
2021-02-02 02:00:00+00,8429,0,5220,9984,141,4660,1099,152,0,0,29685,136,16444,15345,10125,8429
2021-02-02 02:30:00+00,8384,0,5215,10147,141,4654,1100,157,0,0,29798,135,16603,15503,10288,8384
2021-02-02 03:00:00+00,7882,0,5219,10780,141,4320,1100,146,0,0,29588,128,17240,16140,10921,7882
2021-02-02 03:30:00+00,7189,0,5215,11325,141,4076,1104,148,0,0,29198,116,17785,16681,11466,7189
2021-02-02 04:00:00+00,6805,0,5214,11955,141,3462,1104,147,0,0,28828,111,18414,17310,12096,6805
2021-02-02 04:30:00+00,6272,4,5214,12529,141,3378,1102,147,0,0,28787,103,18986,17884,12670,6276
2021-02-02 05:00:00+00,6526,42,5215,13263,143,2852,1108,146,0,0,29295,106,19729,18621,13406,6568
2021-02-02 05:30:00+00,6854,64,5217,13707,158,2922,1032,149,0,0,30103,109,20114,19082,13865,6918
2021-02-02 06:00:00+00,7583,136,5212,14207,175,3204,1106,159,0,0,31782,117,20700,19594,14382,7719
2021-02-02 06:30:00+00,9264,242,5214,14714,177,2930,1132,156,0,0,33829,130,21237,20105,14891,9506
2021-02-02 07:00:00+00,10599,532,5214,14848,193,2668,1156,157,0,62,35429,148,21411,20255,15041,11131
2021-02-02 07:30:00+00,12181,735,5216,14770,193,2558,1178,152,0,16,36999,162,21357,20179,14963,12916
2021-02-02 08:00:00+00,13524,891,5219,14616,225,3174,1211,153,39,0,39052,173,21310,20099,14880,14415
2021-02-02 08:30:00+00,14680,1023,5216,14427,220,3218,1245,167,208,22,40426,182,21316,20071,14855,15703
2021-02-02 09:00:00+00,15226,1137,5218,14387,233,3326,1413,184,537,66,41727,182,21788,20375,15157,16363
2021-02-02 09:30:00+00,15262,1132,5222,14359,233,3276,1614,164,1038,0,42300,180,22466,20852,15630,16394
2021-02-02 10:00:00+00,15029,1137,5216,14264,210,3284,1739,159,1284,0,42322,178,22713,20974,15758,16166
2021-02-02 10:30:00+00,15052,1170,5215,14041,216,3254,1739,164,1267,10,42128,180,22478,20739,15524,16222
2021-02-02 11:00:00+00,15251,1279,5217,13688,228,3230,1740,170,1892,62,42757,182,22765,21025,15808,16530
2021-02-02 11:30:00+00,15735,1383,5216,13253,233,3406,1741,152,2228,0,43347,187,22671,20930,15714,17118
2021-02-02 12:00:00+00,15892,1571,5218,13126,233,3608,1743,150,2175,0,43716,193,22495,20752,15534,17463
2021-02-02 12:30:00+00,15722,1596,5219,13359,188,3510,1744,153,2277,0,43768,191,22787,21043,15824,17318
2021-02-02 13:00:00+00,15311,1546,5220,13525,259,3388,1743,152,2269,8,43421,186,23016,21273,16053,16857
2021-02-02 13:30:00+00,15391,1567,5218,13323,258,3194,1727,149,1864,0,42691,188,22390,20663,15445,16958
2021-02-02 14:00:00+00,14971,1533,5220,13770,193,3186,1637,159,1797,0,42466,184,22617,20980,15760,16504
2021-02-02 14:30:00+00,15142,1373,5217,13723,192,3052,1635,159,1196,0,41689,184,21963,20328,15111,16515
2021-02-02 15:00:00+00,15572,1334,5222,13876,201,3004,1639,190,780,0,41818,187,21718,20079,14857,16906
2021-02-02 15:30:00+00,15612,1403,5221,14104,236,3022,1654,197,376,0,41825,189,21591,19937,14716,17015
2021-02-02 16:00:00+00,16034,1485,5221,13845,314,3148,1699,275,111,0,42132,195,21190,19491,14270,17519
2021-02-02 16:30:00+00,16753,1295,5220,13836,404,3458,1705,345,3,526,43545,195,21168,19463,14243,18048
2021-02-02 17:00:00+00,17211,1376,5222,14064,559,3416,1703,386,0,1356,45293,193,21548,19845,14623,18587
2021-02-02 17:30:00+00,17364,1441,5221,14451,488,3400,1704,451,0,1260,45780,194,21864,20160,14939,18805
2021-02-02 18:00:00+00,17018,1243,5212,14850,443,3462,1708,429,0,906,45271,189,22213,20505,15293,18261
2021-02-02 18:30:00+00,16564,1309,5195,15022,424,3320,1709,312,0,236,44091,190,22350,20641,15446,17873
2021-02-02 19:00:00+00,15212,1240,5195,15485,423,3396,1705,190,0,78,42924,181,22808,21103,15908,16452
2021-02-02 19:30:00+00,14127,1175,5193,15620,369,3246,1630,156,0,0,41516,173,22812,21182,15989,15302
2021-02-02 20:00:00+00,13214,791,5195,15623,240,3288,1521,150,0,0,40022,162,22579,21058,15863,14005
2021-02-02 20:30:00+00,11893,557,5195,15482,215,3254,1520,151,0,0,38267,149,22412,20892,15697,12450
2021-02-02 21:00:00+00,9678,520,5196,15544,168,4004,1483,149,0,8,36750,132,22391,20908,15712,10198
2021-02-02 21:30:00+00,8081,507,5197,15196,144,4138,1465,150,0,0,34878,122,22002,20537,15340,8588
2021-02-02 22:00:00+00,6413,530,5195,15163,144,3850,1464,150,0,24,32933,110,21966,20502,15307,6943
2021-02-02 22:30:00+00,5083,575,5196,15271,143,3744,1463,146,0,0,31621,99,22073,20610,15414,5658
2021-02-02 23:00:00+00,4564,556,5191,15226,142,2790,1457,150,0,0,30076,95,22016,20559,15368,5120
2021-02-02 23:30:00+00,4080,536,5189,14891,142,2604,1487,146,0,0,29075,89,21709,20222,15033,4616
2021-02-03 00:00:00+00,4216,590,5170,14881,143,2506,1489,148,0,0,29143,90,21683,20194,15024,4806
2021-02-03 00:30:00+00,4712,616,5169,14321,142,2626,1554,194,0,0,29334,100,21186,19632,14463,5328
2021-02-03 01:00:00+00,5369,614,5172,13726,142,2738,1680,223,0,0,29664,110,20720,19040,13868,5983
2021-02-03 01:30:00+00,5363,616,5173,13524,143,2620,1648,215,0,0,29302,110,20488,18840,13667,5979
2021-02-03 02:00:00+00,5089,618,5172,13533,143,2608,1673,149,0,0,28985,106,20521,18848,13676,5707
2021-02-03 02:30:00+00,5076,619,5174,13155,141,2502,1647,155,0,0,28469,106,20117,18470,13296,5695
2021-02-03 03:00:00+00,5030,620,5178,13157,141,2368,1675,146,0,0,28315,104,20151,18476,13298,5650
2021-02-03 03:30:00+00,4947,620,5175,13044,141,2358,1552,151,0,0,27988,103,19912,18360,13185,5567
2021-02-03 04:00:00+00,4908,619,5173,12867,140,2358,1530,154,0,0,27749,103,19710,18180,13007,5527
2021-02-03 04:30:00+00,5486,620,5174,12240,140,2358,1752,152,0,0,27922,112,19306,17554,12380,6106
2021-02-03 05:00:00+00,5590,626,5174,11929,140,2790,1753,152,0,0,28154,115,18996,17243,12069,6216
2021-02-03 05:30:00+00,6464,695,5172,11284,152,3030,1735,148,0,0,28680,131,18343,16608,11436,7159
2021-02-03 06:00:00+00,7840,843,5172,10902,180,3616,2193,161,0,0,30907,150,18447,16254,11082,8683
2021-02-03 06:30:00+00,9595,1065,5172,10418,178,3486,2641,150,0,0,32705,169,18409,15768,10596,10660
2021-02-03 07:00:00+00,11607,1378,5170,10114,180,3380,2883,150,0,404,35266,187,18348,15464,10294,12985
2021-02-03 07:30:00+00,13872,1810,5172,9868,190,3148,2905,153,0,68,37186,209,18135,15230,10058,15682
2021-02-03 08:00:00+00,14975,2119,5171,9827,199,3114,2900,335,42,114,38796,220,18139,15239,10068,17094
2021-02-03 08:30:00+00,15840,2399,5173,9832,194,3056,2902,479,193,200,40268,228,18294,15392,10219,18239
2021-02-03 09:00:00+00,16444,2510,5171,9674,200,3004,2902,512,439,376,41232,231,18386,15484,10313,18954
2021-02-03 09:30:00+00,16719,2614,5173,9480,195,3004,2889,494,709,296,41573,234,18446,15557,10384,19333
2021-02-03 10:00:00+00,16749,2724,5171,9218,181,3004,2900,494,1138,404,41983,234,18608,15708,10537,19473
2021-02-03 10:30:00+00,16461,2754,5181,9205,174,3028,2899,484,1497,512,42195,231,18956,16057,10876,19215
2021-02-03 11:00:00+00,16188,2845,5190,9104,171,3678,2899,396,1836,238,42545,228,19200,16301,11111,19033
2021-02-03 11:30:00+00,16256,2812,5174,9049,177,3842,2901,368,2005,0,42584,229,19306,16405,11231,19068
2021-02-03 12:00:00+00,16469,2752,5169,9083,213,3624,2901,356,2102,0,42669,230,19468,16567,11398,19221
2021-02-03 12:30:00+00,16309,2696,5170,9150,219,3664,2902,200,2333,0,42643,226,19774,16872,11702,19005
2021-02-03 13:00:00+00,15958,2169,5169,9516,203,4114,2891,148,2114,0,42282,213,19893,17002,11833,18127
2021-02-03 13:30:00+00,15251,2076,5169,9746,203,4036,2857,157,1991,72,41558,207,19966,17109,11940,17327
2021-02-03 14:00:00+00,15462,2022,5167,9785,162,3794,2892,160,1735,74,41253,208,19741,16849,11682,17484
2021-02-03 14:30:00+00,15571,1935,5171,9710,171,3870,2891,151,1462,0,40932,210,19405,16514,11343,17506
2021-02-03 15:00:00+00,15669,1914,5171,9668,187,4066,2896,152,1062,0,40785,212,18984,16088,10917,17583
2021-02-03 15:30:00+00,15915,1939,5175,9875,207,4132,2932,164,625,0,40964,215,18814,15882,10707,17854
2021-02-03 16:00:00+00,15851,2222,5173,10147,264,4382,2938,278,281,0,41536,219,18803,15865,10692,18073
2021-02-03 16:30:00+00,16613,2601,5173,10140,436,4574,2941,323,33,270,43104,229,18723,15782,10609,19214
2021-02-03 17:00:00+00,17979,2753,5176,10388,450,4324,2944,340,0,368,44722,237,18958,16014,10838,20732
2021-02-03 17:30:00+00,18069,2753,5173,10573,447,4256,2942,370,0,1008,45591,233,19135,16193,11020,20822
2021-02-03 18:00:00+00,18092,2752,5176,10814,370,4114,2919,362,0,976,45575,232,19279,16360,11184,20844
2021-02-03 18:30:00+00,17424,2534,5172,11119,380,4206,2917,310,0,264,44326,228,19588,16671,11499,19958
2021-02-03 19:00:00+00,16546,1966,5172,11329,384,4374,2900,192,0,136,42999,215,19785,16885,11713,18512
2021-02-03 19:30:00+00,15421,1467,5169,11565,366,4326,2648,165,0,148,41275,201,19748,17100,11931,16888
2021-02-03 20:00:00+00,14736,995,5164,11442,305,4758,2316,167,0,358,40241,189,19227,16911,11747,15731
2021-02-03 20:30:00+00,13938,646,5165,11405,299,4746,2318,151,0,68,38736,179,19187,16869,11704,14584
2021-02-03 21:00:00+00,12675,626,5163,11245,236,4588,2318,158,0,174,37183,171,18962,16644,11481,13301
2021-02-03 21:30:00+00,11075,627,5164,11001,212,4654,2242,153,0,284,35412,162,18619,16377,11213,11702
2021-02-03 22:00:00+00,9669,638,5165,11117,159,4568,2228,150,0,58,33752,155,18669,16441,11276,10307
2021-02-03 22:30:00+00,8654,695,5165,10871,182,4482,2134,149,0,0,32332,150,18352,16218,11053,9349
2021-02-03 23:00:00+00,7618,715,5167,10676,176,3986,1831,149,0,128,30446,144,17850,16019,10852,8333
2021-02-03 23:30:00+00,6563,707,5167,10699,157,4032,1867,151,0,0,29343,136,17890,16023,10856,7270
2021-02-04 00:00:00+00,6463,714,5167,10537,128,3874,2048,148,0,72,29151,137,17880,15832,10665,7177
2021-02-04 00:30:00+00,6626,695,5167,10315,124,3974,2181,201,0,374,29657,138,17787,15606,10439,7321
2021-02-04 01:00:00+00,6482,694,5174,9965,128,3968,2175,282,0,534,29402,138,17442,15267,10093,7176
2021-02-04 01:30:00+00,6523,707,5173,9880,135,3966,2193,232,0,80,28889,142,17381,15188,10015,7230
2021-02-04 02:00:00+00,6479,658,5175,9686,120,3926,2186,225,0,0,28455,141,17167,14981,9806,7137
2021-02-04 02:30:00+00,6672,678,5179,9604,122,3924,2169,228,0,0,28576,144,17074,14905,9726,7350
2021-02-04 03:00:00+00,6786,684,5175,9454,138,3922,2131,182,0,0,28472,145,16898,14767,9592,7470
2021-02-04 03:30:00+00,6781,626,5175,9284,140,3840,2085,231,0,0,28162,144,16684,14599,9424,7407
2021-02-04 04:00:00+00,6761,672,5172,9174,140,3724,2103,252,0,0,27998,145,16589,14486,9314,7433
2021-02-04 04:30:00+00,6970,526,5169,8995,140,3718,2184,202,0,0,27904,143,16488,14304,9135,7496
2021-02-04 05:00:00+00,7167,406,5169,9018,140,3970,2158,230,0,0,28258,143,16485,14327,9158,7573
2021-02-04 05:30:00+00,7989,408,5169,9022,139,3922,2144,201,0,0,28994,149,16474,14330,9161,8397
2021-02-04 06:00:00+00,9421,383,5169,9170,154,4282,2376,151,0,0,31106,157,16869,14493,9324,9804
2021-02-04 06:30:00+00,11137,315,5167,9139,156,4138,2780,150,0,8,32990,166,17242,14462,9295,11452
2021-02-04 07:00:00+00,13549,272,5167,9251,157,4072,2989,216,0,186,35859,176,17564,14575,9408,13821
2021-02-04 07:30:00+00,14777,272,5168,9408,156,4204,2878,356,6,0,37225,185,17616,14738,9570,15049
2021-02-04 08:00:00+00,16516,272,5167,9441,183,3960,2936,371,193,186,39225,192,17920,14984,9817,16788
2021-02-04 08:30:00+00,17821,273,5172,9786,172,3900,2814,369,622,0,40929,195,18566,15752,10580,18094
2021-02-04 09:00:00+00,18202,307,5171,9882,163,3994,2920,324,1120,0,42083,194,19256,16336,11165,18509
2021-02-04 09:30:00+00,18555,312,5172,9922,164,3994,2909,192,1315,0,42535,194,19482,16573,11401,18867
2021-02-04 10:00:00+00,18699,313,5172,9778,151,3994,2908,216,1305,0,42536,196,19314,16406,11234,19012
2021-02-04 10:30:00+00,18681,314,5175,9750,152,3994,2909,294,1264,0,42533,196,19250,16341,11166,18995
2021-02-04 11:00:00+00,18858,313,5177,9652,177,3970,2908,326,1181,96,42658,197,19095,16187,11010,19171
2021-02-04 11:30:00+00,19049,314,5179,9864,182,3970,2906,345,1300,10,43119,197,19431,16525,11346,19363
2021-02-04 12:00:00+00,19286,312,5179,9759,194,3994,2905,482,1448,308,43867,197,19485,16580,11401,19598
2021-02-04 12:30:00+00,19325,314,5173,9898,194,3994,2906,511,1286,228,43829,198,19457,16551,11378,19639
2021-02-04 13:00:00+00,19281,313,5163,10007,206,3994,2902,433,1256,134,43689,198,19534,16632,11469,19594
2021-02-04 13:30:00+00,19124,286,5159,9934,213,3994,2892,278,1348,232,43460,195,19546,16654,11495,19410
2021-02-04 14:00:00+00,19104,308,5159,10049,244,3934,2893,261,1143,18,43113,197,19488,16595,11436,19412
2021-02-04 14:30:00+00,18893,336,5166,10192,256,3934,2906,190,818,0,42691,197,19338,16432,11266,19229
2021-02-04 15:00:00+00,19216,511,5168,10284,263,3830,2698,152,568,0,42690,203,18981,16283,11115,19727
2021-02-04 15:30:00+00,18978,717,5180,10288,279,3830,2812,152,316,0,42552,206,18875,16063,10883,19695
2021-02-04 16:00:00+00,19271,774,5166,10760,311,3536,2877,279,98,0,43072,208,19212,16336,11170,20045
2021-02-04 16:30:00+00,19727,772,5167,11017,347,3542,2944,305,6,388,44215,207,19481,16537,11370,20499
2021-02-04 17:00:00+00,19863,774,5166,11443,456,4004,2976,321,0,1152,46155,201,20041,17065,11899,20637
2021-02-04 17:30:00+00,20231,772,5167,11688,411,4014,2973,412,0,1126,46794,202,20239,17266,12099,21003
2021-02-04 18:00:00+00,19839,772,5165,11973,407,4014,2967,302,0,826,46265,200,20512,17545,12380,20611
2021-02-04 18:30:00+00,19514,774,5165,12092,392,4014,2887,295,0,0,45133,202,20536,17649,12484,20288
2021-02-04 19:00:00+00,18520,772,5165,11910,367,4014,2794,205,0,0,43747,199,20236,17442,12277,19292
2021-02-04 19:30:00+00,17439,777,5162,11768,358,4014,2445,170,0,76,42209,195,19733,17288,12126,18216
2021-02-04 20:00:00+00,16015,856,5164,11811,243,4014,2357,156,0,102,40718,189,19575,17218,12054,16871
2021-02-04 20:30:00+00,14746,688,5159,11515,191,4014,2394,154,0,138,38999,181,19259,16865,11706,15434
2021-02-04 21:00:00+00,13643,417,5162,11294,171,3994,2384,178,0,40,37283,171,19011,16627,11465,14060
2021-02-04 21:30:00+00,12109,313,5163,11340,171,3994,2402,173,0,0,35665,159,19076,16674,11511,12422
2021-02-04 22:00:00+00,10306,314,5156,11104,158,3780,2412,155,0,262,33647,147,18830,16418,11262,10620
2021-02-04 22:30:00+00,9278,315,5154,10763,173,3776,2395,145,0,426,32425,140,18485,16090,10936,9593
2021-02-04 23:00:00+00,8839,319,5153,10607,173,3576,2302,145,0,0,31114,140,18235,15933,10780,9158
2021-02-04 23:30:00+00,7872,315,5155,10329,174,3574,2277,146,0,0,29842,133,17935,15658,10503,8187
2021-02-05 00:00:00+00,7732,316,5154,9860,174,3588,2322,155,0,18,29319,133,17510,15188,10034,8048
2021-02-05 00:30:00+00,7647,402,5157,9791,189,3586,2300,221,0,108,29401,135,17437,15137,9980,8049
2021-02-05 01:00:00+00,7614,418,5158,9787,189,3394,2263,222,0,66,29111,136,17397,15134,9976,8032
2021-02-05 01:30:00+00,7496,417,5160,9721,182,3392,2225,192,0,0,28785,135,17288,15063,9903,7913
2021-02-05 02:00:00+00,7565,413,5163,9566,160,3392,2265,145,0,0,28669,136,17154,14889,9726,7978
2021-02-05 02:30:00+00,7667,412,5162,9347,171,3392,2282,146,0,0,28579,138,16962,14680,9518,8079
2021-02-05 03:00:00+00,7682,413,5163,9105,180,3392,2207,147,0,0,28289,140,16655,14448,9285,8095
2021-02-05 03:30:00+00,7494,412,5162,9050,179,3392,2132,147,0,0,27968,138,16523,14391,9229,7906
2021-02-05 04:00:00+00,7122,439,5161,9340,179,3392,1938,149,0,0,27720,134,16618,14680,9519,7561
2021-02-05 04:30:00+00,7166,501,5162,9401,179,3392,1849,151,0,0,27801,136,16591,14742,9580,7667
2021-02-05 05:00:00+00,7062,574,5161,9576,195,3392,1923,152,0,0,28035,136,16855,14932,9771,7636
2021-02-05 05:30:00+00,7853,656,5159,9282,199,3392,1938,152,0,0,28631,147,16578,14640,9481,8509
2021-02-05 06:00:00+00,8954,973,5159,9189,228,3516,2341,149,0,0,30509,163,16917,14576,9417,9927
2021-02-05 06:30:00+00,10118,1434,5156,9256,247,3506,2770,148,0,0,32635,181,17429,14659,9503,11552
2021-02-05 07:00:00+00,12556,1536,5156,9187,247,3110,3029,152,0,0,34973,200,17619,14590,9434,14092
2021-02-05 07:30:00+00,13938,1539,5157,9282,262,3098,3041,149,7,0,36473,207,17749,14708,9551,15477
2021-02-05 08:00:00+00,15182,1545,5154,9405,228,3641,3031,197,217,0,38600,210,18035,15004,9850,16727
2021-02-05 08:30:00+00,15847,1547,5155,9518,211,3670,3018,295,738,0,39999,210,18640,15622,10467,17394
2021-02-05 09:00:00+00,16173,1546,5153,9578,253,3726,3004,255,1336,0,41023,207,19324,16320,11167,17719
2021-02-05 09:30:00+00,15853,1601,5154,9440,266,3729,3015,160,2011,0,41229,204,19886,16871,11717,17454
2021-02-05 10:00:00+00,16070,1604,5168,9255,234,3491,3020,161,2714,16,41734,203,20391,17371,12203,17674
2021-02-05 10:30:00+00,16188,1604,5157,9042,241,3499,3037,154,3042,0,41964,203,20519,17482,12325,17792
2021-02-05 11:00:00+00,15917,1598,5154,8941,255,3753,3035,151,3116,0,41921,201,20501,17466,12312,17515
2021-02-05 11:30:00+00,15708,1557,5156,8882,255,3762,3024,152,2986,0,41482,200,20303,17279,12123,17265
2021-02-05 12:00:00+00,16088,1562,5162,8803,244,3746,3026,160,3067,0,41858,202,20302,17276,12114,17650
2021-02-05 12:30:00+00,16275,1522,5164,8656,243,3749,3017,211,3328,20,42185,202,20408,17391,12227,17797
2021-02-05 13:00:00+00,16489,1429,5160,8399,219,3076,2995,161,3328,30,41285,204,20101,17106,11946,17918
2021-02-05 13:30:00+00,16567,1303,5160,8088,206,3742,2994,157,2985,0,41202,204,19433,16439,11279,17870
2021-02-05 14:00:00+00,16768,1183,5151,7881,171,3768,3002,166,2102,0,40191,208,18307,15305,10154,17951
2021-02-05 14:30:00+00,16930,1164,5152,7829,168,3772,3054,158,1551,36,39814,211,17754,14700,9548,18094
2021-02-05 15:00:00+00,17308,1248,5154,7845,168,3826,3078,155,1221,0,40003,216,17466,14388,9234,18556
2021-02-05 15:30:00+00,17727,1241,5155,7812,167,3832,3100,152,682,0,39868,221,16916,13816,8661,18968
2021-02-05 16:00:00+00,17976,1444,5156,7817,310,3946,3103,279,218,0,40248,227,16604,13501,8345,19420
2021-02-05 16:30:00+00,18708,1547,5154,7725,331,3958,3116,349,22,288,41198,232,16348,13232,8078,20255
2021-02-05 17:00:00+00,19473,1500,5153,7676,401,4009,3107,468,0,966,42752,230,16337,13230,8077,20973
2021-02-05 17:30:00+00,20135,1518,5154,7676,576,4012,3107,493,0,1262,43933,231,16513,13406,8252,21653
2021-02-05 18:00:00+00,20117,1488,5153,7590,473,4016,3107,482,0,1364,43790,230,16323,13216,8063,21605
2021-02-05 18:30:00+00,19839,1481,5153,7663,358,4014,3105,333,0,1084,43030,231,16279,13174,8021,21320
2021-02-05 19:00:00+00,19742,1482,5155,7731,385,3994,3001,253,0,142,41885,235,16272,13271,8116,21224
2021-02-05 19:30:00+00,18726,1481,5155,8104,420,3994,2649,189,0,0,40718,231,16328,13679,8524,20207
2021-02-05 20:00:00+00,17716,1486,5158,8165,284,4014,2470,175,0,0,39468,227,16077,13607,8449,19202
2021-02-05 20:30:00+00,16197,1444,5151,8216,282,4012,2475,166,0,26,37969,220,16124,13649,8498,17641
2021-02-05 21:00:00+00,14794,1362,5156,8343,281,3882,2475,151,0,2,36446,211,16255,13780,8624,16156
2021-02-05 21:30:00+00,13588,1121,5152,8172,279,3884,2478,156,0,0,34830,201,16081,13603,8451,14709
2021-02-05 22:00:00+00,12315,848,5153,8039,235,3992,2414,153,0,0,33149,188,15841,13427,8274,13163
2021-02-05 22:30:00+00,11586,412,5153,8095,273,3994,2006,152,0,0,31671,173,15527,13521,8368,11998
2021-02-05 23:00:00+00,10810,413,5155,8076,247,3508,1367,153,0,190,29919,169,14845,13478,8323,11223
2021-02-05 23:30:00+00,10156,416,5158,8363,231,3502,1037,152,0,0,29015,165,14789,13752,8594,10572
2021-02-06 00:00:00+00,9522,415,5156,8697,218,3602,1035,160,0,0,28805,155,15106,14071,8915,9937
2021-02-06 00:30:00+00,9646,416,5155,8785,201,3596,1039,179,0,0,29017,156,15180,14141,8986,10062
2021-02-06 01:00:00+00,9727,417,5159,8680,197,3216,1037,192,0,0,28625,159,15073,14036,8877,10144
2021-02-06 01:30:00+00,8772,416,5158,9068,194,3236,1039,154,0,0,28037,148,15459,14420,9262,9188
2021-02-06 02:00:00+00,7758,417,5157,9278,192,3262,1036,162,0,0,27262,139,15663,14627,9470,8175
2021-02-06 02:30:00+00,7346,416,5155,9364,192,3210,1039,162,0,0,26884,134,15750,14711,9556,7762
2021-02-06 03:00:00+00,7346,417,5153,9293,193,3020,1038,153,0,0,26613,135,15677,14639,9486,7763
2021-02-06 03:30:00+00,6889,417,5155,9461,192,3018,1038,154,0,0,26324,129,15846,14808,9653,7306
2021-02-06 04:00:00+00,6191,417,5153,9693,209,3016,1042,155,0,0,25876,121,16097,15055,9902,6608
2021-02-06 04:30:00+00,6136,417,5155,9705,209,3016,1043,158,0,0,25839,120,16112,15069,9914,6553
2021-02-06 05:00:00+00,5943,463,5157,10047,226,3016,1055,148,0,0,26055,118,16485,15430,10273,6406
2021-02-06 05:30:00+00,6180,500,5153,10067,226,3018,1059,152,0,0,26355,121,16505,15446,10293,6680
2021-02-06 06:00:00+00,7440,577,5152,10033,241,3020,1059,159,0,0,27681,136,16485,15426,10274,8017
2021-02-06 06:30:00+00,7806,658,5154,10161,244,3026,1060,163,0,0,28272,142,16619,15559,10405,8464
2021-02-06 07:00:00+00,8521,682,5153,10263,262,3212,1059,279,0,26,29457,148,16737,15678,10525,9203
2021-02-06 07:30:00+00,9027,683,5152,10434,262,3258,1060,280,8,0,30164,152,16916,15856,10704,9710
2021-02-06 08:00:00+00,9672,681,5150,10611,259,3504,1061,279,150,0,31367,156,17231,16170,11020,10353
2021-02-06 08:30:00+00,11226,684,5152,10201,253,3524,1059,233,465,24,32821,167,17130,16071,10919,11910
2021-02-06 09:00:00+00,12345,683,5163,10041,251,3638,1042,222,814,0,34199,172,17311,16269,11106,13028
2021-02-06 09:30:00+00,12578,682,5162,10175,251,3638,1045,317,1367,0,35215,171,18000,16955,11793,13260
2021-02-06 10:00:00+00,12795,682,5163,10463,259,3562,1058,353,1461,204,36000,169,18404,17346,12183,13477
2021-02-06 10:30:00+00,12789,685,5153,10768,258,3544,1057,396,1625,0,36275,168,18861,17804,12651,13474
2021-02-06 11:00:00+00,12296,684,5153,10883,242,3679,1057,399,1860,244,36497,161,19195,18138,12985,12980
2021-02-06 11:30:00+00,12248,684,5150,11265,240,3682,1056,291,2171,402,37189,157,19882,18826,13676,12932
2021-02-06 12:00:00+00,12152,684,5151,11781,243,3796,1047,277,2803,770,38703,150,21025,19978,14827,12836
2021-02-06 12:30:00+00,12593,684,5153,12038,255,3801,1053,248,2787,258,38870,153,21286,20234,15080,13277
2021-02-06 13:00:00+00,12104,684,5150,12316,238,3968,1054,198,2305,0,38016,152,21063,20009,14859,12788
2021-02-06 13:30:00+00,11900,685,5151,12558,238,3975,1055,161,2159,10,37892,150,21161,20106,14955,12585
2021-02-06 14:00:00+00,11683,685,5150,12940,202,3884,1053,156,1997,0,37750,148,21342,20289,15139,12368
2021-02-06 14:30:00+00,11174,685,5152,13238,204,3885,1054,172,1229,4,36797,146,20877,19823,14671,11859
2021-02-06 15:00:00+00,11308,685,5149,13501,215,3864,1068,156,712,160,36819,148,20645,19577,14428,11993
2021-02-06 15:30:00+00,11739,685,5151,13780,215,3868,1074,155,415,0,37082,151,20635,19561,14410,12424
2021-02-06 16:00:00+00,12771,685,5150,14012,335,3521,1084,157,189,0,37904,158,20770,19686,14536,13456
2021-02-06 16:30:00+00,13720,683,5150,14194,340,3512,1099,208,25,102,39033,164,20808,19709,14559,14403
2021-02-06 17:00:00+00,14447,684,5153,14386,346,4033,1108,377,0,924,41458,164,20993,19885,14732,15131
2021-02-06 17:30:00+00,14754,684,5151,14703,346,4042,1113,431,0,1546,42770,162,21313,20200,15049,15438
2021-02-06 18:00:00+00,14706,691,5155,14831,346,4038,1116,433,0,944,42260,163,21448,20332,15177,15397
2021-02-06 18:30:00+00,14436,686,5157,15033,346,4033,1116,254,0,812,41873,161,21652,20536,15379,15122
2021-02-06 19:00:00+00,13413,685,5156,15420,320,4028,1118,154,0,0,40294,156,22014,20896,15740,14098
2021-02-06 19:30:00+00,11847,657,5156,15643,306,4024,1118,154,0,0,38904,145,22223,21105,15949,12504
2021-02-06 20:00:00+00,10548,570,5150,15659,230,4037,1117,162,0,18,37491,135,22156,21039,15889,11118
2021-02-06 20:30:00+00,9285,555,5152,15460,211,4108,1118,154,0,58,36101,127,21941,20823,15671,9840
2021-02-06 21:00:00+00,8527,618,5150,15457,203,3438,1118,151,0,48,34710,123,21928,20810,15660,9145
2021-02-06 21:30:00+00,7539,583,5151,15470,192,3398,1119,150,0,0,33602,114,21932,20813,15662,8122
2021-02-06 22:00:00+00,6455,545,5150,15553,146,3092,1115,152,0,0,32208,105,21964,20849,15699,7000
2021-02-06 22:30:00+00,5121,542,5151,15693,163,3064,1115,150,0,0,30999,92,22122,21007,15856,5663
2021-02-06 23:00:00+00,5054,698,5147,15615,163,1484,1107,159,0,58,29485,99,22032,20925,15778,5752
2021-02-06 23:30:00+00,4392,720,5149,15615,163,1418,1110,150,0,0,28717,93,22037,20927,15778,5112
2021-02-07 00:00:00+00,4138,720,5147,15462,163,1446,1103,150,0,0,28329,90,21875,20772,15625,4858
2021-02-07 00:30:00+00,4743,719,5148,15417,163,1450,1091,154,0,0,28885,97,21819,20728,15580,5462
2021-02-07 01:00:00+00,4676,715,5142,15508,162,1636,1086,154,0,0,29079,95,21898,20812,15670,5391
2021-02-07 01:30:00+00,4294,718,5145,15472,162,1646,1087,151,0,0,28675,91,21866,20779,15634,5012
2021-02-07 02:00:00+00,3600,695,5150,15613,162,1644,1087,155,0,0,28106,83,22012,20925,15775,4295
2021-02-07 02:30:00+00,3583,687,5160,15705,162,1640,1075,151,0,0,28163,82,22102,21027,15867,4270
2021-02-07 03:00:00+00,3628,720,5158,15569,162,1658,995,162,0,0,28052,84,21884,20889,15731,4348
2021-02-07 03:30:00+00,3275,679,5161,15594,162,1644,1027,150,0,0,27692,79,21944,20917,15756,3954
2021-02-07 04:00:00+00,3184,675,5158,15579,162,1220,1117,157,0,0,27252,79,22016,20899,15741,3859
2021-02-07 04:30:00+00,3139,563,5158,15539,164,1190,1170,153,0,0,27076,75,22031,20861,15703,3702
2021-02-07 05:00:00+00,3290,689,5160,15598,178,1158,1217,150,0,0,27440,80,22153,20936,15776,3979
2021-02-07 05:30:00+00,3251,685,5159,15673,178,1158,1249,154,0,0,27507,79,22259,21010,15851,3936
2021-02-07 06:00:00+00,3380,622,5157,15601,192,1282,1423,155,0,0,27812,79,22373,20950,15793,4002
2021-02-07 06:30:00+00,3686,601,5156,15600,195,1414,1531,157,0,0,28340,84,22482,20951,15795,4287
2021-02-07 07:00:00+00,3831,632,5156,15548,213,1802,1451,166,0,0,28799,85,22368,20917,15761,4463
2021-02-07 07:30:00+00,4328,413,5156,15508,213,1898,1427,164,2,0,29109,85,22306,20879,15723,4741
2021-02-07 08:00:00+00,4217,413,5156,15491,213,2792,1416,154,60,0,29912,84,22336,20920,15764,4630
2021-02-07 08:30:00+00,5225,409,5156,15487,214,2974,1494,158,201,22,31340,96,22552,21058,15902,5634
2021-02-07 09:00:00+00,6190,404,5155,15495,220,3746,1554,153,424,0,33341,104,22848,21294,16139,6594
2021-02-07 09:30:00+00,7375,322,5155,15395,233,3810,1735,159,639,30,34853,113,23157,21422,16267,7697
2021-02-07 10:00:00+00,8340,315,5149,15398,252,3826,1751,155,1008,0,36194,119,23558,21807,16658,8655
2021-02-07 10:30:00+00,8777,313,5149,15796,266,3846,1739,273,1393,0,37552,121,24343,22604,17455,9090
2021-02-07 11:00:00+00,9237,314,5147,16056,253,3954,1748,247,1510,0,38466,120,24714,22966,17819,9551
2021-02-07 11:30:00+00,10012,315,5146,16112,245,4074,1748,172,1876,0,39700,125,25127,23379,18233,10327
2021-02-07 12:00:00+00,10637,315,5143,16111,225,4274,1740,172,1828,60,40505,130,25047,23307,18164,10952
2021-02-07 12:30:00+00,11108,315,5146,16150,246,4284,1626,271,1704,50,40900,134,24872,23246,18100,11423
2021-02-07 13:00:00+00,11185,316,5147,16267,262,4238,1631,320,1555,56,40977,135,24862,23231,18084,11501
2021-02-07 13:30:00+00,11134,317,5145,16103,262,4260,1703,252,1339,82,40597,136,24552,22849,17704,11451
2021-02-07 14:00:00+00,11150,317,5143,15943,250,4746,1640,174,998,0,40361,135,23974,22334,17191,11467
2021-02-07 14:30:00+00,11497,317,5143,15884,261,4706,1531,158,737,30,40264,138,23556,22025,16882,11814
2021-02-07 15:00:00+00,11847,339,5146,15845,277,4672,1625,155,479,164,40549,140,23372,21747,16601,12186
2021-02-07 15:30:00+00,12655,413,5146,15585,284,4630,1631,160,315,276,41095,148,22961,21330,16184,13068
2021-02-07 16:00:00+00,13877,415,5148,15378,358,4728,1585,154,127,378,42148,156,22596,21011,15863,14292
2021-02-07 16:30:00+00,14177,415,5150,15384,359,4870,1726,262,15,698,43056,158,22634,20908,15758,14592
2021-02-07 17:00:00+00,15277,410,5147,15287,365,4896,1753,454,0,876,44465,165,22552,20799,15652,15687
2021-02-07 17:30:00+00,15809,315,5150,15273,365,4890,1756,514,0,1010,45082,166,22544,20788,15638,16124
2021-02-07 18:00:00+00,15576,313,5150,15338,351,4524,1764,295,0,952,44263,164,22603,20839,15689,15889
2021-02-07 18:30:00+00,15016,315,5150,15270,334,4336,1763,184,0,960,43328,159,22517,20754,15604,15331
2021-02-07 19:00:00+00,14247,315,5152,15394,282,4446,1718,155,0,252,41961,159,22546,20828,15676,14562
2021-02-07 19:30:00+00,12557,314,5151,15498,270,4350,1711,152,0,48,40051,148,22630,20919,15768,12871
2021-02-07 20:00:00+00,11105,321,5148,15463,213,4566,1759,153,0,200,38928,138,22583,20824,15676,11426
2021-02-07 20:30:00+00,9883,403,5148,15410,206,4636,1760,150,0,44,37640,133,22524,20764,15616,10286
2021-02-07 21:00:00+00,8470,415,5148,15312,180,4444,1764,148,0,298,36179,125,22404,20640,15492,8885
2021-02-07 21:30:00+00,7039,413,5145,15243,166,4460,1689,159,0,134,34448,115,22243,20554,15409,7452
2021-02-07 22:00:00+00,6400,414,5144,15120,118,3940,1560,150,0,42,32888,110,21942,20382,15238,6814
2021-02-07 22:30:00+00,5276,414,5146,15084,111,3708,1387,153,0,0,31279,98,21728,20341,15195,5690
2021-02-07 23:00:00+00,4313,415,5146,15047,110,2926,1506,150,0,0,29613,90,21809,20303,15157,4728
2021-02-07 23:30:00+00,3798,389,5144,14843,110,3046,1480,152,0,0,28962,87,21577,20097,14953,4187
2021-02-08 00:00:00+00,4017,408,5144,14568,110,2910,1488,148,0,0,28793,92,21310,19822,14678,4425
2021-02-08 00:30:00+00,3795,412,5143,14452,113,2990,1719,176,0,0,28800,92,21427,19708,14565,4207
2021-02-08 01:00:00+00,3348,410,5143,14483,170,2968,1831,325,0,64,28742,89,21627,19796,14653,3758
2021-02-08 01:30:00+00,3279,409,5142,14276,183,2936,1761,343,0,0,28329,89,21362,19601,14459,3688
2021-02-08 02:00:00+00,3314,411,5146,14127,269,2896,1747,337,0,0,28247,90,21289,19542,14396,3725
2021-02-08 02:30:00+00,3569,414,5147,13899,269,2876,1752,340,0,0,28266,93,21067,19315,14168,3983
2021-02-08 03:00:00+00,3923,414,5149,13830,303,2756,1764,340,0,0,28479,97,21046,19282,14133,4337
2021-02-08 03:30:00+00,4132,393,5152,13662,232,2856,1813,331,0,0,28571,100,20859,19046,13894,4525
2021-02-08 04:00:00+00,3981,383,5152,13711,151,3118,1838,240,0,0,28574,98,20852,19014,13862,4364
2021-02-08 04:30:00+00,4244,298,5153,13675,109,3212,1776,149,0,0,28616,98,20713,18937,13784,4542
2021-02-08 05:00:00+00,4273,275,5152,13768,109,3086,1720,162,0,0,28545,96,20749,19029,13877,4548
2021-02-08 05:30:00+00,5378,290,5154,13647,124,3050,1864,150,0,0,29657,107,20789,18925,13771,5668
2021-02-08 06:00:00+00,6807,353,5151,13618,137,3478,1994,158,0,92,31788,122,20900,18906,13755,7160
2021-02-08 06:30:00+00,8743,413,5152,13656,142,3416,2171,147,0,0,33840,138,21121,18950,13798,9156
2021-02-08 07:00:00+00,13025,414,5152,13639,162,2134,2403,153,0,134,37216,170,21356,18953,13801,13439
2021-02-08 07:30:00+00,15454,414,5152,13360,163,2166,2370,152,4,0,39235,186,21049,18679,13527,15868
2021-02-08 08:00:00+00,16097,415,5150,13504,214,3330,2459,182,124,4,41479,184,21451,18992,13842,16512
2021-02-08 08:30:00+00,17490,414,5146,13682,243,3370,2525,181,432,280,43763,187,22028,19503,14357,17904
2021-02-08 09:00:00+00,17628,415,5143,14003,264,4090,2516,180,857,0,45096,183,22783,20267,15124,18043
2021-02-08 09:30:00+00,17837,415,5143,13959,264,4118,2513,157,1383,14,45803,182,23262,20749,15606,18252
2021-02-08 10:00:00+00,18383,413,5142,13986,242,3726,2513,158,1626,0,46189,184,23509,20996,15854,18796
2021-02-08 10:30:00+00,18091,414,5143,14348,235,3828,2495,153,1983,0,46690,181,24204,21709,16566,18505
2021-02-08 11:00:00+00,17861,413,5144,14558,223,3810,2496,151,2206,0,46862,179,24627,22131,16987,18274
2021-02-08 11:30:00+00,17714,412,5143,14655,236,3980,2498,156,2170,12,46976,179,24702,22204,17061,18126
2021-02-08 12:00:00+00,17675,415,5141,14968,218,4542,2504,151,2045,0,47659,179,24876,22372,17231,18090
2021-02-08 12:30:00+00,17722,414,5151,15024,219,4436,2504,151,1922,0,47543,179,24820,22316,17165,18136
2021-02-08 13:00:00+00,18030,412,5153,15056,200,3610,2501,212,1951,284,47409,178,24861,22360,17207,18442
2021-02-08 13:30:00+00,18031,391,5141,14875,203,3506,2498,254,1928,30,46857,179,24645,22147,17006,18422
2021-02-08 14:00:00+00,18230,416,5141,14872,212,3132,2499,240,1664,48,46454,180,24388,21889,16748,18646
2021-02-08 14:30:00+00,18221,482,5088,14934,216,3132,2502,224,1395,0,46194,183,24135,21633,16545,18703
2021-02-08 15:00:00+00,18488,665,5077,14715,227,2848,2490,296,924,172,45902,191,23433,20943,15866,19153
2021-02-08 15:30:00+00,18656,929,5080,14310,227,2810,2484,364,601,292,45753,199,22702,20218,15138,19585
2021-02-08 16:00:00+00,19176,1188,5082,14171,316,2762,2503,434,270,6,45908,208,22342,19839,14757,20364
2021-02-08 16:30:00+00,18915,1356,5094,13917,340,2840,2508,470,37,832,46309,208,21896,19388,14294,20271
2021-02-08 17:00:00+00,18832,1408,5140,13646,422,3690,2504,490,0,984,47116,205,21712,19208,14068,20240
2021-02-08 17:30:00+00,19908,1412,5143,13235,423,3594,2504,527,0,1504,48250,208,21305,18801,13658,21320
2021-02-08 18:00:00+00,20007,1415,5148,13037,389,4112,2506,454,0,1328,48396,209,21080,18574,13426,21422
2021-02-08 18:30:00+00,19775,1347,5148,12887,389,4042,2499,375,0,874,47336,209,20923,18424,13276,21122
2021-02-08 19:00:00+00,19528,1390,5146,12712,385,3928,2501,267,0,414,46271,212,20744,18243,13097,20918
2021-02-08 19:30:00+00,18981,1204,5147,12599,369,3878,2500,166,0,0,44844,209,20615,18115,12968,20185
2021-02-08 20:00:00+00,18164,874,5148,12429,206,4150,2500,151,0,24,43646,202,20283,17783,12635,19038
2021-02-08 20:30:00+00,16354,729,5147,12355,187,4192,2494,162,0,26,41646,192,20183,17689,12542,17083
2021-02-08 21:00:00+00,14727,523,5160,12099,117,4596,2500,155,0,178,40055,181,19876,17376,12216,15250
2021-02-08 21:30:00+00,13697,413,5153,11884,111,4612,2489,149,0,22,38530,175,19637,17148,11995,14110
2021-02-08 22:00:00+00,12802,408,5147,11720,77,3418,2484,150,0,12,36218,172,19428,16944,11797,13210
2021-02-08 22:30:00+00,11114,413,5145,11630,76,3462,2416,159,0,12,34427,163,19267,16851,11706,11527
2021-02-08 23:00:00+00,9023,414,5143,11350,77,4542,2244,153,0,0,32946,152,18814,16570,11427,9437
2021-02-08 23:30:00+00,8334,416,5144,10799,77,4624,2247,153,0,0,31794,150,18267,16020,10876,8750
2021-02-09 00:00:00+00,8345,415,5143,10660,77,4640,2252,155,0,0,31687,152,18132,15880,10737,8760
2021-02-09 00:30:00+00,8840,395,5142,10499,77,4718,2257,205,0,0,32133,157,17975,15718,10576,9235
2021-02-09 01:00:00+00,8839,410,5145,10306,78,5180,2254,154,0,0,32366,160,17783,15529,10384,9249
2021-02-09 01:30:00+00,8687,412,5143,10108,78,5252,2254,150,0,0,32084,160,17583,15329,10186,9099
2021-02-09 02:00:00+00,8905,413,5142,9803,78,5269,2251,157,0,0,32017,164,17274,15023,9881,9318
2021-02-09 02:30:00+00,9162,414,5139,9668,78,5264,2258,159,0,0,32142,167,17143,14885,9746,9576
2021-02-09 03:00:00+00,9445,414,5143,9407,78,5215,2302,149,0,0,32153,170,16930,14628,9485,9859
2021-02-09 03:30:00+00,9643,414,5143,9406,78,5203,2409,151,0,0,32447,171,17036,14627,9484,10057
2021-02-09 04:00:00+00,10105,415,5146,9479,78,4518,2466,148,0,0,32356,175,17169,14703,9557,10520
2021-02-09 04:30:00+00,10616,415,5147,9549,78,4475,2437,158,0,0,32874,178,17211,14774,9627,11031
2021-02-09 05:00:00+00,11578,472,5149,9452,79,4281,2486,154,0,0,33650,186,17166,14680,9531,12050
2021-02-09 05:30:00+00,12691,521,5148,9541,92,4261,2469,151,0,0,34873,193,17250,14781,9633,13212
2021-02-09 06:00:00+00,14219,649,5149,9521,111,4029,2403,161,0,28,36270,203,17184,14781,9632,14868
2021-02-09 06:30:00+00,15589,959,5150,9482,113,3972,2352,150,0,0,37767,216,17097,14745,9595,16548
2021-02-09 07:00:00+00,16843,1241,5147,9436,136,2958,2360,158,0,26,38304,227,17079,14719,9572,18084
2021-02-09 07:30:00+00,17653,1487,5146,9308,143,2862,2483,166,14,396,39658,232,17094,14611,9465,19140
2021-02-09 08:00:00+00,18269,1741,5146,9436,158,4217,2494,158,236,90,41945,236,17470,14976,9830,20010
2021-02-09 08:30:00+00,18741,1929,5144,9563,167,4292,2504,159,652,248,43400,237,18030,15526,10382,20670
2021-02-09 09:00:00+00,19159,2157,5143,9645,196,4361,2503,160,1242,24,44590,240,18729,16226,11083,21316
2021-02-09 09:30:00+00,19459,2270,5143,9706,201,4321,2418,159,1756,0,45434,240,19224,16806,11663,21729
2021-02-09 10:00:00+00,19734,2272,5142,9943,205,3929,2334,162,2454,6,46181,235,20078,17744,12602,22006
2021-02-09 10:30:00+00,19966,2293,5141,9870,205,3964,2472,157,2767,14,46849,235,20455,17983,12842,22259
2021-02-09 11:00:00+00,20253,2307,5141,9851,176,3717,2502,160,2622,56,46785,240,20292,17790,12649,22560
2021-02-09 11:30:00+00,20450,2307,5140,9773,177,3798,2487,271,2349,22,46774,243,19926,17439,12299,22757
2021-02-09 12:00:00+00,20675,2306,5141,9401,179,3396,2503,431,2636,754,47422,241,19860,17357,12216,22981
2021-02-09 12:30:00+00,20911,2308,5141,9183,182,3264,2497,469,2506,658,47119,244,19509,17012,11871,23219
2021-02-09 13:00:00+00,21396,2302,5143,9113,155,2498,2483,477,2283,764,46614,247,19177,16694,11551,23698
2021-02-09 13:30:00+00,21485,2304,5143,9318,162,2290,2479,457,2209,414,46261,248,19311,16832,11689,23789
2021-02-09 14:00:00+00,21127,2224,5142,9355,162,3020,2285,332,1978,680,46305,245,18922,16637,11495,23351
2021-02-09 14:30:00+00,21141,2181,5146,9727,176,3002,2101,333,1682,386,45875,246,18832,16731,11585,23322
2021-02-09 15:00:00+00,21616,2044,5143,9957,190,2766,2027,378,1450,190,45761,246,18767,16740,11597,23660
2021-02-09 15:30:00+00,21889,2043,5142,9933,191,2808,2009,423,987,350,45775,248,18262,16253,11111,23932
2021-02-09 16:00:00+00,21946,2026,5145,10112,308,2806,2115,423,413,214,45508,251,18093,15978,10833,23972
2021-02-09 16:30:00+00,22046,2044,5143,10237,311,2832,2036,474,73,782,45978,249,17800,15764,10621,24090
2021-02-09 17:00:00+00,21460,1919,5148,10617,340,4230,2001,491,0,1156,47362,239,18106,16105,10957,23379
2021-02-09 17:30:00+00,21897,1865,5147,10933,340,4154,2017,562,0,1170,48085,238,18437,16420,11273,23762
2021-02-09 18:00:00+00,22029,1912,5143,10856,336,3642,2121,492,0,1254,47785,240,18456,16335,11192,23941
2021-02-09 18:30:00+00,21663,1918,5142,10854,303,3622,2193,416,0,1352,47463,238,18492,16299,11157,23581
2021-02-09 19:00:00+00,21468,2093,5143,10986,364,3442,2408,341,0,436,46681,240,18901,16493,11350,23561
2021-02-09 19:30:00+00,20249,2202,5142,11103,273,3422,2487,173,0,0,45051,239,19005,16518,11376,22451
2021-02-09 20:00:00+00,18914,2211,5141,10817,129,3518,2489,165,0,262,43646,234,18576,16087,10946,21125
2021-02-09 20:30:00+00,17419,2214,5143,10773,122,3534,2494,178,0,44,41921,230,18532,16038,10895,19633
2021-02-09 21:00:00+00,16138,1943,5147,10711,97,3712,2491,170,0,0,40409,221,18446,15955,10808,18081
2021-02-09 21:30:00+00,14324,1671,5160,10837,95,3798,2490,156,0,0,38531,207,18582,16092,10932,15995
2021-02-09 22:00:00+00,12478,1677,5144,10689,80,3754,2491,161,0,0,36474,200,18404,15913,10769,14155
2021-02-09 22:30:00+00,11183,1609,5143,10659,91,3726,2489,150,0,0,35050,191,18382,15893,10750,12792
2021-02-09 23:00:00+00,8964,1474,5141,10566,97,4210,2402,154,0,0,33008,177,18206,15804,10663,10438
2021-02-09 23:30:00+00,8356,1474,5141,10459,97,4132,2405,167,0,0,32231,173,18102,15697,10556,9830
2021-02-10 00:00:00+00,8935,1451,5141,10269,97,3514,2446,179,0,0,32032,179,17953,15507,10366,10386
2021-02-10 00:30:00+00,9519,1469,5140,9868,97,3500,2450,158,0,0,32201,186,17555,15105,9965,10988
2021-02-10 01:00:00+00,9701,1429,5138,9517,97,4180,2440,162,0,0,32664,186,17192,14752,9614,11130
2021-02-10 01:30:00+00,9562,1472,5139,9479,96,4257,2445,150,0,0,32600,187,17159,14714,9575,11034
2021-02-10 02:00:00+00,9006,1474,5139,9600,96,4355,2443,155,0,0,32267,184,17278,14835,9696,10480
2021-02-10 02:30:00+00,8916,1478,5137,9341,96,4297,2421,159,0,0,31845,185,16995,14574,9437,10394
2021-02-10 03:00:00+00,9295,1475,5138,9201,96,3896,2415,153,0,0,31669,190,16850,14435,9297,10770
2021-02-10 03:30:00+00,9264,1467,5139,9110,96,3741,2427,149,0,0,31394,190,16772,14345,9206,10731
2021-02-10 04:00:00+00,9457,1473,5136,9231,96,3066,2425,151,0,0,31034,191,16888,14463,9327,10930
2021-02-10 04:30:00+00,9502,1478,5140,9452,100,2946,2394,149,0,0,31161,190,17086,14692,9552,10980
2021-02-10 05:00:00+00,10475,1508,5140,9447,119,2528,2417,150,0,0,31785,200,17123,14706,9566,11983
2021-02-10 05:30:00+00,11306,1655,5142,9259,136,2548,2499,152,0,0,32697,210,17036,14537,9395,12961
2021-02-10 06:00:00+00,14903,2273,5140,8980,152,1938,2540,129,0,0,36055,240,16812,14272,9132,17176
2021-02-10 06:30:00+00,16510,2741,5144,8857,152,1811,2784,128,0,0,38127,254,16937,14153,9009,19251
2021-02-10 07:00:00+00,18729,2593,5139,8694,175,2336,2848,151,0,280,40945,258,16856,14008,8869,21322
2021-02-10 07:30:00+00,20182,2849,5142,8521,167,2324,2854,316,32,440,42827,267,16716,13862,8720,23031
2021-02-10 08:00:00+00,20598,2947,5142,8157,146,2895,2882,278,366,390,43801,268,16693,13811,8669,23545
2021-02-10 08:30:00+00,21310,3015,5144,7874,156,2987,2884,344,960,582,45256,268,17018,14134,8990,24325
2021-02-10 09:00:00+00,21322,3127,5140,7495,205,4081,2897,389,1818,466,46940,264,17555,14658,9518,24449
2021-02-10 09:30:00+00,21653,3237,5140,6961,290,4075,2906,369,2733,316,47680,266,18030,15124,9984,24890
2021-02-10 10:00:00+00,21946,3238,5136,6616,300,3176,2903,357,3414,322,47408,268,18369,15466,10330,25184
2021-02-10 10:30:00+00,22026,3190,5135,6289,255,3104,2916,409,4054,192,47570,267,18649,15733,10598,25216
2021-02-10 11:00:00+00,21886,3229,5131,6015,271,2796,2903,251,4301,174,46957,270,18621,15718,10587,25115
2021-02-10 11:30:00+00,21836,3225,5133,5715,244,2730,2910,218,4297,394,46702,270,18299,15389,10256,25061
2021-02-10 12:00:00+00,21883,3316,5131,5314,276,3092,2935,432,3530,740,46649,274,17186,14251,9120,25199
2021-02-10 12:30:00+00,22050,3359,5132,4905,203,3108,2946,436,3728,342,46209,279,16914,13968,8836,25409
2021-02-10 13:00:00+00,21779,3345,5133,5015,216,2740,2958,379,3872,618,46055,275,17194,14236,9103,25124
2021-02-10 13:30:00+00,21601,3324,5131,4829,184,2738,2957,338,3761,552,45415,276,16862,13905,8774,24925
2021-02-10 14:00:00+00,20867,3227,5135,5204,154,3428,2863,308,3238,370,44794,275,16594,13731,8596,24094
2021-02-10 14:30:00+00,21187,3230,5136,4803,148,3414,2866,267,2835,660,44546,279,15788,12922,7786,24417
2021-02-10 15:00:00+00,20931,3321,5134,4605,258,4654,2798,214,2383,720,45018,277,15178,12380,7246,24252
2021-02-10 15:30:00+00,20820,3323,5141,4967,298,4704,2870,259,1629,900,44911,277,14905,12035,6894,24143
2021-02-10 16:00:00+00,21238,3189,5134,4781,415,4802,2954,505,682,1130,44830,282,13966,11012,5878,24427
2021-02-10 16:30:00+00,21753,2965,5138,4806,595,4952,2966,560,115,1618,45468,280,13620,10654,5516,24718
2021-02-10 17:00:00+00,22008,3071,5139,4643,788,5128,2996,563,0,1930,46266,282,13566,10570,5431,25079
2021-02-10 17:30:00+00,22228,3350,5141,4992,796,5316,2999,625,0,2108,47555,284,13928,10929,5788,25578
2021-02-10 18:00:00+00,22075,3212,5141,5078,764,5454,2971,603,0,2108,47406,280,13954,10983,5842,25287
2021-02-10 18:30:00+00,22164,2956,5142,5250,664,5258,2971,511,0,2000,46916,276,14027,11056,5914,25120
2021-02-10 19:00:00+00,22556,2907,5142,5253,406,5348,2966,413,0,1338,46329,282,13767,10801,5659,25463
2021-02-10 19:30:00+00,22446,2857,5143,5342,319,5260,2958,314,0,610,45249,286,13762,10804,5661,25303
2021-02-10 20:00:00+00,21737,3025,5141,5525,205,5262,2969,218,0,156,44238,287,13840,10871,5730,24762
2021-02-10 20:30:00+00,19760,3048,5143,5632,201,5240,2970,176,0,350,42520,280,13946,10976,5833,22808
2021-02-10 21:00:00+00,18999,2555,5145,5527,334,5076,2283,163,0,288,40370,274,13289,11006,5861,21554
2021-02-10 21:30:00+00,18005,1983,5143,5307,308,4958,2224,141,0,0,38069,265,12982,10758,5615,19988
2021-02-10 22:00:00+00,16954,1641,5139,5398,134,5056,2214,131,0,0,36667,256,12885,10671,5532,18595
2021-02-10 22:30:00+00,15459,1350,5141,5586,149,5058,2180,154,0,244,35321,241,13056,10876,5735,16809
2021-02-10 23:00:00+00,15216,1131,5140,5702,105,4394,2162,122,0,0,33972,240,13109,10947,5807,16347
2021-02-10 23:30:00+00,14229,1046,5142,6081,103,4418,2129,143,0,0,33291,232,13455,11326,6184,15275
2021-02-11 00:00:00+00,13886,1047,5139,6101,103,4642,2165,124,0,0,33207,230,13508,11343,6204,14933
2021-02-11 00:30:00+00,14352,1044,5136,5960,103,4722,2218,171,0,0,33706,234,13417,11199,6063,15396
2021-02-11 01:00:00+00,13779,1040,5135,5824,85,5284,2254,126,0,0,33527,231,13298,11044,5909,14819
2021-02-11 01:30:00+00,13130,1039,5135,5734,85,5410,2402,122,0,0,33057,229,13356,10954,5819,14169
2021-02-11 02:00:00+00,12874,1044,5132,5598,85,5022,2533,131,0,0,32420,230,13348,10816,5684,13918
2021-02-11 02:30:00+00,13023,1041,5130,5633,85,4966,2493,129,0,0,32500,231,13341,10848,5718,14064
2021-02-11 03:00:00+00,13266,980,5134,5551,84,4246,2738,130,0,0,32129,235,13507,10769,5635,14246
2021-02-11 03:30:00+00,13040,950,5136,5428,83,4242,2776,122,0,0,31777,234,13423,10647,5511,13990
2021-02-11 04:00:00+00,13506,1024,5136,5331,83,3522,2729,136,0,0,31467,241,13279,10550,5414,14530
2021-02-11 04:30:00+00,13783,1187,5138,5174,83,3440,2727,128,0,0,31660,247,13122,10395,5257,14970
2021-02-11 05:00:00+00,15692,1336,5142,5314,88,1686,2726,125,0,0,32109,261,13270,10544,5402,17028
2021-02-11 05:30:00+00,16180,1599,5141,5510,88,1588,2709,128,0,0,32943,267,13448,10739,5598,17779
2021-02-11 06:00:00+00,17998,1931,5145,5553,102,1064,2702,169,0,0,34664,281,13502,10800,5655,19929
2021-02-11 06:30:00+00,19231,2305,5144,5714,106,1064,2701,278,0,0,36543,291,13665,10964,5820,21536
2021-02-11 07:00:00+00,19873,2091,5144,5859,338,2070,2667,171,0,212,38425,280,14008,11341,6197,21964
2021-02-11 07:30:00+00,20398,2229,5145,6062,389,2130,2669,180,53,552,39807,278,14318,11649,6504,22627
2021-02-11 08:00:00+00,20579,2288,5144,6357,400,3736,2668,262,521,600,42555,274,15090,12422,7278,22867
2021-02-11 08:30:00+00,20874,2492,5142,6608,413,3778,2670,270,1261,862,44370,270,16094,13424,8282,23366
2021-02-11 09:00:00+00,21605,2666,5142,6740,339,3536,2670,381,2080,396,45555,273,16971,14301,9159,24271
2021-02-11 09:30:00+00,21495,2742,5139,6892,326,3542,2674,315,2590,274,45989,270,17621,14947,9808,24237
2021-02-11 10:00:00+00,21331,2745,5141,7201,239,3676,2724,227,3218,2,46504,264,18523,15799,10658,24076
2021-02-11 10:30:00+00,21265,2704,5142,7355,237,3656,2711,150,3415,128,46763,261,18860,16149,11007,23969
2021-02-11 11:00:00+00,21314,2739,5140,7501,200,3266,2778,131,3666,78,46813,262,19285,16507,11367,24053
2021-02-11 11:30:00+00,21382,2680,5138,7420,201,3280,2779,163,3860,114,47017,260,19398,16619,11481,24062
2021-02-11 12:00:00+00,21014,2508,5136,7425,190,4374,2776,135,4040,290,47888,251,19567,16791,11655,23522
2021-02-11 12:30:00+00,21085,2489,5136,7436,195,4378,2854,128,4121,86,47908,251,19742,16888,11752,23574
2021-02-11 13:00:00+00,21534,2518,5137,7579,141,3470,2836,128,4176,0,47519,256,19869,17033,11896,24052
2021-02-11 13:30:00+00,21240,2473,5137,7709,139,3446,2801,124,3935,0,47004,255,19721,16920,11783,23713
2021-02-11 14:00:00+00,21368,2712,5140,7745,139,2808,2828,124,3482,0,46346,263,19334,16506,11366,24080
2021-02-11 14:30:00+00,21181,2752,5139,7802,147,2810,2856,125,3058,0,45870,265,19002,16146,11007,23933
2021-02-11 15:00:00+00,21100,2694,5136,7899,171,3166,2829,130,2084,108,45317,266,18119,15290,10154,23794
2021-02-11 15:30:00+00,21281,2847,5136,8062,195,3182,2855,216,1278,100,45152,273,17526,14671,9535,24128
2021-02-11 16:00:00+00,21364,2994,5138,8293,297,2918,2855,451,535,250,45095,276,17118,14263,9125,24358
2021-02-11 16:30:00+00,21635,2924,5134,8471,354,2916,2864,495,135,838,45766,273,16958,14094,8960,24559
2021-02-11 17:00:00+00,21594,2664,5132,8569,447,4058,2868,547,0,1086,46965,265,17016,14148,9016,24258
2021-02-11 17:30:00+00,21918,2802,5134,8761,733,4090,2874,589,0,1230,48131,264,17502,14628,9494,24720
2021-02-11 18:00:00+00,21937,2654,5135,9067,613,4292,2891,548,0,1100,48237,260,17706,14815,9680,24591
2021-02-11 18:30:00+00,21703,2616,5131,9297,379,4308,2864,428,0,1094,47820,259,17671,14807,9676,24319
2021-02-11 19:00:00+00,21616,2639,5136,9497,231,4526,2844,320,0,324,47133,263,17708,14864,9728,24255
2021-02-11 19:30:00+00,20545,2502,5137,9806,229,4540,2890,269,0,0,45918,258,18062,15172,10035,23047
2021-02-11 20:00:00+00,18931,2041,5137,10017,138,4988,2856,123,0,10,44241,243,18148,15292,10155,20972
2021-02-11 20:30:00+00,17158,1630,5137,10223,106,5010,2898,140,0,28,42330,229,18364,15466,10329,18788
2021-02-11 21:00:00+00,15728,1018,5139,10444,86,5312,2774,127,0,60,40688,210,18443,15669,10530,16746
2021-02-11 21:30:00+00,13740,858,5140,10810,78,5408,2857,123,0,28,39042,197,18885,16028,10888,14598
2021-02-11 22:00:00+00,11712,861,5143,10865,78,5328,2835,120,0,42,36984,186,18921,16086,10943,12573
2021-02-11 22:30:00+00,9636,864,5140,11005,78,5330,2815,120,0,0,34988,174,19038,16223,11083,10500
2021-02-11 23:00:00+00,7887,861,5139,11139,76,5024,2870,128,0,0,33124,160,19224,16354,11215,8748
2021-02-11 23:30:00+00,6508,785,5139,11417,78,5024,2872,121,0,0,31944,147,19506,16634,11495,7293
2021-02-12 00:00:00+00,6247,696,5137,11728,78,5024,2874,125,0,0,31909,138,19817,16943,11806,6943
2021-02-12 00:30:00+00,6438,650,5139,12052,78,5022,2868,121,0,0,32368,137,20137,17269,12130,7088
2021-02-12 01:00:00+00,6652,805,5139,12269,77,4924,2871,123,0,0,32860,142,20356,17485,12346,7457
2021-02-12 01:30:00+00,6405,889,5139,12420,77,4908,2873,120,0,0,32831,141,20509,17636,12497,7294
2021-02-12 02:00:00+00,6018,872,5138,12588,77,4580,2878,121,0,0,32272,138,20681,17803,12665,6890
2021-02-12 02:30:00+00,5883,788,5133,12647,77,4564,2879,124,0,0,32095,135,20736,17857,12724,6671
2021-02-12 03:00:00+00,5786,796,5133,12878,77,4164,2868,121,0,0,31823,134,20956,18088,12955,6582
2021-02-12 03:30:00+00,5391,778,5135,13030,77,4152,2866,120,0,0,31549,130,21108,18242,13107,6169
2021-02-12 04:00:00+00,5504,748,5133,13306,76,3634,2874,120,0,0,31395,130,21389,18515,13382,6252
2021-02-12 04:30:00+00,5595,626,5134,13431,76,3632,2741,115,0,0,31350,127,21382,18641,13507,6221
2021-02-12 05:00:00+00,6607,844,5133,13752,99,2467,2628,118,0,0,31648,139,21612,18984,13851,7451
2021-02-12 05:30:00+00,6632,1035,5135,14107,99,1872,2603,112,0,0,31595,144,21944,19341,14206,7667
2021-02-12 06:00:00+00,10016,1247,5132,14475,113,1114,2631,134,0,0,34862,171,22351,19720,14588,11263
2021-02-12 06:30:00+00,12111,1466,5138,14603,119,1106,2572,124,0,0,37239,187,22432,19860,14722,13577
2021-02-12 07:00:00+00,15017,1549,5137,14694,191,1054,2574,136,0,0,40352,203,22596,20022,14885,16566
2021-02-12 07:30:00+00,16201,1517,5142,14904,213,1044,2577,129,52,0,41779,206,22888,20311,15169,17718
2021-02-12 08:00:00+00,17045,1571,5140,15091,269,1388,2643,129,343,0,43619,207,23486,20843,15703,18616
2021-02-12 08:30:00+00,17515,1749,5142,15166,262,1478,2646,130,937,0,45025,209,24153,21507,16365,19264
2021-02-12 09:00:00+00,17176,1583,5138,15245,272,1628,2648,123,1559,0,45372,203,24862,22214,17076,18759
2021-02-12 09:30:00+00,17049,1414,5142,15357,273,1480,2683,124,2334,96,45952,194,25789,23106,17964,18463
2021-02-12 10:00:00+00,16601,1394,5143,15463,265,1946,2768,124,3132,136,46972,188,26771,24003,18860,17995
2021-02-12 10:30:00+00,16157,1429,5136,15508,245,1910,2808,125,3678,138,47134,184,27375,24567,19431,17586
2021-02-12 11:00:00+00,16009,1464,5135,15672,137,2224,2915,125,4163,142,47986,181,28022,25107,19972,17473
2021-02-12 11:30:00+00,15619,1424,5134,15778,135,2294,2927,126,4505,144,48086,177,28479,25552,20418,17043
2021-02-12 12:00:00+00,15594,1417,5137,15835,133,2240,2912,138,4673,144,48223,176,28690,25778,20641,17011
2021-02-12 12:30:00+00,15096,1436,5133,15863,131,2256,2931,158,4477,300,47781,174,28535,25604,20471,16532
2021-02-12 13:00:00+00,14791,1471,5132,15809,127,2250,2932,147,4465,204,47328,174,28465,25533,20401,16262
2021-02-12 13:30:00+00,14643,1450,5132,15784,127,2250,2693,128,4062,30,46299,175,27798,25105,19973,16093
2021-02-12 14:00:00+00,14419,1469,5132,15824,126,2256,2678,132,3673,14,45723,176,27433,24755,19623,15888
2021-02-12 14:30:00+00,14459,1472,5134,15907,127,2256,2660,130,3273,0,45418,177,27101,24441,19307,15931
2021-02-12 15:00:00+00,14366,1464,5133,15927,149,2436,2653,118,2258,0,44504,180,26120,23467,18334,15830
2021-02-12 15:30:00+00,14625,1475,5132,15860,155,2488,2685,131,1542,8,44101,185,25374,22689,17557,16100
2021-02-12 16:00:00+00,15242,1250,5132,15774,201,2164,2867,250,721,60,43661,189,24695,21828,16696,16492
2021-02-12 16:30:00+00,15960,1244,5132,15826,213,2294,2894,312,146,606,44627,192,24211,21317,16185,17204
2021-02-12 17:00:00+00,16341,1201,5133,15832,298,3608,2900,387,1,672,46373,189,24164,21264,16131,17542
2021-02-12 17:30:00+00,17369,1386,5134,15900,298,3664,2911,425,0,930,48017,195,24243,21332,16198,18755
2021-02-12 18:00:00+00,17260,1484,5134,15944,299,3700,2908,392,0,886,48007,195,24285,21377,16243,18744
2021-02-12 18:30:00+00,16768,1448,5135,16108,294,3606,2857,362,0,588,47166,193,24394,21537,16402,18216
2021-02-12 19:00:00+00,16661,1259,5135,16241,218,3264,2497,241,0,448,45964,193,24091,21594,16459,17920
2021-02-12 19:30:00+00,15591,1024,5137,16355,177,3272,2270,142,0,288,44256,184,23939,21669,16532,16615
2021-02-12 20:00:00+00,12917,1031,5136,16412,114,4266,2271,124,0,198,42469,170,23933,21662,16526,13948
2021-02-12 20:30:00+00,10917,1032,5136,16569,108,4424,2270,163,0,288,40907,159,24083,21813,16677,11949
2021-02-12 21:00:00+00,9709,1028,5137,16639,108,4226,2336,157,0,96,39436,153,24220,21884,16747,10737
2021-02-12 21:30:00+00,8086,911,5134,16419,108,4094,2683,149,0,20,37604,140,24344,21661,16527,8997
2021-02-12 22:00:00+00,7182,835,5139,16426,107,3468,2811,139,0,0,36107,134,24483,21672,16533,8017
2021-02-12 22:30:00+00,6035,659,5144,16444,89,3416,2576,120,0,0,34483,121,24253,21677,16533,6694
2021-02-12 23:00:00+00,5910,663,5138,16472,90,1920,2238,132,0,178,32741,121,23938,21700,16562,6573
2021-02-12 23:30:00+00,5288,571,5142,16493,90,1870,2235,112,0,0,31801,114,23960,21725,16583,5859
2021-02-13 00:00:00+00,4954,537,5143,16380,90,2196,2228,112,0,0,31640,109,23841,21613,16470,5491
2021-02-13 00:30:00+00,5122,541,5139,16425,91,2208,2229,124,0,0,31879,111,23884,21655,16516,5663
2021-02-13 01:00:00+00,4865,532,5140,16452,90,2420,2209,114,0,0,31822,107,23891,21682,16542,5397
2021-02-13 01:30:00+00,4330,536,5137,16585,91,2434,2226,115,0,0,31454,102,24039,21813,16676,4866
2021-02-13 02:00:00+00,4494,573,5136,16679,90,2164,2224,116,0,0,31476,105,24129,21905,16769,5067
2021-02-13 02:30:00+00,4341,582,5137,16642,91,2152,2234,127,0,0,31306,104,24104,21870,16733,4923
2021-02-13 03:00:00+00,4457,706,5135,16623,87,1536,2239,124,0,0,30907,108,24084,21845,16710,5163
2021-02-13 03:30:00+00,4377,618,5137,16626,77,1522,2230,119,0,0,30706,105,24070,21840,16703,4995
2021-02-13 04:00:00+00,4718,712,5135,16537,77,1256,2224,117,0,0,30776,109,23973,21749,16614,5430
2021-02-13 04:30:00+00,4796,731,5133,16504,77,1254,2195,126,0,0,30816,110,23909,21714,16581,5527
2021-02-13 05:00:00+00,4500,712,5136,16559,77,1950,2184,122,0,0,31240,108,23956,21772,16636,5212
2021-02-13 05:30:00+00,4673,664,5137,16566,82,1976,2201,117,0,0,31416,109,23986,21785,16648,5337
2021-02-13 06:00:00+00,5246,694,5134,16539,129,1676,2207,117,0,0,31742,115,24009,21802,16668,5940
2021-02-13 06:30:00+00,5961,683,5137,16597,129,1672,2214,118,0,0,32511,120,24077,21863,16726,6644
2021-02-13 07:00:00+00,6513,673,5138,16724,129,1662,2228,119,0,0,33186,125,24219,21991,16853,7186
2021-02-13 07:30:00+00,6915,675,5140,16772,134,1674,2247,129,111,0,33797,128,24404,22157,17017,7590
2021-02-13 08:00:00+00,6981,644,5142,16815,145,2636,2251,122,602,26,35364,125,24955,22704,17562,7625
2021-02-13 08:30:00+00,8049,709,5140,16956,145,2612,2252,121,1197,202,37383,129,25690,23438,18298,8758
2021-02-13 09:00:00+00,7458,713,5141,17148,137,4132,2255,122,1737,154,38997,118,26418,24163,19022,8171
2021-02-13 09:30:00+00,8007,715,5140,17267,157,4134,2253,131,2666,140,40610,118,27483,25230,20090,8722
2021-02-13 10:00:00+00,7945,715,5137,17309,197,4626,2231,126,3165,198,41649,113,28039,25808,20671,8660
2021-02-13 10:30:00+00,7894,716,5129,17371,190,4714,2232,133,3581,56,42016,112,28503,26271,21142,8610
2021-02-13 11:00:00+00,8213,716,5132,17514,181,4332,2234,131,3761,0,42214,115,28822,26588,21456,8929
2021-02-13 11:30:00+00,8331,675,5130,17457,181,4372,2234,135,3999,50,42564,115,29001,26767,21637,9006
2021-02-13 12:00:00+00,8515,674,5129,17314,172,4468,2233,134,3886,378,42903,116,28734,26501,21372,9189
2021-02-13 12:30:00+00,8906,674,5131,17218,172,4492,2232,129,3789,204,42947,120,28542,26310,21179,9580
2021-02-13 13:00:00+00,9106,675,5127,17088,156,4726,2234,130,3359,16,42617,124,27964,25730,20603,9781
2021-02-13 13:30:00+00,9371,675,5128,17033,153,4558,2256,127,2773,0,42074,126,27343,25087,19959,10046
2021-02-13 14:00:00+00,9608,675,5126,17061,135,4456,2258,127,1889,14,41349,130,26469,24211,19085,10283
2021-02-13 14:30:00+00,9942,676,5124,16993,132,4456,2275,130,1397,128,41253,134,25921,23646,18522,10618
2021-02-13 15:00:00+00,10385,745,5127,17089,135,4060,2288,131,1172,376,41508,140,25811,23523,18396,11130
2021-02-13 15:30:00+00,10828,901,5127,16811,142,4196,2292,125,588,474,41484,149,24960,22668,17541,11729
2021-02-13 16:00:00+00,11517,1106,5128,16709,172,4228,2310,127,215,472,41984,159,24534,22224,17096,12623
2021-02-13 16:30:00+00,12375,1159,5122,16715,215,4368,2303,148,31,936,43372,164,24386,22083,16961,13534
2021-02-13 17:00:00+00,13014,1154,5123,16820,301,4588,2301,220,0,1568,45089,164,24545,22244,17121,14168
2021-02-13 17:30:00+00,14225,1146,5122,16753,414,4600,2303,274,0,1742,46579,169,24592,22289,17167,15371
2021-02-13 18:00:00+00,14568,1144,5121,16694,538,4362,2297,318,0,1300,46342,172,24650,22353,17232,15712
2021-02-13 18:30:00+00,13825,1143,5123,16724,303,4846,2283,287,0,1302,45836,168,24433,22150,17027,14968
2021-02-13 19:00:00+00,12442,1146,5125,16776,254,5024,2274,223,0,958,44222,161,24429,22155,17030,13588
2021-02-13 19:30:00+00,11540,1144,5125,16738,235,5090,2274,162,0,284,42592,159,24372,22098,16973,12684
2021-02-13 20:00:00+00,10324,1139,5124,16864,148,4950,2266,133,0,0,40948,152,24402,22136,17012,11463
2021-02-13 20:30:00+00,9115,1005,5123,16693,128,5000,2273,127,0,136,39600,143,24217,21944,16821,10120
2021-02-13 21:00:00+00,8215,873,5127,16591,113,4674,2263,139,0,68,38063,137,24094,21831,16704,9088
2021-02-13 21:30:00+00,6775,914,5127,16645,114,4694,2255,132,0,100,36756,128,24141,21886,16759,7689
2021-02-13 22:00:00+00,5629,950,5128,16803,113,4124,2258,120,0,18,35143,120,24302,22044,16916,6579
2021-02-13 22:30:00+00,4757,772,5128,16603,91,4042,2105,120,0,0,33618,110,23927,21822,16694,5529
2021-02-13 23:00:00+00,4676,821,5133,16528,79,2220,2227,122,0,96,31902,112,23967,21740,16607,5497
2021-02-13 23:30:00+00,3996,763,5131,16390,78,2146,2270,96,0,0,30870,105,23869,21599,16468,4759
2021-02-14 00:00:00+00,3889,776,5129,16210,78,2022,2270,89,0,0,30463,103,23687,21417,16288,4665
2021-02-14 00:30:00+00,4198,835,5129,16373,78,2024,2276,89,0,0,31002,107,23856,21580,16451,5033
2021-02-14 01:00:00+00,4536,901,5127,16432,78,1912,2275,84,0,0,31345,113,23912,21637,16510,5437
2021-02-14 01:30:00+00,4246,845,5121,16386,78,1890,2276,82,0,0,30924,109,23861,21585,16464,5091
2021-02-14 02:00:00+00,4454,852,5128,16252,78,1278,2271,82,0,0,30395,110,23729,21458,16330,5306
2021-02-14 02:30:00+00,4356,900,5130,16132,78,1276,2278,81,0,0,30231,111,23618,21340,16210,5256
2021-02-14 03:00:00+00,4181,937,5127,16259,78,1148,2278,84,0,0,30092,110,23742,21464,16337,5118
2021-02-14 03:30:00+00,3962,774,5126,16160,78,1146,2159,85,0,0,29490,103,23523,21364,16238,4736
2021-02-14 04:00:00+00,4059,809,5127,16192,78,1256,2203,82,0,0,29806,106,23600,21397,16270,4868
2021-02-14 04:30:00+00,3932,812,5127,16249,78,1277,2281,76,0,0,29832,104,23735,21454,16327,4744
2021-02-14 05:00:00+00,4264,842,5126,16261,96,1154,2281,75,0,0,30099,106,23764,21483,16357,5106
2021-02-14 05:30:00+00,4283,848,5124,16254,97,1019,2281,85,0,0,29991,105,23756,21475,16351,5131
2021-02-14 06:00:00+00,4031,771,5122,16215,97,1799,2113,82,0,0,30229,101,23547,21434,16312,4802
2021-02-14 06:30:00+00,4168,835,5126,16201,103,1914,2236,83,0,0,30666,104,23666,21430,16304,5003
2021-02-14 07:00:00+00,4315,821,5128,16204,148,2235,2280,83,0,0,31214,107,23760,21480,16352,5136
2021-02-14 07:30:00+00,4477,809,5128,16314,148,2357,2274,95,25,0,31627,108,23889,21615,16487,5286
2021-02-14 08:00:00+00,4422,822,5129,16335,148,3143,2281,93,124,0,32497,108,24017,21736,16607,5244
2021-02-14 08:30:00+00,5666,1006,5128,16454,149,3275,2299,85,250,0,34311,121,24280,21981,16853,6672
2021-02-14 09:00:00+00,5194,1066,5128,16516,138,4194,2283,79,422,0,35020,117,24487,22204,17076,6260
2021-02-14 09:30:00+00,6067,932,5131,16606,131,4312,2297,95,650,20,36241,119,24815,22518,17387,6999
2021-02-14 10:00:00+00,6555,921,5138,16678,194,4786,2293,83,865,36,37549,121,25168,22875,17737,7476
2021-02-14 10:30:00+00,7443,912,5138,16754,196,4771,2295,85,1045,0,38639,126,25428,23133,17995,8355
2021-02-14 11:00:00+00,7941,941,5137,16836,180,4823,2293,84,1250,0,39486,128,25696,23403,18266,8882
2021-02-14 11:30:00+00,8616,930,5137,16992,182,4944,2286,83,1291,0,40461,132,25888,23602,18465,9546
2021-02-14 12:00:00+00,8935,1017,5133,17146,192,5247,2301,93,1399,4,41467,135,26171,23870,18737,9952
2021-02-14 12:30:00+00,9182,1143,5134,17081,196,5352,2300,133,1049,36,41607,140,25760,23460,18326,10325
2021-02-14 13:00:00+00,9412,1128,5132,17015,203,5433,2298,244,789,0,41654,143,25437,23139,18007,10540
2021-02-14 13:30:00+00,9523,1101,5135,17040,185,5467,2284,233,661,0,41629,143,25305,23021,17886,10624
2021-02-14 14:00:00+00,9380,999,5132,17172,140,5645,2296,129,543,4,41440,140,25283,22987,17855,10379
2021-02-14 14:30:00+00,9600,954,5132,17223,130,5654,2289,94,422,66,41564,139,25196,22907,17775,10554
2021-02-14 15:00:00+00,9982,951,5134,17209,115,5592,2286,90,277,0,41636,142,25021,22735,17601,10933
2021-02-14 15:30:00+00,9963,934,5138,17280,114,5718,2294,88,163,0,41692,142,24989,22695,17557,10897
2021-02-14 16:00:00+00,10604,908,5140,17282,119,5774,2304,96,72,58,42357,146,24917,22613,17473,11512
2021-02-14 16:30:00+00,11113,1026,5137,17263,184,5752,2304,197,7,436,43419,150,24895,22591,17454,12139
2021-02-14 17:00:00+00,12203,1080,5135,17164,350,5546,2305,265,0,798,44846,156,24954,22649,17514,13283
2021-02-14 17:30:00+00,12644,1068,5137,16993,389,5400,2302,272,0,1196,45401,156,24821,22519,17382,13712
2021-02-14 18:00:00+00,13052,1026,5137,16855,392,4952,2300,245,0,926,44885,157,24684,22384,17247,14078
2021-02-14 18:30:00+00,12368,1015,5140,16734,372,4968,2302,121,0,764,43784,154,24548,22246,17106,13383
2021-02-14 19:00:00+00,10769,995,5139,16530,335,5256,2301,93,0,752,42170,145,24305,22004,16865,11764
2021-02-14 19:30:00+00,10106,992,5140,16358,316,5366,2294,86,0,184,40842,144,24108,21814,16674,11098
2021-02-14 20:00:00+00,9638,650,5138,16033,213,5110,2290,98,0,166,39336,137,23674,21384,16246,10288
2021-02-14 20:30:00+00,8720,650,5139,15761,196,5104,2286,89,0,94,38039,132,23382,21096,15957,9370
2021-02-14 21:00:00+00,8193,813,5140,15334,188,4274,2284,129,0,168,36523,136,22946,20662,15522,9006
2021-02-14 21:30:00+00,7193,812,5142,14797,185,4226,2289,109,0,46,34799,131,22413,20124,14982,8005
2021-02-14 22:00:00+00,6677,774,5144,14345,183,3396,2288,189,0,148,33144,129,21960,19672,14528,7451
2021-02-14 22:30:00+00,5855,713,5142,13984,178,3112,2285,241,0,20,31530,119,21589,19304,14162,6568
2021-02-14 23:00:00+00,4841,713,5141,13739,153,2934,2282,146,0,0,29949,110,21315,19033,13892,5554
2021-02-14 23:30:00+00,4263,713,5140,13465,152,3138,2283,89,0,0,29243,107,21040,18757,13617,4976
2021-02-15 00:00:00+00,4603,714,5140,13079,152,3438,2326,146,0,0,29598,114,20697,18371,13231,5317
2021-02-15 00:30:00+00,4766,712,5156,12868,153,3552,2357,187,0,0,29751,118,20534,18177,13021,5478
2021-02-15 01:00:00+00,4948,713,5172,12537,159,3804,2383,211,0,0,29927,121,20251,17868,12696,5661
2021-02-15 01:30:00+00,4879,714,5175,12210,162,3760,2446,225,0,0,29571,121,19993,17547,12372,5593
2021-02-15 02:00:00+00,4652,711,5176,12069,151,3934,2648,189,0,0,29530,120,20044,17396,12220,5363
2021-02-15 02:30:00+00,4577,625,5185,11958,151,3992,2859,91,0,0,29438,117,20153,17294,12109,5202
2021-02-15 03:00:00+00,4541,711,5185,11773,158,3975,2925,208,0,0,29476,122,20041,17116,11931,5252
2021-02-15 03:30:00+00,4493,715,5183,11603,163,3941,2933,191,0,0,29221,121,19882,16949,11766,5208
2021-02-15 04:00:00+00,4766,724,5185,11292,174,3368,2933,220,0,0,28662,129,19584,16651,11466,5490
2021-02-15 04:30:00+00,4894,752,5185,11192,175,3381,2933,239,0,0,28750,131,19485,16552,11367,5646
2021-02-15 05:00:00+00,4468,774,5185,10779,175,3586,2925,146,0,0,28038,128,19064,16139,10954,5242
2021-02-15 05:30:00+00,5325,798,5186,10577,178,3605,2923,86,0,0,28678,136,18864,15941,10755,6123
2021-02-15 06:00:00+00,7298,824,5182,10080,187,4086,2934,129,0,10,30729,154,18383,15449,10267,8122
2021-02-15 06:30:00+00,9257,825,5187,9783,190,4132,2937,416,0,0,32727,171,18097,15160,9973,10082
2021-02-15 07:00:00+00,11867,1083,5187,10098,236,4122,2938,376,0,0,35907,192,18459,15521,10334,12950
2021-02-15 07:30:00+00,13187,1188,5183,9986,246,4158,2941,198,23,18,37128,201,18379,15438,10255,14375
2021-02-15 08:00:00+00,14065,1194,5184,10113,310,4455,2930,138,232,0,38621,200,18769,15839,10655,15259
2021-02-15 08:30:00+00,15112,1221,5186,10300,314,4685,2933,167,445,160,40523,204,19178,16245,11059,16333
2021-02-15 09:00:00+00,15665,1219,5184,10138,337,4680,2939,161,705,286,41314,203,19303,16364,11180,16884
2021-02-15 09:30:00+00,15904,1216,5185,10157,342,4656,2936,159,1140,224,41920,201,19760,16824,11639,17120
2021-02-15 10:00:00+00,15680,1216,5186,10725,333,4294,2964,158,1749,104,42409,195,20957,17993,12807,16896
2021-02-15 10:30:00+00,14794,1212,5194,11172,332,4302,2974,185,2150,140,42455,187,21822,18848,13654,16006
2021-02-15 11:00:00+00,14721,1214,5186,11206,333,4148,2977,193,2541,188,42707,184,22243,19266,14080,15935
2021-02-15 11:30:00+00,14493,1215,5179,11324,314,4160,2974,136,2883,0,42679,182,22674,19700,14522,15708
2021-02-15 12:00:00+00,14213,1207,5179,11321,281,4688,2976,125,3321,0,43311,178,23078,20102,14923,15420
2021-02-15 12:30:00+00,14327,1206,5177,10886,295,4652,2972,131,3534,0,43180,179,22864,19892,14715,15533
2021-02-15 13:00:00+00,14434,1207,5180,10885,295,4358,2969,100,3057,14,42499,179,22386,19417,14237,15641
2021-02-15 13:30:00+00,13490,1200,5178,11214,295,4346,2973,91,3316,0,42103,171,22976,20003,14825,14690
2021-02-15 14:00:00+00,13751,1197,5180,10525,296,4036,2959,95,2919,216,41174,181,21879,18920,13740,14948
2021-02-15 14:30:00+00,14382,1192,5181,10370,310,4026,2937,88,2159,0,40645,188,20957,18020,12839,15574
2021-02-15 15:00:00+00,15050,1175,5182,10056,314,3814,2932,91,1877,10,40501,193,20361,17429,12247,16225
2021-02-15 15:30:00+00,15745,1180,5181,9459,318,3816,2958,89,1210,56,40012,202,19126,16168,10987,16925
2021-02-15 16:00:00+00,15740,1180,5179,9333,390,4168,2988,199,533,440,40150,205,18423,15435,10256,16920
2021-02-15 16:30:00+00,16532,1181,5180,8819,408,4244,2995,242,127,1168,40896,210,17529,14534,9354,17713
2021-02-15 17:00:00+00,17489,1167,5183,8910,638,4434,2996,351,3,1110,42281,213,17730,14734,9551,18656
2021-02-15 17:30:00+00,18158,1191,5183,9353,812,4474,2993,460,0,1534,44158,211,18341,15348,10165,19349
2021-02-15 18:00:00+00,17598,1235,5184,9628,810,4925,2995,430,0,1362,44166,210,18617,15622,10438,18833
2021-02-15 18:30:00+00,17001,1269,5179,9724,717,4908,2964,332,0,994,43088,210,18584,15620,10441,18270
2021-02-15 19:00:00+00,16381,1219,5179,9578,485,5157,2922,212,0,756,41888,210,18164,15242,10063,17600
2021-02-15 19:30:00+00,15593,1175,5177,9067,488,5124,2951,146,0,118,39839,212,17683,14732,9555,16768
2021-02-15 20:00:00+00,14596,1117,5177,9054,439,4748,2983,129,0,82,38326,210,17653,14670,9493,15713
2021-02-15 20:30:00+00,12677,1026,5174,9747,435,4589,2984,128,0,0,36760,196,18340,15356,10182,13703
2021-02-15 21:00:00+00,10410,954,5177,10548,391,4406,2981,124,0,0,34992,178,19097,16116,10939,11364
2021-02-15 21:30:00+00,8324,895,5173,11346,378,4182,2943,130,0,0,33371,158,19840,16897,11724,9219
2021-02-15 22:00:00+00,7759,846,5175,11774,333,3541,2820,127,0,0,32375,154,20102,17282,12107,8605
2021-02-15 22:30:00+00,6305,838,5176,12113,354,3499,2802,124,0,0,31211,142,20445,17643,12467,7143
2021-02-15 23:00:00+00,5751,852,5175,12612,349,3065,2815,127,0,0,30746,135,20951,18136,12961,6603
2021-02-15 23:30:00+00,5223,842,5176,12604,347,2985,2801,112,0,0,30090,130,20928,18127,12951,6065
2021-02-16 00:00:00+00,5676,900,5175,12733,347,2741,2807,116,0,0,30495,134,21062,18255,13080,6576
2021-02-16 00:30:00+00,5589,944,5177,13097,346,2675,2811,113,0,0,30752,133,21431,18620,13443,6533
2021-02-16 01:00:00+00,5881,970,5175,13062,322,2085,2817,126,0,0,30438,135,21376,18559,13384,6851
2021-02-16 01:30:00+00,5294,1011,5176,13546,310,2004,2856,112,0,0,30309,129,21888,19032,13856,6305
2021-02-16 02:00:00+00,6012,1051,5175,13508,310,1357,2899,125,0,0,30437,135,21892,18993,13818,7063
2021-02-16 02:30:00+00,6186,1087,5177,13517,310,1271,2897,114,0,0,30559,138,21901,19004,13827,7273
2021-02-16 03:00:00+00,6787,1055,5177,13721,313,1091,2899,113,0,0,31155,141,22110,19211,14034,7842
2021-02-16 03:30:00+00,6511,1033,5176,13630,314,1027,2904,118,0,0,30712,139,22024,19120,13944,7544
2021-02-16 04:00:00+00,6439,973,5176,13204,312,839,2902,119,0,0,29964,140,21594,18692,13516,7412
2021-02-16 04:30:00+00,6800,984,5172,13074,314,756,2903,115,0,0,30118,144,21463,18560,13388,7784
2021-02-16 05:00:00+00,6473,1009,5176,13254,312,720,2902,112,0,0,29958,140,21644,18742,13566,7482
2021-02-16 05:30:00+00,6969,1013,5172,13195,325,754,2909,112,0,0,30449,145,21601,18692,13520,7982
2021-02-16 06:00:00+00,7228,1006,5174,13122,349,1226,2910,113,0,0,31128,147,21555,18645,13471,8234
2021-02-16 06:30:00+00,8777,1123,5173,13265,356,1176,2908,112,0,0,32890,160,21702,18794,13621,9900
2021-02-16 07:00:00+00,10704,1161,5171,13526,424,682,2930,118,0,60,34776,172,22051,19121,13950,11865
2021-02-16 07:30:00+00,11652,1172,5175,13657,422,734,2927,116,18,222,36095,177,22199,19272,14097,12824
2021-02-16 08:00:00+00,11897,1174,5176,13679,417,906,2939,128,158,478,36952,171,22369,19430,14254,13071
2021-02-16 08:30:00+00,12876,1170,5173,13939,408,1040,2960,341,352,246,38505,177,22832,19872,14699,14046
2021-02-16 09:00:00+00,12464,1174,4927,14023,405,2688,2936,167,568,252,39604,173,22859,19923,14996,13638
2021-02-16 09:30:00+00,12622,1173,4921,13811,403,2676,2914,206,841,382,39949,173,22890,19976,15055,13795
2021-02-16 10:00:00+00,12599,1174,4922,13683,376,2556,2939,244,1201,434,40128,171,23121,20182,15260,13773
2021-02-16 10:30:00+00,12458,1164,4922,13861,375,2556,2951,248,1575,240,40350,169,23684,20733,15811,13622
2021-02-16 11:00:00+00,11625,1012,4924,14017,396,3328,2954,194,1817,144,40411,160,24108,21154,16230,12637
2021-02-16 11:30:00+00,11842,1007,4923,13945,391,3422,2954,145,1969,188,40786,161,24182,21228,16305,12849
2021-02-16 12:00:00+00,11341,1107,4925,13959,384,4552,2951,147,1793,206,41365,157,24012,21061,16136,12448
2021-02-16 12:30:00+00,11674,1191,4924,13426,387,4598,2948,148,1768,298,41362,162,23453,20505,15581,12865
2021-02-16 13:00:00+00,11662,1300,4922,13848,403,4244,2946,150,1761,178,41414,164,23880,20934,16012,12962
2021-02-16 13:30:00+00,11227,1255,4919,13809,398,4218,2951,155,1788,136,40856,161,23865,20914,15995,12482
2021-02-16 14:00:00+00,11821,1360,4920,13580,396,3538,2952,151,1713,174,40605,170,23561,20609,15689,13181
2021-02-16 14:30:00+00,11972,1368,4917,13128,398,3512,2938,154,1737,202,40326,172,23118,20180,15263,13340
2021-02-16 15:00:00+00,12505,1342,4914,12685,400,3880,2915,153,1404,496,40694,175,22318,19403,14489,13847
2021-02-16 15:30:00+00,12729,1349,4917,12833,411,3850,2906,152,1075,474,40696,177,22142,19236,14319,14078
2021-02-16 16:00:00+00,14345,1353,4916,12113,415,2754,2905,257,710,452,40220,194,21059,18154,13238,15698
2021-02-16 16:30:00+00,15350,1348,4916,11458,450,2804,2918,292,201,990,40727,201,19943,17025,12109,16698
2021-02-16 17:00:00+00,15160,1347,4918,11417,492,4714,2906,294,11,1022,42281,196,19744,16838,11920,16507
2021-02-16 17:30:00+00,15886,1348,4917,12156,506,4802,2925,431,0,1302,44273,195,20504,17579,12662,17234
2021-02-16 18:00:00+00,15241,1346,4916,12896,502,5010,2923,404,0,1320,44558,188,21237,18314,13398,16587
2021-02-16 18:30:00+00,14323,1351,4914,13034,498,5018,2891,271,0,1528,43828,182,21337,18446,13532,15674
2021-02-16 19:00:00+00,13348,1353,4917,12908,518,4972,2911,172,0,1014,42113,179,21254,18343,13426,14701
2021-02-16 19:30:00+00,12341,1354,4915,12651,525,4968,2909,190,0,648,40501,177,21000,18091,13176,13695
2021-02-16 20:00:00+00,11071,1294,4916,12682,512,5038,2924,162,0,554,39153,169,21034,18110,13194,12365
2021-02-16 20:30:00+00,9531,1297,4917,12869,529,5164,2911,149,0,216,37583,162,21226,18315,13398,10828
2021-02-16 21:00:00+00,8322,1280,4916,13137,501,4946,2807,143,0,0,36052,156,21361,18554,13638,9602
2021-02-16 21:30:00+00,6817,1154,4914,13201,461,5086,2813,145,0,0,34591,144,21389,18576,13662,7971
2021-02-16 22:00:00+00,5777,1160,4914,13183,440,4358,2814,155,0,0,32801,136,21351,18537,13623,6937
2021-02-16 22:30:00+00,4715,1278,4915,13107,433,4286,2520,143,0,0,31397,130,20975,18455,13540,5993
2021-02-16 23:00:00+00,4448,1133,4916,12864,439,3626,1991,142,0,0,29559,124,20210,18219,13303,5581
2021-02-16 23:30:00+00,3883,1065,4917,12770,442,3652,1820,139,0,0,28688,118,19949,18129,13212,4948
2021-02-17 00:00:00+00,3989,1106,4917,13058,445,2906,1979,143,0,0,28543,119,20399,18420,13503,5095
2021-02-17 00:30:00+00,4309,1138,4917,12869,444,3016,2333,152,0,0,29178,125,20563,18230,13313,5447
2021-02-17 01:00:00+00,4251,1115,4919,13029,473,2632,2514,139,0,0,29072,124,20935,18421,13502,5366
2021-02-17 01:30:00+00,3986,1113,4920,13428,474,2574,2434,139,0,0,29068,119,21256,18822,13902,5099
2021-02-17 02:00:00+00,3731,1116,4919,13420,460,2594,2266,139,0,0,28645,122,21065,18799,13880,4847
2021-02-17 02:30:00+00,3683,1115,4920,13230,469,2550,2173,149,0,0,28289,123,20792,18619,13699,4798
2021-02-17 03:00:00+00,3774,1110,4925,13072,470,1984,2381,152,0,0,27868,125,20848,18467,13542,4884
2021-02-17 03:30:00+00,3587,1117,4926,12933,470,1934,2177,139,0,0,27283,124,20506,18329,13403,4704
2021-02-17 04:00:00+00,4378,1242,4927,12924,486,1258,2264,143,0,0,27622,133,20601,18337,13410,5620
2021-02-17 04:30:00+00,4560,1217,4926,13067,485,1250,2228,144,0,0,27877,134,20706,18478,13552,5777
2021-02-17 05:00:00+00,3878,1186,4927,13403,483,920,2113,141,0,0,27051,123,20926,18813,13886,5064
2021-02-17 05:30:00+00,3998,1218,4923,13556,485,916,2312,193,0,0,27601,124,21276,18964,14041,5216
2021-02-17 06:00:00+00,5171,1255,4926,13874,528,1164,2696,262,0,0,29876,136,22024,19328,14402,6426
2021-02-17 06:30:00+00,6499,1335,4913,14054,495,1026,2903,267,0,0,31492,147,22365,19462,14549,7834
2021-02-17 07:00:00+00,8042,1372,4909,14111,479,1728,2922,164,0,0,33727,158,22421,19499,14590,9414
2021-02-17 07:30:00+00,9207,1393,4909,14064,484,1784,2920,149,65,0,34975,166,22442,19522,14613,10600
2021-02-17 08:00:00+00,9447,1301,4907,13773,525,2680,2923,148,355,0,36059,162,22483,19560,14653,10748
2021-02-17 08:30:00+00,10294,1336,4908,14055,559,2934,2942,155,807,0,37990,166,23271,20329,15421,11630
2021-02-17 09:00:00+00,10373,1397,4909,14038,561,3304,2907,155,1387,0,39031,163,23802,20895,15986,11770
2021-02-17 09:30:00+00,10271,1285,4908,13837,507,3340,2904,157,2185,0,39394,157,24341,21437,16529,11556
2021-02-17 10:00:00+00,9975,1116,4909,13719,494,4056,2816,150,2480,0,39715,151,24418,21602,16693,11091
2021-02-17 10:30:00+00,9835,1108,4905,13699,530,4024,2782,163,2517,20,39583,149,24433,21651,16746,10943
2021-02-17 11:00:00+00,9684,1261,4904,13442,504,4212,2810,154,2625,94,39690,151,24285,21475,16571,10945
2021-02-17 11:30:00+00,9898,1395,4907,13312,499,4304,2716,145,2635,26,39837,157,24069,21353,16446,11293
2021-02-17 12:00:00+00,10304,1401,4910,13447,509,4414,2733,177,2825,38,40758,159,24424,21691,16781,11705
2021-02-17 12:30:00+00,10536,1428,4919,13242,483,4402,2819,186,2461,38,40514,163,23924,21105,16186,11964
2021-02-17 13:00:00+00,10268,1455,4927,13547,471,4396,2680,160,2428,38,40370,161,24053,21373,16446,11723
2021-02-17 13:30:00+00,9389,1464,4924,13672,464,4390,2357,157,2382,346,39545,153,23799,21442,16518,10853
2021-02-17 14:00:00+00,9413,1402,4923,13516,472,5204,2450,153,1772,300,39605,152,23133,20683,15760,10815
2021-02-17 14:30:00+00,9630,1502,4925,13544,526,5092,2687,145,1175,102,39328,158,22857,20170,15245,11132
2021-02-17 15:00:00+00,10183,1638,4924,13307,526,4576,2871,147,792,410,39374,165,22420,19549,14625,11821
2021-02-17 15:30:00+00,10975,1765,4926,13217,527,4560,2801,145,496,470,39882,173,21967,19166,14240,12740
2021-02-17 16:00:00+00,11689,1754,4927,13358,533,4314,2680,243,231,496,40225,178,21729,19049,14122,13443
2021-02-17 16:30:00+00,12646,1753,4924,13654,535,4328,2701,303,44,872,41760,181,21858,19157,14233,14399
2021-02-17 17:00:00+00,13533,1781,4925,13689,541,4876,2966,322,0,1216,43849,183,22121,19155,14230,15314
2021-02-17 17:30:00+00,14381,1776,4927,14118,539,4896,2986,490,0,1290,45403,186,22570,19584,14657,16157
2021-02-17 18:00:00+00,13698,1726,4926,14422,547,5016,2996,423,0,1370,45124,179,22891,19895,14969,15424
2021-02-17 18:30:00+00,13180,1518,4925,14335,550,5016,2997,316,0,1546,44383,173,22807,19810,14885,14698
2021-02-17 19:00:00+00,12580,1538,4926,14657,542,4822,2688,174,0,752,42679,172,22813,20125,15199,14118
2021-02-17 19:30:00+00,11429,1700,4925,14763,521,4824,2384,148,0,506,41200,170,22593,20209,15284,13129
2021-02-17 20:00:00+00,10147,1687,4926,14652,519,4900,2107,141,0,524,39603,163,22204,20097,15171,11834
2021-02-17 20:30:00+00,8385,1624,4925,14569,512,4880,2086,141,0,508,37630,151,22092,20006,15081,10009
2021-02-17 21:00:00+00,7532,1413,4894,14723,517,4140,2083,140,0,576,36018,140,22217,20134,15240,8945
2021-02-17 21:30:00+00,6063,1262,4865,14710,511,4070,2168,141,0,380,34170,127,22254,20086,15221,7325
2021-02-17 22:00:00+00,5568,1316,4864,14562,484,2498,2340,141,0,282,32055,128,22250,19910,15046,6884
2021-02-17 22:30:00+00,4512,1365,4865,14433,521,2448,2050,139,0,230,30563,121,21869,19819,14954,5877
2021-02-17 23:00:00+00,4559,1081,4865,14512,511,1132,1623,141,0,292,28716,110,21511,19888,15023,5640
2021-02-17 23:30:00+00,4663,619,4860,14650,513,1100,1319,139,0,6,27869,98,21342,20023,15163,5282
2021-02-18 00:00:00+00,5087,664,4863,14746,513,564,1174,141,0,0,27752,102,21296,20122,15259,5751
2021-02-18 00:30:00+00,5258,721,4862,14859,513,546,1237,139,0,0,28135,105,21471,20234,15372,5979
2021-02-18 01:00:00+00,5316,718,4861,14946,516,490,1357,139,0,0,28343,106,21680,20323,15462,6034
2021-02-18 01:30:00+00,4907,695,4861,14962,525,490,1254,139,0,0,27833,101,21602,20348,15487,5602
2021-02-18 02:00:00+00,5343,709,4862,14858,537,0,1422,139,0,0,27870,107,21679,20257,15395,6052
2021-02-18 02:30:00+00,5152,721,4861,14712,537,0,1651,140,0,0,27774,106,21761,20110,15249,5873
2021-02-18 03:00:00+00,5180,737,4860,14537,554,0,2091,142,0,0,28101,108,22042,19951,15091,5917
2021-02-18 03:30:00+00,5072,781,4860,14667,520,0,2081,139,0,0,28120,107,22128,20047,15187,5853
2021-02-18 04:00:00+00,4938,793,4861,14916,520,8,2190,145,0,0,28371,106,22487,20297,15436,5731
2021-02-18 04:30:00+00,5051,779,4860,14655,522,16,2180,144,0,0,28207,107,22217,20037,15177,5830
2021-02-18 05:00:00+00,5294,693,4860,14600,522,24,1957,139,0,0,28089,107,21939,19982,15122,5987
2021-02-18 05:30:00+00,5757,796,4860,14472,524,78,2103,148,0,0,28738,116,21959,19856,14996,6553
2021-02-18 06:00:00+00,6089,987,4860,14276,531,748,2166,150,0,0,29807,127,21833,19667,14807,7076
2021-02-18 06:30:00+00,6892,1324,4859,13787,520,1029,2341,205,0,356,31313,146,21507,19166,14307,8216
2021-02-18 07:00:00+00,8152,1446,4861,12898,522,817,2623,478,0,610,32408,162,20904,18281,13420,9598
2021-02-18 07:30:00+00,9408,1618,4860,12496,506,768,2942,473,63,376,33509,176,20867,17925,13065,11026
2021-02-18 08:00:00+00,9130,1606,4861,12876,506,2454,3001,461,248,372,35515,170,21492,18491,13630,10736
2021-02-18 08:30:00+00,9519,1620,4857,13630,508,2832,2999,399,561,280,37205,169,22555,19556,14699,11139
2021-02-18 09:00:00+00,8433,1726,4860,13765,526,3698,2973,266,851,348,37446,159,22975,20002,15142,10159
2021-02-18 09:30:00+00,8757,1720,4858,13793,525,3816,2927,169,1314,338,38218,158,23417,20490,15632,10477
2021-02-18 10:00:00+00,9768,1663,4857,13768,513,2550,2938,263,1704,620,38644,164,23780,20842,15985,11431
2021-02-18 10:30:00+00,9263,1760,4859,14271,523,2530,2956,307,2215,132,38816,160,24824,21868,17009,11023
2021-02-18 11:00:00+00,9281,1745,4864,14586,532,2022,2961,156,2819,64,39030,152,25762,22801,17937,11026
2021-02-18 11:30:00+00,9044,1764,4863,14522,549,2113,2961,144,3126,0,39086,150,26021,23060,18197,10808
2021-02-18 12:00:00+00,8858,1761,4867,14644,550,2630,2957,144,3689,0,40101,148,26707,23750,18883,10619
2021-02-18 12:30:00+00,8383,1730,4867,14673,560,2671,2966,142,3981,0,39973,143,27047,24081,19214,10113
2021-02-18 13:00:00+00,8139,1613,4867,14563,578,2783,2839,144,4202,0,39728,140,27049,24210,19343,9752
2021-02-18 13:30:00+00,7779,1590,4869,14274,571,2766,2714,145,4288,0,38996,137,26716,24002,19133,9369
2021-02-18 14:00:00+00,7817,1553,4866,14082,572,2671,2705,147,3903,72,38389,139,26128,23423,18557,9370
2021-02-18 14:30:00+00,7537,1539,4867,14279,562,2718,2703,143,3564,108,38020,137,25975,23272,18405,9076
2021-02-18 15:00:00+00,7723,1537,4865,13866,584,2984,2838,147,3001,212,37757,140,25154,22316,17451,9260
2021-02-18 15:30:00+00,8567,1555,4865,13697,570,2984,2946,144,2167,226,37721,150,24245,21299,16434,10122
2021-02-18 16:00:00+00,9673,1560,4867,13922,568,3194,2967,257,1193,310,38511,160,23517,20550,15683,11233
2021-02-18 16:30:00+00,11277,1565,4865,14140,585,3228,2969,287,386,476,39778,171,22945,19976,15111,12842
2021-02-18 17:00:00+00,11989,1574,4866,14253,611,4048,2974,319,17,602,41253,170,22721,19747,14881,13563
2021-02-18 17:30:00+00,13218,1587,4863,14439,613,4098,2980,401,0,950,43149,175,22895,19915,15052,14805
2021-02-18 18:00:00+00,13539,1690,4864,14453,604,4162,2989,470,0,1054,43825,178,22910,19921,15057,15229
2021-02-18 18:30:00+00,12891,1617,4864,14363,602,4142,2990,359,0,1134,42962,173,22819,19829,14965,14508
2021-02-18 19:00:00+00,11797,1654,4862,14274,602,3762,2988,218,0,1132,41289,171,22726,19738,14876,13451
2021-02-18 19:30:00+00,11048,1672,4864,13942,603,3744,2989,159,0,752,39773,170,22398,19409,14545,12720
2021-02-18 20:00:00+00,10402,1686,4863,13607,603,3632,2979,143,0,546,38461,172,22052,19073,14210,12088
2021-02-18 20:30:00+00,9205,1663,4862,13490,594,3740,2979,143,0,478,37154,166,21925,18946,14084,10868
2021-02-18 21:00:00+00,8420,1641,4863,13208,583,3578,2978,140,0,188,35599,165,21632,18654,13791,10061
2021-02-18 21:30:00+00,7298,1569,4864,12937,584,3490,2956,141,0,194,34033,157,21341,18385,13521,8867
2021-02-18 22:00:00+00,6754,1414,4863,12870,575,2952,2725,142,0,96,32391,154,21033,18308,13445,8168
2021-02-18 22:30:00+00,6319,1158,4865,12619,563,2834,2192,140,0,0,30690,146,20239,18047,13182,7477
2021-02-18 23:00:00+00,5549,735,4864,12381,557,2974,1970,139,0,0,29169,127,19772,17802,12938,6284
2021-02-18 23:30:00+00,4906,549,4864,12220,552,3082,1845,142,0,0,28160,117,19481,17636,12772,5455
2021-02-19 00:00:00+00,4819,380,4866,12174,551,3342,1678,142,0,0,27952,117,19269,17591,12725,5199
2021-02-19 00:30:00+00,5095,382,4865,12075,550,3416,1749,142,0,0,28274,121,19239,17490,12625,5477
2021-02-19 01:00:00+00,4913,353,4865,12027,521,3594,1780,142,0,0,28195,118,19193,17413,12548,5266
2021-02-19 01:30:00+00,4609,381,4868,12231,524,3598,1685,141,0,0,28037,115,19308,17623,12755,4990
2021-02-19 02:00:00+00,4698,382,4868,12282,527,3110,1678,142,0,0,27687,117,19355,17677,12809,5080
2021-02-19 02:30:00+00,4662,381,4865,12387,528,3000,1627,140,0,0,27590,116,19407,17780,12915,5043
2021-02-19 03:00:00+00,5636,380,4863,12522,529,1942,1888,143,0,0,27903,125,19802,17914,13051,6016
2021-02-19 03:30:00+00,5410,382,4865,12831,505,1930,1748,139,0,0,27810,121,19949,18201,13336,5792
2021-02-19 04:00:00+00,5822,382,4865,13010,515,1242,1666,155,0,0,27657,123,20056,18390,13525,6204
2021-02-19 04:30:00+00,6141,367,4866,13077,519,1230,1429,140,0,0,27769,125,19891,18462,13596,6508
2021-02-19 05:00:00+00,6242,337,4864,13381,531,1104,1536,142,0,0,28137,124,20312,18776,13912,6579
2021-02-19 05:30:00+00,6542,373,4866,13649,530,1108,1639,139,0,0,28846,126,20684,19045,14179,6915
2021-02-19 06:00:00+00,6062,621,4867,13818,545,1726,1503,143,0,0,29285,130,20733,19230,14363,6683
2021-02-19 06:30:00+00,6775,837,4863,13756,550,1836,1717,165,0,0,30499,142,20886,19169,14306,7612
2021-02-19 07:00:00+00,6941,863,4863,13883,551,2642,2219,149,0,182,32293,140,21516,19297,14434,7804
2021-02-19 07:30:00+00,8138,881,4866,14009,562,2660,2269,143,73,158,33759,148,21779,19510,14644,9019
2021-02-19 08:00:00+00,8411,882,4865,14087,558,3814,2276,146,228,266,35533,147,22014,19738,14873,9293
2021-02-19 08:30:00+00,9358,883,4867,14310,561,3844,2267,146,454,366,37056,151,22459,20192,15325,10241
2021-02-19 09:00:00+00,9276,931,4865,14438,600,4738,2257,172,634,404,38315,150,22794,20537,15672,10207
2021-02-19 09:30:00+00,9717,941,4865,14409,605,4754,2254,169,816,388,38918,152,22949,20695,15830,10658
2021-02-19 10:00:00+00,9782,942,4865,14697,639,4748,2256,158,988,186,39261,152,23445,21189,16324,10724
2021-02-19 10:30:00+00,9892,941,4864,14746,641,4664,2265,160,1079,158,39410,151,23595,21330,16466,10833
2021-02-19 11:00:00+00,9517,942,4866,14643,663,5220,2260,155,1182,320,39768,144,23614,21354,16488,10459
2021-02-19 11:30:00+00,9290,941,4866,14685,756,5404,2262,178,1300,350,40032,141,23869,21607,16741,10231
2021-02-19 12:00:00+00,9291,941,4864,14732,764,5306,2218,199,1156,512,39983,140,23734,21516,16652,10232
2021-02-19 12:30:00+00,9421,941,4865,14681,764,5290,2191,255,1050,536,39994,142,23551,21360,16495,10362
2021-02-19 13:00:00+00,9703,942,4860,14683,764,5410,2187,274,955,370,40148,145,23449,21262,16402,10645
2021-02-19 13:30:00+00,9383,941,4857,14983,738,5342,2189,161,1038,68,39700,142,23805,21616,16759,10324
2021-02-19 14:00:00+00,9162,942,4863,14991,743,5238,2172,147,918,182,39358,140,23687,21515,16652,10104
2021-02-19 14:30:00+00,9236,938,4860,14726,746,5252,2182,150,710,228,39028,142,23224,21042,16182,10174
2021-02-19 15:00:00+00,9009,938,4860,14674,765,5410,2189,153,528,272,38798,142,23016,20827,15967,9947
2021-02-19 15:30:00+00,8980,939,4861,14668,771,5426,2194,150,372,306,38667,143,22866,20672,15811,9919
2021-02-19 16:00:00+00,9214,935,4860,14521,851,5350,2243,220,195,330,38719,145,22670,20427,15567,10149
2021-02-19 16:30:00+00,9986,932,4861,14546,848,5298,2234,266,45,368,39384,150,22534,20300,15439,10918
2021-02-19 17:00:00+00,10642,930,4862,14655,844,5206,2244,342,0,924,40649,151,22605,20361,15499,11572
2021-02-19 17:30:00+00,11293,932,4861,14666,859,5116,2314,339,0,1486,41866,152,22700,20386,15525,12225
2021-02-19 18:00:00+00,11448,934,4863,14666,860,5014,2311,407,0,1446,41949,153,22700,20389,15526,12382
2021-02-19 18:30:00+00,11254,923,4862,14768,860,5010,2313,326,0,758,41074,153,22803,20490,15628,12177
2021-02-19 19:00:00+00,10298,882,4862,14789,861,5010,2321,225,0,548,39796,147,22833,20512,15650,11180
2021-02-19 19:30:00+00,8477,868,4859,14694,857,5006,2316,223,0,444,37744,136,22726,20410,15551,9345
2021-02-19 20:00:00+00,7554,852,4860,14674,856,4754,2295,181,0,420,36446,128,22685,20390,15530,8406
2021-02-19 20:30:00+00,6504,852,4862,14608,835,4742,1980,157,0,310,34850,121,22285,20305,15443,7356
2021-02-19 21:00:00+00,5882,859,4861,14637,813,4278,1664,153,0,264,33411,116,21975,20311,15450,6741
2021-02-19 21:30:00+00,5385,765,4860,14466,808,4244,1660,144,0,248,32580,110,21794,20134,15274,6150
2021-02-19 22:00:00+00,4732,805,4847,14254,774,2886,1666,142,0,176,30282,107,21541,19875,15028,5537
2021-02-19 22:30:00+00,4289,595,4835,13937,774,2826,1673,141,0,88,29158,98,21219,19546,14711,4884
2021-02-19 23:00:00+00,4359,303,4819,13527,774,2284,1522,145,0,46,27779,86,20642,19120,14301,4662
2021-02-19 23:30:00+00,4266,348,4806,13408,774,2294,1164,156,0,0,27216,87,20152,18988,14182,4614
2021-02-20 00:00:00+00,3977,285,4795,13466,753,2716,1019,154,0,0,27165,81,20033,19014,14219,4262
2021-02-20 00:30:00+00,4139,259,4779,13540,745,2732,1022,157,0,0,27373,82,20086,19064,14285,4398
2021-02-20 01:00:00+00,3848,210,4766,13364,729,3004,1018,152,0,0,27091,78,19877,18859,14093,4058
2021-02-20 01:30:00+00,3827,0,4753,13061,738,2988,1024,154,0,0,26545,72,19576,18552,13799,3827
2021-02-20 02:00:00+00,4260,0,4742,13119,753,2126,1036,152,0,0,26188,78,19650,18614,13872,4260
2021-02-20 02:30:00+00,4109,0,4726,12948,753,2094,1041,156,0,0,25827,77,19468,18427,13701,4109
2021-02-20 03:00:00+00,4310,0,4709,12572,753,1536,1049,146,0,0,25075,82,19083,18034,13325,4310
2021-02-20 03:30:00+00,4369,0,4698,12313,776,1512,1052,140,0,0,24860,83,18839,17787,13089,4369
2021-02-20 04:00:00+00,4063,0,4678,12393,799,1228,1052,152,0,0,24365,78,18922,17870,13192,4063
2021-02-20 04:30:00+00,3827,0,4663,12472,798,1224,1052,151,0,0,24187,75,18985,17933,13270,3827
2021-02-20 05:00:00+00,3549,0,4650,12770,792,1372,1049,151,0,0,24333,70,19261,18212,13562,3549
2021-02-20 05:30:00+00,3673,7,4634,12837,736,1366,1055,141,0,0,24449,72,19262,18207,13573,3680
2021-02-20 06:00:00+00,4015,14,4617,12913,745,1656,1069,141,0,0,25170,77,19344,18275,13658,4029
2021-02-20 06:30:00+00,4142,163,4600,12906,772,1656,1070,149,0,172,25630,83,19348,18278,13678,4305
2021-02-20 07:00:00+00,3999,310,4585,13246,841,2620,1070,146,2,6,26825,80,19744,18674,14089,4309
2021-02-20 07:30:00+00,4429,291,4571,13454,793,2682,1070,157,104,0,27551,83,19992,18922,14351,4720
2021-02-20 08:00:00+00,4587,267,4552,13741,764,3450,1074,156,352,0,28943,87,20483,19409,14857,4854
2021-02-20 08:30:00+00,5241,266,4536,13579,765,3684,1077,156,522,4,29830,96,20479,19402,14866,5507
2021-02-20 09:00:00+00,5900,273,4522,13431,765,3888,1074,185,763,360,31161,101,20555,19481,14959,6173
2021-02-20 09:30:00+00,6069,361,4508,13811,760,3978,1075,242,1089,272,32165,104,21243,20168,15660,6430
2021-02-20 10:00:00+00,6190,402,4305,14276,681,4428,1074,239,1524,0,33119,108,21860,20786,16481,6592
2021-02-20 10:30:00+00,6058,401,4296,14140,683,4438,1079,226,2174,0,33495,105,22372,21293,16997,6459
2021-02-20 11:00:00+00,5837,400,4299,14555,650,4404,1079,223,2803,0,34250,99,23386,22307,18008,6237
2021-02-20 11:30:00+00,5811,401,4297,14828,638,4476,1071,211,2963,0,34696,99,23797,22726,18429,6212
2021-02-20 12:00:00+00,6126,384,4298,14742,626,4788,1069,201,2704,0,34938,103,23439,22370,18072,6510
2021-02-20 12:30:00+00,6434,397,4296,14694,626,4778,1069,176,2270,0,34740,107,22955,21886,17590,6831
2021-02-20 13:00:00+00,6730,396,4295,14511,632,4646,1062,185,1897,128,34482,112,22397,21335,17040,7126
2021-02-20 13:30:00+00,6366,349,4298,14568,631,4682,1056,186,1880,0,34016,108,22433,21377,17079,6715
2021-02-20 14:00:00+00,6124,352,4301,14452,663,4684,1061,151,1701,12,33501,107,22178,21117,16816,6476
2021-02-20 14:30:00+00,6460,349,4294,14236,665,4678,1059,145,1483,0,33369,111,21737,20678,16384,6809
2021-02-20 15:00:00+00,6520,349,4292,14352,670,4544,1057,145,1129,0,33058,113,21500,20443,16151,6869
2021-02-20 15:30:00+00,6501,349,4291,14394,683,4544,1057,152,899,142,33012,113,21324,20267,15976,6850
2021-02-20 16:00:00+00,7022,349,4293,14448,705,4920,1055,147,517,114,33570,118,21018,19963,15670,7371
2021-02-20 16:30:00+00,8071,359,4297,14359,695,4878,1059,161,135,394,34408,126,20545,19486,15189,8430
2021-02-20 17:00:00+00,8898,399,4297,14279,684,5094,1076,201,8,1280,36216,129,20344,19268,14971,9297
2021-02-20 17:30:00+00,9889,400,4299,14455,692,5126,1079,416,0,1492,37848,135,20525,19446,15147,10289
2021-02-20 18:00:00+00,10091,400,4299,14468,726,5126,1079,430,0,1648,38267,136,20572,19493,15194,10491
2021-02-20 18:30:00+00,9699,346,4298,14459,735,4996,1066,357,0,1522,37478,132,20558,19492,15194,10045
2021-02-20 19:00:00+00,9254,383,4298,14377,682,4916,1057,330,0,862,36159,133,20414,19357,15059,9637
2021-02-20 19:30:00+00,8809,351,4297,14268,702,5034,1047,233,0,228,34969,133,20314,19267,14970,9160
2021-02-20 20:00:00+00,8082,353,4297,14117,724,4778,1041,167,0,250,33809,129,20179,19138,14841,8435
2021-02-20 20:30:00+00,7106,297,4298,13943,708,4760,1049,156,0,144,32461,121,19998,18949,14651,7403
2021-02-20 21:00:00+00,6900,335,4299,13589,737,3740,1044,156,0,154,30954,121,19669,18625,14326,7235
2021-02-20 21:30:00+00,6117,327,4300,13342,748,3670,1049,141,0,90,29784,114,19439,18390,14090,6444
2021-02-20 22:00:00+00,5791,342,4300,13196,749,2806,1115,141,0,84,28524,114,19360,18245,13945,6133
2021-02-20 22:30:00+00,5023,339,4298,13207,745,2702,1198,140,0,0,27652,105,19448,18250,13952,5362
2021-02-20 23:00:00+00,4680,314,4298,13407,732,2014,1345,142,0,0,26932,100,19782,18437,14139,4994
2021-02-20 23:30:00+00,4580,218,4297,13229,753,1968,1343,139,0,0,26527,96,19622,18279,13982,4798
2021-02-21 00:00:00+00,4947,0,4298,12903,762,1976,1345,151,0,0,26382,97,19308,17963,13665,4947
2021-02-21 00:30:00+00,5199,0,4296,12675,761,2010,1369,148,0,0,26458,101,19101,17732,13436,5199
2021-02-21 01:00:00+00,5043,0,4295,12558,764,2224,1362,145,0,0,26391,103,18979,17617,13322,5043
2021-02-21 01:30:00+00,4883,0,4296,12277,769,2172,1358,143,0,0,25898,101,18700,17342,13046,4883
2021-02-21 02:00:00+00,5018,0,4285,11895,754,1840,1434,157,0,0,25383,104,18368,16934,12649,5018
2021-02-21 02:30:00+00,5085,0,4291,11640,748,1802,1416,144,0,0,25126,105,18095,16679,12388,5085
2021-02-21 03:00:00+00,4875,0,4298,11460,748,2012,1372,144,0,0,24909,102,17878,16506,12208,4875
2021-02-21 03:30:00+00,4985,0,4298,11328,740,1948,1421,140,0,0,24860,103,17787,16366,12068,4985
2021-02-21 04:00:00+00,5301,0,4297,11348,741,1414,1534,151,0,0,24786,105,17920,16386,12089,5301
2021-02-21 04:30:00+00,5547,0,4299,11094,745,1402,1622,155,0,0,24864,109,17760,16138,11839,5547
2021-02-21 05:00:00+00,5645,0,4298,10887,763,1788,1621,148,0,0,25150,112,17569,15948,11650,5645
2021-02-21 05:30:00+00,5866,0,4300,10573,754,1800,1623,141,0,0,25057,116,17250,15627,11327,5866
2021-02-21 06:00:00+00,6189,0,4299,10252,790,2192,1585,141,0,0,25448,124,16926,15341,11042,6189
2021-02-21 06:30:00+00,6630,0,4300,10053,782,2218,1566,155,0,0,25704,130,16701,15135,10835,6630
2021-02-21 07:00:00+00,6100,0,4303,9612,770,3558,1755,143,0,0,26241,119,16440,14685,10382,6100
2021-02-21 07:30:00+00,6329,0,4304,9466,771,3530,1782,156,93,0,26431,120,16416,14634,10330,6329
2021-02-21 08:00:00+00,7221,0,4304,8888,762,3870,1820,150,291,86,27392,130,16065,14245,9941,7221
2021-02-21 08:30:00+00,7887,0,4302,8866,758,4036,1870,232,654,254,28859,136,16450,14580,10278,7887
2021-02-21 09:00:00+00,8675,0,4302,8712,763,4504,2078,288,962,330,30614,141,16817,14739,10437,8675
2021-02-21 09:30:00+00,9174,0,4301,8315,770,4506,2286,276,1093,844,31565,144,16765,14479,10178,9174
2021-02-21 10:00:00+00,9614,0,4305,8426,781,4688,2361,405,1309,762,32651,146,17182,14821,10516,9614
2021-02-21 10:30:00+00,10495,0,4303,8194,778,4710,2323,276,1944,678,33701,150,17542,15219,10916,10495
2021-02-21 11:00:00+00,11598,18,4302,8465,758,4750,2329,269,1981,296,34766,157,17835,15506,11204,11616
2021-02-21 11:30:00+00,12074,49,4303,8586,763,4752,2331,198,2508,260,35824,158,18491,16160,11857,12123
2021-02-21 12:00:00+00,12612,106,4301,8648,805,4994,2330,163,2693,0,36652,161,18777,16447,12146,12718
2021-02-21 12:30:00+00,12991,200,4301,8357,799,4998,2314,185,2890,0,37035,166,18661,16347,12046,13191
2021-02-21 13:00:00+00,12871,261,4299,8194,798,4998,2309,206,2755,0,36691,168,18355,16046,11747,13132
2021-02-21 13:30:00+00,12767,275,4299,7830,794,5052,2312,152,2546,0,36027,171,17781,15469,11170,13042
2021-02-21 14:00:00+00,13031,265,4298,7703,794,4910,2312,158,2260,0,35731,174,17367,15055,10757,13296
2021-02-21 14:30:00+00,13421,275,4297,7585,795,4900,2311,145,1738,0,35467,180,16726,14415,10118,13696
2021-02-21 15:00:00+00,13979,271,4296,7114,799,4694,2315,161,1459,100,35188,185,15983,13668,9372,14250
2021-02-21 15:30:00+00,14795,267,4296,6696,801,4692,2320,274,916,260,35317,195,15029,12709,8413,15062
2021-02-21 16:00:00+00,15859,276,4295,6126,833,4896,2327,374,501,254,35741,207,14082,11755,7460,16135
2021-02-21 16:30:00+00,17136,275,4295,6534,818,4898,2329,456,185,406,37332,212,14161,11832,7537,17411
2021-02-21 17:00:00+00,17876,308,4296,6692,814,5014,2329,469,15,1132,38945,213,14146,11817,7521,18184
2021-02-21 17:30:00+00,18716,314,4297,6535,804,5016,2333,505,0,1540,40060,216,13969,11636,7339,19030
2021-02-21 18:00:00+00,18468,311,4297,6927,829,5018,2334,591,0,1750,40525,212,14387,12053,7756,18779
2021-02-21 18:30:00+00,18034,296,4300,6972,876,5018,2335,529,0,1310,39670,211,14483,12148,7848,18330
2021-02-21 19:00:00+00,17454,275,4301,6958,872,5018,2293,431,0,434,38036,212,14424,12131,7830,17729
2021-02-21 19:30:00+00,16806,275,4299,6760,873,5018,2273,245,0,392,36941,210,14205,11932,7633,17081
2021-02-21 20:00:00+00,15615,275,4300,6873,916,5018,2140,163,0,396,35696,203,14229,12089,7789,15890
2021-02-21 20:30:00+00,14604,275,4301,6522,960,5018,2131,151,0,402,34364,199,13914,11783,7482,14879
2021-02-21 21:00:00+00,13488,275,4301,6344,958,4998,2148,151,0,428,33091,193,13751,11603,7302,13763
2021-02-21 21:30:00+00,12254,275,4301,6065,956,4994,2148,150,0,404,31547,187,13470,11322,7021,12529
2021-02-21 22:00:00+00,11400,274,4301,5824,892,4754,2181,150,0,334,30110,184,13198,11017,6716,11674
2021-02-21 22:30:00+00,10489,274,4301,5680,941,4752,2183,149,0,260,29029,179,13105,10922,6621,10763
2021-02-21 23:00:00+00,10203,275,4301,5526,940,4036,2191,154,0,44,27670,181,12958,10767,6466,10478
2021-02-21 23:30:00+00,9316,307,4302,5249,940,4020,2188,151,0,0,26473,177,12679,10491,6189,9623
2021-02-22 00:00:00+00,9485,369,4300,4823,941,4020,2237,151,0,0,26326,187,12301,10064,5764,9854
2021-02-22 00:30:00+00,9712,377,4298,4774,939,4020,2246,174,0,142,26682,188,12257,10011,5713,10089
2021-02-22 01:00:00+00,9705,375,4298,4552,940,4018,2244,154,0,256,26542,189,12034,9790,5492,10080
2021-02-22 01:30:00+00,9527,378,4298,4496,900,4016,2248,149,0,36,26048,190,11942,9694,5396,9905
2021-02-22 02:00:00+00,9525,336,4298,4400,908,4016,2247,157,0,0,25887,189,11853,9606,5308,9861
2021-02-22 02:30:00+00,9451,357,4297,4399,934,4016,2246,152,0,0,25852,189,11876,9630,5333,9808
2021-02-22 03:00:00+00,9059,371,4299,4464,897,4018,2250,152,0,0,25510,186,11910,9660,5361,9430
2021-02-22 03:30:00+00,8638,351,4298,4580,896,4018,2315,152,0,0,25248,181,12089,9774,5476,8989
2021-02-22 04:00:00+00,8743,362,4298,4178,899,4018,2349,162,0,0,25009,185,11724,9375,5077,9105
2021-02-22 04:30:00+00,9272,409,4298,3884,934,4030,2368,158,0,0,25353,193,11484,9116,4818,9681
2021-02-22 05:00:00+00,8946,438,4299,3960,900,4736,2389,149,0,0,25817,189,11548,9159,4860,9384
2021-02-22 05:30:00+00,9383,458,4299,4184,900,4752,2413,150,0,0,26539,191,11796,9383,5084,9841
2021-02-22 06:00:00+00,10625,526,4300,4510,950,5048,2436,149,0,0,28544,199,12196,9760,5460,11151
2021-02-22 06:30:00+00,12428,663,4300,4782,950,4998,2489,148,0,0,30758,211,12521,10032,5732,13091
2021-02-22 07:00:00+00,14515,684,4300,4939,949,4966,2705,160,6,0,33224,222,12899,10194,5894,15199
2021-02-22 07:30:00+00,15725,759,4300,4984,950,4966,2910,185,125,0,34904,228,13269,10359,6059,16484
2021-02-22 08:00:00+00,16976,787,4298,4959,950,5054,2972,231,304,84,36615,233,13483,10511,6213,17763
2021-02-22 08:30:00+00,17680,834,4298,5129,949,5056,2966,488,536,488,38424,233,13878,10912,6614,18514
2021-02-22 09:00:00+00,17916,852,4299,5351,936,5056,2982,546,819,298,39055,232,14387,11405,7106,18768
2021-02-22 09:30:00+00,17856,842,4297,5699,926,5056,2990,484,1073,254,39477,228,14985,11995,7698,18698
2021-02-22 10:00:00+00,17822,845,4298,5983,927,5056,2993,304,1360,254,39842,224,15561,12568,8270,18667
2021-02-22 10:30:00+00,17550,894,4294,6093,918,5056,2985,206,1650,256,39902,221,15940,12955,8661,18444
2021-02-22 11:00:00+00,17521,938,4294,6269,915,5056,2983,159,2000,312,40447,219,16461,13478,9184,18459
2021-02-22 11:30:00+00,16612,1047,4293,6836,891,5052,2981,158,2440,104,40414,213,17441,14460,10167,17659
2021-02-22 12:00:00+00,16171,1152,4292,7126,883,4962,2946,157,2804,108,40601,210,18051,15105,10813,17323
2021-02-22 12:30:00+00,15988,1176,4290,6818,882,5020,2900,151,3049,108,40382,210,17939,15039,10749,17164
2021-02-22 13:00:00+00,15769,1201,4293,6625,878,5018,2891,163,3206,112,40156,211,17893,15002,10709,16970
2021-02-22 13:30:00+00,14951,1252,4291,6409,818,5150,2885,151,3240,110,39257,210,17643,14758,10467,16203
2021-02-22 14:00:00+00,14988,1441,4291,6091,796,4818,2885,163,3326,108,38907,217,17389,14504,10213,16429
2021-02-22 14:30:00+00,15213,1621,4292,5732,761,4718,2834,154,3020,108,38453,225,16639,13805,9513,16834
2021-02-22 15:00:00+00,16535,1691,4293,5256,765,3702,2789,149,2512,224,37916,235,15615,12826,8533,18226
2021-02-22 15:30:00+00,17178,1704,4292,5089,831,3630,2801,164,2144,284,38117,239,15157,12356,8064,18882
2021-02-22 16:00:00+00,17248,1655,4290,4998,891,4580,2739,282,1286,292,38261,246,14204,11465,7175,18903
2021-02-22 16:30:00+00,18127,1696,4289,4861,893,4722,2799,333,520,458,38698,256,13362,10563,6274,19823
2021-02-22 17:00:00+00,18449,1856,4292,5140,902,5492,2802,381,46,754,40114,258,13182,10380,6088,20305
2021-02-22 17:30:00+00,18659,1976,4293,5579,905,5730,2841,513,0,1204,41700,256,13618,10777,6484,20635
2021-02-22 18:00:00+00,18805,1902,4293,6121,906,5790,2881,504,0,1118,42320,253,14201,11320,7027,20707
2021-02-22 18:30:00+00,18373,1670,4292,6674,868,5700,2880,478,0,1046,41981,244,14714,11834,7542,20043
2021-02-22 19:00:00+00,17871,1375,4292,6823,772,5810,2876,340,0,336,40495,242,14763,11887,7595,19246
2021-02-22 19:30:00+00,16743,1305,4293,6917,773,5828,2877,184,0,208,39128,236,14860,11983,7690,18048
2021-02-22 20:00:00+00,15964,960,4293,6754,779,5794,2877,159,0,380,37960,226,14703,11826,7533,16924
2021-02-22 20:30:00+00,14646,912,4294,6861,786,5770,2871,145,0,152,36437,220,14812,11941,7647,15558
2021-02-22 21:00:00+00,13407,864,4291,6722,786,5728,2861,141,0,254,35054,213,14660,11799,7508,14271
2021-02-22 21:30:00+00,11887,801,4293,6899,787,5658,2868,139,0,40,33372,203,14847,11979,7686,12688
2021-02-22 22:00:00+00,9855,814,4295,7106,801,5464,2873,144,0,0,31352,191,15075,12202,7907,10669
2021-02-22 22:30:00+00,8073,612,4296,7133,826,5452,2876,140,0,0,29408,173,15131,12255,7959,8685
2021-02-22 23:00:00+00,7641,330,4294,7148,804,4436,2871,142,0,70,27736,164,15117,12246,7952,7971
2021-02-22 23:30:00+00,6682,332,4295,7366,783,4416,2873,143,0,0,26890,155,15317,12444,8149,7014
2021-02-23 00:00:00+00,6899,330,4294,7858,723,3520,2872,140,0,0,26636,153,15747,12875,8581,7229
2021-02-23 00:30:00+00,7024,329,4293,8214,723,3500,2871,141,0,0,27095,152,16101,13230,8937,7353
2021-02-23 01:00:00+00,6665,329,4293,8569,706,3200,2872,140,0,0,26774,147,16440,13568,9275,6994
2021-02-23 01:30:00+00,6050,334,4296,8611,697,3192,2873,141,0,0,26194,142,16477,13604,9308,6384
2021-02-23 02:00:00+00,5781,337,4296,8855,690,2650,2868,141,0,0,25618,137,16709,13841,9545,6118
2021-02-23 02:30:00+00,5548,326,4293,9013,690,2644,2869,142,0,0,25525,134,16865,13996,9703,5874
2021-02-23 03:00:00+00,5320,328,4292,9158,690,1770,2880,150,0,0,24588,136,17020,14140,9848,5648
2021-02-23 03:30:00+00,4990,325,4292,9251,690,1728,2899,145,0,0,24320,132,17132,14233,9941,5315
2021-02-23 04:00:00+00,5006,335,4292,9161,707,1252,2912,217,0,0,23882,136,17072,14160,9868,5341
2021-02-23 04:30:00+00,5034,336,4294,9253,714,1214,2935,257,0,0,24037,136,17196,14261,9967,5370
2021-02-23 05:00:00+00,5460,336,4293,9288,895,756,2927,261,0,0,24216,134,17403,14476,10183,5796
2021-02-23 05:30:00+00,6105,336,4291,9315,884,756,2910,265,0,0,24861,141,17400,14490,10199,6441
2021-02-23 06:00:00+00,7153,337,4294,9945,780,1614,2918,242,0,0,27283,153,17937,15019,10725,7490
2021-02-23 06:30:00+00,8066,333,4293,10858,721,1862,2906,168,0,92,29299,155,18778,15872,11579,8399
2021-02-23 07:00:00+00,8869,330,4291,11438,720,3729,2901,149,23,154,32604,153,19373,16472,12181,9199
2021-02-23 07:30:00+00,9230,330,4291,11924,721,4356,2899,143,273,66,34233,150,20108,17209,12918,9560
2021-02-23 08:00:00+00,9407,331,4292,13132,720,5382,2905,148,647,104,37068,142,21696,18791,14499,9738
2021-02-23 08:30:00+00,9439,330,4291,13796,720,5412,2893,147,1464,106,38597,137,23164,20271,15980,9769
2021-02-23 09:00:00+00,9415,330,4289,13931,707,5402,2907,144,2230,108,39463,133,24064,21157,16868,9745
2021-02-23 09:30:00+00,9283,334,4290,14086,692,5260,2901,143,3408,106,40503,126,25377,22476,18186,9617
2021-02-23 10:00:00+00,9165,333,4291,14416,680,4898,2879,143,4237,0,41042,122,26503,23624,19333,9498
2021-02-23 10:30:00+00,9042,332,4292,14641,686,4802,2809,115,4660,0,41378,119,27088,24279,19987,9374
2021-02-23 11:00:00+00,8989,332,4293,14697,684,3722,2911,115,4764,46,40553,117,27349,24438,20145,9321
2021-02-23 11:30:00+00,8861,280,4293,14845,690,3728,2893,107,4546,148,40391,115,27267,24374,20081,9141
2021-02-23 12:00:00+00,8761,140,4294,15110,698,3432,2885,108,4245,112,39785,110,27232,24347,20053,8901
2021-02-23 12:30:00+00,8556,0,4294,15082,691,3512,2894,115,3745,118,39007,107,26706,23812,19518,8556
2021-02-23 13:00:00+00,7855,0,4291,15180,693,4230,2888,120,3255,54,38566,101,26307,23419,19128,7855
2021-02-23 13:30:00+00,7749,0,4294,15316,693,4288,2881,110,2554,0,37885,101,25738,22857,18563,7749
2021-02-23 14:00:00+00,7282,0,4296,15466,695,4602,2847,133,2119,0,37440,100,25423,22576,18280,7282
2021-02-23 14:30:00+00,7292,0,4297,15480,695,4568,2806,105,2013,4,37260,100,25291,22485,18188,7292
2021-02-23 15:00:00+00,7048,0,4299,15397,708,5308,2816,114,1515,8,37213,104,24735,21919,17620,7048
2021-02-23 15:30:00+00,7988,0,4298,15271,715,5332,2823,112,916,18,37473,113,24023,21200,16902,7988
2021-02-23 16:00:00+00,8904,0,4298,15211,754,5258,2824,196,683,0,38128,121,23770,20946,16648,8904
2021-02-23 16:30:00+00,10049,0,4298,15004,743,5378,2815,292,261,54,38894,132,23121,20306,16008,10049
2021-02-23 17:00:00+00,10655,0,4299,14866,742,5578,2809,300,23,486,39757,137,22739,19930,15631,10655
2021-02-23 17:30:00+00,11611,0,4299,14743,724,5598,2788,322,0,1222,41306,142,22554,19766,15467,11611
2021-02-23 18:00:00+00,11975,0,4304,14640,732,5493,2780,290,0,1320,41533,144,22456,19676,15372,11975
2021-02-23 18:30:00+00,11822,0,4302,14542,723,5313,2785,262,0,962,40711,144,22352,19567,15265,11822
2021-02-23 19:00:00+00,10946,0,4303,14556,725,5417,2794,224,0,466,39431,142,22378,19584,15281,10946
2021-02-23 19:30:00+00,9633,0,4303,14615,718,5242,2822,120,0,246,37698,133,22458,19636,15333,9633
2021-02-23 20:00:00+00,8818,0,4302,14632,693,4845,2806,116,0,236,36448,127,22433,19627,15325,8818
2021-02-23 20:30:00+00,7422,0,4302,14624,686,4702,2796,120,0,76,34728,116,22408,19612,15310,7422
2021-02-23 21:00:00+00,6728,0,4303,14596,687,3734,2764,123,0,120,33055,110,22350,19586,15283,6728
2021-02-23 21:30:00+00,5186,0,4306,14615,616,3368,2750,120,0,182,31143,93,22287,19537,15231,5186
2021-02-23 22:00:00+00,5206,0,4305,14559,625,2939,2709,121,0,200,30664,95,22198,19489,15184,5206
2021-02-23 22:30:00+00,4434,0,4307,14279,656,2855,2630,99,0,102,29362,88,21872,19242,14935,4434
2021-02-23 23:00:00+00,4730,0,4305,14146,691,1598,2711,111,0,68,28360,88,21853,19142,14837,4730
2021-02-23 23:30:00+00,4291,0,4306,14141,690,1460,2756,102,0,0,27746,83,21893,19137,14831,4291
2021-02-24 00:00:00+00,4777,0,4306,14258,689,1511,2759,115,0,0,28416,89,22012,19253,14947,4777
2021-02-24 00:30:00+00,5024,0,4307,14312,666,1526,2761,108,0,0,28704,93,22046,19285,14978,5024
2021-02-24 01:00:00+00,4928,0,4305,14329,632,1393,2761,112,0,0,28460,92,22027,19266,14961,4928
2021-02-24 01:30:00+00,4460,0,4305,14155,631,1293,2802,105,0,0,27750,88,21893,19091,14786,4460
2021-02-24 02:00:00+00,4767,0,4303,14096,653,940,2865,104,0,0,27728,92,21917,19052,14749,4767
2021-02-24 02:30:00+00,4813,0,4301,13843,640,812,2868,120,0,0,27397,93,21652,18784,14483,4813
2021-02-24 03:00:00+00,4624,0,4303,13681,639,658,2870,105,0,0,26880,92,21493,18623,14320,4624
2021-02-24 03:30:00+00,4189,0,4306,13831,638,504,2879,99,0,0,26446,85,21654,18775,14469,4189
2021-02-24 04:00:00+00,4540,0,4308,13707,657,522,2898,127,0,0,26759,90,21570,18672,14364,4540
2021-02-24 04:30:00+00,4709,0,4310,13557,660,432,2913,115,0,0,26696,91,21440,18527,14217,4709
2021-02-24 05:00:00+00,4742,0,4308,13675,660,456,2914,113,0,0,26868,92,21557,18643,14335,4742
2021-02-24 05:30:00+00,5121,0,4310,13723,658,496,2917,109,0,0,27334,96,21608,18691,14381,5121
2021-02-24 06:00:00+00,4719,0,4310,13798,672,1538,2911,106,0,0,28054,88,21691,18780,14470,4719
2021-02-24 06:30:00+00,5669,0,4309,13889,669,1950,2920,110,0,176,29692,99,21787,18867,14558,5669
2021-02-24 07:00:00+00,6112,0,4309,13668,669,3378,2926,109,13,278,31462,104,21585,18659,14350,6112
2021-02-24 07:30:00+00,7477,0,4311,13603,669,3342,2923,122,221,28,32696,116,21727,18804,14493,7477
2021-02-24 08:00:00+00,8187,0,4310,13604,668,4208,2924,139,622,64,34726,119,22128,19204,14894,8187
2021-02-24 08:30:00+00,8720,0,4309,13706,668,4182,2926,102,1369,0,35982,120,22978,20052,15743,8720
2021-02-24 09:00:00+00,8134,0,4309,13906,667,4532,2928,108,2184,0,36768,111,23994,21066,16757,8134
2021-02-24 09:30:00+00,7939,0,4307,13720,670,4504,2927,105,2502,0,36674,108,24126,21199,16892,7939
2021-02-24 10:00:00+00,8217,0,4307,13666,681,4208,2931,104,2923,0,37037,109,24508,21577,17270,8217
2021-02-24 10:30:00+00,8373,0,4309,13679,685,4198,2930,105,3036,0,37315,110,24639,21709,17400,8373
2021-02-24 11:00:00+00,8159,0,4312,13611,688,4426,2888,106,2990,0,37180,109,24489,21601,17289,8159
2021-02-24 11:30:00+00,8549,0,4313,13395,691,4420,2876,105,3176,0,37525,112,24451,21575,17262,8549
2021-02-24 12:00:00+00,8874,0,4311,13198,695,4710,2870,108,2990,238,37994,115,24064,21194,16883,8874
2021-02-24 12:30:00+00,9170,0,4313,12961,694,4726,2885,128,2371,196,37444,120,23224,20339,16026,9170
2021-02-24 13:00:00+00,9210,0,4313,12726,695,4750,2885,141,2433,306,37459,120,23052,20167,15854,9210
2021-02-24 13:30:00+00,9197,0,4311,12728,700,4752,2883,140,2130,136,36977,122,22752,19869,15558,9197
2021-02-24 14:00:00+00,9105,0,4313,12654,683,4996,2881,140,1897,136,36805,122,22428,19547,15234,9105
2021-02-24 14:30:00+00,9433,0,4311,12411,665,4998,2885,114,1406,136,36359,127,21678,18793,14482,9433
2021-02-24 15:00:00+00,10127,0,4312,12208,665,4998,2886,115,1145,136,36592,134,21216,18330,14018,10127
2021-02-24 15:30:00+00,10488,0,4311,12303,744,4994,2885,139,858,136,36858,137,21101,18216,13905,10488
2021-02-24 16:00:00+00,11275,0,4311,12446,864,4692,2891,228,536,136,37379,141,21048,18157,13846,11275
2021-02-24 16:30:00+00,12568,0,4309,12273,866,4684,2911,228,194,86,38119,151,20553,17642,13333,12568
2021-02-24 17:00:00+00,12977,0,4310,11952,893,5068,2911,284,19,1314,39728,153,20085,17174,12864,12977
2021-02-24 17:30:00+00,14393,0,4314,11961,917,5078,2909,437,0,1424,41433,162,20101,17192,12878,14393
2021-02-24 18:00:00+00,14458,0,4309,12206,903,5078,2909,431,0,1456,41750,161,20327,17418,13109,14458
2021-02-24 18:30:00+00,13835,0,4310,12375,896,5076,2914,346,0,1374,41126,157,20495,17581,13271,13835
2021-02-24 19:00:00+00,13736,0,4309,12426,767,5078,2911,172,0,472,39871,159,20413,17502,13193,13736
2021-02-24 19:30:00+00,12729,0,4311,12520,725,5076,2909,132,0,8,38410,155,20465,17556,13245,12729
2021-02-24 20:00:00+00,11303,0,4311,12319,713,5076,2902,123,0,0,36747,146,20245,17343,13032,11303
2021-02-24 20:30:00+00,9833,0,4311,12125,712,5078,2890,116,0,0,35065,137,20038,17148,12837,9833
2021-02-24 21:00:00+00,8611,0,4313,12370,712,4400,2908,127,0,0,33441,127,20303,17395,13082,8611
2021-02-24 21:30:00+00,7145,0,4313,12305,712,4386,2914,127,0,10,31912,115,20244,17330,13017,7145
2021-02-24 22:00:00+00,6400,0,4315,12156,712,3616,2912,117,0,82,30310,108,20095,17183,12868,6400
2021-02-24 22:30:00+00,5287,0,4315,12138,671,3600,2910,113,0,0,29034,97,20034,17124,12809,5287
2021-02-24 23:00:00+00,4414,0,4316,12349,669,3286,2674,122,0,0,27830,88,20008,17334,13018,4414
2021-02-24 23:30:00+00,3873,0,4314,12583,659,3278,2261,114,0,0,27082,80,19817,17556,13242,3873
2021-02-25 00:00:00+00,3617,0,4313,12513,643,3298,2239,131,0,0,26754,81,19708,17469,13156,3617
2021-02-25 00:30:00+00,3584,0,4314,12442,642,3301,2415,116,0,0,26814,81,19813,17398,13084,3584
2021-02-25 01:00:00+00,2989,0,4314,12338,624,3426,2706,106,0,0,26503,75,19982,17276,12962,2989
2021-02-25 01:30:00+00,2942,0,4314,12329,624,3435,2717,100,0,0,26461,74,19984,17267,12953,2942
2021-02-25 02:00:00+00,2894,0,4312,12121,623,3434,2674,101,0,0,26159,74,19730,17056,12744,2894
2021-02-25 02:30:00+00,2901,0,4312,12301,622,3439,2568,99,0,0,26242,74,19803,17235,12923,2901
2021-02-25 03:00:00+00,3126,0,4310,11993,622,2644,2720,114,0,0,25529,75,19645,16925,12615,3126
2021-02-25 03:30:00+00,3320,0,4307,11810,621,2631,2790,109,0,0,25588,78,19528,16738,12431,3320
2021-02-25 04:00:00+00,3886,42,4308,11133,607,2156,2931,106,0,0,25169,87,18979,16048,11740,3928
2021-02-25 04:30:00+00,4063,121,4310,10525,611,2168,2965,106,0,0,24869,94,18411,15446,11136,4184
2021-02-25 05:00:00+00,4342,173,4310,10092,620,2623,2967,109,0,0,25236,106,17989,15022,10712,4515
2021-02-25 05:30:00+00,5289,272,4311,9447,645,2681,2964,178,0,182,25969,123,17367,14403,10092,5561
2021-02-25 06:00:00+00,5963,505,4311,9457,678,3772,2948,205,0,102,27941,134,17394,14446,10135,6468
2021-02-25 06:30:00+00,8143,647,4309,9408,639,3756,2965,224,0,0,30091,158,17321,14356,10047,8790
2021-02-25 07:00:00+00,10968,695,4311,9074,639,3015,2963,373,15,150,32203,185,17002,14039,9728,11663
2021-02-25 07:30:00+00,12710,700,4312,9021,644,2976,2965,402,236,90,34056,196,17178,14213,9901,13410
2021-02-25 08:00:00+00,13185,701,4310,9121,653,3962,2972,377,781,30,36092,193,17837,14865,10555,13886
2021-02-25 08:30:00+00,13409,701,4309,9367,629,3984,2959,395,1455,0,37208,189,18719,15760,11451,14110
2021-02-25 09:00:00+00,13609,701,4311,9131,640,4064,2893,363,2115,32,37859,188,19090,16197,11886,14310
2021-02-25 09:30:00+00,13587,691,4309,8861,670,4100,2949,357,2379,0,37903,188,19168,16219,11910,14278
2021-02-25 10:00:00+00,13052,653,4310,8709,668,5006,2960,355,2692,0,38405,180,19339,16379,12069,13705
2021-02-25 10:30:00+00,12700,672,4311,8475,668,5056,2950,311,3402,104,38649,175,19806,16856,12545,13372
2021-02-25 11:00:00+00,12587,760,4309,8000,643,5056,2907,134,3869,26,38291,176,19728,16821,12512,13347
2021-02-25 11:30:00+00,12242,837,4309,8393,668,5056,2919,123,3838,0,38385,174,20127,17208,12899,13079
2021-02-25 12:00:00+00,12103,879,4310,8446,658,5056,2930,117,4270,0,38769,172,20614,17684,13374,12982
2021-02-25 12:30:00+00,11711,909,4309,8287,654,5056,2936,117,4560,0,38539,169,20746,17810,13501,12620
2021-02-25 13:00:00+00,11725,964,4309,8046,654,4998,2935,114,4402,0,38147,172,20346,17411,13102,12689
2021-02-25 13:30:00+00,11662,1021,4311,7948,654,4972,2929,113,4423,0,38033,173,20265,17336,13025,12683
2021-02-25 14:00:00+00,12371,1039,4310,7880,654,4066,2907,117,4184,48,37576,179,19936,17028,12718,13410
2021-02-25 14:30:00+00,12789,1024,4311,7740,661,4028,2935,111,3544,0,37143,185,19191,16256,11945,13813
2021-02-25 15:00:00+00,13593,1023,4312,7878,675,3588,2928,120,2958,0,37075,190,18751,15823,11511,14616
2021-02-25 15:30:00+00,14792,1054,4310,7595,676,3586,2938,127,2254,0,37332,202,17773,14835,10525,15846
2021-02-25 16:00:00+00,15900,1099,4314,7619,676,3610,2917,217,1534,0,37886,214,17060,14143,9829,16999
2021-02-25 16:30:00+00,17683,1102,4307,7268,685,3642,2857,235,712,150,38641,228,15829,12972,8665,18785
2021-02-25 17:00:00+00,18539,1038,4306,7016,837,4844,2751,272,122,182,39907,234,15032,12281,7975,19577
2021-02-25 17:30:00+00,19394,947,4309,6929,869,4886,2869,437,0,628,41268,234,14976,12107,7798,20341
2021-02-25 18:00:00+00,19717,963,4309,6838,901,5072,2883,461,0,1258,42402,232,14931,12048,7739,20680
2021-02-25 18:30:00+00,19602,1072,4310,6713,903,5076,2917,401,0,1186,42180,235,14843,11926,7616,20674
2021-02-25 19:00:00+00,19153,1102,4308,6687,903,5076,2888,278,0,746,41141,235,14786,11898,7590,20255
2021-02-25 19:30:00+00,18884,1102,4306,6635,904,5076,2285,169,0,344,39705,239,14130,11845,7539,19986
2021-02-25 20:00:00+00,17648,1102,4307,6875,894,5026,2296,116,0,0,38264,234,14372,12076,7769,18750
2021-02-25 20:30:00+00,16142,1102,4305,7197,872,5028,2307,121,0,52,37126,225,14681,12374,8069,17244
2021-02-25 21:00:00+00,14683,1102,4307,7344,856,5056,2318,113,0,0,35779,218,14825,12507,8200,15785
2021-02-25 21:30:00+00,12852,1101,4307,7613,712,5056,2323,113,0,8,34085,208,14955,12632,8325,13953
2021-02-25 22:00:00+00,11792,864,4308,7339,668,4754,2177,109,0,46,32057,199,14492,12315,8007,12656
2021-02-25 22:30:00+00,11309,359,4308,7137,701,4752,2006,120,0,110,30802,185,14152,12146,7838,11668
2021-02-25 23:00:00+00,10388,0,4309,7188,700,4364,1921,110,0,4,28984,170,14118,12197,7888,10388
2021-02-25 23:30:00+00,9588,0,4311,7009,700,4354,1918,115,0,0,27995,165,13938,12020,7709,9588
2021-02-26 00:00:00+00,9579,0,4310,6818,699,4502,1901,110,0,0,27919,167,13728,11827,7517,9579
2021-02-26 00:30:00+00,10050,0,4311,6690,699,4508,1899,113,0,0,28270,172,13599,11700,7389,10050
2021-02-26 01:00:00+00,9871,0,4310,6387,699,4508,1893,110,0,0,27778,172,13289,11396,7086,9871
2021-02-26 01:30:00+00,9650,0,4311,6068,683,4506,1896,110,0,0,27224,172,12958,11062,6751,9650
2021-02-26 02:00:00+00,9848,0,4308,5588,682,4508,1965,121,0,0,27020,177,12543,10578,6270,9848
2021-02-26 02:30:00+00,9875,0,4308,5282,682,4508,2072,115,0,0,26842,179,12344,10272,5964,9875
2021-02-26 03:00:00+00,9772,0,4307,5221,682,4520,2122,109,0,0,26733,179,12332,10210,5903,9772
2021-02-26 03:30:00+00,9743,0,4309,4922,682,4508,2047,109,0,0,26320,180,11960,9913,5604,9743
2021-02-26 04:00:00+00,9825,0,4308,4785,663,4508,1973,113,0,0,26175,182,11729,9756,5448,9825
2021-02-26 04:30:00+00,9878,0,4310,4700,662,4533,1966,109,0,0,26158,184,11638,9672,5362,9878
2021-02-26 05:00:00+00,10102,0,4310,4660,662,4592,2020,109,0,0,26455,187,11652,9632,5322,10102
2021-02-26 05:30:00+00,10851,0,4308,4596,662,4644,2211,109,0,0,27381,193,11777,9566,5258,10851
2021-02-26 06:00:00+00,13164,0,4310,4491,734,4636,2335,111,0,94,29875,209,11870,9535,5225,13164
2021-02-26 06:30:00+00,14851,0,4310,4319,734,4554,2687,110,0,12,31577,219,12050,9363,5053,14851
2021-02-26 07:00:00+00,16506,0,4310,4072,747,5148,2771,216,90,22,33882,227,11990,9219,4909,16506
2021-02-26 07:30:00+00,17338,0,4310,3850,745,5192,2747,307,760,146,35395,228,12412,9665,5355,17338
2021-02-26 08:00:00+00,17669,0,4311,3689,860,5150,2762,335,1959,312,37047,221,13581,10819,6508,17669
2021-02-26 08:30:00+00,17989,0,4311,3453,752,5208,2828,314,3234,292,38381,217,14578,11750,7439,17989
2021-02-26 09:00:00+00,18050,0,4310,3470,708,5058,2837,252,4312,0,38997,212,15637,12800,8490,18050
2021-02-26 09:30:00+00,17541,0,4311,3474,709,5056,2834,156,5219,0,39300,204,16547,13713,9402,17541
2021-02-26 10:00:00+00,17012,0,4315,3562,689,5056,2819,115,5961,0,39529,197,17346,14527,10212,17012
2021-02-26 10:30:00+00,16136,0,4315,3694,685,5068,2688,117,6534,0,39237,190,17916,15228,10913,16136
2021-02-26 11:00:00+00,15704,0,4314,3762,686,5080,2280,116,6939,20,38901,186,17981,15701,11387,15704
2021-02-26 11:30:00+00,15229,0,4314,3905,687,5108,2180,112,7125,0,38660,182,18211,16031,11717,15229
2021-02-26 12:00:00+00,15197,0,4314,4204,658,5167,2125,114,7073,0,38852,182,18374,16249,11935,15197
2021-02-26 12:30:00+00,15054,0,4314,4501,568,5268,2026,113,6851,0,38695,182,18260,16234,11920,15054
2021-02-26 13:00:00+00,14524,0,4314,4673,555,5234,2029,116,6131,0,37576,181,17702,15673,11359,14524
2021-02-26 13:30:00+00,14219,0,4311,4703,574,5254,2026,118,5547,0,36752,182,17161,15135,10824,14219
2021-02-26 14:00:00+00,13801,0,4313,4850,577,5390,2029,117,5116,0,36193,182,16885,14856,10543,13801
2021-02-26 14:30:00+00,13833,0,4314,4903,511,5442,2012,108,4513,0,35636,186,16253,14241,9927,13833
2021-02-26 15:00:00+00,14088,0,4314,4928,541,5374,2046,129,3871,0,35291,190,15700,13654,9340,14088
2021-02-26 15:30:00+00,14982,0,4313,4854,591,5350,2179,106,2988,0,35363,200,14925,12746,8433,14982
2021-02-26 16:00:00+00,16385,0,4313,4868,679,4580,2510,231,1973,0,35539,210,14343,11833,7520,16385
2021-02-26 16:30:00+00,18444,0,4314,4611,700,4464,2686,246,913,0,36378,226,13224,10538,6224,18444
2021-02-26 17:00:00+00,19109,0,4313,4441,762,5388,2778,226,161,460,37638,234,12455,9677,5364,19109
2021-02-26 17:30:00+00,20161,0,4313,4603,827,5494,2861,289,0,854,39402,236,12604,9743,5430,20161
2021-02-26 18:00:00+00,21033,0,4312,4782,795,5414,2895,405,0,1146,40782,237,12784,9889,5577,21033
2021-02-26 18:30:00+00,20918,0,4317,4881,826,5330,2881,308,0,1240,40701,235,12905,10024,5707,20918
2021-02-26 19:00:00+00,20554,0,4315,4688,828,5328,2862,191,0,546,39312,238,12693,9831,5516,20554
2021-02-26 19:30:00+00,19547,0,4316,4691,829,5262,2880,126,0,290,37941,235,12716,9836,5520,19547
2021-02-26 20:00:00+00,18620,0,4316,4768,761,5332,2893,122,0,102,36914,232,12738,9845,5529,18620
2021-02-26 20:30:00+00,17483,0,4316,4564,743,5416,2911,117,0,0,35550,230,12534,9623,5307,17483
2021-02-26 21:00:00+00,16564,0,4317,4385,645,5338,2920,110,0,0,34279,227,12267,9347,5030,16564
2021-02-26 21:30:00+00,14952,0,4316,4217,634,5454,2915,124,0,0,32612,220,12082,9167,4851,14952
2021-02-26 22:00:00+00,13608,0,4317,4280,601,5184,2890,113,0,178,31171,212,12088,9198,4881,13608
2021-02-26 22:30:00+00,12657,0,4317,4282,600,5120,2856,109,0,0,29941,207,12055,9199,4882,12657
2021-02-26 23:00:00+00,11501,0,4318,4421,584,4800,2858,111,0,22,28615,198,12181,9323,5005,11501
2021-02-26 23:30:00+00,10964,0,4318,4298,544,4646,2832,109,0,0,27711,194,11992,9160,4842,10964
2021-02-27 00:00:00+00,11065,0,4319,4185,471,4510,2828,109,0,10,27497,194,11803,8975,4656,11065
2021-02-27 00:30:00+00,11394,0,4320,4132,471,4508,2857,113,0,38,27833,196,11780,8923,4603,11394
2021-02-27 01:00:00+00,11040,0,4321,4276,470,4510,2863,109,0,0,27589,193,11930,9067,4746,11040
2021-02-27 01:30:00+00,10811,0,4321,4226,470,4508,2678,116,0,0,27130,192,11695,9017,4696,10811
2021-02-27 02:00:00+00,10456,0,4321,4199,457,4508,2672,112,0,0,26725,190,11649,8977,4656,10456
2021-02-27 02:30:00+00,10364,0,4322,4081,457,4508,2671,122,0,0,26525,190,11531,8860,4538,10364
2021-02-27 03:00:00+00,10520,0,4322,4088,458,4268,2673,112,0,0,26441,192,11541,8868,4546,10520
2021-02-27 03:30:00+00,10267,0,4324,3992,458,4264,2675,109,0,0,26089,190,11449,8774,4450,10267
2021-02-27 04:00:00+00,10110,0,4323,3788,460,4266,2675,115,0,0,25737,191,11246,8571,4248,10110
2021-02-27 04:30:00+00,10163,0,4325,3645,461,4266,2676,111,0,0,25647,192,11107,8431,4106,10163
2021-02-27 05:00:00+00,10037,0,4322,3425,476,4266,2675,115,0,0,25316,193,10898,8223,3901,10037
2021-02-27 05:30:00+00,10370,0,4325,3361,475,4266,2675,112,0,0,25584,196,10836,8161,3836,10370
2021-02-27 06:00:00+00,11539,0,4320,3086,511,4504,2676,114,0,0,26750,206,10593,7917,3597,11539
2021-02-27 06:30:00+00,12779,0,4322,2872,513,4510,2509,110,0,0,27615,216,10216,7707,3385,12779
2021-02-27 07:00:00+00,14115,0,4321,2643,525,4568,2273,117,110,0,28672,224,9872,7599,3278,14115
2021-02-27 07:30:00+00,14812,0,4319,2404,528,4574,2271,114,785,0,29807,225,10307,8036,3717,14812
2021-02-27 08:00:00+00,15187,0,4318,2178,573,4990,2271,115,1853,40,31525,221,11193,8922,4604,15187
2021-02-27 08:30:00+00,15644,0,4320,1987,573,4998,2273,133,3029,0,32957,217,12182,9909,5589,15644
2021-02-27 09:00:00+00,15818,0,4320,1796,700,5046,2275,144,3987,16,34102,212,13078,10803,6483,15818
2021-02-27 09:30:00+00,15663,0,4322,1817,700,5046,2276,133,4852,0,34809,206,13967,11691,7369,15663
2021-02-27 10:00:00+00,15163,0,4321,1827,766,5048,2256,121,5585,0,35087,199,14755,12499,8178,15163
2021-02-27 10:30:00+00,14743,0,4320,1713,764,5046,2260,112,6280,0,35238,193,15337,13077,8757,14743
2021-02-27 11:00:00+00,14204,0,4319,1642,671,5056,2259,120,6904,0,35175,188,15795,13536,9217,14204
2021-02-27 11:30:00+00,14054,0,4320,1580,639,5056,2258,114,7192,0,35213,186,15989,13731,9411,14054
2021-02-27 12:00:00+00,14053,0,4311,1536,641,5056,2256,115,6804,0,34772,188,15548,13292,8981,14053
2021-02-27 12:30:00+00,14156,0,4315,1485,642,5056,2257,115,6484,0,34510,191,15183,12926,8611,14156
2021-02-27 13:00:00+00,14144,0,4324,1466,554,5058,2163,117,6237,0,34063,193,14744,12581,8257,14144
2021-02-27 13:30:00+00,14123,6,4339,1409,553,5058,1922,116,5675,0,33201,197,13898,11976,7637,14129
2021-02-27 14:00:00+00,14088,32,4317,1419,553,4998,1727,131,5343,0,32608,199,13359,11632,7315,14120
2021-02-27 14:30:00+00,14354,121,4310,1308,553,4998,1723,117,4799,0,32283,207,12693,10970,6660,14475
2021-02-27 15:00:00+00,14854,269,4310,1238,580,4998,1719,120,4084,8,32180,218,11931,10212,5902,15123
2021-02-27 15:30:00+00,15779,407,4317,1183,586,4996,1702,126,2963,8,32067,234,10751,9049,4732,16186
2021-02-27 16:00:00+00,17181,579,4320,1177,624,4968,1835,117,1950,0,32751,251,9906,8071,3751,17760
2021-02-27 16:30:00+00,19153,625,4319,1164,783,4968,2213,166,926,88,34405,264,9405,7192,2873,19778
2021-02-27 17:00:00+00,20411,714,4321,1171,785,5076,2257,246,183,832,35996,272,8717,6460,2139,21125
2021-02-27 17:30:00+00,20859,981,4321,1180,903,5076,2261,387,0,934,36902,278,8664,6404,2082,21840
2021-02-27 18:00:00+00,21262,1233,4320,1165,908,5076,2276,514,0,1750,38504,278,8669,6393,2073,22495
2021-02-27 18:30:00+00,21613,1294,4322,1198,950,5076,2276,521,0,1548,38798,281,8746,6470,2148,22907
2021-02-27 19:00:00+00,21353,1289,4320,1191,797,5076,2282,443,0,1138,37889,284,8590,6308,1988,22642
2021-02-27 19:30:00+00,20975,1116,4322,1211,778,5074,2248,359,0,506,36589,285,8559,6311,1989,22091
2021-02-27 20:00:00+00,20817,720,4320,1301,761,5076,2258,306,0,18,35577,280,8640,6382,2062,21537
2021-02-27 20:30:00+00,20079,545,4322,1356,760,5076,2235,218,0,16,34607,273,8673,6438,2116,20624
2021-02-27 21:00:00+00,19313,335,4322,1400,733,5056,2284,206,0,0,33649,266,8739,6455,2133,19648
2021-02-27 21:30:00+00,18257,54,4322,1432,712,5056,2284,159,0,0,32276,256,8750,6466,2144,18311
2021-02-27 22:00:00+00,17336,36,4323,1307,473,4998,2279,152,0,22,30926,254,8382,6103,1780,17372
2021-02-27 22:30:00+00,16575,18,4321,1281,562,4998,2031,115,0,26,29927,251,8195,6164,1843,16593
2021-02-27 23:00:00+00,15934,0,4321,1281,541,4998,1368,110,0,0,28553,250,7511,6143,1822,15934
2021-02-27 23:30:00+00,15543,0,4321,1241,537,4996,1043,112,0,0,27793,250,7142,6099,1778,15543
2021-02-28 00:00:00+00,15648,0,4320,1224,537,4758,1057,118,0,0,27662,250,7138,6081,1761,15648
2021-02-28 00:30:00+00,15915,0,4321,1231,538,4754,1057,133,0,0,27949,251,7147,6090,1769,15915
2021-02-28 01:00:00+00,15531,0,4315,1245,518,4754,1057,115,0,0,27535,249,7135,6078,1763,15531
2021-02-28 01:30:00+00,15140,0,4316,1244,519,4754,1055,111,0,0,27139,247,7134,6079,1763,15140
2021-02-28 02:00:00+00,15015,0,4319,1275,520,4754,1056,111,0,0,27050,246,7170,6114,1795,15015
2021-02-28 02:30:00+00,14819,0,4320,1306,519,4754,1055,110,0,0,26883,245,7200,6145,1825,14819
2021-02-28 03:00:00+00,14611,0,4320,1331,504,4754,1057,111,0,0,26688,244,7212,6155,1835,14611
2021-02-28 03:30:00+00,14277,0,4321,1325,503,4754,1059,111,0,0,26350,242,7208,6149,1828,14277
2021-02-28 04:00:00+00,13924,0,4318,1339,443,4754,1060,111,0,0,25949,240,7160,6100,1782,13924
2021-02-28 04:30:00+00,13674,0,4319,1353,403,4752,1060,110,0,0,25671,239,7135,6075,1756,13674
2021-02-28 05:00:00+00,13753,0,4320,1325,433,4752,1058,110,0,0,25751,239,7136,6078,1758,13753
2021-02-28 05:30:00+00,14074,0,4319,1274,435,4752,1058,113,0,0,26025,242,7086,6028,1709,14074
2021-02-28 06:00:00+00,14691,0,4319,1265,459,4752,1059,110,0,0,26655,245,7102,6043,1724,14691
2021-02-28 06:30:00+00,15011,0,4317,1257,461,4752,1057,110,0,0,26965,247,7092,6035,1718,15011
2021-02-28 07:00:00+00,15093,0,4309,1189,471,4754,1058,119,110,0,27103,247,7137,6079,1770,15093
2021-02-28 07:30:00+00,15728,0,4303,1141,468,4754,1058,112,693,0,28257,246,7663,6605,2302,15728
2021-02-28 08:00:00+00,16272,0,4294,1135,504,4752,1059,123,1539,0,29678,241,8531,7472,3178,16272
2021-02-28 08:30:00+00,16742,0,4284,1112,510,4756,1058,157,2430,0,31049,237,9394,8336,4052,16742
2021-02-28 09:00:00+00,17260,0,4273,1108,516,5054,1059,123,3282,0,32675,233,10238,9179,4906,17260
2021-02-28 09:30:00+00,17392,0,4262,1207,517,5056,1060,116,4031,10,33651,227,11077,10017,5755,17392
2021-02-28 10:00:00+00,17245,0,4244,1248,637,5056,1058,113,4826,0,34427,221,12013,10955,6711,17245
2021-02-28 10:30:00+00,16893,0,4234,1324,655,5056,1049,124,5563,0,34898,214,12825,11776,7542,16893
2021-02-28 11:00:00+00,16520,0,4216,1328,643,5056,1041,115,6064,0,34983,209,13292,12251,8035,16520
2021-02-28 11:30:00+00,16346,0,4202,1305,645,5056,1095,113,6544,0,35306,205,13791,12696,8494,16346
2021-02-28 12:00:00+00,16254,0,4182,1369,663,5056,1156,121,6881,0,35682,202,14251,13095,8913,16254
2021-02-28 12:30:00+00,15665,0,4159,1422,666,5056,1382,125,6962,0,35437,198,14591,13209,9050,15665
2021-02-28 13:00:00+00,15460,0,4145,1401,648,5056,1619,119,6861,0,35309,197,14674,13055,8910,15460
2021-02-28 13:30:00+00,15120,0,4135,1398,632,5056,1606,116,6549,0,34612,197,14320,12714,8579,15120
2021-02-28 14:00:00+00,15281,0,4124,1418,620,4996,1617,115,6009,0,34180,202,13788,12171,8047,15281
2021-02-28 14:30:00+00,15678,4,4116,1465,625,4994,1617,118,5249,0,33866,208,13072,11455,7339,15682
2021-02-28 15:00:00+00,16606,27,4104,1553,664,4998,1620,114,4360,0,34046,218,12301,10681,6577,16633
2021-02-28 15:30:00+00,17813,163,4095,1582,682,4998,1623,118,3350,0,34424,233,11332,9709,5614,17976
2021-02-28 16:00:00+00,19448,516,4083,1699,718,5018,1644,124,2259,16,35525,253,10403,8759,4676,19964
2021-02-28 16:30:00+00,20381,939,4074,1784,722,5016,1829,196,1060,394,36395,269,9469,7640,3566,21320
2021-02-28 17:00:00+00,20977,1205,4067,1944,922,4892,1987,367,211,1022,37594,276,9131,7144,3077,22182
2021-02-28 17:30:00+00,21662,1201,4057,2233,966,4890,1997,473,1,1302,38782,276,9254,7257,3200,22863
2021-02-28 18:00:00+00,22316,1216,4047,2388,966,5074,2002,503,0,1308,39820,276,9403,7401,3354,23532
2021-02-28 18:30:00+00,22053,1117,4042,2517,967,5076,2002,449,0,1218,39441,273,9528,7526,3484,23170
2021-02-28 19:00:00+00,22023,901,4032,2611,967,5076,2003,430,0,518,38561,273,9613,7610,3578,22924
2021-02-28 19:30:00+00,21638,780,4018,2702,824,5076,2011,247,0,294,37590,272,9555,7544,3526,22418
2021-02-28 20:00:00+00,20837,790,3994,2813,630,5076,2004,179,0,0,36323,272,9441,7437,3443,21627
2021-02-28 20:30:00+00,19623,543,3978,2882,621,5076,1991,125,0,0,34839,263,9472,7481,3503,20166
2021-02-28 21:00:00+00,18361,533,3962,2942,577,5056,1936,126,0,0,33493,258,9417,7481,3519,18894
2021-02-28 21:30:00+00,17190,233,3948,2962,514,5056,1686,128,0,62,31779,248,9110,7424,3476,17423
2021-02-28 22:00:00+00,15976,217,3941,2849,439,4998,1689,121,0,0,30230,243,8918,7229,3288,16193
2021-02-28 22:30:00+00,15072,0,3928,2620,464,4998,1649,118,0,0,28849,235,8661,7012,3084,15072
2021-02-28 23:00:00+00,14373,0,3919,2407,461,5054,1701,111,0,0,28026,233,8488,6787,2868,14373
2021-02-28 23:30:00+00,14353,0,3906,2238,441,5058,1704,110,0,0,27810,235,8289,6585,2679,14353
2021-03-01 00:00:00+00,14473,0,3905,2179,410,5056,1680,113,0,0,27816,240,8174,6494,2589,14473
2021-03-01 00:30:00+00,14799,0,3906,2209,404,5054,1687,109,0,0,28168,242,8206,6519,2613,14799
2021-03-01 01:00:00+00,14822,0,3905,2120,404,5000,1686,110,0,0,28047,242,8115,6429,2524,14822
2021-03-01 01:30:00+00,14516,0,3903,2073,402,5000,1684,110,0,0,27688,241,8062,6378,2475,14516
2021-03-01 02:00:00+00,14187,5,3906,2067,403,5000,1684,111,0,0,27364,239,8060,6376,2470,14192
2021-03-01 02:30:00+00,13877,11,3904,2039,403,5000,1682,111,0,0,27027,238,8028,6346,2442,13888
2021-03-01 03:00:00+00,13715,35,3740,2014,385,4955,1689,119,0,0,26652,240,7828,6139,2399,13750
2021-03-01 03:30:00+00,13596,60,3735,1946,383,4936,1685,113,0,0,26454,240,7749,6064,2329,13656
2021-03-01 04:00:00+00,13948,84,3735,1964,383,4637,1699,121,0,0,26571,245,7781,6082,2347,14032
2021-03-01 04:30:00+00,13980,108,3737,2023,380,4589,1856,113,0,0,26786,245,7996,6140,2403,14088
2021-03-01 05:00:00+00,15287,144,3735,2054,376,3593,2057,110,0,0,27356,256,8222,6165,2430,15431
2021-03-01 05:30:00+00,15896,285,3736,2140,388,3558,2171,183,0,0,28357,261,8435,6264,2528,16181
2021-03-01 06:00:00+00,16985,397,3742,2276,448,4086,2381,241,0,0,30556,263,8847,6466,2724,17382
2021-03-01 06:30:00+00,19070,367,3752,2333,454,4089,2726,199,0,0,32990,268,9265,6539,2787,19437
2021-03-01 07:00:00+00,21140,386,3756,2262,519,3515,2892,239,41,312,35061,275,9470,6578,2822,21526
2021-03-01 07:30:00+00,21716,771,3763,2149,625,3521,2963,369,321,764,36962,278,9821,6858,3095,22487
2021-03-01 08:00:00+00,21683,1280,3769,2048,637,4430,2991,226,777,574,38415,281,10222,7231,3462,22963
2021-03-01 08:30:00+00,21665,1595,3770,1981,654,4479,2979,320,1198,826,39467,282,10582,7603,3833,23260
2021-03-01 09:00:00+00,21651,1860,3774,1982,679,5065,2979,312,1643,534,40479,283,11057,8078,4304,23511
2021-03-01 09:30:00+00,21655,1904,3781,1993,665,5087,2971,340,2114,424,40934,281,11524,8553,4772,23559
2021-03-01 10:00:00+00,21652,1924,3787,1884,640,5070,2967,286,2572,446,41228,279,11850,8883,5096,23576
2021-03-01 10:30:00+00,21666,1945,3794,1843,591,5071,2966,222,3000,466,41564,277,12194,9228,5434,23611
2021-03-01 11:00:00+00,21470,1973,3800,1909,435,5092,2979,212,3390,304,41563,276,12513,9534,5734,23443
2021-03-01 11:30:00+00,21402,1986,3805,2068,415,5094,2971,177,3923,144,41985,273,13182,10211,6406,23388
2021-03-01 12:00:00+00,21432,1989,3805,2135,415,5073,2984,149,4333,154,42469,270,13672,10688,6883,23421
2021-03-01 12:30:00+00,21318,1968,3806,2201,422,5071,2972,155,4546,100,42560,267,13947,10975,7169,23286
2021-03-01 13:00:00+00,20781,1784,3806,2314,468,5001,2978,134,4531,0,41797,262,14097,11119,7313,22565
2021-03-01 13:30:00+00,20160,1767,3809,2361,333,5000,2974,121,4334,44,40903,262,13811,10837,7028,21927
2021-03-01 14:00:00+00,19938,2002,3811,2425,322,5000,2970,116,4157,0,40741,266,13685,10715,6904,21940
2021-03-01 14:30:00+00,19835,2159,3811,2521,334,4984,2961,110,3713,0,40428,271,13340,10379,6568,21994
2021-03-01 15:00:00+00,20421,2126,3809,2490,470,4328,2972,117,3065,34,39832,279,12806,9834,6025,22547
2021-03-01 15:30:00+00,21047,1952,3811,2512,501,4594,2965,120,2262,0,39764,282,12051,9086,5275,22999
2021-03-01 16:00:00+00,21473,2156,3812,2511,559,4894,2963,160,1515,52,40095,288,11360,8397,4585,23629
2021-03-01 16:30:00+00,22030,2521,3811,2588,697,4906,2980,223,762,440,40958,297,10838,7858,4047,24551
2021-03-01 17:00:00+00,22241,2727,3811,2706,747,5074,2973,448,183,802,41712,302,10420,7447,3636,24968
2021-03-01 17:30:00+00,22151,2732,3813,2986,746,5076,2969,476,1,1344,42294,298,10515,7546,3733,24883
2021-03-01 18:00:00+00,22726,2342,3812,3157,748,5078,2983,535,0,1688,43069,290,10700,7717,3905,25068
2021-03-01 18:30:00+00,22621,2387,3811,3109,744,5078,2955,539,0,1390,42634,293,10619,7664,3853,25008
2021-03-01 19:00:00+00,22307,2198,3809,3166,712,5074,2953,512,0,950,41681,292,10640,7687,3878,24505
2021-03-01 19:30:00+00,21859,1721,3810,3252,832,5076,2984,458,0,778,40770,282,10878,7894,4084,23580
2021-03-01 20:00:00+00,21714,1493,3810,3226,658,5078,2984,387,0,586,39936,280,10678,7694,3884,23207
2021-03-01 20:30:00+00,21505,1415,3811,3195,529,5076,2987,173,0,0,38691,283,10522,7535,3724,22920
2021-03-01 21:00:00+00,20174,1056,3813,3175,389,5058,2953,131,0,0,36749,274,10330,7377,3564,21230
2021-03-01 21:30:00+00,19003,654,3813,3135,365,5058,2979,123,0,0,35130,263,10292,7313,3500,19657
2021-03-01 22:00:00+00,17362,391,3814,3176,324,5000,2979,120,0,0,33166,251,10293,7314,3500,17753
2021-03-01 22:30:00+00,16215,232,3814,3181,338,5000,2947,107,0,0,31834,242,10280,7333,3519,16447
2021-03-01 23:00:00+00,15518,230,3813,3071,338,4978,2945,108,0,0,31001,239,10167,7222,3409,15748
2021-03-01 23:30:00+00,14774,230,3813,2947,338,4978,2952,109,0,0,30141,236,10050,7098,3285,15004
2021-03-02 00:00:00+00,14697,230,3813,2971,337,5056,2965,123,0,0,30192,238,10086,7121,3308,14927
2021-03-02 00:30:00+00,15041,229,3813,2990,336,5058,2968,120,0,0,30555,239,10107,7139,3326,15270
2021-03-02 01:00:00+00,14761,231,3814,3004,294,5000,2965,106,0,0,30175,238,10077,7112,3298,14992
2021-03-02 01:30:00+00,14263,230,3812,2976,294,5000,2965,111,0,0,29651,235,10047,7082,3270,14493
2021-03-02 02:00:00+00,14151,230,3813,2726,294,5000,2914,117,0,0,29245,237,9747,6833,3020,14381
2021-03-02 02:30:00+00,14244,230,3809,2470,294,4998,2966,116,0,0,29127,239,9539,6573,2764,14474
2021-03-02 03:00:00+00,14016,230,3809,2264,266,5000,2972,107,0,0,28664,240,9311,6339,2530,14246
2021-03-02 03:30:00+00,13905,229,3810,2158,257,5000,2963,107,0,0,28428,241,9188,6224,2414,14134
2021-03-02 04:00:00+00,14019,230,3813,2149,257,4840,2940,110,0,0,28358,242,9159,6219,2406,14249
2021-03-02 04:30:00+00,14127,230,3814,2148,256,4778,2949,111,0,0,28414,243,9168,6218,2404,14357
2021-03-02 05:00:00+00,15619,230,3814,2146,257,3098,2932,116,0,0,28212,258,9149,6217,2403,15849
2021-03-02 05:30:00+00,16890,250,3815,2121,258,3044,2980,107,0,0,29465,264,9174,6194,2379,17140
2021-03-02 06:00:00+00,18166,254,3815,2100,272,3200,2972,174,0,0,30953,270,9159,6187,2372,18420
2021-03-02 06:30:00+00,19518,473,3812,2073,290,3234,2971,319,0,62,32752,279,9146,6175,2363,19991
2021-03-02 07:00:00+00,20597,862,3814,2036,293,4412,2961,258,35,0,35268,286,9139,6178,2364,21459
2021-03-02 07:30:00+00,21144,1285,3813,2025,353,4452,2970,335,252,102,36731,292,9413,6443,2630,22429
2021-03-02 08:00:00+00,21504,1547,3814,1894,552,5044,2974,376,574,344,38623,289,9808,6834,3020,23051
2021-03-02 08:30:00+00,21619,1934,3813,1721,595,5058,2976,423,920,740,39799,292,10025,7049,3236,23553
2021-03-02 09:00:00+00,21713,2127,3812,1580,750,5058,2971,494,1270,954,40729,291,10383,7412,3600,23840
2021-03-02 09:30:00+00,21760,2180,3811,1527,768,5058,2976,496,1701,760,41037,291,10783,7807,3996,23940
2021-03-02 10:00:00+00,21677,2441,3808,1522,750,5058,2946,430,2090,614,41336,293,11116,8170,4362,24118
2021-03-02 10:30:00+00,21658,2368,3811,1517,726,5058,2915,440,2496,656,41645,290,11465,8550,4739,24026
2021-03-02 11:00:00+00,21525,2333,3813,1437,651,5058,2922,427,2886,490,41542,289,11709,8787,4974,23858
2021-03-02 11:30:00+00,21469,2454,3813,1381,589,5058,2928,437,3310,156,41595,291,12021,9093,5280,23923
2021-03-02 12:00:00+00,21516,2547,3812,1376,560,5058,2931,467,3678,160,42105,291,12357,9426,5614,24063
2021-03-02 12:30:00+00,21438,2385,3813,1298,539,5058,2963,387,3930,182,41993,287,12543,9580,5767,23823
2021-03-02 13:00:00+00,21501,2256,3815,1201,363,5000,2969,344,4066,146,41661,285,12414,9445,5630,23757
2021-03-02 13:30:00+00,21437,2232,3816,1110,266,5000,2971,241,4107,0,41180,286,12270,9299,5483,23669
2021-03-02 14:00:00+00,21293,2222,3817,1018,259,5000,2969,172,3999,102,40851,287,12062,9093,5276,23515
2021-03-02 14:30:00+00,21291,2159,3818,945,275,5000,2968,153,3686,0,40295,289,11692,8724,4906,23450
2021-03-02 15:00:00+00,21151,2303,3812,933,230,5000,2976,158,3090,236,39889,294,11041,8065,4253,23454
2021-03-02 15:30:00+00,21581,2744,3817,937,339,5000,2973,153,2274,10,39828,309,10340,7367,3550,24325
2021-03-02 16:00:00+00,22052,2752,3816,910,551,5020,2937,275,1400,424,40137,313,9614,6677,2861,24804
2021-03-02 16:30:00+00,22298,3006,3817,855,745,5020,2949,424,636,942,40692,318,9002,6053,2236,25304
2021-03-02 17:00:00+00,22360,2786,3815,778,900,5078,2971,531,157,1612,40988,313,8621,5650,1835,25146
2021-03-02 17:30:00+00,22664,2883,3809,761,921,5078,2969,542,1,2082,41710,312,8461,5492,1683,25547
2021-03-02 18:00:00+00,23355,3093,3803,738,925,5078,2963,555,0,2086,42596,317,8429,5466,1663,26448
2021-03-02 18:30:00+00,23129,2975,3802,747,925,5078,2962,542,0,2086,42246,314,8436,5474,1672,26104
2021-03-02 19:00:00+00,22888,2956,3799,700,923,5078,2962,458,0,1604,41368,318,8384,5422,1623,25844
2021-03-02 19:30:00+00,23056,2856,3801,685,895,5078,2955,357,0,1064,40747,321,8336,5381,1580,25912
2021-03-02 20:00:00+00,23376,2361,3800,681,850,5078,2955,338,0,514,39953,319,8286,5331,1531,25737
2021-03-02 20:30:00+00,22562,2231,3800,688,828,5078,2947,228,0,62,38424,318,8263,5316,1516,24793
2021-03-02 21:00:00+00,21896,1929,3800,724,438,5058,2944,123,0,146,37058,313,7906,4962,1162,23825
2021-03-02 21:30:00+00,21047,1393,3801,746,366,5058,2946,108,0,0,35465,304,7859,4913,1112,22440
2021-03-02 22:00:00+00,19949,928,3803,759,262,4970,2908,108,0,0,33687,293,7732,4824,1021,20877
2021-03-02 22:30:00+00,18648,929,3803,770,260,4970,2860,110,0,0,32350,289,7693,4833,1030,19577
2021-03-02 23:00:00+00,18106,945,3802,751,261,5054,2353,114,0,0,31386,291,7167,4814,1012,19051
2021-03-02 23:30:00+00,17400,922,3804,746,260,5056,2088,107,0,0,30383,289,6898,4810,1006,18322
2021-03-03 00:00:00+00,17153,1152,3804,796,259,5058,2093,109,0,0,30424,294,6952,4859,1055,18305
2021-03-03 00:30:00+00,17503,1104,3803,749,258,5058,2233,111,0,0,30819,294,7043,4810,1007,18607
2021-03-03 01:00:00+00,17364,1057,3803,692,258,5048,2279,110,0,0,30612,292,7032,4753,950,18421
2021-03-03 01:30:00+00,17034,1130,3805,677,257,5044,2246,106,0,0,30299,293,6985,4739,934,18164
2021-03-03 02:00:00+00,16618,961,3804,690,257,4997,2248,107,0,0,29682,288,6999,4751,947,17579
2021-03-03 02:30:00+00,16663,919,3804,689,257,4997,2250,108,0,0,29687,288,7000,4750,946,17582
2021-03-03 03:00:00+00,16421,919,3804,653,242,4908,2254,108,0,0,29310,288,6953,4699,895,17340
2021-03-03 03:30:00+00,16096,919,3803,582,242,4899,2263,109,0,0,28913,287,6890,4627,824,17015
2021-03-03 04:00:00+00,15983,918,3804,584,227,4697,2272,107,0,0,28592,287,6887,4615,811,16901
2021-03-03 04:30:00+00,16030,920,3802,626,219,4685,2273,109,0,0,28664,286,6920,4647,845,16950
2021-03-03 05:00:00+00,17124,989,3802,651,217,4236,2276,108,0,0,29403,295,6946,4670,868,18113
2021-03-03 05:30:00+00,17813,1097,3803,695,224,4084,2269,108,0,0,30093,300,6991,4722,919,18910
2021-03-03 06:00:00+00,18837,1557,3806,753,271,3709,2501,109,0,0,31542,313,7331,4830,1024,20394
2021-03-03 06:30:00+00,20079,1726,3804,691,271,3994,2931,107,0,0,33603,316,7697,4766,962,21805
2021-03-03 07:00:00+00,21818,1544,3804,625,306,4830,2974,113,15,0,36029,312,7724,4750,946,23362
2021-03-03 07:30:00+00,23069,1707,3803,651,325,4854,2973,125,129,26,37662,316,7881,4908,1105,24776
2021-03-03 08:00:00+00,23722,1883,3804,691,599,5046,2969,365,349,0,39428,316,8412,5443,1639,25605
2021-03-03 08:30:00+00,23921,1865,3803,681,722,5040,2956,458,559,0,40005,314,8721,5765,1962,25786
2021-03-03 09:00:00+00,23981,1990,3805,638,749,5090,2969,475,917,816,41429,307,9078,6109,2304,25971
2021-03-03 09:30:00+00,23922,1996,3803,664,742,5074,2971,463,1116,976,41726,304,9296,6324,2522,25918
2021-03-03 10:00:00+00,23932,1998,3806,733,705,5072,2976,511,1536,520,41789,304,9756,6780,2974,25930
2021-03-03 10:30:00+00,23971,1999,3807,716,661,5058,2972,523,1663,528,41898,304,9819,6847,3040,25970
2021-03-03 11:00:00+00,23956,1999,3806,734,615,5066,2972,488,1602,480,41717,305,9729,6757,2951,25955
2021-03-03 11:30:00+00,23924,2001,3806,745,656,5058,2973,475,1933,552,42123,302,10113,7140,3334,25925
2021-03-03 12:00:00+00,23815,2023,3804,736,621,5058,2964,517,1740,1292,42570,298,9865,6901,3097,25838
2021-03-03 12:30:00+00,23799,2042,3804,745,617,5056,2967,499,1624,1190,42343,300,9757,6790,2986,25841
2021-03-03 13:00:00+00,23834,2101,3803,767,611,4812,2965,484,1494,966,41837,303,9640,6675,2872,25935
2021-03-03 13:30:00+00,23840,2233,3802,820,538,4810,2964,436,1175,534,41152,311,9299,6335,2533,26073
2021-03-03 14:00:00+00,23868,2290,3805,844,540,4998,2968,406,917,166,40802,317,9074,6106,2301,26158
2021-03-03 14:30:00+00,23638,2436,3821,840,547,5000,2970,367,828,288,40735,318,9006,6036,2215,26074
2021-03-03 15:00:00+00,23289,2856,3816,842,671,5000,2965,436,575,408,40858,324,8869,5904,2088,26145
2021-03-03 15:30:00+00,23635,3155,3804,873,751,5000,2922,473,490,152,41255,331,8840,5918,2114,26790
2021-03-03 16:00:00+00,23614,3219,3804,906,943,5020,2747,456,316,622,41647,329,8716,5969,2165,26833
2021-03-03 16:30:00+00,23536,3101,3808,907,909,5020,2833,482,168,1578,42342,320,8625,5792,1984,26637
2021-03-03 17:00:00+00,23918,3269,3819,941,952,5078,2908,431,41,1674,43031,323,8661,5753,1934,27187
2021-03-03 17:30:00+00,24042,3245,3826,1056,957,5076,2936,556,0,1672,43366,322,8775,5839,2013,27287
2021-03-03 18:00:00+00,24046,3209,3828,1058,973,5078,2946,676,0,1788,43602,321,8805,5859,2031,27255
2021-03-03 18:30:00+00,23738,2942,3833,1047,891,5076,2928,635,0,1812,42902,317,8699,5771,1938,26680
2021-03-03 19:00:00+00,23297,2895,3849,1054,822,5076,2927,449,0,1916,42285,314,8652,5725,1876,26192
2021-03-03 19:30:00+00,23167,2733,3850,1081,707,4420,2924,406,0,1898,41186,317,8562,5638,1788,25900
2021-03-03 20:00:00+00,23154,2428,3851,1146,719,4082,2917,397,0,808,39502,323,8633,5716,1865,25582
2021-03-03 20:30:00+00,22700,2205,3862,1238,748,4082,2913,295,0,108,38151,323,8761,5848,1986,24905
2021-03-03 21:00:00+00,21592,1735,3897,1274,655,4062,2866,192,0,306,36579,311,8692,5826,1929,23327
2021-03-03 21:30:00+00,20797,1428,3898,1328,522,4062,2879,149,0,0,35063,305,8627,5748,1850,22225
2021-03-03 22:00:00+00,20073,906,3897,1310,281,3990,2888,176,0,72,33593,294,8376,5488,1591,20979
2021-03-03 22:30:00+00,19038,493,3901,1413,274,4442,2829,119,0,0,32509,280,8417,5588,1687,19531
2021-03-03 23:00:00+00,17477,186,3924,1534,273,4558,2573,110,0,0,30635,267,8304,5731,1807,17663
2021-03-03 23:30:00+00,16632,0,3950,1546,269,4558,2345,108,0,0,29408,260,8110,5765,1815,16632
2021-03-04 00:00:00+00,16341,0,3960,1581,261,4556,2418,108,0,0,29225,258,8220,5802,1842,16341
2021-03-04 00:30:00+00,16530,0,3961,1659,266,4556,2601,109,0,0,29682,257,8487,5886,1925,16530
2021-03-04 01:00:00+00,16449,0,4017,1686,267,4500,2710,128,0,0,29757,256,8680,5970,1953,16449
2021-03-04 01:30:00+00,16228,0,4035,1801,267,4498,2595,128,0,0,29552,254,8698,6103,2068,16228
2021-03-04 02:00:00+00,15920,0,4039,1951,268,4498,2233,120,0,0,29029,253,8491,6258,2219,15920
2021-03-04 02:30:00+00,15694,0,4040,1999,267,4498,2158,109,0,0,28765,251,8464,6306,2266,15694
2021-03-04 03:00:00+00,15664,0,4039,2060,248,4500,2163,109,0,0,28783,251,8510,6347,2308,15664
2021-03-04 03:30:00+00,15057,0,4038,2224,248,4498,2218,109,0,0,28392,246,8728,6510,2472,15057
2021-03-04 04:00:00+00,14795,0,4039,2432,247,4498,2242,112,0,0,28365,243,8960,6718,2679,14795
2021-03-04 04:30:00+00,14883,0,4037,2311,248,4496,2329,109,0,0,28413,244,8925,6596,2559,14883
2021-03-04 05:00:00+00,15286,0,4038,2347,248,4378,2478,108,0,0,28883,246,9111,6633,2595,15286
2021-03-04 05:30:00+00,15640,0,4036,2591,247,4378,2473,121,0,0,29486,245,9347,6874,2838,15640
2021-03-04 06:00:00+00,16864,134,4041,2561,264,4416,2523,112,0,0,30915,254,9389,6866,2825,16998
2021-03-04 06:30:00+00,18458,377,4039,2697,267,4414,2367,112,0,0,32731,266,9370,7003,2964,18835
2021-03-04 07:00:00+00,20308,683,4036,2713,298,4264,2579,113,28,84,35106,276,9654,7075,3039,20991
2021-03-04 07:30:00+00,21115,1055,4037,2949,317,4260,2729,246,154,0,36862,282,10186,7457,3420,22170
2021-03-04 08:00:00+00,21701,1371,4035,2973,356,4550,2903,316,382,44,38631,286,10649,7746,3711,23072
2021-03-04 08:30:00+00,22433,1491,4035,2983,357,4558,2949,315,632,20,39773,288,10956,8007,3972,23924
2021-03-04 09:00:00+00,22565,1437,4037,3058,670,4558,2933,348,785,0,40391,284,11483,8550,4513,24002
2021-03-04 09:30:00+00,22544,1318,4044,3238,724,4558,2937,371,995,0,40729,279,11938,9001,4957,23862
2021-03-04 10:00:00+00,22525,1280,4043,3555,719,4558,2931,316,1415,0,41342,273,12663,9732,5689,23805
2021-03-04 10:30:00+00,22524,1290,4050,3984,528,4558,2937,237,1404,0,41512,272,12903,9966,5916,23814
2021-03-04 11:00:00+00,22643,1326,4045,4089,509,4558,2938,221,1456,76,41861,271,13037,10099,6054,23969
2021-03-04 11:30:00+00,22489,1329,4044,4449,477,4558,2948,325,1532,0,42151,269,13450,10502,6458,23818
2021-03-04 12:00:00+00,22379,1295,4044,4970,693,4558,2953,332,1333,44,42601,264,13993,11040,6996,23674
2021-03-04 12:30:00+00,22318,1105,4044,5180,616,4558,2918,273,1492,256,42760,258,14250,11332,7288,23423
2021-03-04 13:00:00+00,22231,950,4083,5428,610,4500,2945,231,1575,44,42597,254,14641,11696,7613,23181
2021-03-04 13:30:00+00,21762,885,4138,5647,477,4498,2936,132,1640,0,42115,250,14838,11902,7764,22647
2021-03-04 14:00:00+00,21524,950,4137,5845,330,4500,2921,112,1607,0,41926,250,14840,11919,7782,22474
2021-03-04 14:30:00+00,21515,819,4135,5771,320,4500,2929,116,1155,0,41260,252,14310,11381,7246,22334
2021-03-04 15:00:00+00,21409,772,4141,5900,317,4500,2922,112,938,0,41011,251,14218,11296,7155,22181
2021-03-04 15:30:00+00,21001,775,4136,6671,324,4500,2910,119,559,0,40995,247,14600,11690,7554,21776
2021-03-04 16:00:00+00,21016,794,4132,7230,345,4518,2775,220,302,16,41348,246,14784,12009,7877,21810
2021-03-04 16:30:00+00,21844,796,4133,7004,402,4520,2873,292,178,140,42182,250,14590,11717,7584,22640
2021-03-04 17:00:00+00,22034,781,4136,7165,664,4576,2906,302,41,582,43187,246,14912,12006,7870,22815
2021-03-04 17:30:00+00,22275,782,4130,8031,800,4576,2928,270,0,616,44408,241,15889,12961,8831,23057
2021-03-04 18:00:00+00,22497,805,4037,8098,775,4378,2931,372,0,1108,45001,241,15841,12910,8873,23302
2021-03-04 18:30:00+00,22482,780,3980,7856,794,4374,2976,388,0,834,44464,243,15606,12630,8650,23262
2021-03-04 19:00:00+00,22237,775,3984,7792,705,4386,2981,315,0,0,43175,248,15462,12481,8497,23012
2021-03-04 19:30:00+00,21342,779,3980,7565,593,4386,2987,138,0,80,41850,246,15125,12138,8158,22121
2021-03-04 20:00:00+00,20604,790,3981,7312,464,4526,2979,111,0,102,40869,245,14736,11757,7776,21394
2021-03-04 20:30:00+00,19497,672,3980,7196,414,4528,2953,112,0,28,39380,240,14543,11590,7610,20169
2021-03-04 21:00:00+00,18550,181,3980,6822,327,4558,2975,107,0,0,37500,230,14104,11129,7149,18731
2021-03-04 21:30:00+00,17239,0,3982,6669,283,4554,2910,108,0,0,35745,222,13844,10934,6952,17239
2021-03-04 22:00:00+00,15658,0,3984,6661,255,4370,2925,107,0,0,33960,215,13825,10900,6916,15658
2021-03-04 22:30:00+00,14361,0,3985,6485,251,4366,2896,111,0,0,32455,209,13617,10721,6736,14361
2021-03-04 23:00:00+00,13530,0,3990,6614,249,4366,2647,126,0,0,31522,205,13500,10853,6863,13530
2021-03-04 23:30:00+00,13379,0,3990,6444,248,4362,2218,124,0,0,30765,206,12900,10682,6692,13379
2021-03-05 00:00:00+00,13281,0,3989,6278,230,4434,2156,107,0,0,30475,204,12653,10497,6508,13281
2021-03-05 00:30:00+00,13816,0,3990,6011,227,4442,2149,110,0,0,30745,209,12377,10228,6238,13816
2021-03-05 01:00:00+00,13555,0,4069,5704,225,4496,2146,107,0,0,30302,209,12144,9998,5929,13555
2021-03-05 01:30:00+00,13265,0,4101,5461,222,4500,2183,107,0,0,29839,208,11967,9784,5683,13265
2021-03-05 02:00:00+00,13077,0,4098,5325,219,4500,2217,108,0,0,29544,208,11859,9642,5544,13077
2021-03-05 02:30:00+00,12889,0,4103,5497,219,4500,2168,110,0,0,29486,206,11987,9819,5716,12889
2021-03-05 03:00:00+00,12663,0,4103,5286,207,4500,2160,106,0,0,29025,206,11756,9596,5493,12663
2021-03-05 03:30:00+00,12090,0,4105,5408,203,4496,2164,106,0,0,28572,201,11880,9716,5611,12090
2021-03-05 04:00:00+00,12279,0,4121,5174,202,4406,2162,107,0,0,28451,204,11659,9497,5376,12279
2021-03-05 04:30:00+00,12541,17,4139,5171,201,4402,2161,107,0,0,28739,206,11672,9511,5372,12558
2021-03-05 05:00:00+00,13639,92,4141,4972,201,3548,2165,107,0,0,28865,219,11479,9314,5173,13731
2021-03-05 05:30:00+00,14384,154,4138,4739,202,3518,2165,110,0,0,29410,227,11244,9079,4941,14538
2021-03-05 06:00:00+00,17285,211,4138,4592,225,2070,2194,107,0,0,30822,253,11149,8955,4817,17496
2021-03-05 06:30:00+00,18593,403,4136,4335,250,2028,2687,111,0,74,32617,262,11408,8721,4585,18996
2021-03-05 07:00:00+00,19812,576,4136,4582,335,2560,2951,113,138,52,35255,262,12142,9191,5055,20388
2021-03-05 07:30:00+00,20546,627,4133,4315,351,2586,2947,258,520,354,36637,263,12266,9319,5186,21173
2021-03-05 08:00:00+00,20743,915,4133,3806,361,4256,2965,383,1142,124,38828,263,12407,9442,5309,21658
2021-03-05 08:30:00+00,20876,1477,4135,3866,369,4302,2967,222,1759,28,40001,268,13096,10129,5994,22353
2021-03-05 09:00:00+00,21242,1767,4136,3730,386,4314,2965,115,2113,30,40798,272,13330,10365,6229,23009
2021-03-05 09:30:00+00,21520,1815,4134,3790,362,4324,2966,117,2499,72,41599,271,13751,10785,6651,23335
2021-03-05 10:00:00+00,21251,2036,4136,3508,338,4546,2966,116,2553,80,41530,274,13501,10535,6399,23287
2021-03-05 10:30:00+00,21244,2205,4141,3325,359,4558,2961,139,2783,164,41879,276,13569,10608,6467,23449
2021-03-05 11:00:00+00,21373,2150,4140,3284,480,4558,2961,166,2895,104,42111,274,13760,10799,6659,23523
2021-03-05 11:30:00+00,21384,2309,4140,3143,617,4558,2960,151,2813,0,42075,278,13673,10713,6573,23693
2021-03-05 12:00:00+00,21501,2513,4038,2945,713,4558,2976,296,2772,28,42340,283,13444,10468,6430,24014
2021-03-05 12:30:00+00,21564,2458,3920,3075,683,4558,2983,363,3045,0,42649,281,13706,10723,6803,24022
2021-03-05 13:00:00+00,21540,2448,3901,3055,457,4500,2990,237,2906,226,42260,282,13309,10319,6418,23988
2021-03-05 13:30:00+00,21449,2678,3913,2823,302,4500,2992,178,2749,22,41606,290,12779,9787,5874,24127
2021-03-05 14:00:00+00,21434,2755,3790,2765,295,4500,2977,127,2405,132,41180,294,12232,9255,5465,24189
2021-03-05 14:30:00+00,21427,2679,3786,2628,337,4500,2889,119,2393,184,40942,294,12033,9144,5358,24106
2021-03-05 15:00:00+00,21649,3019,3785,2608,342,4500,2790,136,2102,0,40931,304,11627,8837,5052,24668
2021-03-05 15:30:00+00,21749,3163,3783,2434,394,4500,2782,139,1524,0,40468,311,10917,8135,4352,24912
2021-03-05 16:00:00+00,21723,3159,3781,2402,527,4520,2792,207,1025,16,40152,315,10527,7735,3954,24882
2021-03-05 16:30:00+00,21808,3198,3781,2267,617,4520,2969,325,517,354,40356,317,10151,7182,3401,25006
2021-03-05 17:00:00+00,21672,3132,3784,2262,857,4578,2980,421,159,1208,41053,312,10042,7062,3278,24804
2021-03-05 17:30:00+00,22324,3207,3783,2205,857,4578,2989,413,7,1598,41961,313,9841,6852,3069,25531
2021-03-05 18:00:00+00,22757,3257,3784,2065,890,4600,3004,449,0,1882,42688,313,9743,6739,2955,26014
2021-03-05 18:30:00+00,22688,3379,3785,2090,954,4578,3003,417,0,1814,42708,314,9832,6829,3044,26067
2021-03-05 19:00:00+00,22441,3365,3787,2012,881,4578,2997,424,0,1022,41507,320,9677,6680,2893,25806
2021-03-05 19:30:00+00,21987,3459,3784,1858,833,4578,3001,401,0,496,40397,326,9476,6475,2691,25446
2021-03-05 20:00:00+00,21703,3420,3784,1665,739,4578,3001,202,0,0,39092,330,9189,6188,2404,25123
2021-03-05 20:30:00+00,20987,3107,3784,1638,528,4578,3003,118,0,182,37926,324,8954,5950,2166,24094
2021-03-05 21:00:00+00,20482,2526,3785,1577,347,4558,2999,107,0,18,36399,317,8708,5709,1924,23008
2021-03-05 21:30:00+00,19573,1995,3785,1670,306,4558,3000,108,0,12,35007,305,8761,5761,1976,21568
2021-03-05 22:00:00+00,18872,1323,3785,1624,256,4500,2977,107,0,0,33444,292,8642,5665,1880,20195
2021-03-05 22:30:00+00,17581,706,3763,1802,255,4500,2902,106,0,28,31643,274,8722,5820,2057,18287
2021-03-05 23:00:00+00,17014,381,3758,1723,255,4558,2481,106,0,0,30276,268,8217,5736,1978,17395
2021-03-05 23:30:00+00,16341,210,3747,1770,255,4558,2144,106,0,0,29131,262,7916,5772,2025,16551
2021-03-06 00:00:00+00,16417,0,3732,1855,247,4558,2135,107,0,0,29051,255,7969,5834,2102,16417
2021-03-06 00:30:00+00,16704,0,3715,1928,246,4556,2137,108,0,0,29394,256,8026,5889,2174,16704
2021-03-06 01:00:00+00,16811,0,3700,1881,246,4500,2134,107,0,0,29379,257,7961,5827,2127,16811
2021-03-06 01:30:00+00,16683,0,3687,1556,244,4500,2165,111,0,0,28946,259,7652,5487,1800,16683
2021-03-06 02:00:00+00,16241,0,3673,1501,243,4500,2407,108,0,0,28673,257,7824,5417,1744,16241
2021-03-06 02:30:00+00,16141,0,3660,1453,230,4500,2428,107,0,0,28519,257,7771,5343,1683,16141
2021-03-06 03:00:00+00,16420,0,3645,1418,222,4502,2168,108,0,0,28483,260,7453,5285,1640,16420
2021-03-06 03:30:00+00,16153,0,3632,1433,221,4502,2143,106,0,0,28190,259,7429,5286,1654,16153
2021-03-06 04:00:00+00,16017,0,3621,1394,222,4502,2150,107,0,0,28013,258,7387,5237,1616,16017
2021-03-06 04:30:00+00,15919,0,3614,1321,222,4500,2143,105,0,0,27824,259,7300,5157,1543,15919
2021-03-06 05:00:00+00,16121,0,3602,1351,221,4502,2150,107,0,0,28054,259,7324,5174,1572,16121
2021-03-06 05:30:00+00,16282,0,3588,1385,220,4500,2303,106,0,0,28384,259,7496,5193,1605,16282
2021-03-06 06:00:00+00,16796,0,3573,1355,235,4500,2471,106,0,0,29036,261,7634,5163,1590,16796
2021-03-06 06:30:00+00,17107,0,3554,1388,252,4502,2314,107,5,0,29229,263,7513,5199,1645,17107
2021-03-06 07:00:00+00,17702,52,3540,1294,278,4502,2233,112,173,0,29887,266,7518,5285,1745,17754
2021-03-06 07:30:00+00,18349,105,3522,1350,282,4500,2279,109,624,0,31120,266,8057,5778,2256,18454
2021-03-06 08:00:00+00,19140,365,3504,1295,333,4500,2282,148,1229,26,32822,269,8643,6361,2857,19505
2021-03-06 08:30:00+00,19350,483,3484,1267,425,4500,2281,311,1922,10,34033,267,9379,7098,3614,19833
2021-03-06 09:00:00+00,19364,499,3469,1286,613,4556,2278,385,2408,138,34996,262,10054,7776,4307,19863
2021-03-06 09:30:00+00,19437,517,3469,1410,555,4558,2276,369,2894,138,35623,259,10604,8328,4859,19954
2021-03-06 10:00:00+00,19480,752,3477,1526,495,4558,2275,367,3264,138,36332,260,11037,8762,5285,20232
2021-03-06 10:30:00+00,19404,951,3483,1712,586,4558,2234,334,3367,16,36645,262,11382,9148,5665,20355
2021-03-06 11:00:00+00,19390,989,3488,1752,541,4558,2235,244,3394,138,36729,261,11410,9175,5687,20379
2021-03-06 11:30:00+00,19349,987,3507,1738,701,4558,2229,238,3422,66,36795,260,11597,9368,5861,20336
2021-03-06 12:00:00+00,19268,1062,3526,1797,694,4558,2231,320,3637,70,37163,259,11885,9654,6128,20330
2021-03-06 12:30:00+00,19203,1248,3546,1873,604,4558,2231,323,3842,0,37428,261,12096,9865,6319,20451
2021-03-06 13:00:00+00,19309,1299,3560,1917,335,4558,2265,254,4131,0,37628,262,12208,9943,6383,20608
2021-03-06 13:30:00+00,19057,1249,3576,1964,299,4558,2265,194,3958,0,37120,261,12062,9797,6221,20306
2021-03-06 14:00:00+00,18959,1205,3593,1921,307,4500,2265,146,3736,72,36704,260,11822,9557,5964,20164
2021-03-06 14:30:00+00,18870,1210,3608,1957,307,4500,2258,144,3367,0,36221,263,11497,9239,5631,20080
2021-03-06 15:00:00+00,18690,1271,3623,2051,359,4500,2262,143,2917,0,35816,265,11212,8950,5327,19961
2021-03-06 15:30:00+00,19044,1354,3636,1955,382,4500,2269,145,2288,18,35591,273,10530,8261,4625,20398
2021-03-06 16:00:00+00,19645,1463,3650,1900,495,4520,2266,235,1661,550,36385,277,9972,7706,4056,21108
2021-03-06 16:30:00+00,20245,1498,3664,1863,592,4520,2267,290,847,1280,37066,280,9233,6966,3302,21743
2021-03-06 17:00:00+00,21124,1960,3681,1821,828,4576,2286,474,281,1602,38633,292,8897,6611,2930,23084
2021-03-06 17:30:00+00,21337,2266,3693,1808,922,4578,2298,483,18,1686,39089,298,8739,6441,2748,23603
2021-03-06 18:00:00+00,22430,2298,3707,1909,940,4578,2272,503,0,1634,40271,301,8828,6556,2849,24728
2021-03-06 18:30:00+00,22308,2289,3722,1984,938,4578,2306,496,0,1722,40343,299,8950,6644,2922,24597
2021-03-06 19:00:00+00,22029,2286,3737,1976,912,4578,2316,500,0,1508,39842,300,8941,6625,2888,24315
2021-03-06 19:30:00+00,21875,2260,3755,1966,741,4578,2318,449,0,778,38720,306,8780,6462,2707,24135
2021-03-06 20:00:00+00,21416,1986,3766,2033,488,4578,2322,350,0,356,37295,304,8609,6287,2521,23402
2021-03-06 20:30:00+00,20428,1979,3775,2044,447,4578,2319,330,0,348,36248,302,8585,6266,2491,22407
2021-03-06 21:00:00+00,19623,1873,3788,2058,391,4558,2318,395,0,62,35066,301,8555,6237,2449,21496
2021-03-06 21:30:00+00,19134,1410,3798,2192,350,4558,2311,306,0,0,34059,291,8651,6340,2542,20544
2021-03-06 22:00:00+00,18521,911,3802,2258,255,4502,2215,106,0,0,32570,279,8530,6315,2513,19432
2021-03-06 22:30:00+00,17736,392,3805,2205,249,4500,2214,119,0,34,31254,265,8473,6259,2454,18128
2021-03-06 23:00:00+00,16811,30,3804,2197,254,4500,2132,106,0,0,29834,254,8387,6255,2451,16841
2021-03-06 23:30:00+00,16081,0,3804,2236,252,4500,1893,105,0,0,28871,250,8185,6292,2488,16081
2021-03-07 00:00:00+00,15877,0,3804,2324,245,4500,1724,105,0,0,28579,250,8097,6373,2569,15877
2021-03-07 00:30:00+00,15981,0,3803,2331,244,4498,1809,107,0,0,28773,250,8187,6378,2575,15981
2021-03-07 01:00:00+00,15784,0,3792,2334,243,4310,2009,106,0,0,28578,249,8378,6369,2577,15784
2021-03-07 01:30:00+00,15610,0,3797,2426,241,4306,1852,107,0,0,28339,248,8316,6464,2667,15610
2021-03-07 02:00:00+00,15320,0,3803,2514,224,4308,1751,108,0,0,28028,246,8292,6541,2738,15320
2021-03-07 02:30:00+00,15219,0,3803,2550,225,4308,1695,107,0,0,27907,246,8273,6578,2775,15219
2021-03-07 03:00:00+00,14781,0,3804,2530,225,4308,1632,105,0,0,27385,244,8191,6559,2755,14781
2021-03-07 03:30:00+00,14703,0,3802,2553,230,4072,1622,106,0,0,27088,245,8207,6585,2783,14703
2021-03-07 04:00:00+00,14750,0,3804,2487,229,4072,1627,106,0,0,27075,246,8147,6520,2716,14750
2021-03-07 04:30:00+00,14738,0,3808,2438,228,4072,1645,108,0,0,27037,246,8119,6474,2666,14738
2021-03-07 05:00:00+00,14812,0,3817,2387,227,4072,1606,106,0,0,27027,247,8037,6431,2614,14812
2021-03-07 05:30:00+00,14867,0,3814,2328,228,4072,1616,107,0,0,27032,248,7986,6370,2556,14867
2021-03-07 06:00:00+00,15331,0,3815,2242,241,4344,1884,105,0,0,27962,248,8182,6298,2483,15331
2021-03-07 06:30:00+00,15184,0,3816,2129,240,4354,2261,107,5,0,28096,246,8451,6190,2374,15184
2021-03-07 07:00:00+00,15436,0,3814,2082,240,4496,2337,109,169,0,28683,246,8642,6305,2491,15436
2021-03-07 07:30:00+00,15867,0,3812,2066,242,4502,2392,111,540,0,29532,245,9052,6660,2848,15867
2021-03-07 08:00:00+00,16286,0,3811,2015,308,4500,2446,111,1085,0,30562,242,9665,7219,3408,16286
2021-03-07 08:30:00+00,16796,70,3808,1934,313,4498,2706,111,1797,2,32035,240,10558,7852,4044,16866
2021-03-07 09:00:00+00,17560,141,3808,1852,350,4434,2888,113,2383,0,33529,240,11281,8393,4585,17701
2021-03-07 09:30:00+00,17677,383,3806,1840,349,4434,2930,185,2953,0,34557,242,11878,8948,5142,18060
2021-03-07 10:00:00+00,17577,501,3808,1793,405,4532,2932,235,3302,16,35101,242,12240,9308,5500,18078
2021-03-07 10:30:00+00,17590,924,3810,1578,575,4534,2900,196,3757,0,35864,248,12620,9720,5910,18514
2021-03-07 11:00:00+00,17606,1303,3808,1523,314,4558,2924,110,4176,0,36322,254,12745,9821,6013,18909
2021-03-07 11:30:00+00,17544,1520,3809,1563,313,4558,2923,109,4699,0,37038,254,13307,10384,6575,19064
2021-03-07 12:00:00+00,17618,1682,3808,1638,315,4558,2925,115,5072,0,37731,254,13758,10833,7025,19300
2021-03-07 12:30:00+00,17651,1450,3812,1698,317,4558,2922,113,5117,0,37638,249,13866,10944,7132,19101
2021-03-07 13:00:00+00,17482,1226,3814,1769,296,4558,2922,115,5316,0,37498,243,14117,11195,7381,18708
2021-03-07 13:30:00+00,16813,1201,3815,1904,297,4558,2924,111,5234,0,36857,239,14174,11250,7435,18014
2021-03-07 14:00:00+00,16716,1030,3815,2029,298,4500,2922,111,4842,0,36263,237,13906,10984,7169,17746
2021-03-07 14:30:00+00,17081,929,3814,2057,301,4500,2812,111,4378,14,35997,240,13362,10550,6736,18010
2021-03-07 15:00:00+00,17507,1011,3815,1974,324,4500,2882,140,3577,248,35978,247,12572,9690,5875,18518
2021-03-07 15:30:00+00,18374,1341,3815,1958,326,4500,2913,220,2863,198,36508,262,11875,8962,5147,19715
2021-03-07 16:00:00+00,19233,1628,3813,1899,345,4520,2916,262,2084,348,37048,275,11057,8141,4328,20861
2021-03-07 16:30:00+00,20317,1661,3810,1787,507,4520,2924,390,1209,984,38109,280,10237,7313,3503,21978
2021-03-07 17:00:00+00,21485,1607,3813,1821,914,4580,2920,493,386,1174,39193,285,9854,6934,3121,23092
2021-03-07 17:30:00+00,21913,1664,3809,1784,921,4580,2926,496,30,1460,39582,288,9470,6544,2734,23577
2021-03-07 18:00:00+00,22610,1661,3808,1847,922,4578,2925,498,0,1836,40685,287,9502,6577,2769,24271
2021-03-07 18:30:00+00,22725,1783,3806,1809,922,4578,2915,499,0,1690,40727,291,9452,6537,2731,24508
2021-03-07 19:00:00+00,22121,1797,3806,1841,897,4578,2902,494,0,1262,39698,293,9446,6544,2738,23918
2021-03-07 19:30:00+00,21301,1917,3807,2002,760,4578,2907,366,0,986,38624,294,9476,6569,2762,23218
2021-03-07 20:00:00+00,21227,1612,3805,2076,577,4580,2918,292,0,830,37917,290,9376,6458,2653,22839
2021-03-07 20:30:00+00,20630,1576,3809,2172,509,4578,2920,247,0,132,36573,293,9410,6490,2681,22206
2021-03-07 21:00:00+00,20000,1292,3809,2270,298,4558,2920,185,0,0,35332,288,9297,6377,2568,21292
2021-03-07 21:30:00+00,18970,899,3808,2206,277,4560,2922,122,0,0,33764,278,9213,6291,2483,19869
2021-03-07 22:00:00+00,17659,596,3810,2212,259,4500,2920,107,0,34,32097,266,9201,6281,2471,18255
2021-03-07 22:30:00+00,16519,280,3808,2347,259,4500,2925,119,0,0,30757,254,9339,6414,2606,16799
2021-03-07 23:00:00+00,15178,0,3810,2459,257,4450,2944,106,0,0,29204,240,9470,6526,2716,15178
2021-03-07 23:30:00+00,14265,0,3809,2613,250,4450,2944,106,0,0,28437,234,9616,6672,2863,14265
2021-03-08 00:00:00+00,14312,0,3805,2692,247,4304,2944,106,0,0,28410,237,9688,6744,2939,14312
2021-03-08 00:30:00+00,14503,0,3806,2786,245,4304,2948,108,0,0,28700,237,9785,6837,3031,14503
2021-03-08 01:00:00+00,14455,0,3808,2877,223,4304,2931,107,0,0,28705,236,9839,6908,3100,14455
2021-03-08 01:30:00+00,13926,0,3808,3015,220,4304,2925,113,0,0,28311,232,9968,7043,3235,13926
2021-03-08 02:00:00+00,13540,0,3810,3276,202,4304,2926,109,0,0,28167,228,10214,7288,3478,13540
2021-03-08 02:30:00+00,13055,0,3805,3444,203,4300,2926,110,0,0,27843,224,10378,7452,3647,13055
2021-03-08 03:00:00+00,12737,0,3807,3483,203,4304,2928,111,0,0,27573,221,10421,7493,3686,12737
2021-03-08 03:30:00+00,12851,0,3812,3624,203,4300,2926,110,0,0,27826,221,10565,7639,3827,12851
2021-03-08 04:00:00+00,12671,0,3809,3778,203,4004,2929,110,0,0,27504,220,10719,7790,3981,12671
2021-03-08 04:30:00+00,12748,0,3817,3931,203,3970,2926,112,0,0,27707,220,10877,7951,4134,12748
2021-03-08 05:00:00+00,13139,0,3820,3969,204,3194,2832,109,0,0,27267,225,10825,7993,4173,13139
2021-03-08 05:30:00+00,14023,139,3828,4217,203,3158,2616,109,0,0,28293,233,10864,8248,4420,14162
2021-03-08 06:00:00+00,15554,365,3828,4409,224,3524,2653,113,0,0,30670,243,11114,8461,4633,15919
2021-03-08 06:30:00+00,17074,654,3828,4537,228,3534,2635,108,3,0,32601,255,11231,8596,4768,17728
2021-03-08 07:00:00+00,19183,881,3828,4461,250,3388,2840,118,134,126,35209,265,11513,8673,4845,20064
2021-03-08 07:30:00+00,20303,1161,3829,4359,257,3384,2907,117,471,20,36808,273,11823,8916,5087,21464
2021-03-08 08:00:00+00,20518,1196,3826,4544,334,4520,2917,166,929,0,38950,266,12550,9633,5807,21714
2021-03-08 08:30:00+00,20869,1222,3827,4654,337,4558,2876,265,1549,0,40157,263,13243,10367,6540,22091
2021-03-08 09:00:00+00,21067,1224,3824,4663,378,4528,2922,337,2014,0,40957,260,13801,10879,7055,22291
2021-03-08 09:30:00+00,20921,1221,3823,4663,457,4528,2924,315,2469,0,41321,256,14336,11412,7589,22142
2021-03-08 10:00:00+00,20686,1219,3828,4753,413,4558,2915,153,2895,0,41420,252,14804,11889,8061,21905
2021-03-08 10:30:00+00,20413,1218,3824,4926,360,4558,2911,110,3754,0,42074,245,15775,12864,9040,21631
2021-03-08 11:00:00+00,19995,1135,3824,4838,359,4558,2921,115,4064,42,41851,241,16006,13085,9261,21130
2021-03-08 11:30:00+00,19914,1220,3822,4763,339,4558,2922,111,4139,0,41788,242,15985,13063,9241,21134
2021-03-08 12:00:00+00,20068,1218,3823,4813,338,4558,2918,110,4101,0,41947,243,15993,13075,9252,21286
2021-03-08 12:30:00+00,19507,1017,3824,5017,342,4558,2921,110,3982,0,41278,237,16086,13165,9341,20524
2021-03-08 13:00:00+00,19084,728,3824,4982,337,4500,2919,113,3721,176,40384,231,15783,12864,9040,19812
2021-03-08 13:30:00+00,19681,694,3830,4989,337,4500,2882,107,3619,84,40723,234,15657,12775,8945,20375
2021-03-08 14:00:00+00,19250,691,3830,5149,346,4400,2849,110,3459,0,40084,232,15633,12784,8954,19941
2021-03-08 14:30:00+00,18805,790,3830,5297,349,4400,2802,111,3202,0,39586,233,15480,12678,8848,19595
2021-03-08 15:00:00+00,18424,985,3829,5297,369,4498,2831,113,2830,0,39176,237,15156,12325,8496,19409
2021-03-08 15:30:00+00,18822,1144,3826,5217,395,4500,2889,174,2331,142,39440,244,14658,11769,7943,19966
2021-03-08 16:00:00+00,19740,1300,3831,5088,488,4520,2898,185,1837,226,40113,253,14142,11244,7413,21040
2021-03-08 16:30:00+00,20031,1523,3825,5239,517,4520,2909,276,1095,492,40427,260,13585,10676,6851,21554
2021-03-08 17:00:00+00,19944,1691,3823,5374,945,4456,2882,339,412,1238,41104,259,13436,10554,6731,21635
2021-03-08 17:30:00+00,20818,1693,3826,5279,948,4522,2919,285,37,1616,41943,262,13009,10090,6264,22511
2021-03-08 18:00:00+00,21367,1719,3822,5244,950,4782,2920,309,0,2004,43117,264,12936,10016,6194,23086
2021-03-08 18:30:00+00,21071,1615,3827,5632,947,4922,2918,501,0,1990,43424,260,13324,10406,6580,22686
2021-03-08 19:00:00+00,20609,1568,3825,5745,940,4824,2917,418,0,1518,42364,259,13427,10510,6685,22177
2021-03-08 19:30:00+00,20265,1531,3826,5647,873,4674,2919,205,0,660,40600,263,13265,10346,6520,21796
2021-03-08 20:00:00+00,20433,1538,3823,5549,373,4578,2918,158,0,346,39716,269,12663,9745,5922,21971
2021-03-08 20:30:00+00,19546,1423,3826,5276,335,4578,2918,121,0,0,38023,268,12355,9437,5611,20969
2021-03-08 21:00:00+00,18211,1041,3827,5183,273,4558,2904,108,0,0,36105,257,12187,9283,5456,19252
2021-03-08 21:30:00+00,16770,558,3827,5141,270,4558,2901,109,0,36,34170,242,12139,9238,5411,17328
2021-03-08 22:00:00+00,15449,216,3830,5185,269,4484,2898,109,0,24,32464,228,12182,9284,5454,15665
2021-03-08 22:30:00+00,14122,0,3829,5193,269,4482,2913,107,0,80,30995,215,12204,9291,5462,14122
2021-03-08 23:00:00+00,13032,0,3829,4971,269,4186,2914,107,0,226,29534,210,11983,9069,5240,13032
2021-03-08 23:30:00+00,12415,0,3828,4772,268,4180,2919,107,0,48,28537,209,11787,8868,5040,12415
2021-03-09 00:00:00+00,12157,0,3828,4927,250,4370,2916,107,0,0,28555,206,11921,9005,5177,12157
2021-03-09 00:30:00+00,12738,0,3824,4534,250,4386,2926,109,0,62,28829,212,11534,8608,4784,12738
2021-03-09 01:00:00+00,12835,0,3821,4198,249,4403,2922,108,0,0,28535,216,11190,8268,4447,12835
2021-03-09 01:30:00+00,12258,0,3824,4262,246,4404,2921,107,0,0,28022,212,11253,8332,4508,12258
2021-03-09 02:00:00+00,12148,0,3824,4289,230,4327,2920,108,0,0,27846,211,11263,8343,4519,12148
2021-03-09 02:30:00+00,11962,0,3826,4229,230,4319,2923,108,0,0,27597,211,11208,8285,4459,11962
2021-03-09 03:00:00+00,12246,0,3824,4271,228,4005,2926,107,0,0,27607,211,11249,8323,4499,12246
2021-03-09 03:30:00+00,11860,0,3824,4338,229,3993,2923,107,0,0,27274,208,11314,8391,4567,11860
2021-03-09 04:00:00+00,12089,0,3828,4444,228,3135,2916,107,0,0,26746,207,11416,8500,4672,12089
2021-03-09 04:30:00+00,12511,0,3833,4497,229,3110,2923,108,0,0,27210,210,11482,8559,4726,12511
2021-03-09 05:00:00+00,14210,0,3838,4414,246,2709,2927,109,0,0,28454,222,11425,8498,4660,14210
2021-03-09 05:30:00+00,15228,0,3837,4352,245,2519,2924,130,0,58,29293,228,11358,8434,4597,15228
2021-03-09 06:00:00+00,18176,0,3836,4322,268,2505,2921,301,0,76,32405,245,11347,8426,4590,18176
2021-03-09 06:30:00+00,19458,0,3834,4511,403,2490,2925,364,40,326,34351,246,11713,8788,4954,19458
2021-03-09 07:00:00+00,19782,2,3836,4370,649,3125,2920,447,502,352,35985,239,12277,9357,5521,19784
2021-03-09 07:30:00+00,20054,181,3835,4249,658,3259,2920,450,1374,558,37538,237,13036,10116,6281,20235
2021-03-09 08:00:00+00,19809,329,3837,4526,682,3478,2911,344,2210,426,38552,231,14166,11255,7418,20138
2021-03-09 08:30:00+00,19629,231,3835,4508,653,3575,2913,215,3167,590,39316,222,15076,12163,8328,19860
2021-03-09 09:00:00+00,19968,230,3833,4326,563,3758,2908,241,4082,88,39997,223,15712,12804,8971,20198
2021-03-09 09:30:00+00,19405,231,3832,4433,427,3787,2912,186,4979,0,40192,217,16583,13671,9839,19636
2021-03-09 10:00:00+00,18642,229,3830,4819,361,3643,2906,150,5683,0,40263,207,17599,14693,10863,18871
2021-03-09 10:30:00+00,17457,229,3829,5181,353,3640,2896,129,6213,0,39927,197,18472,15576,11747,17686
2021-03-09 11:00:00+00,16776,232,3824,5662,313,3368,2867,112,6732,0,39886,191,19398,16531,12707,17008
2021-03-09 11:30:00+00,16204,233,3837,5698,310,3500,2846,105,6987,0,39720,188,19678,16832,12995,16437
2021-03-09 12:00:00+00,16352,231,3838,6687,296,3126,2868,112,6779,0,40289,188,20468,17600,13762,16583
2021-03-09 12:30:00+00,15641,234,3836,7071,296,3198,2878,112,6542,0,39808,185,20623,17745,13909,15875
2021-03-09 13:00:00+00,15160,239,3835,7834,301,2852,2905,113,6024,80,39343,181,20899,17994,14159,15399
2021-03-09 13:30:00+00,14916,244,3835,8106,296,2852,2899,117,5237,0,38502,182,20373,17474,13639,15160
2021-03-09 14:00:00+00,15981,240,3832,8278,297,1990,2890,107,4150,92,37857,195,19447,16557,12725,16221
2021-03-09 14:30:00+00,16171,238,3822,8593,301,1960,2891,102,3344,0,37422,198,18951,16060,12238,16409
2021-03-09 15:00:00+00,17109,233,3823,8442,314,1706,2908,102,2846,208,37691,206,18333,15425,11602,17342
2021-03-09 15:30:00+00,18084,368,3829,8293,333,1700,2924,138,2045,234,37948,219,17424,14500,10671,18452
2021-03-09 16:00:00+00,18416,399,3829,8382,378,1820,2923,443,1268,220,38078,226,16780,13857,10028,18815
2021-03-09 16:30:00+00,18527,425,3823,8477,414,1838,2923,440,675,306,37849,229,16312,13389,9566,18952
2021-03-09 17:00:00+00,18378,435,3810,8777,450,1670,2927,471,227,946,38091,226,16191,13264,9454,18813
2021-03-09 17:30:00+00,18229,477,3811,9445,413,1676,2920,470,15,1278,38735,223,16604,13684,9873,18706
2021-03-09 18:00:00+00,17784,394,3811,10025,401,2162,2923,461,0,1550,39511,213,17160,14237,10426,18178
2021-03-09 18:30:00+00,17205,424,3809,10534,401,2198,2920,338,0,1240,39069,209,17664,14744,10935,17629
2021-03-09 19:00:00+00,16471,371,3810,10737,402,2830,2919,176,0,284,38000,205,17868,14949,11139,16842
2021-03-09 19:30:00+00,15494,200,3811,11432,368,2844,2916,107,0,8,37180,193,18527,15611,11800,15694
2021-03-09 20:00:00+00,14722,0,3813,11877,325,2894,2919,100,0,0,36650,183,18934,16015,12202,14722
2021-03-09 20:30:00+00,13644,0,3812,12211,309,2884,2922,100,0,0,35882,175,19254,16332,12520,13644
2021-03-09 21:00:00+00,12515,0,3814,12385,270,3468,2920,101,0,10,35483,167,19389,16469,12655,12515
2021-03-09 21:30:00+00,11048,0,3814,12583,265,3328,2919,103,0,6,34066,155,19581,16662,12848,11048
2021-03-09 22:00:00+00,9632,0,3817,12888,234,1604,2915,108,0,50,31248,146,19854,16939,13122,9632
2021-03-09 22:30:00+00,8341,0,3819,13135,270,1276,2917,101,0,0,29859,131,20141,17224,13405,8341
2021-03-09 23:00:00+00,7331,0,3817,13507,310,1234,2854,101,0,0,29154,120,20488,17634,13817,7331
2021-03-09 23:30:00+00,6624,0,3819,13667,309,1146,2551,102,0,0,28218,110,20346,17795,13976,6624
2021-03-10 00:00:00+00,6338,0,3838,14039,305,1016,2798,102,0,0,28436,104,20980,18182,14344,6338
2021-03-10 00:30:00+00,6152,0,3836,14256,317,1018,2921,105,0,0,28606,101,21330,18409,14573,6152
2021-03-10 01:00:00+00,5809,0,3835,14316,335,998,2923,111,0,0,28327,97,21409,18486,14651,5809
2021-03-10 01:30:00+00,5337,0,3831,14106,350,994,2922,105,0,0,27645,93,21209,18287,14456,5337
2021-03-10 02:00:00+00,4974,0,3832,14216,392,666,2917,106,0,0,27103,88,21357,18440,14608,4974
2021-03-10 02:30:00+00,4631,0,3830,14138,371,660,2919,105,0,0,26654,85,21258,18339,14509,4631
2021-03-10 03:00:00+00,4296,0,3831,14455,365,522,2922,104,0,0,26495,79,21573,18651,14820,4296
2021-03-10 03:30:00+00,3855,0,3836,14695,380,536,2884,103,0,0,26289,73,21795,18911,15075,3855
2021-03-10 04:00:00+00,3731,0,3835,14541,383,856,2549,102,0,0,25997,72,21308,18759,14924,3731
2021-03-10 04:30:00+00,3911,0,3866,14344,387,860,2299,105,0,0,25772,74,20896,18597,14731,3911
2021-03-10 05:00:00+00,4175,0,3882,13763,391,1118,1884,102,0,0,25315,78,19920,18036,14154,4175
2021-03-10 05:30:00+00,4851,0,3907,13646,494,1144,1926,102,0,0,26070,86,19973,18047,14140,4851
2021-03-10 06:00:00+00,6479,0,3927,13321,409,1848,2475,106,0,142,28707,104,20132,17657,13730,6479
2021-03-10 06:30:00+00,7865,0,3927,13363,413,1872,2913,105,0,110,30568,117,20616,17703,13776,7865
2021-03-10 07:00:00+00,11121,0,3926,13109,440,1760,2956,114,39,268,33733,145,20470,17514,13588,11121
2021-03-10 07:30:00+00,12338,0,3924,12610,434,1826,2960,196,165,72,34525,156,20093,17133,13209,12338
2021-03-10 08:00:00+00,13556,0,3924,12247,496,3410,2955,137,344,4,37073,160,19966,17011,13087,13556
2021-03-10 08:30:00+00,13987,0,3921,11808,826,3496,2953,201,468,0,37660,163,19976,17023,13102,13987
2021-03-10 09:00:00+00,14313,0,3921,11536,723,3584,2958,228,645,316,38224,165,19783,16825,12904,14313
2021-03-10 09:30:00+00,14205,0,3918,11769,636,3714,2950,236,861,674,38963,162,20134,17184,13266,14205
2021-03-10 10:00:00+00,14158,0,3924,12267,654,3912,2949,306,1062,266,39498,163,20856,17907,13983,14158
2021-03-10 10:30:00+00,13707,0,3919,12710,656,4046,2954,284,1036,306,39618,159,21275,18321,14402,13707
2021-03-10 11:00:00+00,13785,0,3915,12945,613,4184,2953,196,1073,206,39870,160,21499,18546,14631,13785
2021-03-10 11:30:00+00,13772,0,3917,13418,688,4252,2956,189,1022,58,40272,159,22001,19045,15128,13772
2021-03-10 12:00:00+00,13509,0,3932,14588,670,4252,2950,331,922,0,41154,154,23062,20112,16180,13509
2021-03-10 12:30:00+00,13142,0,3963,15418,635,4252,2961,194,813,0,41378,149,23790,20829,16866,13142
2021-03-10 13:00:00+00,12895,0,3988,15964,420,4252,2957,109,696,4,41285,146,24025,21068,17080,12895
2021-03-10 13:30:00+00,12431,0,4005,16223,346,4252,2956,105,623,0,40941,143,24153,21197,17192,12431
2021-03-10 14:00:00+00,11885,0,4024,16202,329,4252,2929,108,511,0,40240,140,23995,21066,17042,11885
2021-03-10 14:30:00+00,11438,0,4027,16476,323,4252,2910,105,456,0,39987,136,24192,21282,17255,11438
2021-03-10 15:00:00+00,11487,0,4031,16439,322,4252,2915,105,385,0,39936,137,24092,21177,17146,11487
2021-03-10 15:30:00+00,11979,0,4032,16437,350,4252,2909,109,261,0,40329,140,23989,21080,17048,11979
2021-03-10 16:00:00+00,12405,0,4029,16545,379,4272,2915,150,182,0,40877,143,24050,21135,17106,12405
2021-03-10 16:30:00+00,13278,0,4030,16620,412,4260,2919,160,103,0,41782,148,24084,21165,17135,13278
2021-03-10 17:00:00+00,14052,0,4032,16718,486,3780,2927,397,27,32,42451,154,24190,21263,17231,14052
2021-03-10 17:30:00+00,13995,0,4028,16822,492,3626,2927,459,2,684,43035,151,24271,21344,17316,13995
2021-03-10 18:00:00+00,13910,0,4023,16751,499,3536,2916,314,0,1288,43237,147,24189,21273,17250,13910
2021-03-10 18:30:00+00,13920,0,4047,16572,449,3394,2890,385,0,888,42545,150,23958,21068,17021,13920
2021-03-10 19:00:00+00,13291,0,4046,16603,450,3440,2910,318,0,182,41240,149,24009,21099,17053,13291
2021-03-10 19:30:00+00,11950,0,4047,16447,449,3375,2920,163,0,0,39350,141,23863,20943,16896,11950
2021-03-10 20:00:00+00,9956,0,4049,16381,405,3835,2923,115,0,196,37860,128,23758,20835,16786,9956
2021-03-10 20:30:00+00,8668,0,4050,16476,407,3666,2921,104,0,0,36292,118,23854,20933,16883,8668
2021-03-10 21:00:00+00,7563,0,4054,16270,366,3196,2888,104,0,92,34533,109,23578,20690,16636,7563
2021-03-10 21:30:00+00,5841,0,4071,16142,336,3090,2822,105,0,18,32425,94,23371,20549,16478,5841
2021-03-10 22:00:00+00,5627,0,4081,15616,341,2744,2891,104,0,142,31546,95,22929,20038,15957,5627
2021-03-10 22:30:00+00,4742,0,4086,15755,370,2676,2637,103,0,52,30421,86,22848,20211,16125,4742
2021-03-10 23:00:00+00,4837,0,4100,15688,365,1838,2135,104,0,32,29100,88,22288,20153,16053,4837
2021-03-10 23:30:00+00,4389,0,4099,15445,362,1731,2099,103,0,0,28228,83,22005,19906,15807,4389
2021-03-11 00:00:00+00,4335,0,4097,15271,347,1811,2326,105,0,0,28291,84,22041,19715,15618,4335
2021-03-11 00:30:00+00,4529,0,4106,15122,358,1847,2711,105,0,0,28778,88,22297,19586,15480,4529
2021-03-11 01:00:00+00,4414,0,4119,15054,364,1769,2758,104,0,0,28582,87,22295,19537,15418,4414
2021-03-11 01:30:00+00,4016,0,4141,15055,358,1675,2745,103,0,0,28093,82,22299,19554,15413,4016
2021-03-11 02:00:00+00,4052,0,4142,14999,354,1662,2572,104,0,0,27885,84,22067,19495,15353,4052
2021-03-11 02:30:00+00,4191,0,4139,14884,377,1602,2435,105,0,0,27733,85,21835,19400,15261,4191
2021-03-11 03:00:00+00,4264,0,4143,14979,378,1440,2765,103,0,0,28072,86,22265,19500,15357,4264
2021-03-11 03:30:00+00,4268,0,4142,15012,372,1374,2848,102,0,0,28118,87,22374,19526,15384,4268
2021-03-11 04:00:00+00,4487,0,4144,15162,372,1272,2867,101,0,0,28405,89,22545,19678,15534,4487
2021-03-11 04:30:00+00,4453,0,4143,15048,373,1248,2876,104,0,0,28245,88,22440,19564,15421,4453
2021-03-11 05:00:00+00,3948,0,4152,14971,372,1152,2749,104,0,0,27448,83,22244,19495,15343,3948
2021-03-11 05:30:00+00,4658,0,4153,14541,374,1254,2749,122,0,158,28009,92,21817,19068,14915,4658
2021-03-11 06:00:00+00,5030,0,4155,14397,391,2749,2686,108,0,0,29516,92,21629,18943,14788,5030
2021-03-11 06:30:00+00,6417,0,4155,14314,394,3314,2858,111,25,292,31880,102,21746,18888,14733,6417
2021-03-11 07:00:00+00,8326,0,4157,14588,439,3774,2903,137,197,212,34733,116,22284,19381,15224,8326
2021-03-11 07:30:00+00,9256,0,4156,14457,452,3946,2951,232,537,40,36027,125,22553,19602,15446,9256
2021-03-11 08:00:00+00,9951,0,4155,14570,445,3870,2938,220,1164,30,37343,127,23272,20334,16179,9951
2021-03-11 08:30:00+00,8962,0,4154,14707,472,3934,2933,223,1947,264,37596,116,24213,21280,17126,8962
2021-03-11 09:00:00+00,8477,0,4151,14897,504,3936,2943,231,2780,126,38045,109,25275,22332,18181,8477
2021-03-11 09:30:00+00,8019,0,4162,14975,532,3900,2937,172,3562,2,38261,103,26168,23231,19069,8019
2021-03-11 10:00:00+00,7231,0,4161,15215,527,3890,2885,112,4419,0,38440,93,27207,24322,20161,7231
2021-03-11 10:30:00+00,6889,0,4140,15219,525,3732,2787,107,4867,0,38266,87,27538,24751,20611,6889
2021-03-11 11:00:00+00,7081,0,4140,15231,491,3640,2876,105,4928,0,38492,88,27666,24790,20650,7081
2021-03-11 11:30:00+00,7031,0,4139,15413,488,3650,2954,106,5276,0,39057,87,28270,25316,21177,7031
2021-03-11 12:00:00+00,7102,0,4141,15518,461,3704,2950,106,5759,0,39741,87,28829,25879,21738,7102
2021-03-11 12:30:00+00,7030,0,4143,15409,462,3648,2960,106,4816,0,38574,88,27790,24830,20687,7030
2021-03-11 13:00:00+00,6992,0,4142,15442,467,3760,2958,111,5223,70,39165,87,28232,25274,21132,6992
2021-03-11 13:30:00+00,6360,0,4136,16009,480,3684,2915,108,4752,0,38444,81,28292,25377,21241,6360
2021-03-11 14:00:00+00,6312,0,4098,16110,475,3756,2733,134,4499,0,38117,82,27915,25182,21084,6312
2021-03-11 14:30:00+00,6699,0,4054,15879,463,3722,2642,152,3648,34,37293,88,26686,24044,19990,6699
2021-03-11 15:00:00+00,7048,0,4038,15784,442,3978,2684,145,3045,218,37382,93,25993,23309,19271,7048
2021-03-11 15:30:00+00,7705,0,4030,15835,434,4084,2899,146,2415,228,37776,101,25613,22714,18684,7705
2021-03-11 16:00:00+00,8626,0,4039,15811,438,3966,2956,182,1858,228,38104,108,25102,22146,18107,8626
2021-03-11 16:30:00+00,10101,0,4045,15702,470,3862,2966,202,1104,462,38914,120,24287,21321,17276,10101
2021-03-11 17:00:00+00,11144,0,4055,15613,481,3922,2962,195,423,1106,39901,128,23534,20572,16517,11144
2021-03-11 17:30:00+00,11786,0,4069,15780,483,3938,2942,272,61,1342,40673,132,23335,20393,16324,11786
2021-03-11 18:00:00+00,11919,0,4075,15846,480,4093,2951,459,0,1534,41357,136,23352,20401,16326,11919
2021-03-11 18:30:00+00,12083,0,4096,15926,484,3994,2950,461,0,1472,41466,136,23456,20506,16410,12083
2021-03-11 19:00:00+00,11723,0,4104,16009,500,3711,2946,388,0,1096,40477,133,23559,20613,16509,11723
2021-03-11 19:30:00+00,11266,0,4108,16117,501,3541,2960,259,0,412,39165,130,23686,20726,16618,11266
2021-03-11 20:00:00+00,10709,0,4114,15854,485,3468,2955,163,0,18,37766,130,23408,20453,16339,10709
2021-03-11 20:30:00+00,9349,0,4116,15578,451,3357,2956,151,0,48,36006,120,23101,20145,16029,9349
2021-03-11 21:00:00+00,8114,0,4130,15565,389,3091,2948,143,0,0,34380,112,23032,20084,15954,8114
2021-03-11 21:30:00+00,6558,0,4151,15427,385,2809,2953,145,0,122,32550,97,22916,19963,15812,6558
2021-03-11 22:00:00+00,5287,0,4164,15416,366,2410,2919,142,0,0,30704,83,22865,19946,15782,5287
2021-03-11 22:30:00+00,4206,0,4191,15263,347,2411,2694,141,0,2,29256,73,22495,19801,15610,4206
2021-03-11 23:00:00+00,4226,0,4230,15032,346,1961,2387,143,0,0,28325,76,21995,19608,15378,4226
2021-03-11 23:30:00+00,4077,0,4239,15051,345,1972,2412,141,0,0,28237,75,22047,19635,15396,4077
2021-03-12 00:00:00+00,4495,0,4251,15038,345,1771,2471,146,0,0,28517,82,22105,19634,15383,4495
2021-03-12 00:30:00+00,4799,0,4250,15051,343,1753,2602,145,0,0,28943,86,22246,19644,15394,4799
2021-03-12 01:00:00+00,4686,0,4253,14909,344,1604,2590,145,0,0,28531,84,22096,19506,15253,4686
2021-03-12 01:30:00+00,4386,0,4264,14835,343,1593,2597,143,0,0,28161,82,22039,19442,15178,4386
2021-03-12 02:00:00+00,4491,0,4268,14943,344,1740,2580,142,0,0,28508,86,22135,19555,15287,4491
2021-03-12 02:30:00+00,4481,0,4261,14773,342,1720,2547,147,0,0,28271,86,21923,19376,15115,4481
2021-03-12 03:00:00+00,4186,0,4270,14637,341,1342,2463,147,0,0,27386,85,21711,19248,14978,4186
2021-03-12 03:30:00+00,3852,0,4270,14456,341,1275,2577,142,0,0,26913,82,21644,19067,14797,3852
2021-03-12 04:00:00+00,3566,0,4275,14399,340,1088,2461,142,0,0,26271,80,21475,19014,14739,3566
2021-03-12 04:30:00+00,3603,0,4271,14256,339,1024,2360,145,0,0,25998,81,21226,18866,14595,3603
2021-03-12 05:00:00+00,3618,0,4275,14191,339,1478,2160,147,0,0,26208,81,20965,18805,14530,3618
2021-03-12 05:30:00+00,3913,0,4282,14619,379,1430,2284,146,0,0,27053,82,21564,19280,14998,3913
2021-03-12 06:00:00+00,4069,0,4285,14483,555,2766,2288,146,0,28,28620,78,21611,19323,15038,4069
2021-03-12 06:30:00+00,4880,0,4287,14765,555,2978,2695,145,71,146,30522,87,22373,19678,15391,4880
2021-03-12 07:00:00+00,6619,0,4292,14687,676,3834,2796,154,416,348,33822,100,22867,20071,15779,6619
2021-03-12 07:30:00+00,7602,0,4290,14789,685,3792,2782,334,860,380,35514,107,23406,20624,16334,7602
2021-03-12 08:00:00+00,7619,0,4294,15104,709,4064,2769,341,1260,668,36828,105,24136,21367,17073,7619
2021-03-12 08:30:00+00,7773,0,4290,15016,714,4122,2741,279,1701,788,37424,105,24462,21721,17431,7773
2021-03-12 09:00:00+00,7976,0,4292,14994,717,4006,2747,278,2312,1070,38392,103,25062,22315,18023,7976
2021-03-12 09:30:00+00,8030,0,4290,15137,717,3988,2740,244,3361,500,39007,102,26245,23505,19215,8030
2021-03-12 10:00:00+00,7827,0,4291,15221,707,3760,2747,178,4081,132,38944,98,27047,24300,20009,7827
2021-03-12 10:30:00+00,7750,0,4289,15285,663,3680,2785,167,4933,40,39592,95,27955,25170,20881,7750
2021-03-12 11:00:00+00,7385,0,4288,15582,588,3592,2818,149,5162,0,39564,90,28438,25620,21332,7385
2021-03-12 11:30:00+00,6956,0,4296,15598,542,3598,2827,148,5172,0,39137,87,28435,25608,21312,6956
2021-03-12 12:00:00+00,6851,0,4296,15845,515,3528,2834,225,5402,0,39496,85,28892,26058,21762,6851
2021-03-12 12:30:00+00,6607,0,4299,15990,460,3542,2855,196,5389,0,39338,83,28993,26138,21839,6607
2021-03-12 13:00:00+00,6318,0,4308,15837,460,3534,2862,188,5285,0,38792,82,28752,25890,21582,6318
2021-03-12 13:30:00+00,5826,0,4312,15698,467,3564,2727,155,4855,0,37604,79,28059,25332,21020,5826
2021-03-12 14:00:00+00,5978,0,4311,15577,474,3344,2643,158,4482,0,36967,81,27487,24844,20533,5978
2021-03-12 14:30:00+00,5863,0,4312,15543,465,3424,2457,150,4081,0,36295,81,26858,24401,20089,5863
2021-03-12 15:00:00+00,6018,0,4321,15298,480,3620,2497,151,3387,0,35772,84,25983,23486,19165,6018
2021-03-12 15:30:00+00,6418,0,4325,15238,500,3780,2758,163,2901,0,36083,91,25722,22964,18639,6418
2021-03-12 16:00:00+00,7391,0,4327,15191,530,4110,2811,194,2047,0,36601,101,24906,22095,17768,7391
2021-03-12 16:30:00+00,8744,0,4331,14894,531,4188,2924,199,1064,114,36989,116,23744,20820,16489,8744
2021-03-12 17:00:00+00,10030,0,4332,14642,632,4102,2932,194,420,810,38094,125,22958,20026,15694,10030
2021-03-12 17:30:00+00,10549,0,4332,14877,675,4316,2934,200,48,1120,39051,129,22866,19932,15600,10549
2021-03-12 18:00:00+00,11318,0,4328,14492,762,4342,2935,248,0,1664,40089,134,22517,19582,15254,11318
2021-03-12 18:30:00+00,12002,0,4327,13861,765,4342,2943,266,0,1760,40266,141,21896,18953,14626,12002
2021-03-12 19:00:00+00,11581,0,4328,13903,763,4320,2928,397,0,1038,39258,141,21922,18994,14666,11581
2021-03-12 19:30:00+00,10804,0,4323,13693,751,4206,2943,243,0,698,37661,136,21710,18767,14444,10804
2021-03-12 20:00:00+00,10411,0,4324,13666,656,4238,2928,192,0,84,36499,136,21574,18646,14322,10411
2021-03-12 20:30:00+00,9139,0,4323,13597,633,4074,2937,157,0,34,34894,126,21490,18553,14230,9139
2021-03-12 21:00:00+00,8209,0,4327,13339,625,3774,2937,150,0,42,33403,122,21228,18291,13964,8209
2021-03-12 21:30:00+00,7130,0,4326,13098,625,3620,2939,150,0,0,31888,112,20988,18049,13723,7130
2021-03-12 22:00:00+00,6130,0,4329,12945,591,3506,2889,149,0,0,30539,106,20754,17865,13536,6130
2021-03-12 22:30:00+00,5458,0,4325,12786,622,3350,2630,153,0,0,29324,98,20363,17733,13408,5458
2021-03-12 23:00:00+00,5134,0,4325,12343,664,2892,2273,158,0,0,27789,93,19605,17332,13007,5134
2021-03-12 23:30:00+00,4764,0,4332,11975,660,2744,2267,153,0,0,26895,88,19234,16967,12635,4764
2021-03-13 00:00:00+00,4538,0,4339,11769,639,2960,2272,149,0,0,26666,89,19019,16747,12408,4538
2021-03-13 00:30:00+00,5003,0,4343,11615,635,3088,2275,150,0,0,27109,96,18868,16593,12250,5003
2021-03-13 01:00:00+00,4854,0,4343,11583,580,3080,2269,149,0,0,26858,95,18775,16506,12163,4854
2021-03-13 01:30:00+00,4417,0,4353,11571,553,3092,2258,149,0,0,26393,90,18735,16477,12124,4417
2021-03-13 02:00:00+00,4057,0,4353,11588,553,3104,2258,165,0,0,26078,86,18752,16494,12141,4057
2021-03-13 02:30:00+00,4122,0,4352,11613,552,3072,2263,154,0,0,26128,86,18780,16517,12165,4122
2021-03-13 03:00:00+00,4417,0,4347,11682,466,2996,2277,152,0,0,26337,89,18772,16495,12148,4417
2021-03-13 03:30:00+00,3796,0,4347,11936,466,2994,2272,148,0,0,25959,81,19021,16749,12402,3796
2021-03-13 04:00:00+00,3781,0,4356,12139,481,2626,2274,150,0,0,25807,79,19250,16976,12620,3781
2021-03-13 04:30:00+00,3477,0,4359,12352,471,2620,2272,149,0,0,25700,75,19454,17182,12823,3477
2021-03-13 05:00:00+00,4003,0,4365,12571,471,2260,2256,148,0,0,26074,78,19663,17407,13042,4003
2021-03-13 05:30:00+00,4167,0,4376,12774,470,2264,2257,149,0,0,26457,80,19877,17620,13244,4167
2021-03-13 06:00:00+00,3919,0,4377,13017,496,2416,2227,149,0,0,26601,78,20117,17890,13513,3919
2021-03-13 06:30:00+00,4076,0,4376,13333,509,2490,1986,154,83,0,27007,80,20287,18301,13925,4076
2021-03-13 07:00:00+00,4402,0,4377,13474,626,3070,1628,151,501,0,28229,78,20606,18978,14601,4402
2021-03-13 07:30:00+00,4685,0,4380,13718,635,3120,1626,152,996,0,29312,79,21355,19729,15349,4685
2021-03-13 08:00:00+00,5331,0,4377,13994,685,3118,1634,170,1480,110,30899,84,22170,20536,16159,5331
2021-03-13 08:30:00+00,5513,0,4381,14217,686,3198,1643,323,2286,70,32317,85,23213,21570,17189,5513
2021-03-13 09:00:00+00,5639,0,4378,14452,699,3078,1641,387,2927,178,33379,83,24097,22456,18078,5639
2021-03-13 09:30:00+00,5686,0,4383,14644,701,3046,1636,418,3347,44,33905,82,24711,23075,18692,5686
2021-03-13 10:00:00+00,5532,0,4381,15116,684,3042,1627,397,4091,0,34870,78,25899,24272,19891,5532
2021-03-13 10:30:00+00,5594,0,4392,15416,683,2960,1606,256,4649,60,35616,74,26746,25140,20748,5594
2021-03-13 11:00:00+00,5247,0,4399,15742,665,2866,1606,191,5008,0,35724,68,27420,25814,21415,5247
2021-03-13 11:30:00+00,4934,0,4391,15763,660,2980,1602,172,5615,0,36117,66,28031,26429,22038,4934
2021-03-13 12:00:00+00,4717,0,4389,16099,510,3018,1619,178,5681,0,36211,64,28298,26679,22290,4717
2021-03-13 12:30:00+00,4932,0,4388,15774,485,2998,1630,178,5670,0,36055,66,27947,26317,21929,4932
2021-03-13 13:00:00+00,4355,0,4387,15783,479,3258,1627,187,5479,0,35555,62,27755,26128,21741,4355
2021-03-13 13:30:00+00,4250,0,4382,15717,482,3092,1636,196,5523,0,35278,60,27740,26104,21722,4250
2021-03-13 14:00:00+00,4318,0,4385,15463,571,3140,1628,165,4532,34,34236,62,26579,24951,20566,4318
2021-03-13 14:30:00+00,4332,0,4382,15505,541,3126,1634,156,3946,50,33672,63,26008,24374,19992,4332
2021-03-13 15:00:00+00,4689,0,4383,15288,649,3380,1635,155,3088,108,33375,72,25043,23408,19025,4689
2021-03-13 15:30:00+00,5449,0,4383,14929,725,3434,1631,224,2323,14,33112,83,23991,22360,17977,5449
2021-03-13 16:00:00+00,5915,0,4389,14854,765,3878,1638,252,1761,490,33942,89,23407,21769,17380,5915
2021-03-13 16:30:00+00,7441,0,4391,14520,916,3920,1642,168,1372,930,35300,102,22840,21198,16808,7441
2021-03-13 17:00:00+00,9632,0,4391,13897,948,3910,1637,296,618,830,36159,124,21491,19854,15463,9632
2021-03-13 17:30:00+00,10627,0,4396,13688,950,3906,1642,455,122,1006,36792,134,20798,19156,14760,10627
2021-03-13 18:00:00+00,11092,0,4398,13647,969,3994,1644,495,0,1646,37885,134,20658,19014,14616,11092
2021-03-13 18:30:00+00,12057,0,4394,13461,965,3846,1645,505,0,1946,38819,139,20465,18820,14426,12057
2021-03-13 19:00:00+00,11903,0,4396,13555,887,3708,1635,484,0,1488,38056,138,20473,18838,14442,11903
2021-03-13 19:30:00+00,11100,0,4394,13837,692,3710,1636,492,0,1006,36867,134,20559,18923,14529,11100
2021-03-13 20:00:00+00,10932,0,4391,14316,645,3464,1636,387,0,34,35805,135,20988,19352,14961,10932
2021-03-13 20:30:00+00,9939,0,4394,14505,619,3460,1640,239,0,0,34796,126,21158,19518,15124,9939
2021-03-13 21:00:00+00,8851,0,4396,14784,492,3170,1637,182,0,0,33512,118,21309,19672,15276,8851
2021-03-13 21:30:00+00,7453,0,4399,14815,492,3166,1641,173,0,42,32181,105,21347,19706,15307,7453
2021-03-13 22:00:00+00,5977,0,4401,15229,464,2802,1642,151,0,0,30666,91,21736,20094,15693,5977
2021-03-13 22:30:00+00,5094,0,4399,15360,454,2680,1642,144,0,0,29773,80,21855,20213,15814,5094
2021-03-13 23:00:00+00,3826,0,4402,15422,463,2616,1642,147,0,0,28518,65,21929,20287,15885,3826
2021-03-13 23:30:00+00,3262,0,4408,15267,441,2550,1480,146,0,0,27554,57,21596,20116,15708,3262
2021-03-14 00:00:00+00,3226,0,4418,15340,426,2176,1556,146,0,0,27288,58,21740,20184,15766,3226
2021-03-14 00:30:00+00,3620,0,4417,15072,418,2160,1618,144,0,0,27449,63,21525,19907,15490,3620
2021-03-14 01:00:00+00,4092,0,4412,14959,340,2200,1616,143,0,0,27762,70,21327,19711,15299,4092
2021-03-14 01:30:00+00,3617,0,4422,14900,337,2144,1611,145,0,0,27176,64,21270,19659,15237,3617
2021-03-14 02:00:00+00,3921,0,4423,14986,337,1674,1619,143,0,0,27103,68,21365,19746,15323,3921
2021-03-14 02:30:00+00,3644,0,4424,15003,336,1634,1621,143,0,0,26805,65,21384,19763,15339,3644
2021-03-14 03:00:00+00,3736,0,4422,15144,334,766,1623,143,0,0,26168,67,21523,19900,15478,3736
2021-03-14 03:30:00+00,3676,0,4423,15219,333,740,1624,144,0,0,26159,66,21599,19975,15552,3676
2021-03-14 04:00:00+00,3855,0,4417,15075,332,758,1623,148,0,0,26208,68,21447,19824,15407,3855
2021-03-14 04:30:00+00,3645,0,4423,15286,332,752,1620,141,0,0,26199,65,21661,20041,15618,3645
2021-03-14 05:00:00+00,4042,0,4427,15268,345,544,1611,142,0,0,26379,71,21651,20040,15613,4042
2021-03-14 05:30:00+00,4158,0,4433,15171,348,544,1623,148,0,0,26425,72,21575,19952,15519,4158
2021-03-14 06:00:00+00,4056,0,4438,15299,361,1190,1619,142,0,0,27105,70,21717,20098,15660,4056
2021-03-14 06:30:00+00,3832,0,4432,15379,360,1194,1660,152,160,0,27169,66,21991,20331,15899,3832
2021-03-14 07:00:00+00,3424,0,4439,15616,377,1212,1740,150,798,0,27756,60,22970,21230,16791,3424
2021-03-14 07:30:00+00,3514,0,4437,15727,369,1186,1839,144,1553,0,28769,59,23925,22086,17649,3514
2021-03-14 08:00:00+00,3635,0,4437,15686,408,1474,1974,147,2287,0,30048,59,24792,22818,18381,3635
2021-03-14 08:30:00+00,3616,0,4437,15430,409,1480,2471,147,2835,0,30825,59,25582,23111,18674,3616
2021-03-14 09:00:00+00,3641,0,4435,15610,436,1696,2729,146,3692,0,32385,58,26902,24173,19738,3641
2021-03-14 09:30:00+00,3779,0,4433,15545,575,1808,2762,148,4244,0,33294,59,27559,24797,20364,3779
2021-03-14 10:00:00+00,4037,0,4437,15390,574,2930,2166,154,4299,0,33987,60,26866,24700,20263,4037
2021-03-14 10:30:00+00,4007,0,4433,15544,555,3088,2168,156,4432,0,34383,60,27132,24964,20531,4007
2021-03-14 11:00:00+00,4043,0,4434,15408,506,3298,2488,152,3831,0,34160,64,26667,24179,19745,4043
2021-03-14 11:30:00+00,4159,0,4430,15305,505,3376,2729,151,3754,0,34409,67,26723,23994,19564,4159
2021-03-14 12:00:00+00,4722,0,4430,14893,491,3454,2924,150,3914,0,34978,73,26652,23728,19298,4722
2021-03-14 12:30:00+00,5182,0,4427,14223,462,3456,2930,152,3470,182,34484,79,25512,22582,18155,5182
2021-03-14 13:00:00+00,6199,0,4430,13735,438,3456,2923,152,3377,42,34752,90,24903,21980,17550,6199
2021-03-14 13:30:00+00,6417,0,4427,13587,446,3456,2927,152,2990,8,34410,93,24377,21450,17023,6417
2021-03-14 14:00:00+00,6548,0,4429,13699,421,3600,2935,167,2180,0,33979,96,23664,20729,16300,6548
2021-03-14 14:30:00+00,7044,0,4430,14066,438,3604,2931,153,1638,0,34304,101,23503,20572,16142,7044
2021-03-14 15:00:00+00,7797,0,4437,13960,441,3750,2927,153,1123,336,34924,108,22888,19961,15524,7797
2021-03-14 15:30:00+00,9070,0,4449,13853,445,3752,2926,153,746,0,35394,121,22419,19493,15044,9070
2021-03-14 16:00:00+00,10154,0,4432,13738,471,3896,2917,153,440,138,36339,129,21998,19081,14649,10154
2021-03-14 16:30:00+00,11228,0,4433,13663,513,3898,2929,154,243,512,37573,136,21781,18852,14419,11228
2021-03-14 17:00:00+00,12296,0,4436,13559,585,3918,2931,223,108,650,38706,144,21619,18688,14252,12296
2021-03-14 17:30:00+00,12743,0,4429,13480,715,3918,2914,349,16,568,39132,148,21554,18640,14211,12743
2021-03-14 18:00:00+00,12562,0,4429,13090,731,3918,2921,394,0,1122,39167,147,21171,18250,13821,12562
2021-03-14 18:30:00+00,12467,0,4432,13108,732,3918,2889,493,0,1316,39355,146,21161,18272,13840,12467
2021-03-14 19:00:00+00,12727,0,4430,13131,731,3918,2898,408,0,234,38477,150,21190,18292,13862,12727
2021-03-14 19:30:00+00,12262,0,4427,12721,716,3890,2932,208,0,0,37156,149,20796,17864,13437,12262
2021-03-14 20:00:00+00,11545,0,4429,12790,715,3622,2913,156,0,0,36170,143,20847,17934,13505,11545
2021-03-14 20:30:00+00,9729,0,4427,12882,662,3504,2919,151,0,0,34274,129,20890,17971,13544,9729
2021-03-14 21:00:00+00,8779,0,4425,13095,617,2904,2913,148,0,0,32881,123,21050,18137,13712,8779
2021-03-14 21:30:00+00,7633,0,4430,13020,616,2788,2904,146,0,0,31537,113,20970,18066,13636,7633
2021-03-14 22:00:00+00,6072,0,4432,13028,573,2578,2930,148,0,0,29761,99,20963,18033,13601,6072
2021-03-14 22:30:00+00,4905,0,4432,13137,535,2456,2833,147,0,0,28445,86,20937,18104,13672,4905
2021-03-14 23:00:00+00,4176,0,4429,13143,446,2050,2711,151,0,0,27106,77,20729,18018,13589,4176
2021-03-14 23:30:00+00,3814,0,4430,13199,416,2028,2821,151,0,0,26859,72,20866,18045,13615,3814
2021-03-15 00:00:00+00,4045,0,4431,13330,387,2134,2870,149,0,0,27346,76,21018,18148,13717,4045
2021-03-15 00:30:00+00,4351,0,4433,13353,368,2130,2898,150,0,0,27683,80,21052,18154,13721,4351
2021-03-15 01:00:00+00,4475,0,4431,13220,334,2172,2900,151,0,0,27683,82,20885,17985,13554,4475
2021-03-15 01:30:00+00,4440,0,4433,12962,327,2168,2898,153,0,0,27381,82,20620,17722,13289,4440
2021-03-15 02:00:00+00,4649,0,4433,12532,321,1970,2852,156,0,0,26913,86,20138,17286,12853,4649
2021-03-15 02:30:00+00,4922,0,4432,12240,302,1970,2714,151,0,0,26731,90,19688,16974,12542,4922
2021-03-15 03:00:00+00,4441,0,4432,12078,285,2510,2707,150,0,0,26603,84,19502,16795,12363,4441
2021-03-15 03:30:00+00,4400,0,4431,12029,280,2520,2729,151,0,0,26540,84,19469,16740,12309,4400
2021-03-15 04:00:00+00,4378,0,4432,11738,289,2450,2803,153,0,0,26243,84,19262,16459,12027,4378
2021-03-15 04:30:00+00,4769,0,4430,11381,288,2450,2842,152,0,0,26312,90,18941,16099,11669,4769
2021-03-15 05:00:00+00,5389,0,4436,11001,308,1890,2905,153,0,0,26082,100,18650,15745,11309,5389
2021-03-15 05:30:00+00,6444,0,4437,10740,397,1854,2879,135,0,40,26926,112,18453,15574,11137,6444
2021-03-15 06:00:00+00,7816,0,4439,10479,493,3170,2862,230,0,0,29489,123,18273,15411,10972,7816
2021-03-15 06:30:00+00,10507,0,4437,10286,483,3210,2866,151,129,10,32079,146,18201,15335,10898,10507
2021-03-15 07:00:00+00,13590,0,4436,10129,470,2696,2864,319,570,196,35270,168,18469,15605,11169,13590
2021-03-15 07:30:00+00,15146,0,4438,9580,486,2656,2863,428,1161,0,36758,179,18528,15665,11227,15146
2021-03-15 08:00:00+00,16143,0,4441,9200,722,2094,2859,421,2023,70,37973,184,19245,16386,11945,16143
2021-03-15 08:30:00+00,16576,0,4439,8784,683,2100,2869,441,2736,20,38648,185,19511,16642,12203,16576
2021-03-15 09:00:00+00,16524,0,4439,8489,600,3446,2873,328,3418,140,40257,177,19819,16946,12507,16524
2021-03-15 09:30:00+00,16704,0,4439,8452,599,3496,2871,335,3348,0,40244,179,19709,16838,12399,16704
2021-03-15 10:00:00+00,16726,0,4433,8168,602,3296,2869,359,3399,134,39986,180,19471,16602,12169,16726
2021-03-15 10:30:00+00,16736,0,4431,7876,603,3294,2887,283,4310,142,40562,177,20107,17220,12789,16736
2021-03-15 11:00:00+00,16816,0,4432,7657,592,3492,2898,158,4437,164,40646,177,20016,17118,12686,16816
2021-03-15 11:30:00+00,17049,0,4436,7551,627,3496,2894,183,5037,74,41347,176,20545,17651,13215,17049
2021-03-15 12:00:00+00,17323,6,4441,7488,632,3496,2877,208,5129,96,41696,178,20567,17690,13249,17329
2021-03-15 12:30:00+00,17226,37,4441,7443,617,3496,2873,275,5249,142,41799,177,20623,17750,13309,17263
2021-03-15 13:00:00+00,16762,139,4443,7547,599,3496,2798,187,5058,0,41029,178,20445,17647,13204,16901
2021-03-15 13:30:00+00,16379,333,4445,7433,600,3454,2758,131,4874,0,40407,181,20110,17352,12907,16712
2021-03-15 14:00:00+00,16662,463,4443,7371,578,2550,2816,128,4517,0,39528,190,19725,16909,12466,17125
2021-03-15 14:30:00+00,16806,532,4441,7233,578,2540,2826,125,3972,0,39053,195,19050,16224,11783,17338
2021-03-15 15:00:00+00,16288,615,4439,6950,539,3452,2832,125,3303,0,38543,195,18063,15231,10792,16903
2021-03-15 15:30:00+00,17176,762,4439,6690,541,3496,2847,128,2666,22,38767,207,17183,14336,9897,17938
2021-03-15 16:00:00+00,18121,1106,4441,6489,582,3516,2863,170,1959,8,39255,223,16334,13471,9030,19227
2021-03-15 16:30:00+00,19125,1351,4441,6180,607,3516,2857,173,1219,692,40161,234,15304,12447,8006,20476
2021-03-15 17:00:00+00,20344,1259,4441,5828,631,3516,2851,249,513,1526,41158,239,14264,11412,6972,21603
2021-03-15 17:30:00+00,21195,1313,4446,5459,642,3516,2846,313,96,1932,41758,245,13489,10643,6197,22508
2021-03-15 18:00:00+00,20967,1380,4443,5132,757,3516,2851,320,0,2292,41658,245,13183,10332,5889,22347
2021-03-15 18:30:00+00,21271,1521,4440,5024,904,3516,2857,322,0,2314,42169,248,13225,10368,5928,22792
2021-03-15 19:00:00+00,21114,1468,4441,4773,880,3516,2859,324,0,2314,41689,248,12953,10094,5653,22582
2021-03-15 19:30:00+00,20759,1689,4443,4564,777,3516,2788,244,0,1868,40648,256,12572,9784,5341,22448
2021-03-15 20:00:00+00,20131,1643,4445,4499,761,3516,2762,255,0,1160,39172,257,12467,9705,5260,21774
2021-03-15 20:30:00+00,19771,1533,4456,4300,627,3516,2781,177,0,652,37812,260,12164,9382,4926,21304
2021-03-15 21:00:00+00,19377,1052,4493,4220,575,3496,2790,149,0,276,36428,252,12078,9288,4795,20429
2021-03-15 21:30:00+00,18219,555,4524,4342,570,3496,2855,148,0,4,34713,238,12291,9436,4912,18774
2021-03-15 22:00:00+00,16596,199,4530,4568,477,3496,2887,148,0,14,32915,221,12462,9575,5045,16795
2021-03-15 22:30:00+00,14898,0,4534,4957,492,3496,2895,149,0,0,31421,204,12878,9983,5449,14898
2021-03-15 23:00:00+00,13170,0,4540,4556,362,3497,2901,147,0,0,29173,197,12359,9458,4918,13170
2021-03-15 23:30:00+00,11639,0,4567,4791,357,3505,2773,148,0,0,27780,185,12488,9715,5148,11639
2021-03-16 00:00:00+00,11205,0,4610,5329,338,3218,2558,148,0,0,27406,182,12835,10277,5667,11205
2021-03-16 00:30:00+00,11079,0,4626,5754,326,3296,2623,149,0,0,27853,179,13329,10706,6080,11079
2021-03-16 01:00:00+00,10969,0,4642,5922,301,3162,2560,148,0,0,27704,178,13425,10865,6223,10969
2021-03-16 01:30:00+00,10362,0,4653,6145,300,3156,2570,150,0,0,27336,172,13668,11098,6445,10362
2021-03-16 02:00:00+00,10574,0,4670,6149,290,2842,2686,213,0,0,27424,175,13795,11109,6439,10574
2021-03-16 02:30:00+00,9988,0,4669,6443,286,2874,2800,254,0,0,27314,169,14198,11398,6729,9988
2021-03-16 03:00:00+00,9869,0,4667,6394,285,2892,2691,151,0,0,26949,166,14037,11346,6679,9869
2021-03-16 03:30:00+00,9944,0,4669,5900,284,2956,2629,150,0,0,26532,171,13482,10853,6184,9944
2021-03-16 04:00:00+00,9657,0,4672,5961,286,3090,2728,151,0,0,26545,167,13647,10919,6247,9657
2021-03-16 04:30:00+00,9429,0,4677,6167,290,3150,2774,151,0,0,26638,164,13908,11134,6457,9429
2021-03-16 05:00:00+00,10220,0,4682,6790,278,2286,2797,151,0,0,27204,172,14547,11750,7068,10220
2021-03-16 05:30:00+00,10392,0,4683,7290,303,2242,2748,153,0,0,27811,170,15024,12276,7593,10392
2021-03-16 06:00:00+00,11494,69,4685,7808,417,2308,2831,315,0,0,29927,176,15741,12910,8225,11563
2021-03-16 06:30:00+00,12832,312,4681,8217,352,2294,2855,328,31,0,31902,189,16136,13281,8600,13144
2021-03-16 07:00:00+00,14565,483,4679,8473,390,2574,2902,393,207,228,34894,196,16651,13749,9070,15048
2021-03-16 07:30:00+00,15022,504,4679,8935,567,2578,2898,419,517,308,36427,194,17596,14698,10019,15526
2021-03-16 08:00:00+00,15250,497,4678,9357,624,2870,2904,469,845,308,37802,190,18408,15504,10826,15747
2021-03-16 08:30:00+00,15228,495,4673,9548,607,2864,2907,497,1501,384,38704,186,19236,16329,11656,15723
2021-03-16 09:00:00+00,15082,499,4671,9749,541,3402,2900,468,1986,340,39638,180,19847,16947,12276,15581
2021-03-16 09:30:00+00,15120,537,4674,10068,494,3400,2857,376,2283,180,39989,179,20376,17519,12845,15657
2021-03-16 10:00:00+00,14900,528,4675,10225,491,2876,2832,379,2731,98,39735,177,20954,18122,13447,15428
2021-03-16 10:30:00+00,14216,433,4675,10487,478,2852,2848,264,3397,0,39650,168,21885,19037,14362,14649
2021-03-16 11:00:00+00,13956,505,4580,10487,321,2846,2855,162,3695,0,39407,167,21938,19083,14503,14461
2021-03-16 11:30:00+00,13617,639,4681,10660,323,2846,2858,155,3847,0,39626,166,22369,19511,14830,14256
2021-03-16 12:00:00+00,13842,670,4702,10880,323,2398,2855,177,3856,10,39713,168,22616,19761,15059,14512
2021-03-16 12:30:00+00,13769,404,4717,10951,322,2382,2861,226,3968,40,39640,162,22819,19958,15241,14173
2021-03-16 13:00:00+00,13292,315,4739,11011,316,2640,2842,192,3653,0,39000,157,22561,19719,14980,13607
2021-03-16 13:30:00+00,12280,314,4739,11476,309,2648,2824,162,3842,0,38594,148,23190,20366,15627,12594
2021-03-16 14:00:00+00,10865,314,4738,12279,292,2432,2833,162,4028,0,37943,136,24170,21337,16599,11179
2021-03-16 14:30:00+00,10453,347,4736,12554,290,2424,2846,162,4096,0,37908,132,24522,21676,16940,10800
2021-03-16 15:00:00+00,11482,365,4735,12518,298,1050,2854,167,3664,4,37137,143,24069,21215,16480,11847
2021-03-16 15:30:00+00,12545,365,4736,13235,306,852,2863,168,3033,34,38137,150,24173,21310,16574,12910
2021-03-16 16:00:00+00,12991,365,4742,13337,353,1130,2851,197,2431,0,38397,155,23714,20863,16121,13356
2021-03-16 16:30:00+00,13743,360,4753,13831,375,1140,2863,210,1686,0,38961,160,23508,20645,15892,14103
2021-03-16 17:00:00+00,13445,365,4763,14185,639,2612,2865,205,813,122,40014,156,23265,20400,15637,13810
2021-03-16 17:30:00+00,14626,364,4773,13980,643,2644,2855,199,183,432,40699,165,22434,19579,14806,14990
2021-03-16 18:00:00+00,15422,360,4784,13899,669,2540,2860,284,0,958,41776,168,22212,19352,14568,15782
2021-03-16 18:30:00+00,15986,359,4792,13492,776,2552,2862,221,0,1204,42244,171,21922,19060,14268,16345
2021-03-16 19:00:00+00,15733,366,4799,13188,686,3488,2863,184,0,202,41509,173,21536,18673,13874,16099
2021-03-16 19:30:00+00,15001,364,4798,12953,701,3512,2862,162,0,204,40557,170,21314,18452,13654,15365
2021-03-16 20:00:00+00,14564,364,4803,12798,588,3424,2855,153,0,0,39549,170,21044,18189,13386,14928
2021-03-16 20:30:00+00,12873,363,4797,12783,592,3420,2865,153,0,0,37846,160,21037,18172,13375,13236
2021-03-16 21:00:00+00,11112,366,4803,12892,550,3436,2705,153,0,0,36017,148,20950,18245,13442,11478
2021-03-16 21:30:00+00,9939,365,4798,12659,516,3440,2500,153,0,0,34370,141,20473,17973,13175,10304
2021-03-16 22:00:00+00,8968,367,4799,12439,433,2886,2523,153,0,12,32580,136,20194,17671,12872,9335
2021-03-16 22:30:00+00,7548,366,4796,12427,446,2874,2463,152,0,0,31072,124,20132,17669,12873,7914
2021-03-16 23:00:00+00,6557,356,4801,12316,446,2548,2099,151,0,0,29274,116,19662,17563,12762,6913
2021-03-16 23:30:00+00,5662,371,4806,12071,446,2540,2054,151,0,0,28101,109,19377,17323,12517,6033
2021-03-17 00:00:00+00,5926,323,4816,11513,414,2616,2039,151,0,0,27798,112,18782,16743,11927,6249
2021-03-17 00:30:00+00,6529,320,4818,11212,395,2618,2073,152,0,20,28137,119,18498,16425,11607,6849
2021-03-17 01:00:00+00,6380,312,4821,11267,279,2618,2196,150,0,0,28023,117,18563,16367,11546,6692
2021-03-17 01:30:00+00,5968,318,4822,11196,279,2618,2018,150,0,0,27369,114,18315,16297,11475,6286
2021-03-17 02:00:00+00,6330,318,4827,10786,279,2618,2179,151,0,0,27488,119,18071,15892,11065,6648
2021-03-17 02:30:00+00,5985,312,4832,10946,280,2618,2163,151,0,0,27287,115,18221,16058,11226,6297
2021-03-17 03:00:00+00,5889,320,4831,10936,279,2618,2022,153,0,0,27048,114,18068,16046,11215,6209
2021-03-17 03:30:00+00,5726,318,4830,10798,278,2618,2030,153,0,0,26751,113,17936,15906,11076,6044
2021-03-17 04:00:00+00,5689,282,4837,10889,275,2618,1993,152,0,0,26735,111,17994,16001,11164,5971
2021-03-17 04:30:00+00,5575,309,4843,11448,282,2618,1987,152,0,0,27214,108,18560,16573,11730,5884
2021-03-17 05:00:00+00,5748,278,4858,11453,330,2670,1985,152,0,0,27474,109,18626,16641,11783,6026
2021-03-17 05:30:00+00,6359,279,4861,11549,335,2672,2011,152,0,0,28218,115,18756,16745,11884,6638
2021-03-17 06:00:00+00,8794,366,4866,11050,357,2420,2012,151,0,44,30060,142,18285,16273,11407,9160
2021-03-17 06:30:00+00,11002,362,4870,10616,382,2408,2161,152,214,0,32167,160,18243,16082,11212,11364
2021-03-17 07:00:00+00,14175,330,4870,10462,495,1490,2750,154,576,166,35468,179,19153,16403,11533,14505
2021-03-17 07:30:00+00,15266,311,4871,10476,619,1466,2843,157,919,182,37110,183,19728,16885,12014,15577
2021-03-17 08:00:00+00,15017,310,4869,10104,698,2788,2837,402,1349,288,38662,178,19857,17020,12151,15327
2021-03-17 08:30:00+00,15288,309,4869,9560,780,2830,2853,487,1565,316,38857,180,19627,16774,11905,15597
2021-03-17 09:00:00+00,15303,298,4871,9373,771,3484,2862,480,1911,332,39685,178,19788,16926,12055,15601
2021-03-17 09:30:00+00,15234,309,4864,9136,772,3496,2804,462,2459,260,39796,176,20035,17231,12367,15543
2021-03-17 10:00:00+00,15381,311,4867,8938,664,3496,2792,414,2611,368,39842,177,19872,17080,12213,15692
2021-03-17 10:30:00+00,15654,345,4573,8970,650,3496,2790,500,2576,334,39888,181,19559,16769,12196,15999
2021-03-17 11:00:00+00,15593,307,4894,9314,563,3496,2833,500,2652,2,40154,179,20256,17423,12529,15900
2021-03-17 11:30:00+00,15832,308,4898,9166,494,3496,2852,442,2626,0,40114,181,20036,17184,12286,16140
2021-03-17 12:00:00+00,16190,332,4898,8577,481,3496,2846,426,3115,114,40475,183,19917,17071,12173,16522
2021-03-17 12:30:00+00,15773,318,4900,8825,466,3496,2846,266,4205,0,41095,175,21242,18396,13496,16091
2021-03-17 13:00:00+00,15447,310,4902,8805,465,3450,2732,196,4506,0,40813,172,21410,18678,13776,15757
2021-03-17 13:30:00+00,14963,313,4905,8452,464,3448,2546,195,4740,0,40026,170,21107,18561,13656,15276
2021-03-17 14:00:00+00,14876,313,4906,8041,464,3494,1811,244,4474,168,38791,172,19696,17885,12979,15189
2021-03-17 14:30:00+00,15007,306,4912,7701,460,3496,1737,259,4162,34,38074,177,18972,17235,12323,15313
2021-03-17 15:00:00+00,15106,315,4914,7647,474,3496,1803,131,3780,0,37666,179,18618,16815,11901,15421
2021-03-17 15:30:00+00,16042,239,4918,7376,502,3496,1853,159,3009,0,37594,188,17658,15805,10887,16281
2021-03-17 16:00:00+00,17066,321,4922,7032,531,3488,2424,169,2279,0,38232,199,17188,14764,9842,17387
2021-03-17 16:30:00+00,19013,298,4921,6087,724,3488,2732,208,1440,120,39031,215,15904,13172,8251,19311
2021-03-17 17:00:00+00,20286,299,4923,5501,906,3514,2734,241,720,646,39770,224,14784,12050,7127,20585
2021-03-17 17:30:00+00,21291,302,4916,4614,908,3487,2740,303,193,1122,39876,234,13371,10631,5715,21593
2021-03-17 18:00:00+00,21848,311,4918,4191,940,3465,2737,373,1,1734,40518,236,12787,10050,5132,22159
2021-03-17 18:30:00+00,22298,315,4915,4157,942,3440,2735,488,0,1818,41107,238,12749,10014,5099,22613
2021-03-17 19:00:00+00,22158,252,4913,4471,943,3374,2727,455,0,1644,40937,236,13054,10327,5414,22410
2021-03-17 19:30:00+00,22094,315,4912,4183,922,3361,2737,398,0,882,39804,243,12754,10017,5105,22409
2021-03-17 20:00:00+00,21876,314,4912,4317,646,3294,2733,268,0,118,38478,248,12608,9875,4963,22190
2021-03-17 20:30:00+00,20442,314,4916,4391,639,3282,2736,211,0,0,36931,243,12682,9946,5030,20756
2021-03-17 21:00:00+00,19362,312,4927,4240,532,3194,2736,154,0,0,35457,240,12435,9699,4772,19674
2021-03-17 21:30:00+00,17687,309,4933,4258,467,3192,2738,146,0,8,33738,233,12396,9658,4725,17996
2021-03-17 22:00:00+00,15999,314,4936,4261,403,3130,2730,143,0,4,31920,225,12330,9600,4664,16313
2021-03-17 22:30:00+00,14667,313,4932,4223,347,2540,2746,150,0,2,29920,222,12248,9502,4570,14980
2021-03-17 23:00:00+00,13307,311,4937,4578,301,3077,2451,144,0,0,29107,209,12267,9816,4879,13618
2021-03-17 23:30:00+00,12389,309,4936,4500,285,3077,1952,142,0,0,27590,205,11673,9721,4785,12698
2021-03-18 00:00:00+00,12319,315,4938,4393,267,3086,1821,144,0,0,27283,207,11419,9598,4660,12634
2021-03-18 00:30:00+00,12474,311,4933,4594,265,3100,1813,142,0,0,27632,206,11605,9792,4859,12785
2021-03-18 01:00:00+00,12175,314,4936,4834,266,3050,1815,144,0,0,27534,203,11851,10036,5100,12489
2021-03-18 01:30:00+00,11403,311,4947,5056,264,3034,1822,142,0,0,26978,196,12089,10267,5320,11714
2021-03-18 02:00:00+00,11210,315,4952,5427,262,2992,2112,147,0,0,27418,191,12753,10641,5689,11525
2021-03-18 02:30:00+00,10857,315,4955,6013,257,2971,2177,144,0,0,27689,184,13402,11225,6270,11172
2021-03-18 03:00:00+00,10349,297,4962,6602,246,2846,2110,144,0,0,27556,177,13920,11810,6848,10646
2021-03-18 03:30:00+00,9776,315,4966,7044,246,2804,2102,142,0,0,27395,170,14358,12256,7290,10091
2021-03-18 04:00:00+00,9883,314,4964,7231,244,2526,2127,143,0,0,27431,171,14566,12439,7475,10197
2021-03-18 04:30:00+00,9917,315,4967,7489,251,2503,2109,141,0,0,27692,169,14816,12707,7740,10232
2021-03-18 05:00:00+00,11470,312,4978,7608,327,1201,2255,141,0,0,28292,183,15168,12913,7935,11782
2021-03-18 05:30:00+00,11960,310,4978,7745,353,1235,2163,145,0,0,28889,187,15239,13076,8098,12270
2021-03-18 06:00:00+00,14412,311,4974,7678,547,1282,2359,144,0,0,31707,203,15558,13199,8225,14723
2021-03-18 06:30:00+00,16540,311,4967,7686,547,1153,2479,159,111,18,33972,213,15790,13311,8344,16851
2021-03-18 07:00:00+00,17867,310,4965,7569,556,1647,2904,239,376,204,36637,214,16370,13466,8501,18177
2021-03-18 07:30:00+00,18737,314,4965,7211,724,1655,2985,428,695,104,37818,219,16580,13595,8630,19051
2021-03-18 08:00:00+00,18654,312,4967,7233,608,2494,2970,400,1123,156,38917,214,16901,13931,8964,18966
2021-03-18 08:30:00+00,18784,315,4965,7292,532,2557,3010,351,1495,298,39599,212,17294,14284,9319,19099
2021-03-18 09:00:00+00,18321,312,4968,7232,509,3014,2998,255,1782,96,39488,207,17489,14491,9523,18633
2021-03-18 09:30:00+00,18188,317,4970,7426,492,3051,3004,135,2052,0,39635,204,17944,14940,9970,18505
2021-03-18 10:00:00+00,18241,315,4970,7439,445,3165,3003,131,2341,0,40050,203,18198,15195,10225,18556
2021-03-18 10:30:00+00,17828,315,4965,7577,597,3172,2999,243,2709,0,40405,198,18847,15848,10883,18143
2021-03-18 11:00:00+00,17376,313,4967,7858,567,3022,2993,264,2980,0,40340,194,19365,16372,11405,17689
2021-03-18 11:30:00+00,17362,312,4969,7867,460,3004,2993,132,3115,0,40214,193,19404,16411,11442,17674
2021-03-18 12:00:00+00,17071,309,4973,8046,394,3444,3005,126,3112,0,40480,190,19530,16525,11552,17380
2021-03-18 12:30:00+00,16876,311,4975,8221,398,3426,2977,129,3016,0,40329,189,19587,16610,11635,17187
2021-03-18 13:00:00+00,17929,313,4979,8185,419,1914,3036,129,2879,0,39783,200,19498,16462,11483,18242
2021-03-18 13:30:00+00,18160,311,4982,8062,420,1708,3035,127,2847,0,39652,202,19346,16311,11329,18471
2021-03-18 14:00:00+00,18102,317,4983,7936,424,1224,3040,128,2404,0,38558,207,18787,15747,10764,18419
2021-03-18 14:30:00+00,18162,312,4983,7622,548,1164,3044,127,2058,0,38020,211,18255,15211,10228,18474
2021-03-18 15:00:00+00,18449,313,4984,7444,593,1004,3040,127,1924,196,38074,213,17985,14945,9961,18762
2021-03-18 15:30:00+00,19045,314,4988,7631,614,1024,3035,255,1789,0,38695,217,18057,15022,10034,19359
2021-03-18 16:00:00+00,19372,315,4985,7402,521,1838,3018,174,1289,0,38914,219,17215,14197,9212,19687
2021-03-18 16:30:00+00,20058,313,4988,7163,767,1974,3006,240,729,134,39372,225,16653,13647,8659,20371
2021-03-18 17:00:00+00,20081,314,4990,7202,686,2772,2996,237,387,564,40229,222,16261,13265,8275,20395
2021-03-18 17:30:00+00,20277,314,4989,7217,753,2970,2978,319,117,844,40778,223,16054,13076,8087,20591
2021-03-18 18:00:00+00,20861,315,4990,7363,909,2214,2998,407,1,1068,41126,225,16261,13263,8273,21176
2021-03-18 18:30:00+00,20741,314,4987,7617,905,2174,3039,410,0,1296,41483,222,16548,13509,8522,21055
2021-03-18 19:00:00+00,19838,314,4988,7859,761,3470,3053,203,0,676,41162,214,16661,13608,8620,20152
2021-03-18 19:30:00+00,18804,314,4990,7928,770,3498,3046,175,0,0,39525,213,16734,13688,8698,19118
2021-03-18 20:00:00+00,18200,311,4988,8336,712,2480,3057,146,0,0,38230,211,17093,14036,9048,18511
2021-03-18 20:30:00+00,16660,311,4986,8632,666,2408,3063,126,0,0,36852,203,17347,14284,9298,16971
2021-03-18 21:00:00+00,14405,310,4991,8651,593,2960,3055,124,0,0,35089,189,17290,14235,9244,14715
2021-03-18 21:30:00+00,12959,313,4995,8426,552,2904,3010,126,0,0,33285,182,16983,13973,8978,13272
2021-03-18 22:00:00+00,12662,313,4994,8084,480,1706,3037,140,0,0,31416,188,16595,13558,8564,12975
2021-03-18 22:30:00+00,11619,307,4994,7579,417,1660,2888,126,0,0,29590,184,15878,12990,7996,11926
2021-03-18 23:00:00+00,9128,287,4993,7543,393,3172,2592,125,0,0,28233,159,15521,12929,7936,9415
2021-03-18 23:30:00+00,8638,275,4988,7424,388,3212,2408,129,0,0,27462,155,15208,12800,7812,8913
2021-03-19 00:00:00+00,8800,273,4991,7443,278,3178,2253,125,0,0,27341,157,14965,12712,7721,9073
2021-03-19 00:30:00+00,9090,275,4994,7280,278,3266,2219,128,0,0,27530,161,14771,12552,7558,9365
2021-03-19 01:00:00+00,9029,275,4997,7166,277,3574,2186,124,0,0,27628,162,14626,12440,7443,9304
2021-03-19 01:30:00+00,8687,273,4995,7097,277,3616,2184,123,0,0,27252,160,14553,12369,7374,8960
2021-03-19 02:00:00+00,8704,276,4998,6990,276,3606,2165,123,0,0,27138,161,14429,12264,7266,8980
2021-03-19 02:30:00+00,8689,275,4994,6896,270,3554,2163,126,0,0,26967,160,14323,12160,7166,8964
2021-03-19 03:00:00+00,9102,275,4992,6610,265,3490,2173,128,0,0,27035,166,14040,11867,6875,9377
2021-03-19 03:30:00+00,9419,276,4994,6273,265,3474,2166,126,0,0,26993,170,13698,11532,6538,9695
2021-03-19 04:00:00+00,9897,276,4993,6024,283,3046,2178,125,0,0,26822,178,13478,11300,6307,10173
2021-03-19 04:30:00+00,10353,276,4992,5535,284,3002,2408,124,0,0,26974,184,13219,10811,5819,10629
2021-03-19 05:00:00+00,10358,275,5002,5512,306,2524,2550,124,0,0,26651,185,13370,10820,5818,10633
2021-03-19 05:30:00+00,11455,276,5004,5476,312,2592,2274,123,0,0,27512,196,13066,10792,5788,11731
2021-03-19 06:00:00+00,13952,276,5005,5176,347,2012,2474,126,4,100,29472,215,13006,10532,5527,14228
2021-03-19 06:30:00+00,16217,275,5002,4895,355,1990,2755,125,126,0,31740,228,13133,10378,5376,16492
2021-03-19 07:00:00+00,18613,289,5001,4722,468,1688,3015,136,511,96,34539,236,13717,10702,5701,18902
2021-03-19 07:30:00+00,19602,365,4999,4528,599,1728,3022,219,1144,28,36234,238,14292,11270,6271,19967
2021-03-19 08:00:00+00,19426,586,5000,3982,671,2832,3014,150,1648,0,37310,235,14316,11302,6302,20012
2021-03-19 08:30:00+00,19347,819,5000,3653,673,2868,2915,128,2159,0,37562,238,14400,11485,6485,20166
2021-03-19 09:00:00+00,19518,947,4999,3485,670,3000,2754,229,2766,0,38368,239,14674,11920,6921,20465
2021-03-19 09:30:00+00,19416,1112,5002,3307,670,2958,2814,175,3189,0,38643,240,14982,12168,7166,20528
2021-03-19 10:00:00+00,19794,1181,5002,3189,809,2044,2933,159,3502,0,38613,245,15435,12502,7500,20975
2021-03-19 10:30:00+00,19905,1039,4999,3057,816,2040,2981,157,3866,0,38860,241,15719,12738,7739,20944
2021-03-19 11:00:00+00,19475,799,4996,2999,763,2952,2976,132,4049,0,39141,230,15783,12807,7811,20274
2021-03-19 11:30:00+00,19735,813,4998,2788,754,2978,2966,132,4114,0,39278,232,15620,12654,7656,20548
2021-03-19 12:00:00+00,19895,934,5006,2646,740,2984,2959,127,4343,0,39634,234,15694,12735,7729,20829
2021-03-19 12:30:00+00,19735,965,5005,2645,727,3000,2959,126,4344,0,39506,234,15680,12721,7716,20700
2021-03-19 13:00:00+00,19797,894,5007,2760,431,2942,2896,130,4065,0,38922,237,15159,12263,7256,20691
2021-03-19 13:30:00+00,19345,915,5002,2762,424,2994,2908,129,3534,0,38013,238,14630,11722,6720,20260
2021-03-19 14:00:00+00,19432,837,5011,2732,449,2998,2960,128,3113,0,37660,239,14265,11305,6294,20269
2021-03-19 14:30:00+00,19353,784,5012,2628,468,2996,2965,128,2899,0,37233,240,13972,11007,5995,20137
2021-03-19 15:00:00+00,18388,879,5020,2634,373,3954,2966,128,2288,0,36630,237,13281,10315,5295,19267
2021-03-19 15:30:00+00,18804,1132,5013,2662,374,3996,2962,131,1791,0,36865,247,12802,9840,4827,19936
2021-03-19 16:00:00+00,19501,1173,5010,2543,382,4014,2957,189,1435,4,37208,253,12327,9370,4360,20674
2021-03-19 16:30:00+00,19597,1211,5014,2538,574,4014,2951,442,912,150,37403,256,11989,9038,4024,20808
2021-03-19 17:00:00+00,19877,1117,5008,2532,734,4014,2985,440,438,1424,38569,250,11697,8712,3704,20994
2021-03-19 17:30:00+00,20301,1083,5014,2549,875,4014,2971,462,99,1810,39178,249,11508,8537,3523,21384
2021-03-19 18:00:00+00,20284,1239,5014,2487,953,4014,2993,495,1,1890,39370,252,11448,8455,3441,21523
2021-03-19 18:30:00+00,20684,1291,5014,2305,982,4016,2983,493,0,2050,39818,254,11284,8301,3287,21975
2021-03-19 19:00:00+00,20327,1292,5014,2236,845,4016,2993,475,0,2028,39226,254,11088,8095,3081,21619
2021-03-19 19:30:00+00,19876,1288,5012,2086,844,4016,2991,399,0,1672,38184,256,10933,7942,2930,21164
2021-03-19 20:00:00+00,19859,1276,5011,1963,748,4016,2991,373,0,494,36731,265,10713,7722,2711,21135
2021-03-19 20:30:00+00,19664,1141,5010,1887,594,4014,2996,233,0,120,35659,266,10487,7491,2481,20805
2021-03-19 21:00:00+00,19158,684,5011,1792,496,3672,2995,177,0,0,33985,259,10294,7299,2288,19842
2021-03-19 21:30:00+00,18571,224,5012,1802,449,3648,2995,131,0,14,32846,248,10258,7263,2251,18795
2021-03-19 22:00:00+00,17950,0,5012,1815,397,3076,2990,120,0,148,31508,242,10214,7224,2212,17950
2021-03-19 22:30:00+00,16896,0,5009,1833,329,3084,2826,122,0,68,30167,239,9997,7171,2162,16896
2021-03-19 23:00:00+00,15325,0,5012,1719,320,3970,2132,114,0,90,28682,228,9183,7051,2039,15325
2021-03-19 23:30:00+00,14737,0,5008,1633,319,3994,1668,113,0,34,27506,228,8628,6960,1952,14737
2021-03-20 00:00:00+00,14324,0,5008,1596,399,3944,1792,113,0,46,27222,225,8795,7003,1995,14324
2021-03-20 00:30:00+00,14311,0,5003,1632,487,3942,1859,114,0,86,27434,223,8981,7122,2119,14311
2021-03-20 01:00:00+00,14210,0,5004,1559,454,3802,1883,113,0,12,27037,225,8900,7017,2013,14210
2021-03-20 01:30:00+00,13901,0,5011,1579,402,3802,1651,112,0,0,26458,224,8643,6992,1981,13901
2021-03-20 02:00:00+00,13843,0,5007,1618,338,3896,1634,112,0,0,26448,224,8597,6963,1956,13843
2021-03-20 02:30:00+00,13722,0,5008,1722,234,3894,1457,113,0,0,26150,223,8421,6964,1956,13722
2021-03-20 03:00:00+00,13782,0,5004,1748,214,3746,1559,115,0,0,26168,224,8525,6966,1962,13782
2021-03-20 03:30:00+00,13485,0,5006,1814,214,3728,1501,113,0,0,25861,222,8535,7034,2028,13485
2021-03-20 04:00:00+00,13882,0,5010,1916,214,3108,1486,114,0,0,25730,228,8626,7140,2130,13882
2021-03-20 04:30:00+00,13476,0,5014,2107,215,3088,1511,115,0,0,25526,223,8847,7336,2322,13476
2021-03-20 05:00:00+00,13697,0,5012,2183,232,2780,1593,114,0,0,25611,226,9020,7427,2415,13697
2021-03-20 05:30:00+00,14061,0,5014,2177,240,2774,1632,114,0,0,26012,228,9063,7431,2417,14061
2021-03-20 06:00:00+00,14136,0,5017,2249,289,2926,1668,114,3,0,26402,226,9226,7558,2541,14136
2021-03-20 06:30:00+00,14201,0,5011,2281,291,2944,1743,114,91,0,26676,225,9417,7674,2663,14201
2021-03-20 07:00:00+00,14335,0,5015,2378,353,3354,1878,281,325,26,27945,220,9949,8071,3056,14335
2021-03-20 07:30:00+00,14692,0,5015,2614,473,3372,1779,376,583,30,28934,218,10464,8685,3670,14692
2021-03-20 08:00:00+00,14870,0,5010,2770,603,3978,1989,317,951,244,30732,209,11323,9334,4324,14870
2021-03-20 08:30:00+00,15235,0,5012,3045,744,3996,2321,237,1460,136,32186,205,12582,10261,5249,15235
2021-03-20 09:00:00+00,15688,0,5007,3426,788,3996,2336,174,1928,108,33451,202,13485,11149,6142,15688
2021-03-20 09:30:00+00,15613,0,5009,3787,790,3996,2334,231,2287,220,34267,197,14207,11873,6864,15613
2021-03-20 10:00:00+00,15359,0,5012,4442,791,3996,2331,247,2614,102,34894,190,15190,12859,7847,15359
2021-03-20 10:30:00+00,15107,0,5014,4937,765,3996,2328,251,2824,86,35308,185,15868,13540,8526,15107
2021-03-20 11:00:00+00,15127,0,4964,5311,599,3996,2322,245,2902,280,35746,183,16098,13776,8812,15127
2021-03-20 11:30:00+00,15024,0,4956,5687,501,3996,2316,234,2843,110,35667,182,16303,13987,9031,15024
2021-03-20 12:00:00+00,15000,0,4948,5817,486,3996,2322,252,2826,0,35647,182,16399,14077,9129,15000
2021-03-20 12:30:00+00,14986,0,4953,6247,541,3996,2102,329,2848,0,36002,180,16691,14589,9636,14986
2021-03-20 13:00:00+00,14959,0,4955,6691,399,3996,1996,231,2694,50,35971,179,16735,14739,9784,14959
2021-03-20 13:30:00+00,14465,0,4954,6991,261,3996,2025,124,2526,16,35358,176,16757,14732,9778,14465
2021-03-20 14:00:00+00,13980,0,4956,7550,261,3996,1901,120,2438,0,35202,171,17106,15205,10249,13980
2021-03-20 14:30:00+00,13534,0,4955,7940,265,3996,1821,118,1995,0,34624,168,16976,15155,10200,13534
2021-03-20 15:00:00+00,13227,0,4955,8323,296,3996,1822,118,1622,0,34359,166,17018,15196,10241,13227
2021-03-20 15:30:00+00,13588,0,4949,8180,296,3994,1849,121,1332,0,34309,170,16606,14757,9808,13588
2021-03-20 16:00:00+00,14215,0,4953,8560,315,3868,1824,117,957,0,34809,175,16609,14785,9832,14215
2021-03-20 16:30:00+00,14915,0,4954,8622,419,3868,1871,122,710,0,35481,179,16576,14705,9751,14915
2021-03-20 17:00:00+00,15912,0,4957,8563,578,4014,2112,138,391,2,36667,185,16601,14489,9532,15912
2021-03-20 17:30:00+00,16235,0,4953,8292,523,4016,2401,199,143,358,37120,188,16312,13911,8958,16235
2021-03-20 18:00:00+00,16261,0,4960,8315,657,3896,2409,243,4,822,37567,186,16345,13936,8976,16261
2021-03-20 18:30:00+00,16555,0,4952,8446,737,3894,2410,256,0,1234,38484,185,16545,14135,9183,16555
2021-03-20 19:00:00+00,16569,0,4957,8258,744,4014,2409,210,0,1180,38341,186,16368,13959,9002,16569
2021-03-20 19:30:00+00,16127,0,4955,8015,718,4014,2403,264,0,534,37030,188,16091,13688,8733,16127
2021-03-20 20:00:00+00,15216,0,4956,7986,775,4014,2405,315,0,124,35791,185,16122,13717,8761,15216
2021-03-20 20:30:00+00,14239,0,4953,7742,660,4014,2297,310,0,22,34237,182,15652,13355,8402,14239
2021-03-20 21:00:00+00,13152,0,4957,7767,631,3932,2118,258,0,4,32819,175,15473,13355,8398,13152
2021-03-20 21:30:00+00,12489,0,4958,7440,536,3924,1984,114,0,14,31459,172,14918,12934,7976,12489
2021-03-20 22:00:00+00,11832,0,4958,7108,280,3600,1958,112,0,96,29944,171,14304,12346,7388,11832
2021-03-20 22:30:00+00,11095,0,4960,6781,375,3586,1929,113,0,0,28839,167,14045,12116,7156,11095
2021-03-20 23:00:00+00,10043,0,4959,6823,264,3484,1743,113,0,36,27465,160,13789,12046,7087,10043
2021-03-20 23:30:00+00,8985,0,4959,7115,257,3480,1554,113,0,0,26463,150,13885,12331,7372,8985
2021-03-21 00:00:00+00,8942,0,4956,6620,257,3504,1383,113,0,54,25829,150,13216,11833,6877,8942
2021-03-21 00:30:00+00,9372,0,4951,6625,256,3506,1400,113,0,0,26223,155,13232,11832,6881,9372
2021-03-21 01:00:00+00,8901,0,4939,6862,228,3482,1403,113,0,0,25928,149,13432,12029,7090,8901
2021-03-21 01:30:00+00,8723,0,4829,6618,225,3482,1394,112,0,0,25383,150,13066,11672,6843,8723
2021-03-21 02:00:00+00,8508,0,4829,6637,209,3420,1459,125,0,0,25187,148,13134,11675,6846,8508
2021-03-21 02:30:00+00,8125,0,4828,6627,209,3420,1509,112,0,0,24830,144,13173,11664,6836,8125
2021-03-21 03:00:00+00,8134,0,4829,6718,206,3278,1453,112,0,0,24730,144,13206,11753,6924,8134
2021-03-21 03:30:00+00,7923,0,4826,6749,206,3278,1455,112,0,0,24549,142,13236,11781,6955,7923
2021-03-21 04:00:00+00,7875,0,4827,6715,206,3282,1454,112,0,0,24471,141,13202,11748,6921,7875
2021-03-21 04:30:00+00,7734,0,4827,6417,208,3282,1460,112,0,0,24040,142,12912,11452,6625,7734
2021-03-21 05:00:00+00,7764,0,4830,6237,225,3310,1425,112,0,0,23903,143,12717,11292,6462,7764
2021-03-21 05:30:00+00,7885,0,4832,5976,227,3308,1640,113,0,0,23981,146,12675,11035,6203,7885
2021-03-21 06:00:00+00,8233,0,4831,5816,320,3210,1687,112,16,0,24225,150,12670,10983,6152,8233
2021-03-21 06:30:00+00,8880,0,4830,5598,340,3210,1595,112,220,0,24785,156,12583,10988,6158,8880
2021-03-21 07:00:00+00,9174,0,4831,5559,307,3398,2091,114,607,0,26081,156,13395,11304,6473,9174
2021-03-21 07:30:00+00,9448,0,4832,5503,258,3406,2393,114,1156,0,27110,155,14142,11749,6917,9448
2021-03-21 08:00:00+00,10585,0,4830,5433,293,3404,2413,117,1705,0,28780,162,14674,12261,7431,10585
2021-03-21 08:30:00+00,11884,0,4831,5183,309,3412,2399,116,2381,0,30515,169,15103,12704,7873,11884
2021-03-21 09:00:00+00,12487,0,4831,5200,448,3792,2410,115,3144,0,32427,167,16033,13623,8792,12487
2021-03-21 09:30:00+00,13119,0,4828,5004,454,3800,2410,115,4020,0,33750,168,16716,14306,9478,13119
2021-03-21 10:00:00+00,12994,0,4826,4926,549,3992,2397,115,4406,0,34205,165,17104,14707,9881,12994
2021-03-21 10:30:00+00,12856,0,4823,5058,558,3994,2400,115,4458,0,34262,163,17297,14897,10074,12856
2021-03-21 11:00:00+00,13017,0,4826,4983,543,3994,2358,116,4658,0,34495,163,17368,15010,10184,13017
2021-03-21 11:30:00+00,13552,0,4833,4811,541,3994,2342,116,4557,0,34746,168,17084,14742,9909,13552
2021-03-21 12:00:00+00,14267,0,4828,4587,525,3862,2399,123,4262,0,34853,176,16601,14202,9374,14267
2021-03-21 12:30:00+00,14588,0,4831,4406,511,3862,2353,296,4065,0,34912,180,16166,13813,8982,14588
2021-03-21 13:00:00+00,14728,0,4833,4625,465,3994,2307,152,3839,0,34943,181,16069,13762,8929,14728
2021-03-21 13:30:00+00,14718,0,4831,4775,462,3994,2189,123,3544,0,34636,181,15801,13612,8781,14718
2021-03-21 14:00:00+00,14946,0,4832,4731,394,3994,2146,123,3344,0,34510,185,15447,13301,8469,14946
2021-03-21 14:30:00+00,15250,0,4833,4603,394,3994,2115,123,2795,0,34107,190,14740,12625,7792,15250
2021-03-21 15:00:00+00,16207,24,4836,4272,395,3994,2252,123,2366,0,34470,200,14121,11869,7033,16232
2021-03-21 15:30:00+00,16932,49,4833,4254,431,3994,2361,124,1955,0,34933,207,13834,11473,6640,16981
2021-03-21 16:00:00+00,17965,194,4835,4160,643,4014,2372,132,1594,0,35909,216,13604,11232,6397,18159
2021-03-21 16:30:00+00,18989,322,4838,4077,665,4014,2336,319,1169,0,36729,227,13085,10749,5911,19311
2021-03-21 17:00:00+00,19816,434,4832,3715,779,4014,2395,333,712,800,37830,232,12433,10038,5206,20250
2021-03-21 17:30:00+00,20094,491,4832,3610,860,4014,2361,424,270,1040,37996,237,11933,9572,4740,20585
2021-03-21 18:00:00+00,20421,489,4830,3463,836,4014,2395,449,14,1046,37957,241,11538,9143,4313,20910
2021-03-21 18:30:00+00,20639,489,4825,3258,853,4014,2403,453,0,1400,38334,241,11339,8936,4111,21128
2021-03-21 19:00:00+00,20649,445,4829,3113,905,4014,2409,450,0,1380,38194,241,11256,8847,4018,21094
2021-03-21 19:30:00+00,20225,383,4832,3011,788,4014,2405,440,0,1004,37102,241,11036,8631,3799,20608
2021-03-21 20:00:00+00,19830,451,4829,3068,753,4012,2433,413,0,570,36359,243,11083,8650,3821,20281
2021-03-21 20:30:00+00,19465,400,4829,2963,750,4012,2470,326,0,92,35307,244,11012,8542,3713,19865
2021-03-21 21:00:00+00,18269,371,4832,2856,664,3994,2495,135,0,0,33616,240,10847,8352,3520,18640
2021-03-21 21:30:00+00,17164,209,4830,2743,654,3994,2532,124,0,0,32250,232,10759,8227,3397,17373
2021-03-21 22:00:00+00,15323,104,4831,2671,572,3994,2702,220,0,158,30575,219,10776,8074,3243,15428
2021-03-21 22:30:00+00,13820,0,4835,2714,464,3994,2949,256,0,4,29036,209,10962,8013,3178,13820
2021-03-21 23:00:00+00,12195,0,4831,2942,413,3894,3063,194,0,26,27558,196,11249,8186,3355,12195
2021-03-21 23:30:00+00,11324,0,4835,3043,395,3890,3069,119,0,0,26675,189,11342,8273,3438,11324
2021-03-22 00:00:00+00,11223,0,4834,2980,281,3800,3063,119,0,0,26300,194,11158,8095,3261,11223
2021-03-22 00:30:00+00,11304,0,4831,2837,272,3802,3073,118,0,0,26237,195,11013,7940,3109,11304
2021-03-22 01:00:00+00,10869,0,4832,2778,271,3809,3070,138,0,0,25766,193,10951,7881,3049,10869
2021-03-22 01:30:00+00,10637,0,4831,2861,269,3811,3075,191,0,0,25675,191,11036,7961,3130,10637
2021-03-22 02:00:00+00,10822,0,4829,2880,237,3623,3071,119,0,0,25581,193,11017,7946,3117,10822
2021-03-22 02:30:00+00,10772,0,4825,2951,237,3628,3078,119,0,0,25609,192,11091,8013,3188,10772
2021-03-22 03:00:00+00,10731,0,4829,3046,235,3628,3070,119,0,0,25658,191,11180,8110,3281,10731
2021-03-22 03:30:00+00,10481,0,4827,3048,235,3626,3075,120,0,0,25412,189,11185,8110,3283,10481
2021-03-22 04:00:00+00,10752,0,4830,3079,234,3283,3073,118,0,0,25369,192,11216,8143,3313,10752
2021-03-22 04:30:00+00,10791,0,4830,3105,234,3292,3081,118,0,0,25451,192,11250,8169,3339,10791
2021-03-22 05:00:00+00,11311,0,4836,3071,234,2395,3074,172,0,0,25094,203,11215,8141,3305,11311
2021-03-22 05:30:00+00,12035,14,4834,3203,346,2495,3075,221,0,0,26223,208,11458,8383,3549,12049
2021-03-22 06:00:00+00,13029,40,4836,3296,707,3104,3079,305,29,12,28437,209,11947,8868,4032,13069
2021-03-22 06:30:00+00,15125,64,4837,3327,746,3064,3075,351,385,112,31086,217,12370,9295,4458,15189
2021-03-22 07:00:00+00,18288,121,4838,3434,706,2374,3074,355,1102,98,34390,233,13154,10080,5242,18409
2021-03-22 07:30:00+00,19550,239,4833,3373,628,2372,3077,299,1630,170,36171,237,13541,10464,5631,19789
2021-03-22 08:00:00+00,19407,322,4836,3529,625,3482,3076,224,2168,0,37669,229,14234,11158,6322,19729
2021-03-22 08:30:00+00,19562,313,4837,3529,554,3516,3060,200,2785,0,38356,226,14765,11705,6868,19875
2021-03-22 09:00:00+00,19790,307,4835,3693,658,2856,3050,410,3618,6,39223,224,15854,12804,7969,20097
2021-03-22 09:30:00+00,19414,318,4833,4086,707,2798,3059,433,4357,0,40005,216,17042,13983,9150,19732
2021-03-22 10:00:00+00,19185,344,4841,4462,712,2382,3067,445,4744,0,40182,213,17826,14759,9918,19529
2021-03-22 10:30:00+00,19278,302,4842,4583,555,2366,3080,269,4811,0,40086,212,17871,14791,9949,19580
2021-03-22 11:00:00+00,18587,322,4834,4605,339,3080,3075,125,4953,0,39920,206,17806,14731,9897,18909
2021-03-22 11:30:00+00,18428,311,4827,4588,317,3110,3070,123,5010,0,39784,205,17812,14742,9915,18739
2021-03-22 12:00:00+00,18407,321,4828,4596,301,3212,3075,124,5112,0,39976,204,17912,14837,10009,18728
2021-03-22 12:30:00+00,18011,315,4839,4523,302,3214,3076,123,5005,0,39408,202,17745,14669,9830,18326
2021-03-22 13:00:00+00,17699,321,4840,4282,278,3060,3078,122,4873,0,38553,203,17351,14273,9433,18020
2021-03-22 13:30:00+00,16968,322,4840,4329,271,3064,3076,119,4918,0,37907,199,17434,14358,9518,17290
2021-03-22 14:00:00+00,17253,318,4843,4433,272,2126,3063,119,4880,0,37307,205,17491,14428,9585,17571
2021-03-22 14:30:00+00,17097,320,4841,4298,272,2068,3055,119,4683,0,36754,206,17150,14094,9254,17417
2021-03-22 15:00:00+00,17285,319,4841,4141,272,2018,3055,119,4187,0,36237,211,16496,13441,8600,17604
2021-03-22 15:30:00+00,18314,397,4840,4128,307,2010,3059,123,3683,0,36861,220,16017,12958,8118,18711
2021-03-22 16:00:00+00,18922,584,4845,4061,364,2494,3048,163,2821,0,37302,230,15139,12091,7246,19506
2021-03-22 16:30:00+00,20277,771,4844,3924,424,2552,3053,178,1882,0,37905,246,14127,11074,6230,21048
2021-03-22 17:00:00+00,20488,807,4850,3750,725,3872,3057,192,1003,0,38744,247,13385,10328,5478,21295
2021-03-22 17:30:00+00,21191,800,4850,3629,803,3914,3058,344,314,438,39341,251,12654,9596,4746,21991
2021-03-22 18:00:00+00,21669,709,4848,3593,848,4014,3071,497,15,558,39822,252,12375,9304,4456,22378
2021-03-22 18:30:00+00,21944,708,4843,3620,992,4014,3081,482,0,804,40488,250,12536,9455,4612,22652
2021-03-22 19:00:00+00,21649,787,4847,3688,995,4014,3077,492,0,784,40333,250,12607,9530,4683,22436
2021-03-22 19:30:00+00,20930,682,4846,3657,824,4014,3085,305,0,562,38905,248,12412,9327,4481,21612
2021-03-22 20:00:00+00,20484,631,4844,3710,728,3914,3088,185,0,142,37726,249,12370,9282,4438,21115
2021-03-22 20:30:00+00,18941,629,4848,3790,671,3904,3077,131,0,0,35991,243,12386,9309,4461,19570
2021-03-22 21:00:00+00,17600,592,4844,3752,529,3958,3043,116,0,32,34466,237,12168,9125,4281,18192
2021-03-22 21:30:00+00,16083,324,4848,3698,446,3942,3033,115,0,16,32505,225,12025,8992,4144,16407
2021-03-22 22:00:00+00,14942,319,4845,3664,407,3778,3031,116,0,40,31142,220,11947,8916,4071,15261
2021-03-22 22:30:00+00,13393,311,4849,3645,369,3790,3037,114,0,0,29508,211,11900,8863,4014,13704
2021-03-22 23:00:00+00,11701,322,4882,3675,350,3692,3040,117,0,0,27779,202,11947,8907,4025,12023
2021-03-22 23:30:00+00,10393,325,4889,3784,348,3828,3045,179,0,0,26791,194,12066,9021,4132,10718
2021-03-23 00:00:00+00,10119,320,4913,3838,312,4066,3045,165,0,8,26786,191,12108,9063,4150,10439
2021-03-23 00:30:00+00,10327,314,4939,3905,472,4136,3043,115,0,0,27251,191,12359,9316,4377,10641
2021-03-23 01:00:00+00,10161,323,4973,3931,457,4196,3035,113,0,0,27189,191,12396,9361,4388,10484
2021-03-23 01:30:00+00,10026,323,5001,3905,393,4156,3036,113,0,0,26953,190,12335,9299,4298,10349
2021-03-23 02:00:00+00,9924,324,5007,4132,253,4072,3038,113,0,0,26863,190,12430,9392,4385,10248
2021-03-23 02:30:00+00,9523,324,4999,4175,248,3976,3048,117,0,0,26410,187,12470,9422,4423,9847
2021-03-23 03:00:00+00,9166,322,4990,4557,245,3567,3041,113,0,0,26001,186,12833,9792,4802,9488
2021-03-23 03:30:00+00,8514,321,4973,4923,246,3462,3037,113,0,0,25589,178,13179,10142,5169,8835
2021-03-23 04:00:00+00,9193,323,4978,5320,257,3033,3044,113,0,0,26261,185,13599,10555,5577,9516
2021-03-23 04:30:00+00,8979,349,4979,5729,260,2932,3035,113,0,0,26376,181,14003,10968,5989,9328
2021-03-23 05:00:00+00,9865,349,4979,5872,275,2541,3033,113,0,0,27027,190,14159,11126,6147,10214
2021-03-23 05:30:00+00,10722,347,4978,6008,284,2479,3041,113,0,0,27971,196,14311,11270,6292,11069
2021-03-23 06:00:00+00,12092,342,4978,6358,551,2369,3036,136,29,0,29891,201,14952,11916,6938,12434
2021-03-23 06:30:00+00,13502,345,4979,6829,549,2323,3039,341,211,0,32119,207,15607,12568,7589,13847
2021-03-23 07:00:00+00,13908,348,4979,6886,589,2799,3041,202,496,92,33340,203,15991,12950,7971,14256
2021-03-23 07:30:00+00,14617,348,4985,7000,603,2777,3034,245,803,0,34413,206,16425,13391,8406,14965
2021-03-23 08:00:00+00,14107,350,4985,7404,638,3642,3030,323,1336,24,35839,195,17393,14363,9378,14457
2021-03-23 08:30:00+00,13884,351,5000,7804,626,3630,3021,347,1855,0,36519,189,18306,15285,10285,14235
2021-03-23 09:00:00+00,13584,350,5047,8214,528,3606,3014,336,2491,24,37195,181,19294,16280,11233,13934
2021-03-23 09:30:00+00,13063,350,5065,8851,506,3539,3022,292,2890,0,37578,174,20334,17312,12247,13413
2021-03-23 10:00:00+00,13289,344,5065,9613,390,3204,3024,361,2864,0,38155,174,20956,17932,12867,13633
2021-03-23 10:30:00+00,12756,263,5059,10075,319,3115,3025,169,3594,44,38419,163,22072,19047,13988,13019
2021-03-23 11:00:00+00,11188,1,5055,10615,291,3243,3031,117,3916,16,37473,143,22908,19877,14822,11189
2021-03-23 11:30:00+00,10008,0,5054,11300,279,3174,3013,124,3987,0,36939,133,23633,20620,15566,10008
2021-03-23 12:00:00+00,9869,0,5059,11821,265,2834,2980,117,4397,0,37342,129,24522,21542,16483,9869
2021-03-23 12:30:00+00,8826,0,5073,13099,266,2748,2962,119,4730,6,37829,116,26130,23168,18095,8826
2021-03-23 13:00:00+00,8653,0,5123,13485,273,2264,2982,118,4888,6,37792,114,26751,23769,18646,8653
2021-03-23 13:30:00+00,7936,0,5127,13893,278,2170,2993,116,4701,0,37214,108,26992,23999,18872,7936
2021-03-23 14:00:00+00,8777,0,5125,13842,279,1680,3003,118,4612,0,37436,115,26861,23858,18733,8777
2021-03-23 14:30:00+00,8699,0,5125,14148,289,1613,3004,118,4313,0,37309,114,26879,23875,18750,8699
2021-03-23 15:00:00+00,8923,0,5130,14456,302,1488,2994,120,3542,0,36955,117,26424,23430,18300,8923
2021-03-23 15:30:00+00,10095,0,5129,14123,303,1407,2993,124,2936,0,37109,129,25484,22491,17362,10095
2021-03-23 16:00:00+00,11060,0,5125,14042,336,1522,3003,161,2296,0,37545,137,24802,21799,16674,11060
2021-03-23 16:30:00+00,12773,0,5127,13992,336,1372,3019,176,1560,0,38355,150,24034,21015,15888,12773
2021-03-23 17:00:00+00,13851,0,5128,13622,414,1396,3019,194,860,490,38974,155,23043,20024,14896,13851
2021-03-23 17:30:00+00,14472,0,5133,13729,574,1286,3006,362,273,742,39577,159,22715,19709,14576,14472
2021-03-23 18:00:00+00,13933,0,5128,14117,446,2814,3010,321,15,526,40310,153,22716,19706,14578,13933
2021-03-23 18:30:00+00,14031,0,5121,14408,440,2894,3035,344,0,694,40967,151,23004,19969,14848,14031
2021-03-23 19:00:00+00,13750,0,5125,14412,440,3706,3027,250,0,352,41062,149,23004,19977,14852,13750
2021-03-23 19:30:00+00,13017,0,5123,14328,441,3734,3030,137,0,20,39830,145,22922,19892,14769,13017
2021-03-23 20:00:00+00,12830,0,5119,13762,399,2788,3028,126,0,24,38076,149,22308,19280,14161,12830
2021-03-23 20:30:00+00,11714,0,5144,13400,348,2656,3034,123,0,0,36419,144,21926,18892,13748,11714
2021-03-23 21:00:00+00,10537,0,5208,13329,287,2004,3028,121,0,14,34528,137,21852,18824,13616,10537
2021-03-23 21:30:00+00,9125,0,5218,12870,285,2003,3041,122,0,24,32688,128,21414,18373,13155,9125
2021-03-23 22:00:00+00,8256,0,5218,12532,263,1588,3044,121,0,8,31030,124,21057,18013,12795,8256
2021-03-23 22:30:00+00,7088,0,5216,12310,244,1536,3037,121,0,0,29552,114,20807,17770,12554,7088
2021-03-23 23:00:00+00,6079,0,5219,12138,242,1018,2931,121,0,0,27748,106,20530,17599,12380,6079
2021-03-23 23:30:00+00,5814,0,5219,11533,220,1076,2730,122,0,0,26714,106,19702,16972,11753,5814
2021-03-24 00:00:00+00,5414,0,5222,10942,193,1770,2961,120,0,0,26622,102,19318,16357,11135,5414
2021-03-24 00:30:00+00,5735,0,5244,10680,184,1938,3045,121,0,0,26947,108,19153,16108,10864,5735
2021-03-24 01:00:00+00,5922,0,5255,10636,166,1634,3062,119,0,0,26794,113,19119,16057,10802,5922
2021-03-24 01:30:00+00,5749,0,5253,10357,166,1590,3023,121,0,0,26259,112,18799,15776,10523,5749
2021-03-24 02:00:00+00,5487,0,5256,10365,166,1664,3020,119,0,0,26077,109,18807,15787,10531,5487
2021-03-24 02:30:00+00,5699,0,5251,9990,166,1764,3030,120,0,0,26020,113,18437,15407,10156,5699
2021-03-24 03:00:00+00,6055,0,5245,9635,166,1665,3091,121,0,0,25978,120,18137,15046,9801,6055
2021-03-24 03:30:00+00,6159,0,5243,9176,166,1710,3085,120,0,0,25660,122,17670,14585,9342,6159
2021-03-24 04:00:00+00,6218,0,5244,9094,166,1815,3084,120,0,0,25741,123,17588,14504,9260,6218
2021-03-24 04:30:00+00,6421,0,5245,9062,197,1857,3083,123,0,0,25988,125,17587,14504,9259,6421
2021-03-24 05:00:00+00,7790,0,5246,8853,507,1442,3085,121,0,66,27110,138,17691,14606,9360,7790
2021-03-24 05:30:00+00,9272,0,5245,8469,406,1577,3088,121,0,0,28179,155,17208,14120,8875,9272
2021-03-24 06:00:00+00,10595,0,5250,8432,382,2366,3089,121,70,56,30362,164,17223,14134,8884,10595
2021-03-24 06:30:00+00,12333,0,5249,8558,418,2476,3088,120,351,0,32594,174,17664,14576,9327,12333
2021-03-24 07:00:00+00,13534,0,5250,8591,510,2401,3083,123,789,120,34401,175,18223,15140,9890,13534
2021-03-24 07:30:00+00,14414,0,5252,8719,634,2425,3079,127,1337,54,36041,176,19021,15942,10690,14414
2021-03-24 08:00:00+00,14013,0,5253,9145,654,2611,3074,129,1942,0,36820,169,20068,16994,11741,14013
2021-03-24 08:30:00+00,13674,0,5252,9439,602,2707,3074,205,2696,0,37649,163,21063,17989,12737,13674
2021-03-24 09:00:00+00,13359,0,5251,9920,570,2716,3080,224,3404,0,38524,155,22225,19145,13894,13359
2021-03-24 09:30:00+00,12665,0,5255,10348,545,2808,3075,171,4041,0,38909,147,23264,20189,14934,12665
2021-03-24 10:00:00+00,11802,0,5252,10438,475,3013,3074,135,4292,0,38481,141,23531,20457,15205,11802
2021-03-24 10:30:00+00,10877,0,5251,10845,447,3130,3049,131,4667,0,38396,132,24259,21210,15959,10877
2021-03-24 11:00:00+00,10451,0,5267,11226,329,3368,3012,130,4647,0,38430,130,24481,21469,16202,10451
2021-03-24 11:30:00+00,9860,0,5283,11554,316,3603,3078,128,4796,0,38619,125,25027,21949,16666,9860
2021-03-24 12:00:00+00,9865,0,5282,11526,308,3755,3063,124,4843,0,38765,126,25022,21959,16677,9865
2021-03-24 12:30:00+00,9363,0,5289,11907,292,3806,3044,123,5488,0,39312,119,26020,22976,17687,9363
2021-03-24 13:00:00+00,8961,0,5285,12108,292,3586,3066,129,5735,0,39162,114,26486,23420,18135,8961
2021-03-24 13:30:00+00,8703,0,5285,11906,294,3428,3075,125,5653,0,38469,111,26213,23138,17853,8703
2021-03-24 14:00:00+00,9437,0,5280,11772,292,2492,3069,126,5388,0,37856,119,25801,22732,17452,9437
2021-03-24 14:30:00+00,10029,0,5282,11470,291,2250,3042,125,4930,0,37419,125,25015,21973,16691,10029
2021-03-24 15:00:00+00,10262,0,5281,11557,288,1668,3041,125,4258,0,36480,128,24425,21384,16103,10262
2021-03-24 15:30:00+00,10822,0,5281,11734,288,1662,3051,126,3458,0,36422,135,23812,20761,15480,10822
2021-03-24 16:00:00+00,11860,0,5282,11733,368,2178,3067,168,2742,0,37398,143,23192,20125,14843,11860
2021-03-24 16:30:00+00,13567,0,5285,11719,419,2064,3074,179,1875,0,38182,156,22372,19298,14013,13567
2021-03-24 17:00:00+00,14382,0,5285,11735,488,2772,3081,180,984,4,38911,162,21573,18492,13207,14382
2021-03-24 17:30:00+00,15472,0,5285,11550,493,2794,3076,231,320,254,39475,171,20724,17648,12363,15472
2021-03-24 18:00:00+00,15634,0,5283,11199,519,2880,3055,276,27,1176,40049,170,20083,17028,11745,15634
2021-03-24 18:30:00+00,16371,0,5285,10759,519,2918,3064,323,0,1612,40851,175,19627,16563,11278,16371
2021-03-24 19:00:00+00,16188,0,5283,10362,528,3858,3065,205,0,1356,40845,173,19238,16173,10890,16188
2021-03-24 19:30:00+00,15937,0,5283,9948,534,3910,3065,144,0,514,39335,176,18830,15765,10482,15937
2021-03-24 20:00:00+00,15628,0,5281,9971,496,3040,3057,175,0,32,37680,180,18805,15748,10467,15628
2021-03-24 20:30:00+00,14161,0,5277,10216,416,2944,3063,136,0,44,36257,171,18972,15909,10632,14161
2021-03-24 21:00:00+00,14037,0,5282,10194,373,1576,3056,122,0,204,34844,174,18905,15849,10567,14037
2021-03-24 21:30:00+00,12149,0,5280,10402,338,1516,3046,120,0,0,32851,162,19066,16020,10740,12149
2021-03-24 22:00:00+00,10065,0,5282,10396,319,1534,3051,121,0,0,30768,145,19048,15997,10715,10065
2021-03-24 22:30:00+00,8870,0,5280,10273,314,1536,3057,124,0,0,29454,135,18924,15867,10587,8870
2021-03-24 23:00:00+00,7095,0,5282,10044,310,1916,3061,120,0,56,27884,120,18697,15636,10354,7095
2021-03-24 23:30:00+00,6676,0,5283,9918,309,1912,3053,120,0,0,27271,116,18563,15510,10227,6676
2021-03-25 00:00:00+00,5833,0,5293,9655,268,2490,3061,119,0,0,26719,109,18277,15216,9923,5833
2021-03-25 00:30:00+00,5769,0,5310,9339,255,2778,3061,121,0,0,26633,113,17965,14904,9594,5769
2021-03-25 01:00:00+00,5242,0,5313,8810,215,3528,3061,122,0,0,26291,113,17399,14338,9025,5242
2021-03-25 01:30:00+00,5421,0,5312,8026,282,3610,3063,189,0,0,25903,119,16683,13620,8308,5421
2021-03-25 02:00:00+00,5528,0,5314,7425,312,3488,3063,250,0,8,25388,125,16114,13051,7737,5528
2021-03-25 02:30:00+00,5622,0,5309,7076,312,3402,3060,288,0,14,25083,127,15757,12697,7388,5622
2021-03-25 03:00:00+00,5506,0,5312,6915,312,3552,3056,285,0,0,24938,128,15595,12539,7227,5506
2021-03-25 03:30:00+00,5474,0,5306,6720,299,3514,3062,144,0,0,24519,127,15387,12325,7019,5474
2021-03-25 04:00:00+00,5487,0,5304,6669,318,3374,3055,119,0,0,24326,127,15346,12291,6987,5487
2021-03-25 04:30:00+00,5714,0,5305,6643,320,3418,3042,119,0,0,24561,130,15310,12268,6963,5714
2021-03-25 05:00:00+00,6196,0,5311,6834,381,3324,3050,119,0,0,25214,135,15576,12526,7214,6196
2021-03-25 05:30:00+00,6586,0,5308,7086,436,3318,3053,142,0,74,26003,137,15883,12830,7522,6586
2021-03-25 06:00:00+00,8041,0,5306,7123,575,3892,3059,157,91,164,28408,147,16154,13095,7789,8041
2021-03-25 06:30:00+00,9850,0,5308,7154,585,3902,3053,256,510,144,30762,161,16610,13557,8249,9850
2021-03-25 07:00:00+00,11186,0,5309,7225,628,4275,3057,296,1113,214,33303,165,17332,14275,8966,11186
2021-03-25 07:30:00+00,11754,0,5309,7547,718,4284,3020,297,1860,400,35189,162,18454,15434,10125,11754
2021-03-25 08:00:00+00,11176,0,5310,8257,755,4574,2989,221,2725,648,36655,149,20036,17047,11737,11176
2021-03-25 08:30:00+00,10448,0,5314,8868,688,4582,2939,242,3036,564,36681,141,20845,17906,12592,10448
2021-03-25 09:00:00+00,10446,0,5323,9624,675,4550,2941,168,3685,2,37414,136,22248,19307,13984,10446
2021-03-25 09:30:00+00,9935,0,5333,10178,563,4402,2936,125,3856,18,37346,128,22866,19930,14597,9935
2021-03-25 10:00:00+00,9649,0,5337,10335,434,4052,2865,126,4344,36,37178,124,23315,20450,15113,9649
2021-03-25 10:30:00+00,9090,0,5340,10986,397,3806,2915,152,4940,0,37626,114,24578,21663,16323,9090
2021-03-25 11:00:00+00,8428,0,5346,11905,367,3480,2962,148,4989,0,37625,106,25569,22607,17261,8428
2021-03-25 11:30:00+00,7765,0,5342,12232,359,3382,2962,132,4705,66,36945,100,25600,22638,17296,7765
2021-03-25 12:00:00+00,7512,0,5344,12580,352,3712,2936,129,4760,36,37361,98,25972,23036,17692,7512
2021-03-25 12:30:00+00,6830,0,5341,12858,334,3752,2902,127,4586,128,36858,92,26021,23119,17778,6830
2021-03-25 13:00:00+00,6642,0,5343,12249,212,3562,2854,128,4996,0,35986,94,25654,22800,17457,6642
2021-03-25 13:30:00+00,6187,0,5342,13398,339,3498,2864,132,4286,34,36080,88,26229,23365,18023,6187
2021-03-25 14:00:00+00,5872,0,5343,13886,323,3222,2863,129,4870,0,36508,86,27285,24422,19079,5872
2021-03-25 14:30:00+00,5834,0,5344,13948,321,3204,2896,129,4352,0,36028,87,26861,23965,18621,5834
2021-03-25 15:00:00+00,6024,0,5345,14129,345,3066,2932,127,3443,0,35411,93,26194,23262,17917,6024
2021-03-25 15:30:00+00,7005,0,5344,14090,350,3076,2940,132,2559,0,35496,104,25282,22342,16998,7005
2021-03-25 16:00:00+00,8564,0,5308,14143,360,2688,2931,184,2487,0,36665,117,25229,22298,16990,8564
2021-03-25 16:30:00+00,9513,0,5228,14619,388,2692,2913,207,1872,0,37432,125,25020,22107,16879,9513
2021-03-25 17:00:00+00,9807,0,5189,15001,458,2653,2927,209,942,120,37306,129,24517,21590,16401,9807
2021-03-25 17:30:00+00,10153,0,5184,15111,467,2607,2950,246,352,746,37816,131,24064,21114,15930,10153
2021-03-25 18:00:00+00,10117,0,5188,15304,498,2837,2930,295,27,824,38020,131,23947,21017,15829,10117
2021-03-25 18:30:00+00,10715,0,5187,15333,533,2777,2928,246,0,888,38607,134,23981,21053,15866,10715
2021-03-25 19:00:00+00,10863,0,5184,15114,535,2472,2943,209,0,486,37806,138,23776,20833,15649,10863
2021-03-25 19:30:00+00,10027,0,5188,15388,522,2419,2937,178,0,0,36660,133,24035,21098,15910,10027
2021-03-25 20:00:00+00,8998,0,5178,15364,423,2313,2923,154,0,22,35374,126,23888,20965,15787,8998
2021-03-25 20:30:00+00,7958,0,5182,15146,392,2236,2907,152,0,266,34238,117,23627,20720,15538,7958
2021-03-25 21:00:00+00,6696,0,5182,15162,351,1863,2915,149,0,0,32319,108,23610,20695,15513,6696
2021-03-25 21:30:00+00,5089,0,5181,15471,356,1750,2847,145,0,0,30839,91,23855,21008,15827,5089
2021-03-25 22:00:00+00,4418,0,5183,15644,355,1416,2788,150,0,0,29955,84,23970,21182,15999,4418
2021-03-25 22:30:00+00,4218,0,5187,15582,368,1252,2199,145,0,0,28951,80,23336,21137,15950,4218
2021-03-25 23:00:00+00,4094,0,5178,15622,362,1220,2322,148,0,0,28946,77,23484,21162,15984,4094
2021-03-25 23:30:00+00,3618,0,5186,15795,327,1230,2426,146,0,0,28728,72,23734,21308,16122,3618
2021-03-26 00:00:00+00,3638,0,5182,15995,278,1291,2201,147,0,0,28732,71,23656,21455,16273,3638
2021-03-26 00:30:00+00,3552,0,5189,16130,277,1311,2269,146,0,0,28875,71,23865,21596,16407,3552
2021-03-26 01:00:00+00,3790,0,5187,15710,259,1218,2357,148,0,0,28669,75,23513,21156,15969,3790
2021-03-26 01:30:00+00,3693,0,5195,15670,258,1242,2415,146,0,0,28619,75,23538,21123,15928,3693
2021-03-26 02:00:00+00,3569,0,5189,15669,257,830,2456,145,0,0,28115,74,23571,21115,15926,3569
2021-03-26 02:30:00+00,3512,0,5189,15526,256,810,2455,145,0,0,27893,74,23426,20971,15782,3512
2021-03-26 03:00:00+00,3492,0,5187,15483,255,773,2450,145,0,0,27785,74,23375,20925,15738,3492
2021-03-26 03:30:00+00,3298,0,5189,15476,254,750,2461,145,0,0,27573,72,23380,20919,15730,3298
2021-03-26 04:00:00+00,3124,0,5194,15557,248,756,2347,145,0,0,27371,69,23346,20999,15805,3124
2021-03-26 04:30:00+00,3150,0,5189,15711,250,696,2170,146,0,0,27312,68,23320,21150,15961,3150
2021-03-26 05:00:00+00,3435,0,5187,15380,284,480,2374,146,0,0,27286,70,23225,20851,15664,3435
2021-03-26 05:30:00+00,3890,0,5193,15274,334,420,2448,148,0,0,27707,74,23249,20801,15608,3890
2021-03-26 06:00:00+00,4333,0,5192,15302,414,814,2415,147,53,0,28670,78,23376,20961,15769,4333
2021-03-26 06:30:00+00,5458,0,4965,15694,466,866,2450,154,332,320,30705,88,23907,21457,16492,5458
2021-03-26 07:00:00+00,5548,0,4613,16013,531,2097,2433,148,965,134,32482,82,24555,22122,17509,5548
2021-03-26 07:30:00+00,6028,0,4607,15662,631,2321,2450,227,1576,428,33930,86,24926,22476,17869,6028
2021-03-26 08:00:00+00,6139,0,4606,15195,695,3830,2435,178,1696,450,35224,85,24627,22192,17586,6139
2021-03-26 08:30:00+00,6585,0,4611,15040,773,4026,2433,229,2020,292,36009,90,24877,22444,17833,6585
2021-03-26 09:00:00+00,6994,0,4607,15092,866,4318,2440,233,2564,0,37114,93,25569,23129,18522,6994
2021-03-26 09:30:00+00,6925,0,4610,15355,881,4475,2437,223,2442,0,37348,93,25725,23288,18678,6925
2021-03-26 10:00:00+00,6771,0,4616,15592,726,4418,2445,165,3055,0,37788,92,26434,23989,19373,6771
2021-03-26 10:30:00+00,6506,0,4615,15725,706,4432,2439,182,3546,0,38151,88,27031,24592,19977,6506
2021-03-26 11:00:00+00,6441,0,4589,16070,670,4234,2441,152,3641,0,38238,87,27411,24970,20381,6441
2021-03-26 11:30:00+00,6145,0,4510,16067,649,4266,2446,152,3430,0,37665,86,27102,24656,20146,6145
2021-03-26 12:00:00+00,6075,0,4427,16512,623,4234,2407,132,4177,0,38587,82,28146,25739,21312,6075
2021-03-26 12:30:00+00,5712,0,4391,16681,640,4106,2324,83,4716,0,38653,76,28752,26428,22037,5712
2021-03-26 13:00:00+00,5538,0,4406,16718,645,4112,2300,85,4543,0,38347,75,28612,26312,21906,5538
2021-03-26 13:30:00+00,5548,0,4412,16481,655,4018,2307,88,4372,0,37881,75,28227,25920,21508,5548
2021-03-26 14:00:00+00,5880,0,4268,16318,644,3532,2315,86,4095,0,37138,79,27640,25325,21057,5880
2021-03-26 14:30:00+00,6315,0,4264,15441,638,3476,2314,84,3845,0,36377,85,26502,24188,19924,6315
2021-03-26 15:00:00+00,6526,0,4271,14731,594,4062,2307,83,3287,0,35861,90,25190,22883,18612,6526
2021-03-26 15:30:00+00,7249,0,4286,14143,610,4226,2304,85,2780,0,35683,100,24123,21819,17533,7249
2021-03-26 16:00:00+00,8068,0,4302,13878,630,4520,2314,127,2339,0,36178,109,23463,21149,16847,8068
2021-03-26 16:30:00+00,9586,0,4323,13418,703,4670,2324,148,1742,56,36970,125,22510,20186,15863,9586
2021-03-26 17:00:00+00,10470,0,4340,13380,741,4794,2316,142,1076,408,37667,132,21853,19537,15197,10470
2021-03-26 17:30:00+00,10544,0,4367,13500,750,4810,2317,139,379,1318,38124,132,21313,18996,14629,10544
2021-03-26 18:00:00+00,10922,0,4384,13353,756,4810,2311,246,47,1660,38489,135,20851,18540,14156,10922
2021-03-26 18:30:00+00,11454,0,4406,13272,900,4808,2320,293,0,1654,39107,139,20898,18578,14172,11454
2021-03-26 19:00:00+00,11827,0,4416,12817,775,4784,2322,305,0,1430,38676,144,20330,18008,13592,11827
2021-03-26 19:30:00+00,11485,0,4419,13258,742,4636,2330,194,0,408,37472,142,20749,18419,14000,11485
2021-03-26 20:00:00+00,10590,0,4420,13702,638,4478,2325,78,0,476,36707,134,21085,18760,14340,10590
2021-03-26 20:30:00+00,9629,0,4417,13666,605,4294,2319,75,0,276,35281,126,21007,18688,14271,9629
2021-03-26 21:00:00+00,8676,0,4423,13721,557,3808,2332,77,0,16,33610,123,21033,18701,14278,8676
2021-03-26 21:30:00+00,6976,0,4492,13343,555,3730,2337,74,0,90,31597,109,20727,18390,13898,6976
2021-03-26 22:00:00+00,5695,0,4501,13673,514,3196,2323,75,0,310,30287,97,21011,18688,14187,5695
2021-03-26 22:30:00+00,4636,0,4506,13971,510,3018,2145,74,0,8,28868,84,21132,18987,14481,4636
2021-03-26 23:00:00+00,3712,0,4510,14312,508,2566,1986,75,0,24,27693,71,21316,19330,14820,3712
2021-03-26 23:30:00+00,2818,0,4511,14373,509,2486,1983,74,0,0,26754,59,21376,19393,14882,2818
2021-03-27 00:00:00+00,2929,0,4513,14418,495,1824,2002,73,0,0,26254,61,21428,19426,14913,2929
2021-03-27 00:30:00+00,3235,0,4515,14524,497,1886,1975,74,0,0,26706,66,21511,19536,15021,3235
2021-03-27 01:00:00+00,3489,0,4518,14435,494,1174,2005,77,0,0,26192,70,21452,19447,14929,3489
2021-03-27 01:30:00+00,3244,0,4516,14188,491,1064,2108,76,0,0,25687,66,21303,19195,14679,3244
2021-03-27 02:00:00+00,3432,0,4517,14009,490,998,2212,73,0,0,25731,67,21228,19016,14499,3432
2021-03-27 02:30:00+00,3477,0,4521,14026,484,950,2238,74,0,0,25770,67,21269,19031,14510,3477
2021-03-27 03:00:00+00,3907,0,4518,14100,464,570,2279,72,0,0,25910,72,21361,19082,14564,3907
2021-03-27 03:30:00+00,4014,0,4523,13982,466,570,2269,72,0,0,25896,74,21240,18971,14448,4014
2021-03-27 04:00:00+00,4010,0,4520,13909,467,474,2311,75,0,0,25766,74,21207,18896,14376,4010
2021-03-27 04:30:00+00,4333,0,4519,13822,475,472,2322,74,0,0,26017,79,21138,18816,14297,4333
2021-03-27 05:00:00+00,4410,0,4517,14111,600,486,2295,73,0,0,26492,78,21523,19228,14711,4410
2021-03-27 05:30:00+00,4297,0,4591,14279,608,486,2348,72,0,0,26681,76,21826,19478,14887,4297
2021-03-27 06:00:00+00,4103,0,4602,14478,608,770,2384,74,159,0,27178,73,22231,19847,15245,4103
2021-03-27 06:30:00+00,4235,0,4606,14445,616,780,2721,77,806,0,28286,73,23194,20473,15867,4235
2021-03-27 07:00:00+00,3696,0,4611,14576,614,1560,2902,75,1792,0,29826,64,24495,21593,16982,3696
2021-03-27 07:30:00+00,3723,0,4618,14556,542,1642,2895,75,2994,0,31045,62,25605,22710,18092,3723
2021-03-27 08:00:00+00,3780,0,4616,14460,589,2016,3019,75,3791,0,32346,60,26475,23456,18840,3780
2021-03-27 08:30:00+00,3785,0,4618,14400,625,2034,3024,76,4917,0,33479,59,27584,24560,19942,3785
2021-03-27 09:00:00+00,3545,0,4613,14510,620,2718,2758,77,5768,0,34609,53,28269,25511,20898,3545
2021-03-27 09:30:00+00,3455,0,4613,14530,628,2736,2903,96,6163,0,35124,52,28837,25934,21321,3455
2021-03-27 10:00:00+00,3404,0,4607,14245,595,2814,3003,146,6198,0,35012,53,28648,25645,21038,3404
2021-03-27 10:30:00+00,3765,0,4555,13733,597,2820,2913,149,6323,0,34855,57,28121,25208,20653,3765
2021-03-27 11:00:00+00,4401,0,4487,13316,611,2538,2869,146,6053,160,34581,64,27336,24467,19980,4401
2021-03-27 11:30:00+00,4288,0,4491,13294,635,2576,2864,147,6206,0,34501,64,27490,24626,20135,4288
2021-03-27 12:00:00+00,3942,0,4488,13010,688,3376,2826,148,5430,352,34260,63,26442,23616,19128,3942
2021-03-27 12:30:00+00,4275,0,4489,12628,672,3542,2845,148,4827,696,34122,70,25461,22616,18127,4275
2021-03-27 13:00:00+00,4463,0,4502,12361,690,3630,2949,226,4301,420,33542,76,24803,21854,17352,4463
2021-03-27 13:30:00+00,4339,0,4585,12190,675,3692,3009,344,3851,206,32891,79,24310,21301,16716,4339
2021-03-27 14:00:00+00,4008,0,4602,12538,571,3800,3026,314,3570,38,32467,77,24307,21281,16679,4008
2021-03-27 14:30:00+00,3825,0,4605,13049,567,3852,3029,146,3041,44,32158,75,24291,21262,16657,3825
2021-03-27 15:00:00+00,3992,0,4601,13407,566,3780,3045,147,2799,74,32411,75,24418,21373,16772,3992
2021-03-27 15:30:00+00,4457,0,4602,13576,539,3774,3027,148,2134,242,32499,81,23878,20851,16249,4457
2021-03-27 16:00:00+00,5016,0,4676,13659,508,4156,3018,179,1367,500,33079,86,23228,20210,15534,5016
2021-03-27 16:30:00+00,5992,0,4706,13563,540,4162,3000,342,867,782,33954,97,22676,19676,14970,5992
2021-03-27 17:00:00+00,7036,0,4702,13719,601,4356,3041,357,437,1044,35293,105,22500,19459,14757,7036
2021-03-27 17:30:00+00,7784,0,4767,13692,553,4358,3078,437,179,1282,36130,112,22269,19191,14424,7784
2021-03-27 18:00:00+00,7877,0,4808,14155,558,4358,3096,529,17,1434,36832,112,22634,19538,14730,7877
2021-03-27 18:30:00+00,8240,0,4809,14187,545,4360,3093,627,0,1370,37231,116,22634,19541,14732,8240
2021-03-27 19:00:00+00,8111,0,4815,14473,540,4318,3091,715,0,920,36983,115,22919,19828,15013,8111
2021-03-27 19:30:00+00,7661,0,4817,14771,507,4252,3086,600,0,150,35844,112,23181,20095,15278,7661
2021-03-27 20:00:00+00,7129,0,4815,14941,457,2692,3091,278,0,190,33593,109,23304,20213,15398,7129
2021-03-27 20:30:00+00,5948,0,4817,15059,472,2438,3111,144,0,26,32015,97,23459,20348,15531,5948
2021-03-27 21:00:00+00,5064,0,4817,15173,440,2142,3005,143,0,164,30948,90,23435,20430,15613,5064
2021-03-27 21:30:00+00,4103,0,4811,15328,439,2044,2928,154,0,96,29903,81,23506,20578,15767,4103
2021-03-27 22:00:00+00,4508,0,4809,15472,440,1342,2995,233,0,144,29943,87,23716,20721,15912,4508
2021-03-27 22:30:00+00,3794,0,4816,15562,416,1302,2878,174,0,0,28942,79,23672,20794,15978,3794
2021-03-27 23:00:00+00,4017,0,4811,15653,403,756,2660,142,0,90,28532,80,23527,20867,16056,4017
2021-03-27 23:30:00+00,3973,0,4819,15781,412,756,1872,142,0,0,27755,79,22884,21012,16193,3973
2021-03-28 00:00:00+00,4189,0,4826,15910,411,756,1818,144,0,0,28054,80,22965,21147,16321,4189
2021-03-28 00:30:00+00,4459,0,4838,16004,412,757,1915,196,0,0,28580,84,23169,21254,16416,4459
2021-03-28 01:00:00+00,4410,0,4839,16095,142,633,1869,158,0,0,28146,82,22945,21076,16237,4410
2021-03-28 01:30:00+00,4113,0,4844,16235,363,758,1792,140,0,0,28245,79,23234,21442,16598,4113
2021-03-28 02:00:00+00,3810,0,4845,16369,451,762,1842,144,0,0,28223,75,23507,21665,16820,3810
2021-03-28 02:30:00+00,3612,0,4844,16447,447,629,1795,140,0,0,27914,71,23533,21738,16894,3612
2021-03-28 03:00:00+00,3722,0,4841,16490,445,511,1813,140,0,0,27961,70,23589,21776,16935,3722
2021-03-28 03:30:00+00,3581,0,4842,16513,445,410,1803,139,0,0,27733,67,23603,21800,16958,3581
2021-03-28 04:00:00+00,3147,0,4838,16529,475,448,1841,142,0,0,27420,62,23683,21842,17004,3147
2021-03-28 04:30:00+00,3075,0,4839,16539,471,478,1843,143,0,0,27388,62,23692,21849,17010,3075
2021-03-28 05:00:00+00,3084,0,4837,16525,470,352,1836,142,0,0,27246,60,23668,21832,16995,3084
2021-03-28 05:30:00+00,2839,0,4839,16476,464,284,2254,142,0,0,27298,57,24033,21779,16940,2839
2021-03-28 06:00:00+00,2795,0,4838,16410,448,96,2431,142,37,0,27197,54,24164,21733,16895,2795
2021-03-28 06:30:00+00,2978,0,4835,16374,443,106,2498,148,213,0,27595,57,24363,21865,17030,2978
2021-03-28 07:00:00+00,2886,0,4830,15802,443,582,2059,148,451,0,27201,54,23585,21526,16696,2886
2021-03-28 07:30:00+00,2987,0,4836,16427,447,604,1940,146,772,0,28159,53,24422,22482,17646,2987
2021-03-28 08:00:00+00,2966,0,4839,16520,513,1246,2051,144,1168,0,29447,51,25091,23040,18201,2966
2021-03-28 08:30:00+00,3005,0,4839,16492,582,1348,2431,144,1499,0,30340,52,25843,23412,18573,3005
2021-03-28 09:00:00+00,3003,0,4836,16583,604,1917,2549,144,1911,0,31547,51,26483,23934,19098,3003
2021-03-28 09:30:00+00,3179,0,4831,16467,597,2436,2579,146,2185,156,32576,52,26659,24080,19249,3179
2021-03-28 10:00:00+00,3184,0,4836,16471,638,2730,2789,144,2322,114,33228,52,27056,24267,19431,3184
2021-03-28 10:30:00+00,3095,0,4840,16833,609,2738,3042,143,2590,46,33936,51,27914,24872,20032,3095
2021-03-28 11:00:00+00,3395,0,4839,16858,633,2738,3056,144,2948,224,34835,53,28334,25278,20439,3395
2021-03-28 11:30:00+00,3438,0,4841,16766,649,2736,3060,147,3272,200,35109,53,28588,25528,20687,3438
2021-03-28 12:00:00+00,3360,0,4839,16930,652,2788,3045,145,2820,0,34579,53,28286,25241,20402,3360
2021-03-28 12:30:00+00,3130,0,4841,17260,647,2888,2992,144,2632,0,34534,52,28372,25380,20539,3130
2021-03-28 13:00:00+00,2994,0,4840,17321,600,2704,3002,149,2574,0,34184,52,28337,25335,20495,2994
2021-03-28 13:30:00+00,3093,0,4838,17383,549,2656,2990,146,2611,0,34266,53,28371,25381,20543,3093
2021-03-28 14:00:00+00,3826,0,4838,17327,556,2002,2951,147,2217,0,33864,62,27889,24938,20100,3826
2021-03-28 14:30:00+00,4186,0,4839,17442,549,1988,3009,148,1755,0,33916,66,27594,24585,19746,4186
2021-03-28 15:00:00+00,4625,0,4842,17558,526,2264,3027,148,1357,0,34347,70,27310,24283,19441,4625
2021-03-28 15:30:00+00,5164,0,4840,17664,597,2398,3060,152,1138,0,35013,77,27299,24239,19399,5164
2021-03-28 16:00:00+00,4898,0,4838,17786,633,3434,3069,149,836,138,35781,74,27162,24093,19255,4898
2021-03-28 16:30:00+00,4978,0,4842,18025,619,3400,3068,186,535,728,36381,73,27089,24021,19179,4978
2021-03-28 17:00:00+00,4899,0,4838,17888,625,3520,3059,260,295,1080,36464,72,26705,23646,18808,4899
2021-03-28 17:30:00+00,4761,0,4833,17649,623,3688,3049,260,100,1106,36069,73,26254,23205,18372,4761
2021-03-28 18:00:00+00,4941,0,4833,17596,631,3858,3068,385,7,686,36005,78,26135,23067,18234,4941
2021-03-28 18:30:00+00,5446,0,4828,17383,633,3776,3062,414,0,408,35950,83,25906,22844,18016,5446
2021-03-28 19:00:00+00,5698,0,4826,17226,641,3764,3008,318,0,156,35638,86,25702,22694,17868,5698
2021-03-28 19:30:00+00,4492,0,4833,17244,645,3578,3011,205,0,134,34142,73,25733,22722,17889,4492
2021-03-28 20:00:00+00,4505,0,4839,17106,626,2238,2979,147,0,132,32572,75,25550,22571,17732,4505
2021-03-28 20:30:00+00,3795,0,4851,16936,617,2130,2715,141,0,0,31185,69,25119,22404,17553,3795
2021-03-28 21:00:00+00,4332,0,4843,16841,631,1018,2663,145,0,130,30603,79,24978,22315,17472,4332
2021-03-28 21:30:00+00,3696,0,4847,16373,605,1056,2576,142,0,0,29295,74,24401,21825,16978,3696
2021-03-28 22:00:00+00,3305,0,4842,16210,556,1048,2423,143,0,26,28553,70,24031,21608,16766,3305
2021-03-28 22:30:00+00,3209,0,4839,15754,522,1010,2206,143,0,0,27683,70,23321,21115,16276,3209
2021-03-28 23:00:00+00,3618,0,4843,15851,495,756,2221,142,0,0,27926,75,23410,21189,16346,3618
2021-03-28 23:30:00+00,3308,0,4853,15906,491,756,2225,141,0,0,27680,71,23475,21250,16397,3308
2021-03-29 00:00:00+00,3346,0,4855,15919,474,756,2221,141,0,0,27712,71,23469,21248,16393,3346
2021-03-29 00:30:00+00,3763,0,4841,15939,476,756,2215,142,0,0,28132,76,23471,21256,16415,3763
2021-03-29 01:00:00+00,3838,0,4841,15908,502,756,2224,142,0,0,28211,77,23475,21251,16410,3838
2021-03-29 01:30:00+00,3682,0,4832,15800,543,756,2207,142,0,0,27962,75,23382,21175,16343,3682
2021-03-29 02:00:00+00,3491,0,4845,15831,548,756,2219,142,0,0,27832,73,23443,21224,16379,3491
2021-03-29 02:30:00+00,3426,0,4845,15772,549,756,2205,141,0,0,27694,72,23371,21166,16321,3426
2021-03-29 03:00:00+00,3474,0,4849,15688,545,756,2237,142,0,0,27691,73,23319,21082,16233,3474
2021-03-29 03:30:00+00,3589,0,4850,15588,542,756,2239,141,0,0,27705,75,23219,20980,16130,3589
2021-03-29 04:00:00+00,3918,0,4851,15511,544,756,2220,142,0,0,27942,79,23126,20906,16055,3918
2021-03-29 04:30:00+00,4314,0,4852,15532,542,756,2208,141,0,0,28345,83,23134,20926,16074,4314
2021-03-29 05:00:00+00,5577,0,4850,15617,556,756,2314,142,0,0,29812,96,23337,21023,16173,5577
2021-03-29 05:30:00+00,5658,0,4853,15621,558,756,2695,190,0,0,30331,97,23727,21032,16179,5658
2021-03-29 06:00:00+00,5740,0,4851,15553,596,1584,3039,168,119,18,31668,96,24158,21119,16268,5740
2021-03-29 06:30:00+00,6320,0,4846,15681,684,1950,3064,209,494,386,33634,98,24769,21705,16859,6320
2021-03-29 07:00:00+00,6052,0,4843,15632,622,3642,3055,151,889,514,35400,88,25041,21986,17143,6052
2021-03-29 07:30:00+00,6126,0,4844,15911,622,3628,3061,152,1425,370,36139,87,25863,22802,17958,6126
2021-03-29 08:00:00+00,6277,0,4843,15779,621,3684,3056,149,1862,704,36975,85,26161,23105,18262,6277
2021-03-29 08:30:00+00,6145,0,4851,15577,618,3656,3038,147,2623,626,37281,83,26707,23669,18818,6145
2021-03-29 09:00:00+00,5764,0,4856,15663,636,3184,3034,144,3655,628,37564,77,27844,24810,19954,5764
2021-03-29 09:30:00+00,5200,0,4855,15642,639,3106,3012,144,4333,552,37483,70,28481,25469,20614,5200
2021-03-29 10:00:00+00,4570,0,4855,15342,652,3422,3017,143,4823,284,37108,65,28689,25672,20817,4570
2021-03-29 10:30:00+00,3953,0,4856,15439,642,3496,2988,142,5249,0,36765,60,29174,26186,21330,3953
2021-03-29 11:00:00+00,3816,0,4850,15615,658,2998,2982,147,5854,110,37030,57,29959,26977,22127,3816
2021-03-29 11:30:00+00,3602,0,4854,15600,659,3006,2815,143,6401,0,37080,54,30329,27514,22660,3602
2021-03-29 12:00:00+00,3952,0,4855,15379,673,1972,2809,144,6873,0,36657,56,30589,27780,22925,3952
2021-03-29 12:30:00+00,3577,0,4848,15386,666,1750,2618,146,7121,0,36112,51,30639,28021,23173,3577
2021-03-29 13:00:00+00,3566,0,4844,15226,668,2030,2075,148,7032,0,35589,51,29845,27770,22926,3566
2021-03-29 13:30:00+00,3564,0,4848,15083,696,1970,1998,145,6907,0,35211,51,29532,27534,22686,3564
2021-03-29 14:00:00+00,3657,0,4844,15131,704,1438,2078,153,6516,0,34521,53,29273,27195,22351,3657
2021-03-29 14:30:00+00,3891,0,4839,15308,704,1560,2107,156,5973,0,34538,57,28931,26824,21985,3891
2021-03-29 15:00:00+00,3937,0,4844,15332,706,2100,2339,182,5274,0,34714,58,28495,26156,21312,3937
2021-03-29 15:30:00+00,4562,0,4843,15631,706,2258,2460,187,4392,0,35039,67,28032,25572,20729,4562
2021-03-29 16:00:00+00,5013,0,4847,15536,703,3002,2503,194,3476,244,35518,72,27065,24562,19715,5013
2021-03-29 16:30:00+00,6001,0,4841,15026,691,3004,2974,195,2540,656,35928,84,26072,23098,18257,6001
2021-03-29 17:00:00+00,6858,0,4845,14433,688,3516,3068,194,1571,530,35703,96,24605,21537,16692,6858
2021-03-29 17:30:00+00,7574,0,4851,14086,683,3570,3065,189,637,686,35341,105,23322,20257,15406,7574
2021-03-29 18:00:00+00,7185,0,4848,13949,683,3879,3026,206,90,998,34864,104,22596,19570,14722,7185
2021-03-29 18:30:00+00,7902,0,4855,13379,683,3952,3058,181,0,1268,35278,111,21975,18917,14062,7902
2021-03-29 19:00:00+00,8195,0,4851,13288,683,4036,3058,197,0,1000,35308,114,21880,18822,13971,8195
2021-03-29 19:30:00+00,7884,0,4852,13761,683,3849,3025,237,0,370,34660,111,22321,19296,14444,7884
2021-03-29 20:00:00+00,7475,0,4847,13724,683,3203,3045,141,0,238,33356,107,22299,19254,14407,7475
2021-03-29 20:30:00+00,6310,0,4848,13626,682,3222,3033,141,0,0,31863,98,22189,19156,14308,6310
2021-03-29 21:00:00+00,5701,0,4844,13186,678,2678,3061,142,0,122,30412,95,21769,18708,13864,5701
2021-03-29 21:30:00+00,5146,0,4852,12600,695,2533,3055,142,0,0,29023,90,21202,18147,13295,5146
2021-03-29 22:00:00+00,5457,0,4852,12087,701,2043,3045,143,0,126,28454,95,20685,17640,12788,5457
2021-03-29 22:30:00+00,4978,0,4849,11652,701,1968,3064,144,0,36,27392,91,20266,17202,12353,4978
2021-03-29 23:00:00+00,5547,0,4846,11267,697,1780,3066,142,0,48,27393,98,19876,16810,11964,5547
2021-03-29 23:30:00+00,5638,0,4847,11190,687,1907,3065,142,0,0,27476,100,19789,16724,11877,5638
2021-03-30 00:00:00+00,5250,0,4861,10931,676,2120,3060,142,0,0,27040,97,19528,16468,11607,5250
2021-03-30 00:30:00+00,5703,0,4864,10909,678,2180,3055,183,0,0,27572,103,19506,16451,11587,5703
2021-03-30 01:00:00+00,5010,0,4865,10821,678,2590,3056,199,0,0,27218,96,19420,16364,11499,5010
2021-03-30 01:30:00+00,4787,0,4867,10720,686,2597,3051,158,0,0,26866,93,19324,16273,11406,4787
2021-03-30 02:00:00+00,4339,0,4867,10465,706,2465,3062,159,0,0,26063,88,19100,16038,11171,4339
2021-03-30 02:30:00+00,4483,0,4867,10252,707,2482,3069,160,0,0,26021,90,18895,15826,10959,4483
2021-03-30 03:00:00+00,4824,0,4873,10006,706,2539,3058,159,0,0,26166,95,18643,15585,10712,4824
2021-03-30 03:30:00+00,5260,0,4869,9697,708,2570,3034,160,0,0,26297,101,18308,15274,10405,5260
2021-03-30 04:00:00+00,4822,0,4873,9706,707,2936,3081,158,0,0,26283,96,18367,15286,10413,4822
2021-03-30 04:30:00+00,5238,0,4873,9742,706,3277,3082,159,0,10,27087,105,18403,15321,10448,5238
2021-03-30 05:00:00+00,6659,0,4865,9364,707,3671,3093,159,0,370,28888,122,18029,14936,10071,6659
2021-03-30 05:30:00+00,8844,0,4866,9134,707,3698,3087,158,0,342,30836,142,17794,14707,9841,8844
2021-03-30 06:00:00+00,10738,0,4862,8755,707,3593,3089,165,319,528,32756,154,17732,14643,9781,10738
2021-03-30 06:30:00+00,12412,0,4861,8223,863,3405,3088,252,1095,388,34587,163,18130,15042,10181,12412
2021-03-30 07:00:00+00,12977,0,4864,7964,872,3958,3088,408,2076,402,36608,161,18864,15776,10912,12977
2021-03-30 07:30:00+00,12726,0,4864,7783,871,3958,3084,356,3105,472,37219,155,19707,16623,11759,12726
2021-03-30 08:00:00+00,12701,0,4867,7788,871,3934,3084,330,4070,212,37858,151,20680,17596,12729,12701
2021-03-30 08:30:00+00,12066,0,4862,7706,852,3953,3077,188,5022,0,37726,143,21519,18442,13580,12066
2021-03-30 09:00:00+00,11603,0,4859,6984,722,3994,3092,157,5801,0,37212,140,21458,18366,13507,11603
2021-03-30 09:30:00+00,10986,0,4860,6921,722,3962,3094,156,6620,0,37321,133,22217,19123,14263,10986
2021-03-30 10:00:00+00,10598,0,4863,6902,717,3624,3095,158,7258,0,37215,129,22835,19740,14877,10598
2021-03-30 10:30:00+00,10151,0,4860,6981,706,3996,3091,157,7491,0,37433,124,23129,20038,15178,10151
2021-03-30 11:00:00+00,9792,0,4864,6963,703,3996,3091,158,8026,0,37593,120,23647,20556,15692,9792
2021-03-30 11:30:00+00,8836,0,4866,6943,700,3996,3090,155,8456,30,37072,111,24055,20965,16099,8836
2021-03-30 12:00:00+00,8562,0,4866,6882,669,3996,3091,155,8390,0,36611,110,23898,20807,15941,8562
2021-03-30 12:30:00+00,8191,0,4869,6984,668,3996,3082,155,8211,0,36156,107,23814,20732,15863,8191
2021-03-30 13:00:00+00,8152,0,4862,6867,653,3996,3086,155,7970,0,35741,108,23438,20352,15490,8152
2021-03-30 13:30:00+00,8449,0,4864,6768,653,3996,3081,156,7420,0,35387,112,22786,19705,14841,8449
2021-03-30 14:00:00+00,8689,0,4866,6558,655,3998,3083,156,6789,0,34794,117,21951,18868,14002,8689
2021-03-30 14:30:00+00,9767,0,4867,6045,677,3998,3074,158,5945,0,34531,130,20608,17534,12667,9767
2021-03-30 15:00:00+00,11088,0,4872,5633,768,4018,3071,194,4948,0,34592,145,19292,16221,11349,11088
2021-03-30 15:30:00+00,12880,0,4862,5309,781,4017,3070,196,3965,0,35080,164,17987,14917,10055,12880
2021-03-30 16:00:00+00,14497,0,4866,5051,803,4016,3082,210,3024,0,35549,179,16826,13744,8878,14497
2021-03-30 16:30:00+00,15288,0,4868,4871,803,4016,3075,391,2005,0,35317,191,15622,12547,7679,15288
2021-03-30 17:00:00+00,16266,0,4872,4640,803,4016,3074,388,1090,0,35149,203,14479,11405,6533,16266
2021-03-30 17:30:00+00,16147,0,4864,4508,803,4016,3088,298,419,744,34887,202,13682,10594,5730,16147
2021-03-30 18:00:00+00,16573,0,4868,4169,790,4016,3088,236,58,1296,35094,205,12973,9885,5017,16573
2021-03-30 18:30:00+00,17000,0,4863,4047,788,4016,3093,245,0,1520,35572,207,12791,9698,4835,17000
2021-03-30 19:00:00+00,17538,0,4870,3914,788,4016,3071,326,0,1322,35845,213,12643,9572,4702,17538
2021-03-30 19:30:00+00,17350,0,4867,3873,769,4016,3051,381,0,668,34975,216,12560,9509,4642,17350
2021-03-30 20:00:00+00,16828,0,4867,3783,732,3998,3066,190,0,344,33808,216,12448,9382,4515,16828
2021-03-30 20:30:00+00,15663,0,4868,3772,720,3996,3066,151,0,0,32236,211,12426,9360,4492,15663
2021-03-30 21:00:00+00,13808,0,4860,3750,720,3774,3063,181,0,52,30208,201,12393,9330,4470,13808
2021-03-30 21:30:00+00,12227,0,4858,3730,720,3774,3064,153,0,16,28542,191,12372,9308,4450,12227
2021-03-30 22:00:00+00,10415,0,4864,3694,720,3606,2915,183,0,0,26397,179,12193,9278,4414,10415
2021-03-30 22:30:00+00,9538,0,4856,3561,721,3604,2665,154,0,0,25099,173,11803,9138,4282,9538
2021-03-30 23:00:00+00,8897,0,4868,3536,661,3410,2657,149,0,0,24178,168,11722,9065,4197,8897
2021-03-30 23:30:00+00,8656,0,4869,3360,655,3406,2659,149,0,0,23754,167,11543,8884,4015,8656
2021-03-31 00:00:00+00,8748,0,4870,3214,652,3380,2688,148,0,0,23700,170,11424,8736,3866,8748
2021-03-31 00:30:00+00,9150,0,4881,3197,648,3382,2724,148,0,0,24130,174,11450,8726,3845,9150
2021-03-31 01:00:00+00,9074,0,4884,3118,646,3261,2727,148,0,0,23858,174,11375,8648,3764,9074
2021-03-31 01:30:00+00,8784,0,4878,3017,649,3258,2742,149,0,0,23477,172,11286,8544,3666,8784
2021-03-31 02:00:00+00,8926,0,4882,2844,671,3200,2726,148,0,0,23397,174,11123,8397,3515,8926
2021-03-31 02:30:00+00,9002,0,4883,2761,672,3188,2758,148,0,0,23412,176,11074,8316,3433,9002
2021-03-31 03:00:00+00,9138,0,4887,2727,668,2784,2753,148,0,0,23105,180,11035,8282,3395,9138
2021-03-31 03:30:00+00,9180,0,4891,2854,664,2753,2727,149,0,0,23218,180,11136,8409,3518,9180
2021-03-31 04:00:00+00,9890,0,4892,2998,658,2536,2703,148,0,0,23825,186,11251,8548,3656,9890
2021-03-31 04:30:00+00,10585,0,4891,3045,661,2534,2728,149,0,0,24593,192,11325,8597,3706,10585
2021-03-31 05:00:00+00,12801,0,4890,3029,724,2034,2753,183,0,30,26444,210,11396,8643,3753,12801
2021-03-31 05:30:00+00,14251,0,4887,3049,709,2038,2781,240,0,44,27999,220,11426,8645,3758,14251
2021-03-31 06:00:00+00,15777,0,4882,3246,715,3390,2512,256,234,162,31174,218,11589,9077,4195,15777
2021-03-31 06:30:00+00,16145,0,4881,3385,819,3463,2422,285,712,844,32956,211,12219,9797,4916,16145
2021-03-31 07:00:00+00,16353,0,4880,3214,792,3979,2447,382,1412,798,34257,208,12745,10298,5418,16353
2021-03-31 07:30:00+00,16465,0,4879,3045,784,3996,2449,491,2251,548,34909,206,13408,10959,6080,16465
2021-03-31 08:00:00+00,16534,0,4874,2965,795,3994,2452,465,3004,560,35643,202,14090,11638,6764,16534
2021-03-31 08:30:00+00,16310,0,4882,2973,793,3994,2427,379,3744,422,35924,197,14819,12392,7510,16310
2021-03-31 09:00:00+00,16205,0,4876,3120,772,3994,2359,277,4566,16,36185,193,15693,13334,8458,16205
2021-03-31 09:30:00+00,15567,0,4880,3200,827,3994,2247,157,5129,94,36095,186,16283,14036,9156,15567
2021-03-31 10:00:00+00,15177,0,4882,3055,753,3999,2233,156,5522,30,35807,183,16445,14212,9330,15177
2021-03-31 10:30:00+00,14965,0,4882,3082,672,4000,2233,156,5874,68,35932,180,16743,14510,9628,14965
2021-03-31 11:00:00+00,14727,0,4882,3326,684,3997,2242,158,5960,116,36092,176,17094,14852,9970,14727
2021-03-31 11:30:00+00,14351,0,4889,3352,685,3998,2240,157,5639,0,35311,176,16805,14565,9676,14351
2021-03-31 12:00:00+00,14509,0,4855,3512,644,3996,1942,158,5759,0,35375,177,16712,14770,9915,14509
2021-03-31 12:30:00+00,14491,0,4846,3596,645,3996,1647,157,5516,0,34894,178,16250,14603,9757,14491
2021-03-31 13:00:00+00,14132,0,4848,3881,678,3998,1726,157,5289,0,34709,175,16422,14696,9848,14132
2021-03-31 13:30:00+00,13964,0,4845,4152,682,3996,1746,157,4761,0,34303,175,16186,14440,9595,13964
2021-03-31 14:00:00+00,13827,0,4840,4506,710,3998,1837,157,4149,0,34024,175,16042,14205,9365,13827
2021-03-31 14:30:00+00,14014,0,4842,4889,713,4000,1874,162,3807,0,34301,176,16125,14251,9409,14014
2021-03-31 15:00:00+00,14591,0,4838,4959,757,4020,2057,192,3147,0,34561,183,15758,13701,8863,14591
2021-03-31 15:30:00+00,15372,0,4838,4990,760,4020,2429,193,2587,0,35189,190,15604,13175,8337,15372
2021-03-31 16:00:00+00,16222,0,4863,5043,783,3920,2456,264,1996,32,35579,197,15141,12685,7822,16222
2021-03-31 16:30:00+00,16423,0,4882,5065,785,3917,2455,377,1485,184,35573,200,14672,12217,7335,16423
2021-03-31 17:00:00+00,16434,0,4885,5095,893,3928,2452,387,944,706,35724,200,14269,11817,6932,16434
2021-03-31 17:30:00+00,16661,0,4886,5343,971,3910,2460,398,438,426,35493,204,14098,11638,6752,16661
2021-03-31 18:00:00+00,17289,0,4886,5382,984,3414,2462,409,82,304,35212,212,13796,11334,6448,17289
2021-03-31 18:30:00+00,17260,0,4886,5560,943,3382,2463,431,0,456,35381,211,13852,11389,6503,17260
2021-03-31 19:00:00+00,17133,0,4886,5503,943,3918,2467,301,0,510,35661,207,13799,11332,6446,17133
2021-03-31 19:30:00+00,16734,0,4890,5325,933,3912,2464,194,0,76,34528,208,13612,11148,6258,16734
2021-03-31 20:00:00+00,16040,0,4892,5402,788,3168,2458,156,0,36,32940,208,13540,11082,6190,16040
2021-03-31 20:30:00+00,14166,0,4891,5485,789,3142,2426,157,0,82,31138,197,13591,11165,6274,14166
2021-03-31 21:00:00+00,11970,0,4900,5848,733,3486,2116,148,0,0,29201,179,13597,11481,6581,11970
2021-03-31 21:30:00+00,10232,0,4896,6352,734,3492,1783,153,0,2,27644,163,13765,11982,7086,10232
2021-03-31 22:00:00+00,8285,0,4901,6812,734,3588,1550,149,0,0,26019,143,13997,12447,7546,8285
2021-03-31 22:30:00+00,6584,0,4893,6744,732,3596,1420,150,0,0,24119,126,13789,12369,7476,6584
2021-03-31 23:00:00+00,6048,0,4891,6793,722,3312,1209,152,0,0,23127,120,13615,12406,7515,6048
2021-03-31 23:30:00+00,5761,0,4888,7234,721,3322,1133,150,0,0,23209,114,13976,12843,7955,5761
2021-04-01 00:00:00+00,5503,0,4886,8182,720,3022,1146,152,0,0,23611,105,14934,13788,8902,5503
2021-04-01 00:30:00+00,5094,0,4895,8430,720,3078,1257,148,0,0,23622,99,15302,14045,9150,5094
2021-04-01 01:00:00+00,5055,0,4891,8432,701,2876,1478,151,0,0,23584,103,15502,14024,9134,5055
2021-04-01 01:30:00+00,4989,0,4892,8379,700,2736,1488,154,0,0,23338,100,15459,13971,9079,4989
2021-04-01 02:00:00+00,4892,0,4895,8207,700,2716,1487,150,0,0,23047,100,15289,13802,8907,4892
2021-04-01 02:30:00+00,4787,0,4900,8565,702,2642,1489,148,0,0,23233,96,15656,14167,9267,4787
2021-04-01 03:00:00+00,4767,0,4898,8768,702,2336,1493,149,0,0,23113,95,15861,14368,9470,4767
2021-04-01 03:30:00+00,4441,0,4901,9004,701,2402,1488,148,0,0,23085,92,16094,14606,9705,4441
2021-04-01 04:00:00+00,5224,0,4902,9403,728,1696,1415,148,0,0,23516,106,16448,15033,10131,5224
2021-04-01 04:30:00+00,6065,0,4904,9021,728,1842,1362,152,0,0,24074,120,16015,14653,9749,6065
2021-04-01 05:00:00+00,7256,0,4905,9072,777,2252,1462,153,0,0,25877,133,16216,14754,9849,7256
2021-04-01 05:30:00+00,8561,0,4905,9267,797,2190,1496,152,1,26,27395,144,16466,14970,10065,8561
2021-04-01 06:00:00+00,10986,0,4904,9419,809,2368,1501,151,95,0,30233,159,16728,15227,10323,10986
2021-04-01 06:30:00+00,12082,0,4899,9709,808,2396,1716,188,380,22,32200,164,17512,15796,10897,12082
2021-04-01 07:00:00+00,12101,0,4895,9453,797,2868,1715,236,782,580,33427,157,17642,15927,11032,12101
2021-04-01 07:30:00+00,12408,0,4896,9389,778,2822,1729,238,1342,490,34092,157,18134,16405,11509,12408
2021-04-01 08:00:00+00,12110,0,4894,9315,759,3902,1556,210,1871,596,35213,148,18395,16839,11945,12110
2021-04-01 08:30:00+00,12354,0,4895,9215,757,3946,1478,248,2507,354,35754,148,18852,17374,12479,12354
2021-04-01 09:00:00+00,12438,0,4896,9343,747,3896,1186,320,3144,10,35980,148,19316,18130,13234,12438
2021-04-01 09:30:00+00,12304,0,4890,9115,746,3896,1193,283,3598,22,36047,146,19542,18349,13459,12304
2021-04-01 10:00:00+00,12059,0,4891,8892,745,3996,1191,258,4017,0,36049,143,19736,18545,13654,12059
2021-04-01 10:30:00+00,11926,0,4890,8638,723,3996,1188,281,4344,124,36110,141,19783,18595,13705,11926
2021-04-01 11:00:00+00,11993,0,4898,8521,691,3996,1186,342,4717,148,36492,141,20013,18827,13929,11993
2021-04-01 11:30:00+00,11869,0,4899,8430,676,3996,1185,308,5185,22,36570,139,20375,19190,14291,11869
2021-04-01 12:00:00+00,11722,0,4896,8268,676,3996,1185,284,5101,0,36128,139,20126,18941,14045,11722
2021-04-01 12:30:00+00,11650,0,4902,8079,676,3996,1184,277,4804,0,35568,140,19645,18461,13559,11650
2021-04-01 13:00:00+00,11749,0,4897,7787,676,3996,1188,227,4636,20,35176,142,19184,17996,13099,11749
2021-04-01 13:30:00+00,11641,0,4900,7505,838,3996,1188,197,4327,0,34592,143,18758,17570,12670,11641
2021-04-01 14:00:00+00,12014,0,4900,7221,849,3996,1187,171,3968,0,34306,148,18125,16938,12038,12014
2021-04-01 14:30:00+00,12389,0,4897,7001,851,3996,1184,172,3731,0,34221,153,17664,16480,11583,12389
2021-04-01 15:00:00+00,13218,0,4896,6817,906,4016,1179,186,3461,0,34679,161,17259,16080,11184,13218
2021-04-01 15:30:00+00,13975,0,4896,6808,903,4016,1182,189,2889,0,34858,168,16678,15496,10600,13975
2021-04-01 16:00:00+00,14428,0,4894,6873,947,4016,1184,214,2184,466,35206,172,16082,14898,10004,14428
2021-04-01 16:30:00+00,14756,0,4892,6952,949,4116,1184,214,1502,806,35371,176,15479,14295,9403,14756
2021-04-01 17:00:00+00,15034,0,4890,7154,968,4020,1183,214,896,1046,35405,178,15091,13908,9018,15034
2021-04-01 17:30:00+00,14924,0,4893,7243,968,4016,1183,277,390,1036,34930,180,14677,13494,8601,14924
2021-04-01 18:00:00+00,14779,0,4897,7379,955,4106,1178,404,77,1036,34811,181,14486,13308,8411,14779
2021-04-01 18:30:00+00,14698,0,4893,7409,954,4240,1181,395,0,1026,34796,182,14437,13256,8363,14698
2021-04-01 19:00:00+00,15140,0,4897,7482,913,4286,1180,387,0,828,35113,186,14472,13292,8395,15140
2021-04-01 19:30:00+00,14994,0,4895,7479,913,4070,1174,263,0,696,34484,183,14461,13287,8392,14994
2021-04-01 20:00:00+00,14475,0,4894,7702,745,3996,1179,166,0,148,33305,182,14520,13341,8447,14475
2021-04-01 20:30:00+00,13156,0,4898,7656,746,4068,1175,163,0,0,31862,175,14475,13300,8402,13156
2021-04-01 21:00:00+00,11947,0,4902,7482,719,3932,1167,163,0,10,30322,170,14270,13103,8201,11947
2021-04-01 21:30:00+00,10541,0,4900,6935,710,3816,1313,162,0,208,28585,160,13858,12545,7645,10541
2021-04-01 22:00:00+00,9795,0,4902,6412,692,3540,1465,162,0,132,27100,158,13471,12006,7104,9795
2021-04-01 22:30:00+00,9017,0,4898,6115,692,3612,1472,162,0,0,25968,155,13177,11705,6807,9017
2021-04-01 23:00:00+00,8467,0,4899,5978,676,3331,1475,161,0,0,24987,152,13028,11553,6654,8467
2021-04-01 23:30:00+00,8126,0,4903,6013,675,3238,1476,161,0,0,24592,147,13067,11591,6688,8126
2021-04-02 00:00:00+00,8055,0,4896,5862,653,3347,1477,163,0,0,24453,147,12888,11411,6515,8055
2021-04-02 00:30:00+00,8415,0,4900,5727,649,3488,1474,160,0,0,24813,153,12750,11276,6376,8415
2021-04-02 01:00:00+00,8383,0,4894,5706,641,3484,1471,161,0,0,24740,153,12712,11241,6347,8383
2021-04-02 01:30:00+00,8102,0,4898,5651,637,3486,1475,160,0,0,24409,151,12661,11186,6288,8102
2021-04-02 02:00:00+00,7938,0,4898,5586,637,3380,1478,161,0,0,24078,148,12599,11121,6223,7938
2021-04-02 02:30:00+00,7666,0,4901,5642,638,3230,1481,161,0,0,23719,143,12662,11181,6280,7666
2021-04-02 03:00:00+00,7617,0,4897,5608,638,3138,1489,161,0,0,23548,142,12632,11143,6246,7617
2021-04-02 03:30:00+00,7521,0,4902,5712,626,3104,1473,160,0,0,23498,140,12713,11240,6338,7521
2021-04-02 04:00:00+00,7879,0,4901,5680,626,3092,1471,160,0,0,23809,143,12678,11207,6306,7879
2021-04-02 04:30:00+00,8282,0,4904,5627,646,3090,1463,161,0,0,24173,148,12640,11177,6273,8282
2021-04-02 05:00:00+00,9048,0,4899,5823,702,3368,1466,162,0,0,25468,152,12890,11424,6525,9048
2021-04-02 05:30:00+00,9835,0,4908,5813,701,3379,1452,160,4,0,26252,160,12878,11426,6518,9835
2021-04-02 06:00:00+00,10760,0,4906,5529,757,3995,1450,163,150,0,27710,165,12792,11342,6436,10760
2021-04-02 06:30:00+00,11692,0,4901,5311,752,4084,1473,163,523,0,28899,172,12960,11487,6586,11692
2021-04-02 07:00:00+00,12278,0,4895,5391,803,4028,1512,170,1002,108,30187,172,13603,12091,7196,12278
2021-04-02 07:30:00+00,12606,0,4898,5408,920,3996,1614,173,1510,328,31453,169,14350,12736,7838,12606
2021-04-02 08:00:00+00,12780,0,4894,5344,1037,3996,1719,238,2202,340,32550,167,15196,13477,8583,12780
2021-04-02 08:30:00+00,12839,0,4895,5378,1067,3996,1703,296,2968,416,33558,163,16011,14308,9413,12839
2021-04-02 09:00:00+00,12826,0,4893,5148,1044,3996,1704,244,3896,64,33815,161,16685,14981,10088,12826
2021-04-02 09:30:00+00,12473,0,4894,5507,1009,3996,1663,226,4668,0,34436,154,17741,16078,11184,12473
2021-04-02 10:00:00+00,11880,0,4898,5720,775,3996,1604,168,5260,0,34301,147,18257,16653,11755,11880
2021-04-02 10:30:00+00,11681,0,4894,5738,749,3996,1423,163,5811,0,34455,143,18615,17192,12298,11681
2021-04-02 11:00:00+00,11784,0,4895,6055,652,3632,1134,163,6236,0,34551,142,18972,17838,12943,11784
2021-04-02 11:30:00+00,11032,0,4896,5975,651,3626,1152,162,6744,0,34238,135,19418,18266,13370,11032
2021-04-02 12:00:00+00,10014,0,4901,6218,639,3700,1167,164,6925,0,33728,126,19850,18683,13782,10014
2021-04-02 12:30:00+00,9286,0,4900,6307,632,3700,1178,165,7045,14,33227,119,20062,18884,13984,9286
2021-04-02 13:00:00+00,8650,0,4905,6705,632,3698,1178,165,6863,0,32796,113,20283,19105,14200,8650
2021-04-02 13:30:00+00,8376,0,4902,6756,640,3698,1177,165,6369,0,32083,112,19844,18667,13765,8376
2021-04-02 14:00:00+00,8039,0,4905,6973,695,3702,1179,165,5833,0,31491,110,19585,18406,13501,8039
2021-04-02 14:30:00+00,8049,0,4903,7249,694,3700,1181,165,5220,0,31161,111,19247,18066,13163,8049
2021-04-02 15:00:00+00,8790,0,4901,7210,699,3894,1181,203,4593,0,31471,120,18584,17403,12502,8790
2021-04-02 15:30:00+00,10309,0,4897,7115,706,3896,1180,198,3722,0,32023,136,17620,16440,11543,10309
2021-04-02 16:00:00+00,11694,0,4898,7773,787,3914,1183,197,2767,18,33231,148,17408,16225,11327,11694
2021-04-02 16:30:00+00,12911,0,4896,7911,860,3912,1180,245,1972,42,33929,159,16819,15639,10743,12911
2021-04-02 17:00:00+00,13187,0,4896,7836,1025,3990,1155,233,1273,942,34538,160,16186,15030,10134,13187
2021-04-02 17:30:00+00,13678,0,4894,7438,1026,3990,1154,238,560,1020,33998,168,15072,13918,9024,13678
2021-04-02 18:00:00+00,14072,0,4892,7176,1029,4016,1156,282,129,664,33416,176,14382,13226,8334,14072
2021-04-02 18:30:00+00,14147,0,4892,6881,1041,4016,1152,317,0,1076,33522,177,13966,12814,7922,14147
2021-04-02 19:00:00+00,14214,0,4899,6947,1035,4016,1152,297,0,1356,33916,175,14033,12881,7982,14214
2021-04-02 19:30:00+00,14213,0,4893,6805,1034,4016,1153,287,0,1176,33577,177,13885,12732,7839,14213
2021-04-02 20:00:00+00,13752,0,4897,7117,903,4050,1146,208,0,74,32147,179,14063,12917,8020,13752
2021-04-02 20:30:00+00,12805,0,4893,7156,768,4006,1152,182,0,110,31072,172,13969,12817,7924,12805
2021-04-02 21:00:00+00,11665,0,4901,7206,687,4003,1178,169,0,0,29808,164,13972,12794,7893,11665
2021-04-02 21:30:00+00,9897,0,4901,7162,722,3997,1339,143,0,0,28161,150,14124,12785,7884,9897
2021-04-02 22:00:00+00,8190,0,4907,7268,718,3802,1475,145,0,0,26505,134,14368,12893,7986,8190
2021-04-02 22:30:00+00,6933,0,4904,7091,710,3794,1481,147,0,0,25060,122,14186,12705,7801,6933
2021-04-02 23:00:00+00,6638,0,4902,6819,706,3412,1484,147,0,94,24202,121,13911,12427,7525,6638
2021-04-02 23:30:00+00,6198,0,4902,6795,704,3402,1465,146,0,0,23612,117,13866,12401,7499,6198
2021-04-03 00:00:00+00,6279,0,4898,6707,688,3214,1494,146,0,26,23452,118,13787,12293,7395,6279
2021-04-03 00:30:00+00,6770,0,4898,6606,671,3210,1501,148,0,56,23860,124,13676,12175,7277,6770
2021-04-03 01:00:00+00,6501,0,4898,6925,680,3208,1483,142,0,0,23837,120,13986,12503,7605,6501
2021-04-03 01:30:00+00,6170,0,4893,7022,680,3208,1493,143,0,0,23609,116,14088,12595,7702,6170
2021-04-03 02:00:00+00,6009,0,4891,6968,679,3210,1487,142,0,0,23386,114,14025,12538,7647,6009
2021-04-03 02:30:00+00,5845,0,4893,7085,677,3208,1485,142,0,0,23335,111,14140,12655,7762,5845
2021-04-03 03:00:00+00,6184,0,4890,7071,675,3210,1499,144,0,0,23673,116,14135,12636,7746,6184
2021-04-03 03:30:00+00,6263,0,4895,7259,674,3208,1484,142,0,0,23925,116,14312,12828,7933,6263
2021-04-03 04:00:00+00,5902,0,4891,7554,699,3210,1456,143,0,0,23855,110,14600,13144,8253,5902
2021-04-03 04:30:00+00,5967,0,4897,7566,707,3208,1470,144,0,0,23959,110,14640,13170,8273,5967
2021-04-03 05:00:00+00,6806,0,4900,7449,729,3208,1520,144,0,0,24756,121,14598,13078,8178,6806
2021-04-03 05:30:00+00,7363,0,4902,7424,729,3210,1496,143,2,0,25269,127,14553,13057,8155,7363
2021-04-03 06:00:00+00,8480,0,4907,7313,743,3404,1492,145,106,0,26590,137,14561,13069,8162,8480
2021-04-03 06:30:00+00,9662,0,4901,7202,744,3408,1503,150,377,0,27947,147,14727,13224,8323,9662
2021-04-03 07:00:00+00,10530,0,4901,7071,769,3720,1588,147,747,60,29533,151,15076,13488,8587,10530
2021-04-03 07:30:00+00,11257,0,4903,7067,769,3730,1642,166,1145,234,30913,154,15526,13884,8981,11257
2021-04-03 08:00:00+00,11628,0,4898,7061,868,3990,1754,235,1578,170,32182,154,16159,14405,9507,11628
2021-04-03 08:30:00+00,11782,0,4899,7023,972,3996,1650,259,2047,172,32800,153,16591,14941,10042,11782
2021-04-03 09:00:00+00,11858,0,4895,6795,956,3996,1638,252,2589,258,33237,152,16873,15235,10340,11858
2021-04-03 09:30:00+00,11902,0,4896,6629,950,3995,1653,241,3108,190,33564,151,17236,15583,10687,11902
2021-04-03 10:00:00+00,12051,0,4894,6355,944,3994,1713,237,3691,116,33995,151,17597,15884,10990,12051
2021-04-03 10:30:00+00,11969,0,4894,5888,942,3992,1685,237,4192,0,33799,150,17601,15916,11022,11969
2021-04-03 11:00:00+00,12127,0,4896,5478,923,3806,1605,237,4767,146,33985,151,17669,16064,11168,12127
2021-04-03 11:30:00+00,12086,0,4900,5207,932,3800,1564,197,5366,124,34176,149,17969,16405,11505,12086
2021-04-03 12:00:00+00,11884,0,4901,4940,741,3800,1562,183,5702,0,33713,149,17846,16284,11383,11884
2021-04-03 12:30:00+00,11559,0,4903,4633,695,3800,1509,183,5824,0,33106,147,17564,16055,11152,11559
2021-04-03 13:00:00+00,11473,0,4901,4571,659,3800,1503,183,5778,0,32868,147,17412,15909,11008,11473
2021-04-03 13:30:00+00,11044,0,4907,4609,658,3800,1489,184,5671,0,32362,144,17334,15845,10938,11044
2021-04-03 14:00:00+00,10917,0,4905,4551,656,3806,1690,183,5404,0,32112,145,17206,15516,10611,10917
2021-04-03 14:30:00+00,10650,0,4907,4528,657,3802,1752,183,5089,0,31568,144,16933,15181,10274,10650
2021-04-03 15:00:00+00,11335,0,4901,4520,701,3798,1773,183,4577,0,31788,152,16472,14699,9798,11335
2021-04-03 15:30:00+00,12630,0,4902,4562,692,3800,1799,184,4029,0,32598,164,15984,14185,9283,12630
2021-04-03 16:00:00+00,13941,0,4905,4731,756,4012,1827,183,3356,0,33711,174,15575,13748,8843,13941
2021-04-03 16:30:00+00,14932,0,4897,4689,821,4016,1832,187,2480,2,33856,185,14719,12887,7990,14932
2021-04-03 17:00:00+00,15480,0,4900,4722,866,4016,1828,218,1562,482,34074,190,13878,12050,7150,15480
2021-04-03 17:30:00+00,15590,0,4891,4868,979,4016,1830,226,805,468,33673,194,13373,11543,6652,15590
2021-04-03 18:00:00+00,15577,0,4891,4545,980,4014,1830,263,182,1014,33296,196,12428,10598,5707,15577
2021-04-03 18:30:00+00,15721,0,4888,4503,984,4016,1831,232,2,1246,33423,197,12208,10377,5489,15721
2021-04-03 19:00:00+00,15915,0,4891,4402,986,4016,1827,267,0,1386,33690,199,12106,10279,5388,15915
2021-04-03 19:30:00+00,15832,0,4898,4333,985,4016,1827,287,0,1222,33400,199,12043,10216,5318,15832
2021-04-03 20:00:00+00,15655,0,4890,4195,966,3996,1829,245,0,550,32326,203,11880,10051,5161,15655
2021-04-03 20:30:00+00,15375,0,4892,3999,948,3996,1819,168,0,166,31363,205,11658,9839,4947,15375
2021-04-03 21:00:00+00,14790,0,4895,3867,805,3996,1790,147,0,4,30294,204,11357,9567,4672,14790
2021-04-03 21:30:00+00,13773,0,4894,3737,739,3995,1732,150,0,0,29020,199,11102,9370,4476,13773
2021-04-03 22:00:00+00,12495,0,4897,3593,686,3803,1748,150,0,0,27372,192,10924,9176,4279,12495
2021-04-03 22:30:00+00,11276,0,4899,3559,671,3794,1731,148,0,0,26078,183,10860,9129,4230,11276
2021-04-03 23:00:00+00,10884,0,4901,3574,595,3412,1731,149,0,0,25246,183,10801,9070,4169,10884
2021-04-03 23:30:00+00,10418,0,4895,3541,594,3406,1739,149,0,0,24742,179,10769,9030,4135,10418
2021-04-04 00:00:00+00,10331,0,4890,3553,573,3408,1734,148,0,0,24637,179,10750,9016,4126,10331
2021-04-04 00:30:00+00,10505,0,4890,3568,571,3406,1769,147,0,110,24966,180,10798,9029,4139,10505
2021-04-04 01:00:00+00,10598,0,4891,3567,537,3408,1825,147,0,0,24973,181,10820,8995,4104,10598
2021-04-04 01:30:00+00,10239,0,4892,3650,538,3408,1824,148,0,0,24699,178,10904,9080,4188,10239
2021-04-04 02:00:00+00,9555,0,4890,3815,539,3243,1812,147,0,0,24001,172,11056,9244,4354,9555
2021-04-04 02:30:00+00,9075,0,4894,3951,538,3268,1823,147,0,0,23696,167,11206,9383,4489,9075
2021-04-04 03:00:00+00,8758,0,4886,4026,546,3212,1822,148,0,0,23398,162,11280,9458,4572,8758
2021-04-04 03:30:00+00,8572,0,4890,3671,549,3214,1826,148,0,0,22870,163,10936,9110,4220,8572
2021-04-04 04:00:00+00,8504,0,4896,3950,537,3212,1825,147,0,0,23071,160,11208,9383,4487,8504
2021-04-04 04:30:00+00,8260,0,4893,4137,685,3214,1824,147,0,0,23160,156,11539,9715,4822,8260
2021-04-04 05:00:00+00,8362,0,4895,4497,714,3212,1819,147,0,0,23646,154,11925,10106,5211,8362
2021-04-04 05:30:00+00,8479,0,4893,4743,586,3218,1744,149,33,0,23845,154,11999,10255,5362,8479
2021-04-04 06:00:00+00,8790,0,4900,5132,592,3218,1720,157,417,0,24926,152,12761,11041,6141,8790
2021-04-04 06:30:00+00,8834,0,4901,5253,714,3212,1601,155,1175,138,25983,146,13644,12043,7142,8834
2021-04-04 07:00:00+00,8952,0,4899,5490,725,3213,1483,230,2075,140,27207,142,14672,13189,8290,8952
2021-04-04 07:30:00+00,8805,0,4904,5921,733,3214,1480,245,3046,118,28466,134,16084,14604,9700,8805
2021-04-04 08:00:00+00,8650,0,4900,6454,605,3212,1482,230,4041,0,29574,126,17482,16000,11100,8650
2021-04-04 08:30:00+00,8136,0,4903,6912,590,3210,1477,211,5102,0,30541,116,18984,17507,12604,8136
2021-04-04 09:00:00+00,8199,0,4897,7576,569,2826,1387,157,6169,0,31780,111,20598,19211,14314,8199
2021-04-04 09:30:00+00,7402,0,4901,8163,599,2814,1165,149,6964,0,32157,99,21792,20627,15726,7402
2021-04-04 10:00:00+00,6674,0,4892,8712,603,2334,1181,154,7705,0,32255,89,23093,21912,17020,6674
2021-04-04 10:30:00+00,6046,0,4893,9388,593,2328,1178,153,8290,0,32869,80,24342,23164,18271,6046
2021-04-04 11:00:00+00,5971,0,4902,9783,520,2188,1177,149,8647,0,33337,78,25029,23852,18950,5971
2021-04-04 11:30:00+00,5322,0,4901,10320,517,2162,1176,151,9055,0,33604,70,25969,24793,19892,5322
2021-04-04 12:00:00+00,5207,0,4901,10557,491,2080,1173,153,9140,0,33702,68,26262,25089,20188,5207
2021-04-04 12:30:00+00,4068,0,4900,11036,491,2072,1174,153,9034,0,32928,56,26635,25461,20561,4068
2021-04-04 13:00:00+00,3855,0,4898,11465,457,1588,1173,154,8630,0,32220,54,26623,25450,20552,3855
2021-04-04 13:30:00+00,3127,0,4901,11971,465,1574,1158,151,8005,0,31352,47,26500,25342,20441,3127
2021-04-04 14:00:00+00,2953,0,4899,13023,467,1808,1001,154,7259,0,31564,44,26649,25648,20749,2953
2021-04-04 14:30:00+00,3066,0,4902,13356,472,1818,1023,156,6526,0,31319,46,26279,25256,20354,3066
2021-04-04 15:00:00+00,3289,0,4903,13036,556,2076,1149,152,5453,0,30614,50,25097,23948,19045,3289
2021-04-04 15:30:00+00,4274,0,4901,13018,576,2084,1180,153,4423,0,30609,63,24098,22918,18017,4274
2021-04-04 16:00:00+00,4144,0,4903,13135,637,2337,1180,157,3502,846,30841,64,23357,22177,17274,4144
2021-04-04 16:30:00+00,4742,0,4900,12882,602,2571,1180,157,2604,1276,30914,75,22168,20988,16088,4742
2021-04-04 17:00:00+00,4959,0,4902,12880,599,2724,1177,247,1633,1338,30459,83,21191,20014,15112,4959
2021-04-04 17:30:00+00,5150,0,4900,13195,594,2642,1183,326,822,1176,29989,87,20694,19511,14611,5150
2021-04-04 18:00:00+00,5437,0,4900,13295,591,2728,1181,255,208,1254,29849,92,20175,18994,14094,5437
2021-04-04 18:30:00+00,5555,0,4898,13626,620,2644,1183,220,3,1158,29907,93,20330,19147,14249,5555
2021-04-04 19:00:00+00,6005,0,4897,13823,609,2369,1165,155,0,1164,30188,94,20494,19329,14432,6005
2021-04-04 19:30:00+00,5668,0,4896,14332,579,2052,1168,152,0,1032,29879,86,20975,19807,14911,5668
2021-04-04 20:00:00+00,5225,0,4900,14842,565,1833,1167,150,0,150,28833,83,21474,20307,15407,5225
2021-04-04 20:30:00+00,4425,0,4896,14981,582,1633,1166,149,0,0,27832,72,21625,20459,15563,4425
2021-04-04 21:00:00+00,5128,0,4901,14951,479,979,1187,147,0,50,27822,83,21518,20331,15430,5128
2021-04-04 21:30:00+00,4191,0,4900,15186,502,876,1355,148,0,0,27158,70,21943,20588,15688,4191
2021-04-04 22:00:00+00,3683,0,4899,15550,485,746,1460,153,0,0,26976,64,22394,20934,16035,3683
2021-04-04 22:30:00+00,3166,0,4906,15627,463,808,1368,149,0,0,26487,59,22364,20996,16090,3166
2021-04-04 23:00:00+00,3070,0,4903,15176,441,691,1495,150,0,0,25926,58,22016,20520,15618,3070
2021-04-04 23:30:00+00,3233,0,4903,14932,425,680,1493,149,0,0,25814,61,21753,20260,15357,3233
2021-04-05 00:00:00+00,3530,0,4899,14763,425,889,1487,149,0,0,26143,66,21574,20087,15188,3530
2021-04-05 00:30:00+00,4154,0,4898,14756,435,903,1534,151,0,0,26831,74,21623,20089,15191,4154
2021-04-05 01:00:00+00,4105,0,4895,14689,417,904,1528,150,0,0,26688,74,21529,20001,15106,4105
2021-04-05 01:30:00+00,3919,0,4890,14391,405,922,1525,149,0,0,26201,74,21211,19686,14796,3919
2021-04-05 02:00:00+00,3283,0,4892,14123,402,1018,1473,147,0,0,25338,67,20890,19417,14525,3283
2021-04-05 02:30:00+00,3002,0,4889,14189,417,1040,1471,150,0,0,25158,64,20966,19495,14606,3002
2021-04-05 03:00:00+00,3304,0,4892,14174,417,1092,1474,148,0,0,25501,69,20957,19483,14591,3304
2021-04-05 03:30:00+00,3099,0,4891,14141,419,1082,1487,151,0,0,25270,66,20938,19451,14560,3099
2021-04-05 04:00:00+00,3166,0,4890,14013,435,1042,1480,152,0,0,25178,67,20818,19338,14448,3166
2021-04-05 04:30:00+00,3271,0,4898,14156,430,1022,1476,149,0,0,25402,67,20960,19484,14586,3271
2021-04-05 05:00:00+00,3922,0,4892,14325,489,1008,1510,149,0,0,26295,75,21216,19706,14814,3922
2021-04-05 05:30:00+00,3654,0,4895,14645,482,1068,1513,151,10,0,26418,71,21545,20032,15137,3654
2021-04-05 06:00:00+00,4432,0,4894,14424,522,824,1536,154,188,98,27072,77,21564,20028,15134,4432
2021-04-05 06:30:00+00,5068,0,4894,14564,552,876,1590,151,590,2,28287,84,22190,20600,15706,5068
2021-04-05 07:00:00+00,4459,0,4900,14889,709,1184,1445,153,1002,14,28755,71,22945,21500,16600,4459
2021-04-05 07:30:00+00,4527,0,4901,15118,680,1250,1485,156,1740,32,29889,69,23924,22439,17538,4527
2021-04-05 08:00:00+00,3505,0,4900,15358,535,2674,1278,172,2708,306,31436,53,24779,23501,18601,3505
2021-04-05 08:30:00+00,3536,0,4901,15475,526,2732,1164,188,3593,16,32131,52,25659,24495,19594,3536
2021-04-05 09:00:00+00,3543,0,4897,15499,507,2734,1163,179,4165,0,32687,51,26231,25068,20171,3543
2021-04-05 09:30:00+00,3173,0,4893,15719,491,2734,1160,158,5071,0,33399,45,27334,26174,21281,3173
2021-04-05 10:00:00+00,3085,0,4893,15858,463,2812,1160,153,5958,38,34420,43,28332,27172,22279,3085
2021-04-05 10:30:00+00,2853,0,4890,16260,434,2816,1160,153,6723,14,35303,39,29467,28307,23417,2853
2021-04-05 11:00:00+00,3174,0,4891,16334,417,2814,1159,151,7360,0,36300,42,30161,29002,24111,3174
2021-04-05 11:30:00+00,3052,0,4894,16311,417,2814,1159,151,7808,0,36606,40,30589,29430,24536,3052
2021-04-05 12:00:00+00,2941,0,4889,16145,417,2832,1157,154,7890,0,36425,39,30498,29341,24452,2941
2021-04-05 12:30:00+00,2519,0,4895,16238,418,2814,1040,154,7893,0,35971,34,30484,29444,24549,2519
2021-04-05 13:00:00+00,2644,0,4894,16224,414,2360,875,154,7922,0,35487,35,30329,29454,24560,2644
2021-04-05 13:30:00+00,2458,0,4900,16396,413,2324,1003,150,7684,0,35328,34,30396,29393,24493,2458
2021-04-05 14:00:00+00,2435,0,4894,16236,413,2722,844,153,7067,0,34764,34,29454,28610,23716,2435
2021-04-05 14:30:00+00,2704,0,4899,15993,438,2716,833,152,6638,0,34373,37,28801,27968,23069,2704
2021-04-05 15:00:00+00,3215,0,4896,16550,502,2466,809,187,5858,0,34483,43,28615,27806,22910,3215
2021-04-05 15:30:00+00,4236,0,4899,16218,528,2478,927,193,4854,0,34333,56,27426,26499,21600,4236
2021-04-05 16:00:00+00,5013,0,4901,16329,538,2872,1127,202,3877,78,34937,65,26772,25645,20744,5013
2021-04-05 16:30:00+00,6540,0,4898,16151,544,2908,1134,211,2970,198,35554,81,25697,24563,19665,6540
2021-04-05 17:00:00+00,6852,0,4898,15857,664,3504,1140,212,2016,420,35563,84,24575,23435,18537,6852
2021-04-05 17:30:00+00,7373,0,4897,15513,667,3518,1142,211,1018,616,34955,92,23237,22095,17198,7373
2021-04-05 18:00:00+00,7928,0,4899,15005,669,3602,1140,206,259,902,34610,99,21972,20832,15933,7928
2021-04-05 18:30:00+00,8055,0,4894,14968,658,3602,1140,229,7,1036,34589,100,21667,20527,15633,8055
2021-04-05 19:00:00+00,8352,0,4890,14842,643,3602,1147,264,0,1574,35314,102,21522,20375,15485,8352
2021-04-05 19:30:00+00,8637,0,4895,14515,620,3592,1139,263,0,1202,34863,106,21169,20030,15135,8637
2021-04-05 20:00:00+00,8761,0,4890,14146,607,3070,1135,264,0,944,33817,111,20778,19643,14753,8761
2021-04-05 20:30:00+00,8046,0,4891,14055,583,3052,1139,219,0,248,32233,107,20668,19529,14638,8046
2021-04-05 21:00:00+00,7326,0,4899,14047,534,2706,1138,261,0,96,31007,103,20618,19480,14581,7326
2021-04-05 21:30:00+00,5777,0,4891,14298,551,2698,1296,191,0,12,29714,86,21036,19740,14849,5777
2021-04-05 22:00:00+00,5266,0,4896,14233,516,1590,1432,150,0,6,28089,84,21077,19645,14749,5266
2021-04-05 22:30:00+00,4451,0,4892,14100,505,1534,1448,154,0,0,27084,75,20945,19497,14605,4451
2021-04-05 23:00:00+00,3900,0,4898,14196,452,1436,1439,149,0,0,26470,68,20985,19546,14648,3900
2021-04-05 23:30:00+00,3529,0,4897,13946,453,1434,1443,151,0,0,25853,64,20739,19296,14399,3529
2021-04-06 00:00:00+00,3545,0,4901,13603,431,1616,1443,149,0,0,25688,66,20378,18935,14034,3545
2021-04-06 00:30:00+00,3956,0,4902,13587,435,1634,1459,152,0,0,26125,72,20383,18924,14022,3956
2021-04-06 01:00:00+00,3921,0,4902,13568,435,2004,1451,148,0,0,26429,71,20356,18905,14003,3921
2021-04-06 01:30:00+00,3915,0,4898,13478,435,2002,1443,151,0,0,26322,71,20254,18811,13913,3915
2021-04-06 02:00:00+00,3743,0,4900,13499,453,1935,1423,148,0,0,26101,69,20275,18852,13952,3743
2021-04-06 02:30:00+00,3754,0,4898,13502,471,1915,1422,150,0,0,26113,69,20293,18871,13973,3754
2021-04-06 03:00:00+00,4062,0,4895,13578,470,1332,1427,151,0,0,25915,73,20370,18943,14048,4062
2021-04-06 03:30:00+00,4137,0,4894,13663,471,1305,1431,151,0,0,26052,74,20459,19028,14134,4137
2021-04-06 04:00:00+00,4415,0,4891,13719,488,866,1453,151,0,0,25983,77,20551,19098,14207,4415
2021-04-06 04:30:00+00,4858,0,4895,13832,488,997,1453,153,0,0,26676,82,20668,19215,14320,4858
2021-04-06 05:00:00+00,5435,0,4891,13724,474,2154,1604,208,0,140,28630,88,20693,19089,14198,5435
2021-04-06 05:30:00+00,6682,0,4895,13676,558,2156,1750,202,80,206,30205,101,20959,19209,14314,6682
2021-04-06 06:00:00+00,7898,0,4895,13953,617,2814,1739,234,601,392,33143,107,21805,20066,15171,7898
2021-04-06 06:30:00+00,8625,0,4900,13882,783,2788,1747,286,1557,790,35358,108,22869,21122,16222,8625
2021-04-06 07:00:00+00,8975,0,4900,13929,815,3538,1745,295,2632,816,37645,106,24021,22276,17376,8975
2021-04-06 07:30:00+00,8807,0,4906,14163,807,3548,1737,306,3643,560,38477,102,25256,23519,18613,8807
2021-04-06 08:00:00+00,8673,0,4903,14456,807,2658,1743,301,4696,950,39187,98,26605,24862,19959,8673
2021-04-06 08:30:00+00,8180,0,4909,14375,812,2574,1732,206,5509,1116,39413,92,27337,25605,20696,8180
2021-04-06 09:00:00+00,8577,0,4906,14809,735,2514,1737,158,6197,228,39861,94,28384,26647,21741,8577
2021-04-06 09:30:00+00,8246,0,4904,14961,572,2442,1732,162,6876,8,39903,91,29045,27313,22409,8246
2021-04-06 10:00:00+00,8068,0,4899,14989,486,2314,1733,155,7306,228,40178,88,29413,27680,22781,8068
2021-04-06 10:30:00+00,7859,0,4899,15358,482,2334,1742,161,7534,92,40461,86,30015,28273,23374,7859
2021-04-06 11:00:00+00,7587,0,4896,15439,431,3084,1741,156,7228,136,40698,84,29735,27994,23098,7587
2021-04-06 11:30:00+00,7687,0,4893,15527,418,3150,1665,155,6836,146,40477,85,29339,27674,22781,7687
2021-04-06 12:00:00+00,8022,0,4894,15467,419,3230,1467,155,6121,118,39893,89,28368,26901,22007,8022
2021-04-06 12:30:00+00,8066,0,4893,15641,434,3232,1468,155,5629,0,39518,90,28065,26597,21704,8066
2021-04-06 13:00:00+00,7941,0,4898,15983,437,2770,1468,155,4707,0,38359,91,27493,26025,21127,7941
2021-04-06 13:30:00+00,7830,0,4899,16365,423,2768,1602,156,4497,0,38540,90,27786,26184,21285,7830
2021-04-06 14:00:00+00,7206,0,4898,16582,435,3580,1606,153,4337,0,38797,84,27858,26252,21354,7206
2021-04-06 14:30:00+00,6991,0,4901,16849,438,3604,1734,161,4888,0,39566,80,28810,27076,22175,6991
2021-04-06 15:00:00+00,7822,0,4896,16883,489,3452,1694,194,4282,0,39712,90,28244,26550,21654,7822
2021-04-06 15:30:00+00,8940,0,4899,16483,527,3536,1672,211,3561,0,39829,101,27142,25470,20571,8940
2021-04-06 16:00:00+00,9794,0,4902,16182,596,3690,1717,210,2838,374,40303,108,26235,24518,19616,9794
2021-04-06 16:30:00+00,10797,0,4898,15978,623,3678,1734,257,1908,626,40499,119,25141,23407,18509,10797
2021-04-06 17:00:00+00,11767,0,4898,15220,652,3276,1742,327,1468,928,40278,129,23980,22238,17340,11767
2021-04-06 17:30:00+00,12313,0,4903,14979,662,3316,1730,372,863,726,39864,136,23137,21407,16504,12313
2021-04-06 18:00:00+00,12573,0,4900,14399,803,2986,1730,379,214,724,38708,142,22046,20316,15416,12573
2021-04-06 18:30:00+00,13005,0,4896,13906,809,2978,1745,344,8,912,38603,146,21364,19619,14723,13005
2021-04-06 19:00:00+00,12728,0,4898,13742,796,3856,1750,328,0,824,38922,142,21186,19436,14538,12728
2021-04-06 19:30:00+00,12588,0,4891,13577,775,3918,1750,280,0,838,38617,141,20993,19243,14352,12588
2021-04-06 20:00:00+00,12392,0,4896,13329,720,3392,1747,319,0,908,37703,142,20692,18945,14049,12392
2021-04-06 20:30:00+00,11624,0,4896,13348,649,3346,1743,288,0,12,35906,141,20636,18893,13997,11624
2021-04-06 21:00:00+00,11198,0,4895,12984,513,2632,1737,206,0,36,34201,141,20129,18392,13497,11198
2021-04-06 21:30:00+00,10002,0,4898,12731,502,2610,1723,145,0,0,32611,133,19854,18131,13233,10002
2021-04-06 22:00:00+00,8697,0,4893,12376,472,2230,1734,147,0,0,30549,124,19475,17741,12848,8697
2021-04-06 22:30:00+00,7513,0,4895,12178,468,2230,1734,145,0,0,29163,114,19275,17541,12646,7513
2021-04-06 23:00:00+00,7167,0,4895,12284,423,2168,1727,143,0,0,28807,110,19329,17602,12707,7167
2021-04-06 23:30:00+00,6997,0,4897,12266,386,2176,1733,144,0,0,28599,109,19282,17549,12652,6997
2021-04-07 00:00:00+00,6632,0,4898,11928,368,2746,1732,150,0,0,28454,107,18926,17194,12296,6632
2021-04-07 00:30:00+00,6860,0,4901,11955,369,2756,1732,145,0,0,28718,109,18957,17225,12324,6860
2021-04-07 01:00:00+00,6925,0,4901,12093,369,3002,1732,145,0,0,29167,108,19095,17363,12462,6925
2021-04-07 01:30:00+00,6866,0,4899,12110,369,3010,1739,143,0,0,29136,108,19117,17378,12479,6866
2021-04-07 02:00:00+00,6948,0,4902,12231,369,2932,1765,145,0,0,29292,108,19267,17502,12600,6948
2021-04-07 02:30:00+00,7094,0,4896,12158,369,2926,1807,144,0,0,29393,110,19230,17423,12527,7094
2021-04-07 03:00:00+00,7271,0,4896,11815,369,2394,1852,148,0,0,28745,115,18932,17080,12184,7271
2021-04-07 03:30:00+00,7351,0,4894,11863,368,2350,1916,144,0,0,28886,115,19041,17125,12231,7351
2021-04-07 04:00:00+00,7762,0,4892,11869,405,773,1971,193,0,0,27864,125,19137,17166,12274,7762
2021-04-07 04:30:00+00,8150,0,4897,11614,650,731,2133,271,0,0,28446,129,19294,17161,12264,8150
2021-04-07 05:00:00+00,8964,0,4894,11487,567,900,2333,277,0,466,29887,135,19281,16948,12054,8964
2021-04-07 05:30:00+00,9930,0,4889,11357,465,902,2449,235,86,262,30574,144,19246,16797,11908,9930
2021-04-07 06:00:00+00,11315,0,4889,11152,636,947,2599,238,543,354,32673,152,19819,17220,12331,11315
2021-04-07 06:30:00+00,12588,0,4891,10702,758,947,2686,316,1250,1004,35141,157,20287,17601,12710,12588
2021-04-07 07:00:00+00,13695,0,4896,10462,748,1544,2680,287,2077,608,36998,161,20863,18183,13287,13695
2021-04-07 07:30:00+00,14413,0,4897,10299,744,1922,2711,314,2840,670,38810,162,21491,18780,13883,14413
2021-04-07 08:00:00+00,14837,0,4902,10108,521,3582,2859,251,3567,190,40817,159,21957,19098,14196,14837
2021-04-07 08:30:00+00,15100,0,4905,9977,508,3762,2996,194,4168,0,41610,158,22554,19558,14653,15100
2021-04-07 09:00:00+00,15391,0,4916,9895,494,3532,3015,158,4610,0,42011,159,22930,19915,14999,15391
2021-04-07 09:30:00+00,15565,0,4916,10064,477,3526,3003,147,4886,0,42584,158,23346,20343,15427,15565
2021-04-07 10:00:00+00,15723,0,4902,9700,468,3518,2751,178,4885,364,42489,160,22706,19955,15053,15723
2021-04-07 10:30:00+00,15901,0,4904,9351,597,3509,2854,191,4835,298,42440,162,22541,19687,14783,15901
2021-04-07 11:00:00+00,16078,0,4905,9066,687,3392,3009,231,4711,442,42521,163,22378,19369,14464,16078
2021-04-07 11:30:00+00,16472,0,4900,8609,610,3394,3025,279,4594,264,42147,169,21738,18713,13813,16472
2021-04-07 12:00:00+00,16369,0,4903,8838,479,3886,3000,253,4584,28,42340,168,21804,18804,13901,16369
2021-04-07 12:30:00+00,16291,0,4894,8462,440,3898,3010,206,4447,16,41664,170,21253,18243,13349,16291
2021-04-07 13:00:00+00,16358,0,4898,7870,438,3996,3009,193,4511,0,41273,172,20726,17717,12819,16358
2021-04-07 13:30:00+00,16549,0,4882,7350,463,3996,3008,194,4181,0,40623,177,19884,16876,11994,16549
2021-04-07 14:00:00+00,16867,0,4889,7135,467,3938,3012,177,3979,0,40464,180,19482,16470,11581,16867
2021-04-07 14:30:00+00,17586,0,4890,6721,504,3932,3015,180,3428,18,40274,188,18558,15543,10653,17586
2021-04-07 15:00:00+00,18335,15,4892,6439,629,3626,3013,185,2835,238,40207,195,17808,14795,9903,18350
2021-04-07 15:30:00+00,18945,38,4893,6033,792,3628,3012,333,2179,370,40223,205,16909,13897,9004,18983
2021-04-07 16:00:00+00,19479,106,4901,5686,827,4004,3010,346,1734,554,40647,211,16158,13148,8247,19585
2021-04-07 16:30:00+00,20023,234,4897,5274,839,4016,3013,390,1179,552,40417,221,15202,12189,7292,20257
2021-04-07 17:00:00+00,20088,277,4899,4953,864,4014,3011,502,767,1198,40573,223,14494,11483,6584,20365
2021-04-07 17:30:00+00,20364,348,4904,4678,865,4016,3007,502,354,1212,40250,229,13808,10801,5897,20712
2021-04-07 18:00:00+00,20615,302,4901,4051,868,4016,3056,525,102,1468,39904,232,12978,9922,5021,20917
2021-04-07 18:30:00+00,20684,276,4907,3741,859,4016,3003,530,4,1558,39578,234,12514,9511,4604,20960
2021-04-07 19:00:00+00,21353,278,4903,3561,860,3602,3001,534,0,1514,39606,241,12325,9324,4421,21631
2021-04-07 19:30:00+00,20983,264,4901,3323,849,3515,3004,526,0,1190,38555,243,12077,9073,4172,21247
2021-04-07 20:00:00+00,20850,259,4898,3033,804,3430,3001,339,0,562,37176,248,11736,8735,3837,21109
2021-04-07 20:30:00+00,19891,234,4893,2816,553,3382,2993,251,0,80,35093,250,11255,8262,3369,20125
2021-04-07 21:00:00+00,19394,216,4896,2697,485,1664,3000,240,0,156,32749,259,11078,8078,3182,19610
2021-04-07 21:30:00+00,17769,0,4895,3080,522,1491,3003,198,0,16,30974,246,11500,8497,3602,17769
2021-04-07 22:00:00+00,15838,0,4898,3453,510,1290,2997,144,0,0,29130,234,11858,8861,3963,15838
2021-04-07 22:30:00+00,15128,0,4897,3681,496,1462,2976,137,0,0,28777,229,12050,9074,4177,15128
2021-04-07 23:00:00+00,14448,0,4903,3918,456,996,2987,136,0,0,27844,224,12264,9277,4374,14448
2021-04-07 23:30:00+00,13935,0,4902,4303,419,946,2980,136,0,0,27621,218,12604,9624,4722,13935
2021-04-08 00:00:00+00,14051,0,4899,4978,403,1142,2970,136,0,0,28579,215,13250,10280,5381,14051
2021-04-08 00:30:00+00,14204,0,4900,5261,403,1266,2964,138,0,0,29136,215,13528,10564,5664,14204
2021-04-08 01:00:00+00,14202,0,4903,5787,402,1094,2965,139,0,0,29492,212,14057,11092,6189,14202
2021-04-08 01:30:00+00,13857,0,4903,6124,402,1106,2963,140,0,0,29495,207,14392,11429,6526,13857
2021-04-08 02:00:00+00,13654,0,4905,6509,403,954,2966,139,0,0,29530,204,14783,11817,6912,13654
2021-04-08 02:30:00+00,13141,0,4904,7383,403,826,2956,137,0,0,29750,194,15646,12690,7786,13141
2021-04-08 03:00:00+00,13487,0,4902,8145,403,300,2965,140,0,0,30342,193,16415,13450,8548,13487
2021-04-08 03:30:00+00,13162,0,4901,8708,403,266,2969,140,0,0,30549,187,16981,14012,9111,13162
2021-04-08 04:00:00+00,12598,0,4896,9176,401,400,2942,141,0,0,30554,181,17415,14473,9577,12598
2021-04-08 04:30:00+00,12621,0,4901,9671,410,400,2921,138,0,0,31062,179,17903,14982,10081,12621
2021-04-08 05:00:00+00,13113,0,4896,9918,485,608,2949,141,0,0,32110,182,18248,15299,10403,13113
2021-04-08 05:30:00+00,14480,0,4897,10019,525,636,2953,139,36,0,33685,190,18430,15477,10580,14480
2021-04-08 06:00:00+00,15243,0,4893,10087,551,624,2960,196,308,210,35072,190,18799,15839,10946,15243
2021-04-08 06:30:00+00,15862,0,4899,10377,577,618,2935,213,640,450,36571,188,19428,16493,11594,15862
2021-04-08 07:00:00+00,16186,0,4897,11265,603,1056,2947,221,1256,152,38583,182,20968,18021,13124,16186
2021-04-08 07:30:00+00,16042,0,4901,12068,604,1012,2927,221,2017,520,40312,172,22517,19590,14689,16042
2021-04-08 08:00:00+00,15502,0,4899,12637,555,778,2903,230,2661,250,40415,165,23655,20752,15853,15502
2021-04-08 08:30:00+00,14724,0,4905,13163,550,774,2881,189,3339,0,40525,156,24838,21957,17052,14724
2021-04-08 09:00:00+00,14116,0,4902,13912,478,772,2883,160,4142,0,41365,147,26317,23434,18532,14116
2021-04-08 09:30:00+00,12729,0,4905,14536,441,782,2752,161,4756,0,41062,134,27390,24638,19733,12729
2021-04-08 10:00:00+00,11038,0,4901,14767,382,1224,2466,162,4929,0,39869,124,27445,24979,20078,11038
2021-04-08 10:30:00+00,10077,0,4906,15165,357,1482,2390,161,5548,0,40086,117,28366,25976,21070,10077
2021-04-08 11:00:00+00,10284,0,4899,15435,357,1346,2342,170,5875,0,40708,116,28908,26566,21667,10284
2021-04-08 11:30:00+00,10318,0,4897,15508,359,1266,2318,168,5824,0,40658,115,28906,26588,21691,10318
2021-04-08 12:00:00+00,9944,0,4903,15596,362,1470,2230,163,5531,0,40199,114,28622,26392,21489,9944
2021-04-08 12:30:00+00,10033,0,4894,15857,368,1446,2263,169,5312,0,40342,115,28694,26431,21537,10033
2021-04-08 13:00:00+00,10193,0,4892,16054,367,1566,2283,171,4942,0,40468,117,28538,26255,21363,10193
2021-04-08 13:30:00+00,10691,0,4891,16130,367,1566,2288,169,4010,0,40112,123,27686,25398,20507,10691
2021-04-08 14:00:00+00,10772,0,4896,16226,368,1554,2283,166,3393,0,39658,126,27166,24882,19986,10772
2021-04-08 14:30:00+00,10637,0,4895,16338,378,1556,2271,167,2851,0,39093,126,26733,24462,19567,10637
2021-04-08 15:00:00+00,10089,0,4898,16626,426,1542,2240,202,2280,0,38303,123,26470,24230,19332,10089
2021-04-08 15:30:00+00,10370,0,4894,16707,404,1476,2249,218,1949,0,38267,126,26203,23954,19060,10370
2021-04-08 16:00:00+00,10753,0,4900,16881,469,1470,2531,222,1541,0,38767,127,26322,23791,18891,10753
2021-04-08 16:30:00+00,11418,0,4899,16802,493,1402,2756,217,1096,0,39083,133,26046,23290,18391,11418
2021-04-08 17:00:00+00,11957,0,4906,16553,515,1502,2824,316,703,442,39718,139,25501,22677,17771,11957
2021-04-08 17:30:00+00,12194,0,4904,16373,521,1482,2834,375,403,452,39538,142,25035,22201,17297,12194
2021-04-08 18:00:00+00,12074,0,4904,16164,526,1184,2833,399,147,454,38685,141,24574,21741,16837,12074
2021-04-08 18:30:00+00,12090,0,4904,16312,511,1084,2829,414,7,342,38493,141,24563,21734,16830,12090
2021-04-08 19:00:00+00,12127,0,4901,16035,508,1020,2832,428,0,510,38361,141,24276,21444,16543,12127
2021-04-08 19:30:00+00,12273,0,4906,15702,497,1020,2858,401,0,266,37923,144,23963,21105,16199,12273
2021-04-08 20:00:00+00,10892,0,4901,15588,486,1000,2797,205,0,184,36053,134,23772,20975,16074,10892
2021-04-08 20:30:00+00,9665,0,4898,15491,476,1000,2771,158,0,0,34459,126,23636,20865,15967,9665
2021-04-08 21:00:00+00,9636,0,4896,15377,478,900,2505,157,0,0,33949,126,23256,20751,15855,9636
2021-04-08 21:30:00+00,8639,0,4892,15439,492,900,1940,159,0,0,32461,117,22763,20823,15931,8639
2021-04-08 22:00:00+00,6628,0,4895,15273,478,804,1449,152,0,12,29691,99,22095,20646,15751,6628
2021-04-08 22:30:00+00,5721,0,4893,14674,487,808,1451,139,0,6,28179,92,21505,20054,15161,5721
2021-04-08 23:00:00+00,6009,0,4885,14274,489,708,1441,137,0,0,27943,96,21089,19648,14763,6009
2021-04-08 23:30:00+00,6029,0,4895,13892,489,706,1445,137,0,0,27593,97,20721,19276,14381,6029
2021-04-09 00:00:00+00,5827,0,4889,13532,473,706,1462,141,0,0,27030,96,20356,18894,14005,5827
2021-04-09 00:30:00+00,6658,0,4886,12491,472,706,1464,141,0,0,26818,109,19313,17849,12963,6658
2021-04-09 01:00:00+00,6838,0,4891,12099,450,1346,1437,215,0,0,27276,112,18877,17440,12549,6838
2021-04-09 01:30:00+00,6829,0,4886,11843,446,1374,1442,198,0,0,27017,113,18617,17175,12289,6829
2021-04-09 02:00:00+00,6933,0,4895,11352,444,1890,1464,142,0,0,27120,114,18155,16691,11796,6933
2021-04-09 02:30:00+00,7108,0,4889,10885,443,1908,1452,140,0,0,26825,118,17669,16217,11328,7108
2021-04-09 03:00:00+00,7311,0,4902,10385,443,1636,1446,139,0,0,26262,123,17176,15730,10828,7311
2021-04-09 03:30:00+00,7431,0,4897,9655,444,1632,1467,143,0,0,25669,128,16463,14996,10099,7431
2021-04-09 04:00:00+00,7818,0,4911,9203,477,2442,1446,138,0,0,26435,131,16037,14591,9680,7818
2021-04-09 04:30:00+00,8245,0,4926,8796,496,2480,1478,137,0,0,26559,137,15696,14218,9292,8245
2021-04-09 05:00:00+00,9116,0,4922,8474,619,2152,1841,139,0,134,27398,147,15856,14015,9093,9116
2021-04-09 05:30:00+00,10147,0,4922,7912,661,2150,2174,137,107,0,28210,159,15776,13602,8680,10147
2021-04-09 06:00:00+00,11601,0,4920,7367,621,2202,2374,176,503,60,29824,171,15785,13411,8491,11601
2021-04-09 06:30:00+00,12936,0,4926,6736,693,2268,2394,310,1076,974,32313,176,15825,13431,8505,12936
2021-04-09 07:00:00+00,14076,0,4920,6267,715,3496,2400,227,1723,1050,34874,176,16025,13625,8705,14076
2021-04-09 07:30:00+00,14815,0,4922,5889,642,3642,2396,225,2522,748,35801,180,16371,13975,9053,14815
2021-04-09 08:00:00+00,15420,0,4926,5766,625,3988,2397,345,3299,332,37097,182,17012,14616,9690,15420
2021-04-09 08:30:00+00,15861,0,4933,5759,583,3996,2399,363,4105,302,38301,181,17779,15380,10447,15861
2021-04-09 09:00:00+00,16214,0,4930,5640,574,3996,2418,311,4432,372,38888,181,17994,15576,10646,16214
2021-04-09 09:30:00+00,16494,0,4932,5569,580,3994,2413,246,4611,28,38867,183,18105,15692,10760,16494
2021-04-09 10:00:00+00,16789,0,4936,5473,550,3996,2400,281,5014,116,39555,184,18373,15973,11037,16789
2021-04-09 10:30:00+00,17016,0,4934,4562,550,3998,2403,305,5135,10,38912,189,17584,15181,10247,17016
2021-04-09 11:00:00+00,17285,0,4937,4470,492,3996,2413,312,5318,250,39473,189,17630,15216,10280,17285
2021-04-09 11:30:00+00,17467,0,4934,4417,489,3998,2416,362,5222,288,39593,191,17478,15062,10128,17467
2021-04-09 12:00:00+00,17451,0,4932,4540,490,3998,2333,350,4996,30,39120,193,17291,14958,10026,17451
2021-04-09 12:30:00+00,17385,0,4928,4645,497,3996,2270,304,4825,0,38850,193,17165,14895,9967,17385
2021-04-09 13:00:00+00,17418,0,4921,4618,504,3998,2290,329,4811,0,38889,193,17144,14854,9933,17418
2021-04-09 13:30:00+00,16877,0,4923,4728,511,3994,2364,315,4706,0,38418,190,17232,14868,9945,16877
2021-04-09 14:00:00+00,17247,0,4919,4706,526,3992,2387,176,3925,0,37878,195,16463,14076,9157,17247
2021-04-09 14:30:00+00,17413,0,4920,4674,528,3998,2415,228,3428,0,37604,199,15965,13550,8630,17413
2021-04-09 15:00:00+00,17115,0,4925,4787,547,4018,2341,240,2991,0,36964,200,15591,13250,8325,17115
2021-04-09 15:30:00+00,17570,0,4918,4739,557,4018,2416,261,2532,94,37105,204,15162,12746,7828,17570
2021-04-09 16:00:00+00,17715,0,4920,4583,677,4018,2431,376,1983,780,37483,204,14594,12163,7243,17715
2021-04-09 16:30:00+00,17820,0,4926,4628,684,4018,2428,363,1514,1308,37689,204,14180,11752,6826,17820
2021-04-09 17:00:00+00,18064,0,4928,4700,685,4019,2434,424,971,1126,37351,209,13718,11284,6356,18064
2021-04-09 17:30:00+00,18218,0,4929,4568,683,4020,2437,419,531,1222,37027,213,13148,10711,5782,18218
2021-04-09 18:00:00+00,18256,0,4933,4255,683,3588,2433,391,184,1458,36181,217,12488,10055,5122,18256
2021-04-09 18:30:00+00,18291,0,4933,4232,675,3529,2437,366,14,1176,35654,221,12291,9854,4921,18291
2021-04-09 19:00:00+00,18244,0,4926,4116,625,4019,2433,375,0,1116,35854,220,12100,9667,4741,18244
2021-04-09 19:30:00+00,18106,0,4927,4128,614,4013,2434,337,0,1098,35657,219,12103,9669,4742,18106
2021-04-09 20:00:00+00,17954,0,4930,4169,525,3915,2433,312,0,380,34618,223,12057,9624,4694,17954
2021-04-09 20:30:00+00,17263,0,4933,4332,493,3910,2405,226,0,102,33664,220,12163,9758,4825,17263
2021-04-09 21:00:00+00,16739,0,4929,4308,487,3160,2100,142,0,4,31869,223,11824,9724,4795,16739
2021-04-09 21:30:00+00,15799,0,4918,4172,505,3154,1786,145,0,0,30479,220,11381,9595,4677,15799
2021-04-09 22:00:00+00,13659,0,4920,3963,486,3812,1787,143,0,0,28770,206,11156,9369,4449,13659
2021-04-09 22:30:00+00,13466,0,4920,3856,486,3812,1788,143,0,0,28471,205,11050,9262,4342,13466
2021-04-09 23:00:00+00,13274,0,4924,3581,460,3104,1780,143,0,0,27266,209,10745,8965,4041,13274
2021-04-09 23:30:00+00,12887,0,4920,3317,440,3063,1789,145,0,0,26561,208,10466,8677,3757,12887
2021-04-10 00:00:00+00,12418,0,4921,3018,422,3702,1788,142,0,0,26410,204,10149,8361,3440,12418
2021-04-10 00:30:00+00,12976,0,4924,2930,422,3702,1787,143,0,0,26884,208,10063,8276,3352,12976
2021-04-10 01:00:00+00,12912,0,4925,2783,422,3702,1781,143,0,0,26668,209,9911,8130,3205,12912
2021-04-10 01:30:00+00,12884,0,4927,2806,422,3702,1781,144,0,0,26666,209,9936,8155,3228,12884
2021-04-10 02:00:00+00,12782,0,4930,2719,418,3702,1768,145,0,0,26464,209,9835,8067,3137,12782
2021-04-10 02:30:00+00,12686,0,4934,2687,418,3702,1790,143,0,0,26360,208,9829,8039,3105,12686
2021-04-10 03:00:00+00,12738,0,4930,2573,416,3688,1790,145,0,0,26280,210,9709,7919,2989,12738
2021-04-10 03:30:00+00,12648,0,4935,2537,416,3688,1789,143,0,0,26156,209,9677,7888,2953,12648
2021-04-10 04:00:00+00,12731,0,4930,2614,416,3588,1788,144,0,0,26211,210,9748,7960,3030,12731
2021-04-10 04:30:00+00,12814,0,4929,2631,436,3588,1788,144,0,0,26330,210,9784,7996,3067,12814
2021-04-10 05:00:00+00,12532,0,4932,2679,448,3672,1783,144,0,0,26190,207,9842,8059,3127,12532
2021-04-10 05:30:00+00,12877,0,4925,2780,479,3672,1789,144,54,0,26720,208,10027,8238,3313,12877
2021-04-10 06:00:00+00,13880,0,4924,2686,503,3964,1776,148,352,22,28255,211,10241,8465,3541,13880
2021-04-10 06:30:00+00,14924,0,4929,2707,502,3968,1779,147,815,0,29771,214,10732,8953,4024,14924
2021-04-10 07:00:00+00,15581,0,4920,2690,502,3994,1787,285,1341,92,31192,214,11240,9453,4533,15581
2021-04-10 07:30:00+00,15951,0,4928,2837,535,3996,1741,302,1894,286,32470,210,11935,10194,5266,15951
2021-04-10 08:00:00+00,16137,0,4926,2934,534,3996,1778,302,2419,192,33218,208,12591,10813,5887,16137
2021-04-10 08:30:00+00,16330,0,4923,3044,561,3996,1782,170,2944,128,33878,205,13254,11472,6549,16330
2021-04-10 09:00:00+00,16151,0,4926,3287,562,3996,1782,159,3486,292,34641,198,14043,12261,7335,16151
2021-04-10 09:30:00+00,16128,0,4929,3361,562,3998,1748,190,3709,246,34871,197,14309,12561,7632,16128
2021-04-10 10:00:00+00,16502,0,4929,3323,564,3998,1788,228,3974,0,35306,199,14578,12790,7861,16502
2021-04-10 10:30:00+00,16547,0,4930,3410,533,3997,1787,192,4516,58,35970,196,15176,13389,8459,16547
2021-04-10 11:00:00+00,16400,0,4932,3579,503,3997,1781,182,4858,220,36452,191,15653,13872,8940,16400
2021-04-10 11:30:00+00,16356,0,4930,3529,500,3994,1789,182,4869,0,36150,193,15617,13828,8898,16356
2021-04-10 12:00:00+00,15877,0,4937,3736,502,3996,1786,182,4422,0,35438,191,15383,13597,8660,15877
2021-04-10 12:30:00+00,15192,0,4932,3922,473,3996,1785,182,3903,0,34385,189,15015,13230,8298,15192
2021-04-10 13:00:00+00,15001,0,4931,4168,475,3994,1782,183,3824,0,34358,187,15180,13398,8467,15001
2021-04-10 13:30:00+00,14353,0,4928,4521,484,3994,1783,182,3849,0,34094,181,15565,13782,8854,14353
2021-04-10 14:00:00+00,14393,0,4924,4601,485,3698,1777,183,3714,32,33807,183,15501,13724,8800,14393
2021-04-10 14:30:00+00,14491,0,4923,4735,488,3682,1783,183,3270,0,33555,185,15199,13416,8493,14491
2021-04-10 15:00:00+00,15034,0,4921,4880,522,3525,1783,192,2870,0,33727,190,14976,13193,8272,15034
2021-04-10 15:30:00+00,15987,0,4924,5075,521,3522,1783,266,2254,24,34356,198,14557,12774,7850,15987
2021-04-10 16:00:00+00,16105,0,4930,5149,580,3912,1778,295,1750,98,34597,199,14187,12409,7479,16105
2021-04-10 16:30:00+00,16306,0,4927,5388,581,3914,1780,291,1216,326,34729,201,13892,12112,7185,16306
2021-04-10 17:00:00+00,16420,0,4924,5488,590,4014,1782,320,807,768,35113,201,13591,11809,6885,16420
2021-04-10 17:30:00+00,16552,0,4926,5449,593,4014,1782,369,415,748,34848,204,13165,11383,6457,16552
2021-04-10 18:00:00+00,16587,0,4919,5427,594,3589,1782,488,149,812,34347,208,12871,11089,6170,16587
2021-04-10 18:30:00+00,16636,0,4924,5158,594,3536,1784,551,12,770,33965,212,12472,10688,5764,16636
2021-04-10 19:00:00+00,16415,0,4923,5221,596,4029,1783,517,0,594,34078,208,12523,10740,5817,16415
2021-04-10 19:30:00+00,16399,0,4920,5112,595,4026,1783,461,0,254,33550,211,12410,10627,5707,16399
2021-04-10 20:00:00+00,16233,0,4926,4948,573,3604,1784,373,0,316,32757,213,12231,10447,5521,16233
2021-04-10 20:30:00+00,15742,0,4925,4857,558,3597,1779,247,0,0,31705,212,12119,10340,5415,15742
2021-04-10 21:00:00+00,14894,0,4917,4810,485,3644,1782,179,0,60,30771,207,11994,10212,5295,14894
2021-04-10 21:30:00+00,13929,0,4913,4661,484,3649,1782,177,0,136,29731,202,11840,10058,5145,13929
2021-04-10 22:00:00+00,12440,0,4906,4504,450,3642,1782,144,0,18,27886,194,11642,9860,4954,12440
2021-04-10 22:30:00+00,11621,0,4909,4300,448,3664,1782,143,0,0,26867,190,11439,9657,4748,11621
2021-04-10 23:00:00+00,11536,0,4911,4035,416,3657,1779,143,0,0,26477,191,11141,9362,4451,11536
2021-04-10 23:30:00+00,11466,0,4908,3801,415,3630,1777,143,0,0,26140,192,10901,9124,4216,11466
2021-04-11 00:00:00+00,11386,0,4909,3608,414,3622,1773,143,0,0,25855,191,10704,8931,4022,11386
2021-04-11 00:30:00+00,12014,0,4941,3624,419,3604,1775,174,0,0,26551,195,10759,8984,4043,12014
2021-04-11 01:00:00+00,11761,0,4952,3722,427,3604,1775,223,0,0,26464,193,10876,9101,4149,11761
2021-04-11 01:30:00+00,11590,0,4946,3865,420,3604,1777,187,0,0,26389,190,11008,9231,4285,11590
2021-04-11 02:00:00+00,11663,0,4953,3910,412,3602,1785,174,0,0,26499,191,11060,9275,4322,11663
2021-04-11 02:30:00+00,11338,0,4970,4064,412,3602,1788,158,0,0,26332,187,11234,9446,4476,11338
2021-04-11 03:00:00+00,11110,0,5020,4294,412,3596,1783,143,0,0,26358,183,11509,9726,4706,11110
2021-04-11 03:30:00+00,10680,0,5037,4547,411,3596,1780,143,0,0,26194,177,11775,9995,4958,10680
2021-04-11 04:00:00+00,10279,0,5052,4670,411,3534,1774,142,0,0,25862,173,11907,10133,5081,10279
2021-04-11 04:30:00+00,10075,0,5056,4958,411,3535,1785,143,0,0,25964,169,12210,10425,5369,10075
2021-04-11 05:00:00+00,10219,0,5061,5000,421,3801,1785,145,0,0,26432,169,12267,10482,5421,10219
2021-04-11 05:30:00+00,11005,0,5056,4857,439,3805,1773,143,123,0,27201,176,12248,10475,5419,11005
2021-04-11 06:00:00+00,11380,0,5050,4745,500,3942,1792,146,598,0,28154,176,12685,10893,5843,11380
2021-04-11 06:30:00+00,11177,0,5054,4824,506,3944,1872,146,1293,0,28816,169,13549,11677,6623,11177
2021-04-11 07:00:00+00,11540,0,5047,4685,541,3994,2126,145,2136,0,30214,167,14535,12409,7362,11540
2021-04-11 07:30:00+00,11535,0,5045,4367,539,3994,2388,144,3023,0,31035,164,15362,12974,7929,11535
2021-04-11 08:00:00+00,12204,0,5050,4071,488,3848,2408,145,3894,0,32108,166,15911,13503,8453,12204
2021-04-11 08:30:00+00,12461,0,5054,4002,520,3846,2404,146,4528,0,32961,165,16508,14104,9050,12461
2021-04-11 09:00:00+00,12770,0,5091,3871,538,3954,2399,145,5027,0,33795,165,16926,14527,9436,12770
2021-04-11 09:30:00+00,12747,0,5080,3967,537,3954,2240,144,5356,0,34025,163,17180,14940,9860,12747
2021-04-11 10:00:00+00,12874,0,5084,3783,522,3862,2317,147,5828,142,34559,162,17534,15217,10133,12874
2021-04-11 10:30:00+00,13393,0,5085,3630,522,3862,2410,167,5909,78,35056,166,17556,15146,10061,13393
2021-04-11 11:00:00+00,13517,0,5092,3632,523,3878,2412,246,6135,0,35435,166,17794,15382,10290,13517
2021-04-11 11:30:00+00,13515,0,5091,3581,506,3880,2398,285,6319,0,35575,166,17895,15497,10406,13515
2021-04-11 12:00:00+00,13298,0,5101,3745,481,3996,2303,342,6129,86,35481,164,17759,15456,10355,13298
2021-04-11 12:30:00+00,12835,0,5093,3855,471,3996,2292,208,6158,42,34950,160,17869,15577,10484,12835
2021-04-11 13:00:00+00,13068,0,5121,3789,478,3996,2174,220,6089,90,35025,162,17651,15477,10356,13068
2021-04-11 13:30:00+00,12232,0,5137,4269,485,3990,2087,277,5675,0,34152,157,17653,15566,10429,12232
2021-04-11 14:00:00+00,12499,0,5135,4434,479,3860,2176,162,5335,0,34080,159,17558,15382,10248,12499
2021-04-11 14:30:00+00,12575,0,5132,4668,482,3858,2185,148,4756,198,34002,161,17223,15038,9906,12575
2021-04-11 15:00:00+00,13648,0,5125,4422,506,4010,2230,150,4090,260,34441,171,16373,14143,9018,13648
2021-04-11 15:30:00+00,14957,0,5137,4710,529,4016,2391,148,3676,204,35768,180,16443,14052,8915,14957
2021-04-11 16:00:00+00,15907,0,5176,4613,626,4034,2407,223,2951,148,36085,189,15773,13366,8190,15907
2021-04-11 16:30:00+00,16893,0,5192,4226,626,4044,2331,267,2383,386,36348,199,14758,12427,7235,16893
2021-04-11 17:00:00+00,17192,0,5196,3933,665,4056,2293,357,1683,750,36125,205,13770,11477,6281,17192
2021-04-11 17:30:00+00,17552,0,5196,3442,666,4052,2220,367,1019,892,35406,213,12543,10323,5127,17552
2021-04-11 18:00:00+00,17855,0,5200,2985,659,4128,2284,383,430,968,34892,221,11558,9274,4074,17855
2021-04-11 18:30:00+00,18063,0,5200,2721,659,4102,2317,390,50,884,34386,226,10947,8630,3430,18063
2021-04-11 19:00:00+00,18043,0,5203,2720,597,4060,2330,425,0,1328,34706,224,10850,8520,3317,18043
2021-04-11 19:30:00+00,18166,0,5204,2809,595,4014,2330,424,0,972,34514,226,10938,8608,3404,18166
2021-04-11 20:00:00+00,18258,0,5207,2525,587,3994,2414,439,0,366,33790,232,10733,8319,3112,18258
2021-04-11 20:30:00+00,17386,0,5258,2341,576,3996,2420,344,0,98,32419,230,10595,8175,2917,17386
2021-04-11 21:00:00+00,16360,0,5280,2394,504,4072,2406,213,0,106,31335,225,10584,8178,2898,16360
2021-04-11 21:30:00+00,14964,0,5262,2349,533,4110,2425,138,0,0,29781,218,10569,8144,2882,14964
2021-04-11 22:00:00+00,13213,0,5265,2293,512,4020,2368,138,0,0,27809,207,10438,8070,2805,13213
2021-04-11 22:30:00+00,12185,0,5267,2416,489,3996,2315,137,0,0,26805,198,10487,8172,2905,12185
2021-04-11 23:00:00+00,11592,0,5277,2594,436,3872,2317,139,0,0,26227,194,10624,8307,3030,11592
2021-04-11 23:30:00+00,11116,0,5297,2544,435,3870,2321,137,0,0,25720,190,10597,8276,2979,11116
2021-04-12 00:00:00+00,11269,0,5310,2550,419,3974,2304,137,0,0,25963,195,10583,8279,2969,11269
2021-04-12 00:30:00+00,11520,0,5327,2784,416,3978,2351,137,0,0,26512,195,10878,8527,3200,11520
2021-04-12 01:00:00+00,11599,0,5324,3003,399,3970,2364,138,0,0,26797,194,11090,8726,3402,11599
2021-04-12 01:30:00+00,11556,0,5330,3357,398,3968,2343,136,0,0,27088,191,11428,9085,3755,11556
2021-04-12 02:00:00+00,11649,0,5409,3053,399,3512,2352,141,0,0,26516,196,11213,8861,3452,11649
2021-04-12 02:30:00+00,11790,0,5445,2768,399,3476,2346,142,0,0,26365,199,10958,8612,3167,11790
2021-04-12 03:00:00+00,11945,4,5458,2915,399,2954,2344,140,0,0,26159,202,11116,8772,3314,11949
2021-04-12 03:30:00+00,11992,39,5469,2789,405,2824,2339,147,0,0,26005,205,11002,8663,3194,12031
2021-04-12 04:00:00+00,12346,161,5467,2777,438,1120,2331,318,0,0,24958,222,11013,8682,3215,12507
2021-04-12 04:30:00+00,12653,416,5474,2944,401,980,2330,297,0,0,25495,231,11149,8819,3345,13069
2021-04-12 05:00:00+00,13403,730,5503,2729,427,264,2339,294,0,130,25820,247,10998,8659,3156,14133
2021-04-12 05:30:00+00,14417,937,5502,2618,662,74,2335,302,96,494,27437,255,11213,8878,3376,15354
2021-04-12 06:00:00+00,15891,1285,5505,2809,807,558,2326,328,438,510,30457,263,11885,9559,4054,17176
2021-04-12 06:30:00+00,17099,1428,5498,2448,825,568,2329,363,968,1654,33180,261,12068,9739,4241,18527
2021-04-12 07:00:00+00,18209,1486,5516,2141,861,1496,2322,393,1584,1680,35688,260,12424,10102,4586,19695
2021-04-12 07:30:00+00,18840,1484,5528,2172,881,1724,2288,389,2273,1844,37422,254,13142,10854,5326,20324
2021-04-12 08:00:00+00,19274,1489,5531,2338,833,2498,2266,399,3019,812,38459,253,13987,11721,6190,20763
2021-04-12 08:30:00+00,19548,1462,5537,2217,738,2496,2269,401,3715,494,38878,252,14476,12207,6670,21010
2021-04-12 09:00:00+00,19705,1429,5553,2259,510,2630,2261,400,4315,266,39327,250,14898,12637,7084,21134
2021-04-12 09:30:00+00,19735,1434,5575,2324,477,2632,2274,385,5156,0,39991,245,15806,13532,7957,21169
2021-04-12 10:00:00+00,19872,1425,5577,2392,450,2454,2302,361,5677,94,40604,242,16398,14096,8519,21297
2021-04-12 10:30:00+00,20052,1436,5623,2381,449,2442,2309,316,6151,0,41159,241,16913,14604,8981,21488
2021-04-12 11:00:00+00,19988,1446,5641,2286,434,2392,2311,336,6477,150,41461,239,17149,14838,9197,21434
2021-04-12 11:30:00+00,19887,1446,5648,2392,418,2382,2307,268,6685,0,41433,237,17450,15143,9495,21333
2021-04-12 12:00:00+00,19705,1447,5629,2323,367,2394,2305,262,6748,0,41180,237,17372,15067,9438,21152
2021-04-12 12:30:00+00,18913,1464,5634,2331,367,2392,2298,250,6432,0,40081,236,17062,14764,9130,20377
2021-04-12 13:00:00+00,18697,1337,5633,2535,373,1996,2299,250,6291,0,39411,234,17131,14832,9199,20034
2021-04-12 13:30:00+00,18832,1248,5628,2534,377,1858,2302,278,6011,0,39068,235,16852,14550,8922,20080
2021-04-12 14:00:00+00,18973,1017,5627,2207,378,2552,2304,230,5441,0,38729,234,15957,13653,8026,19990
2021-04-12 14:30:00+00,19522,1010,5625,2297,381,2554,2302,220,5098,0,39009,237,15703,13401,7776,20532
2021-04-12 15:00:00+00,19320,1009,5617,2462,456,2788,2295,256,4498,88,38789,237,15328,13033,7416,20329
2021-04-12 15:30:00+00,19331,1066,5632,2577,496,2788,2284,319,4008,92,38593,240,14997,12713,7081,20397
2021-04-12 16:00:00+00,19223,1090,5650,2546,710,3022,2285,326,3213,1152,39217,237,14404,12119,6469,20313
2021-04-12 16:30:00+00,19269,1090,5652,2452,897,3024,2290,364,2565,1456,39059,240,13856,11566,5914,20359
2021-04-12 17:00:00+00,19558,1065,5680,2356,921,3024,2290,346,1861,1674,38775,244,13108,10818,5138,20623
2021-04-12 17:30:00+00,19813,1156,5681,2237,920,3024,2287,277,1135,1690,38220,252,12260,9973,4292,20969
2021-04-12 18:00:00+00,19713,1208,5683,1989,696,3024,2289,287,485,1924,37298,258,11142,8853,3170,20921
2021-04-12 18:30:00+00,19553,1334,5679,1767,760,3024,2290,275,64,2066,36812,263,10560,8270,2591,20887
2021-04-12 19:00:00+00,20126,1484,5679,1503,696,3024,2290,285,0,2010,37097,272,10168,7878,2199,21610
2021-04-12 19:30:00+00,20184,1483,5689,1375,688,3024,2273,302,0,1886,36904,274,10025,7752,2063,21667
2021-04-12 20:00:00+00,20316,1491,5698,1307,585,3004,2183,295,0,1186,36065,281,9773,7590,1892,21807
2021-04-12 20:30:00+00,19739,1493,5715,1175,500,3004,2145,277,0,626,34674,284,9535,7390,1675,21232
2021-04-12 21:00:00+00,18476,1488,5721,1140,479,2880,2109,206,0,308,32807,283,9449,7340,1619,19964
2021-04-12 21:30:00+00,17759,1312,5724,1171,412,2850,2106,170,0,4,31508,279,9413,7307,1583,19071
2021-04-12 22:00:00+00,18196,1010,5725,1062,376,2156,2132,148,0,0,30805,280,9295,7163,1438,19206
2021-04-12 22:30:00+00,17408,973,5730,978,374,2126,2216,137,0,0,29942,277,9298,7082,1352,18381
2021-04-12 23:00:00+00,17242,849,5725,918,350,1810,2226,138,0,0,29258,277,9219,6993,1268,18091
2021-04-12 23:30:00+00,16894,791,5719,882,329,1802,2263,139,0,0,28819,274,9193,6930,1211,17685
2021-04-13 00:00:00+00,16858,824,5720,902,327,1900,2260,138,0,0,28929,274,9209,6949,1229,17682
2021-04-13 00:30:00+00,17080,907,5724,955,327,1902,2263,139,0,0,29297,276,9269,7006,1282,17987
2021-04-13 01:00:00+00,16749,861,5735,1005,327,2378,2251,139,0,0,29445,270,9318,7067,1332,17610
2021-04-13 01:30:00+00,16712,730,5737,1032,327,2386,2247,140,0,0,29311,266,9343,7096,1359,17442
2021-04-13 02:00:00+00,16839,793,5738,945,308,1998,2245,139,0,0,29005,271,9236,6991,1253,17632
2021-04-13 02:30:00+00,16938,849,5743,912,308,1974,2237,139,0,0,29100,273,9200,6963,1220,17787
2021-04-13 03:00:00+00,17295,919,5751,849,307,1304,2248,139,0,0,28812,282,9155,6907,1156,18214
2021-04-13 03:30:00+00,17584,939,5757,805,308,1260,2248,140,0,0,29041,284,9118,6870,1113,18523
2021-04-13 04:00:00+00,17817,1068,5756,781,326,594,2246,155,0,0,28743,293,9109,6863,1107,18885
2021-04-13 04:30:00+00,18151,1307,5764,776,372,584,2189,172,0,0,29315,300,9101,6912,1148,19458
2021-04-13 05:00:00+00,18689,1387,5774,741,480,1328,2202,210,0,0,30811,299,9197,6995,1221,20076
2021-04-13 05:30:00+00,19579,1480,5775,731,519,1354,2208,257,307,0,32210,301,9540,7332,1557,21059
2021-04-13 06:00:00+00,20720,1491,5777,664,560,1802,2208,368,972,284,34846,294,10181,7973,2196,22211
2021-04-13 06:30:00+00,20864,1490,5772,580,581,1974,2209,391,1855,948,36664,281,10997,8788,3016,22354
2021-04-13 07:00:00+00,20905,1492,5772,530,582,2544,2210,399,2617,1166,38217,271,11711,9501,3729,22397
2021-04-13 07:30:00+00,20826,1488,5783,504,570,2620,2207,411,3673,964,39046,264,12737,10530,4747,22314
2021-04-13 08:00:00+00,20767,1488,5777,478,498,3002,2227,372,4803,476,39888,258,13783,11556,5779,22255
2021-04-13 08:30:00+00,20701,1488,5778,466,495,3004,2228,365,5635,240,40400,254,14602,12374,6596,22189
2021-04-13 09:00:00+00,20320,1488,5798,445,476,3004,2228,289,6370,224,40642,249,15317,13089,7291,21808
2021-04-13 09:30:00+00,19796,1490,5800,424,449,3004,2221,233,7089,164,40670,243,15983,13762,7962,21286
2021-04-13 10:00:00+00,19628,1488,5798,433,427,2698,2225,182,7397,36,40312,242,16280,14055,8257,21116
2021-04-13 10:30:00+00,19313,1490,5648,458,422,2666,2289,182,7462,0,39930,241,16279,13990,8342,20803
2021-04-13 11:00:00+00,19488,1490,5803,480,408,2722,2310,226,7025,122,40074,242,16026,13716,7913,20978
2021-04-13 11:30:00+00,19429,1491,5799,530,393,2716,2312,223,6735,0,39628,244,15769,13457,7658,20920
2021-04-13 12:00:00+00,19307,1490,5797,588,358,2898,2306,154,6609,24,39531,243,15658,13352,7555,20797
2021-04-13 12:30:00+00,18980,1489,5805,681,357,2898,2300,141,6363,0,39014,242,15506,13206,7401,20469
2021-04-13 13:00:00+00,18851,1491,5817,764,359,2902,2344,185,6001,0,38714,244,15285,12941,7124,20342
2021-04-13 13:30:00+00,18762,1490,5837,857,362,2902,2353,193,5524,0,38280,246,14933,12580,6743,20252
2021-04-13 14:00:00+00,19021,1480,5834,1027,397,2854,2353,215,5078,0,38259,248,14689,12336,6502,20501
2021-04-13 14:30:00+00,19133,1492,5836,1213,425,2856,2354,224,4370,0,37903,252,14198,11844,6008,20625
2021-04-13 15:00:00+00,19097,1489,5840,1346,497,3022,2354,320,3700,0,37665,256,13737,11383,5543,20586
2021-04-13 15:30:00+00,19375,1289,5847,1366,622,3024,2411,381,3420,398,38133,251,13666,11255,5408,20664
2021-04-13 16:00:00+00,19595,1283,5856,1308,803,3024,2412,461,2789,1086,38617,252,13168,10756,4900,20878
2021-04-13 16:30:00+00,19652,1442,5867,1199,869,3024,2390,428,2284,1486,38641,256,12609,10219,4352,21094
2021-04-13 17:00:00+00,20101,1486,5879,1088,888,3070,2392,475,1580,1528,38487,263,11827,9435,3556,21587
2021-04-13 17:30:00+00,20186,1490,5892,1009,863,3065,2390,487,907,1618,37908,268,11061,8671,2779,21676
2021-04-13 18:00:00+00,20343,1354,5888,942,843,3096,2410,477,343,1654,37349,270,10426,8016,2128,21697
2021-04-13 18:30:00+00,20685,1310,5887,844,754,3120,2414,445,40,1846,37345,273,9939,7525,1638,21995
2021-04-13 19:00:00+00,20641,1284,5892,814,713,3103,2409,450,0,1570,36876,275,9828,7419,1527,21925
2021-04-13 19:30:00+00,20558,1257,5898,826,708,3062,2415,448,0,1328,36500,276,9847,7432,1534,21815
2021-04-13 20:00:00+00,20417,1305,5916,702,632,2951,2411,470,0,498,35302,284,9661,7250,1334,21722
2021-04-13 20:30:00+00,20054,1365,5924,622,517,2946,2408,317,0,58,34211,287,9471,7063,1139,21419
2021-04-13 21:00:00+00,19286,1424,5938,554,434,2710,2372,188,0,158,33064,287,9298,6926,988,20710
2021-04-13 21:30:00+00,17887,1463,5941,525,533,2706,2364,138,0,0,31557,284,9363,6999,1058,19350
2021-04-13 22:00:00+00,18006,1474,5936,505,513,2705,2366,138,0,0,31643,285,9320,6954,1018,19480
2021-04-13 22:30:00+00,17821,1309,5947,488,493,2716,2366,137,0,0,31276,281,9294,6928,981,19130
2021-04-13 23:00:00+00,17597,875,5958,487,447,2835,2337,137,0,0,30673,271,9229,6892,934,18472
2021-04-13 23:30:00+00,17661,691,5964,489,427,2846,2243,138,0,0,30459,268,9123,6880,916,18352
2021-04-14 00:00:00+00,17082,704,5960,493,431,2832,2246,138,0,0,29886,266,9130,6884,924,17786
2021-04-14 00:30:00+00,17333,856,5960,518,432,2839,2249,138,0,0,30324,270,9159,6910,950,18189
2021-04-14 01:00:00+00,17500,863,5955,561,382,2869,2252,138,0,0,30520,271,9150,6898,943,18363
2021-04-14 01:30:00+00,17512,700,5961,592,372,2873,2253,138,0,0,30401,267,9178,6925,964,18212
2021-04-14 02:00:00+00,17300,691,5961,583,372,2860,2249,138,0,0,30153,266,9165,6916,955,17991
2021-04-14 02:30:00+00,17269,697,5962,629,370,2862,2253,137,0,0,30179,266,9214,6961,999,17966
2021-04-14 03:00:00+00,17787,697,5964,691,361,2702,2252,137,0,0,30591,268,9268,7016,1052,18484
2021-04-14 03:30:00+00,17603,1004,5965,756,363,2698,2252,138,0,0,30779,273,9336,7084,1119,18607
2021-04-14 04:00:00+00,17964,1453,5966,828,378,2301,2253,138,0,0,31281,285,9425,7172,1206,19417
2021-04-14 04:30:00+00,18807,1461,5970,874,379,2292,2248,144,0,0,32176,288,9471,7223,1253,20268
2021-04-14 05:00:00+00,19635,1070,5897,904,392,2316,2248,173,9,0,32645,284,9450,7202,1305,20705
2021-04-14 05:30:00+00,20201,1079,5756,916,429,2318,2252,192,235,142,33520,283,9588,7336,1580,21280
2021-04-14 06:00:00+00,20322,1326,5616,885,595,2710,2249,269,830,488,35290,279,10175,7926,2310,21648
2021-04-14 06:30:00+00,20716,1484,5440,846,663,2725,2248,465,1550,838,36975,276,10747,8499,3059,22200
2021-04-14 07:00:00+00,20889,1487,5299,877,577,2800,2250,418,2372,562,37531,274,11375,9125,3826,22376
2021-04-14 07:30:00+00,20933,1474,5294,952,578,2807,2247,413,3350,170,38218,269,12421,10174,4880,22407
2021-04-14 08:00:00+00,20717,1487,5276,898,511,2894,2251,350,4616,286,39286,260,13552,11301,6025,22204
2021-04-14 08:30:00+00,20548,1474,5305,918,508,2899,2246,327,5597,0,39822,254,14574,12328,7023,22022
2021-04-14 09:00:00+00,19594,1461,5343,1052,461,2927,2282,228,6230,0,39577,245,15368,13086,7743,21055
2021-04-14 09:30:00+00,18887,1299,5358,1196,430,2936,2277,183,6824,0,39390,235,16085,13808,8450,20186
2021-04-14 10:00:00+00,19005,1065,5354,1124,417,2945,2269,190,7329,0,39698,228,16493,14224,8870,20070
2021-04-14 10:30:00+00,19031,1083,5356,1072,413,2958,2269,147,6899,0,39229,232,16009,13740,8384,20114
2021-04-14 11:00:00+00,19617,1013,5358,1087,382,2718,2267,202,6722,12,39378,235,15816,13549,8191,20630
2021-04-14 11:30:00+00,19699,1082,5347,1151,382,2732,2292,148,5950,0,38783,240,15122,12830,7483,20781
2021-04-14 12:00:00+00,19687,1090,5350,1201,345,2874,2292,139,5278,12,38268,244,14466,12174,6824,20777
2021-04-14 12:30:00+00,19660,1059,5351,1275,347,2882,2293,139,5465,10,38481,241,14731,12438,7087,20719
2021-04-14 13:00:00+00,19647,1159,5357,1296,365,2934,2292,139,5135,0,38324,245,14445,12153,6796,20806
2021-04-14 13:30:00+00,19639,987,5360,1335,366,2936,2290,140,4700,0,37753,244,14051,11761,6401,20626
2021-04-14 14:00:00+00,19420,1023,5363,1384,369,3002,2293,144,4660,0,37658,244,14069,11776,6413,20443
2021-04-14 14:30:00+00,19433,941,5367,1449,416,3002,2292,147,4259,0,37306,244,13783,11491,6124,20374
2021-04-14 15:00:00+00,19546,1031,5366,1501,526,2898,2300,221,4146,0,37535,247,13839,11539,6173,20577
2021-04-14 15:30:00+00,19707,1182,5362,1608,563,2896,2300,276,3688,0,37582,253,13521,11221,5859,20889
2021-04-14 16:00:00+00,20063,1213,5359,1716,644,3020,2298,361,3155,210,38039,255,13172,10874,5515,21276
2021-04-14 16:30:00+00,20003,1225,5357,1710,652,3022,2302,356,2476,896,37999,256,12497,10195,4838,21228
2021-04-14 17:00:00+00,19691,1232,5360,1746,669,2982,2299,422,1814,990,37205,258,11888,9589,4229,20923
2021-04-14 17:30:00+00,19727,1340,5359,1785,672,2990,2302,431,1093,914,36614,266,11211,8909,3550,21067
2021-04-14 18:00:00+00,19647,1354,5357,1814,671,3039,2299,429,456,1314,36380,267,10597,8298,2941,21001
2021-04-14 18:30:00+00,19762,1310,5357,1781,667,3048,2300,420,62,1178,35884,271,10167,7867,2510,21072
2021-04-14 19:00:00+00,19818,1229,5357,1824,602,2868,2301,436,0,1272,35707,271,10084,7783,2426,21047
2021-04-14 19:30:00+00,19776,1220,5358,1893,588,2839,2295,418,0,1376,35763,269,10134,7839,2481,20996
2021-04-14 20:00:00+00,19816,1211,5362,1880,493,2842,2298,351,0,410,34663,277,10033,7735,2373,21027
2021-04-14 20:30:00+00,19536,1066,5366,1922,453,2492,2298,241,0,376,33750,276,10039,7741,2375,20602
2021-04-14 21:00:00+00,18946,646,5365,1931,414,2526,2254,169,0,244,32495,265,9964,7710,2345,19592
2021-04-14 21:30:00+00,17844,187,5370,1919,399,2494,2294,155,0,72,30734,252,9982,7688,2318,18031
2021-04-14 22:00:00+00,17409,0,5372,1893,413,1582,2295,283,0,0,29247,253,9973,7678,2306,17409
2021-04-14 22:30:00+00,16801,0,5367,1925,375,1538,2272,188,0,0,28466,250,9939,7667,2300,16801
2021-04-14 23:00:00+00,16311,0,5374,1967,344,1578,2291,141,0,0,28006,247,9976,7685,2311,16311
2021-04-14 23:30:00+00,15942,0,5366,1954,345,1578,2298,142,0,0,27625,245,9963,7665,2299,15942
2021-04-15 00:00:00+00,16332,0,5365,1844,344,1492,2297,141,0,0,27815,249,9850,7553,2188,16332
2021-04-15 00:30:00+00,16836,0,5358,1867,343,1480,2298,140,0,0,28322,252,9866,7568,2210,16836
2021-04-15 01:00:00+00,16798,0,5356,1888,325,1740,2294,142,0,0,28543,249,9863,7569,2213,16798
2021-04-15 01:30:00+00,16575,0,5354,1883,325,1746,2276,141,0,0,28300,248,9838,7562,2208,16575
2021-04-15 02:00:00+00,16299,0,5357,1980,321,1682,2261,141,0,0,28041,247,9919,7658,2301,16299
2021-04-15 02:30:00+00,16162,0,5356,2014,318,1670,2269,140,0,0,27929,246,9957,7688,2332,16162
2021-04-15 03:00:00+00,16648,0,5360,1980,299,1018,2271,142,0,0,27718,253,9910,7639,2279,16648
2021-04-15 03:30:00+00,16708,68,5359,2125,300,890,2269,142,0,0,27861,254,10053,7784,2425,16776
2021-04-15 04:00:00+00,17999,136,5361,2330,315,24,2243,141,0,0,28549,264,10249,8006,2645,18135
2021-04-15 04:30:00+00,18366,422,5359,2426,315,48,2247,143,0,0,29326,272,10347,8100,2741,18788
2021-04-15 05:00:00+00,19229,861,5362,2571,360,14,2270,150,9,338,31164,280,10572,8302,2940,20090
2021-04-15 05:30:00+00,19831,1329,5365,2636,460,30,2272,250,281,586,33040,286,11014,8742,3377,21160
2021-04-15 06:00:00+00,20547,1477,5363,2664,591,161,2233,322,931,414,34703,285,11782,9549,4186,22024
2021-04-15 06:30:00+00,21204,1487,5367,2910,600,176,2268,376,1781,750,36919,276,12926,10658,5291,22691
2021-04-15 07:00:00+00,20885,1489,5365,2876,585,1456,2251,318,2684,264,38173,265,13761,11510,6145,22374
2021-04-15 07:30:00+00,20784,1487,5367,2906,568,1616,2183,283,3556,142,38892,259,14580,12397,7030,22271
2021-04-15 08:00:00+00,20049,1305,5369,3025,504,2140,2181,185,4352,116,39226,246,15431,13250,7881,21354
2021-04-15 08:30:00+00,19708,1032,5364,3079,484,2140,2167,172,5008,0,39154,236,16102,13935,8571,20740
2021-04-15 09:00:00+00,19439,854,5367,2968,440,2110,2135,170,5723,124,39330,228,16633,14498,9131,20293
2021-04-15 09:30:00+00,19082,693,5366,3069,416,2116,2141,168,6499,0,39550,219,17491,15350,9984,19775
2021-04-15 10:00:00+00,18710,688,5364,3090,372,1914,2191,163,7090,0,39582,214,18107,15916,10552,19398
2021-04-15 10:30:00+00,18543,692,5366,3085,373,1908,2225,145,7378,0,39715,212,18427,16202,10836,19235
2021-04-15 11:00:00+00,18584,688,5358,3084,343,2098,2222,147,7625,0,40149,209,18632,16410,11052,19272
2021-04-15 11:30:00+00,18762,688,5352,2833,342,2150,2182,143,7487,0,39939,212,18196,16014,10662,19450
2021-04-15 12:00:00+00,17802,691,5356,2749,307,2706,2195,142,7418,0,39366,208,18025,15830,10474,18493
2021-04-15 12:30:00+00,17513,690,5348,2772,307,2720,2177,143,7044,0,38714,208,17648,15471,10123,18203
2021-04-15 13:00:00+00,17501,690,5363,2767,307,2686,2174,141,6487,0,38116,211,17098,14924,9561,18191
2021-04-15 13:30:00+00,17550,689,5355,2635,308,2686,2133,145,6011,24,37536,215,16442,14309,8954,18239
2021-04-15 14:00:00+00,17924,519,5360,2685,310,2846,2126,143,5508,0,37421,216,15989,13863,8503,18443
2021-04-15 14:30:00+00,18588,291,5355,2796,329,2846,2126,142,4979,0,37452,217,15585,13459,8104,18879
2021-04-15 15:00:00+00,19533,257,5362,2801,370,2650,2125,183,4260,16,37557,225,14918,12793,7431,19790
2021-04-15 15:30:00+00,20186,376,5367,2898,484,2648,2125,220,3399,0,37703,234,14273,12148,6781,20562
2021-04-15 16:00:00+00,20614,452,5369,2956,683,2478,2143,244,2776,442,38157,238,13927,11784,6415,21066
2021-04-15 16:30:00+00,20772,458,5366,3047,684,2478,2125,279,2175,716,38100,240,13397,11272,5906,21230
2021-04-15 17:00:00+00,20819,456,5362,3006,683,2632,2145,284,1611,902,37900,243,12807,10662,5300,21275
2021-04-15 17:30:00+00,20855,431,5357,3049,694,2634,2116,288,1020,960,37404,246,12236,10120,4763,21286
2021-04-15 18:00:00+00,20851,437,5359,3019,694,2764,2076,290,534,1044,37068,249,11682,9606,4247,21288
2021-04-15 18:30:00+00,20866,465,5357,2991,649,2764,2077,277,95,1292,36833,251,11169,9092,3735,21331
2021-04-15 19:00:00+00,21008,430,5359,3018,590,2708,2075,256,0,924,36368,255,11042,8967,3608,21438
2021-04-15 19:30:00+00,21113,408,5357,2966,572,2704,2073,203,0,932,36328,255,10968,8895,3538,21521
2021-04-15 20:00:00+00,20811,443,5356,2876,438,2948,2067,197,0,492,35628,257,10737,8670,3314,21254
2021-04-15 20:30:00+00,20305,387,5360,2803,406,2950,2071,158,0,158,34598,257,10640,8569,3209,20692
2021-04-15 21:00:00+00,18629,47,5356,2713,408,2544,2073,146,0,532,32448,244,10550,8477,3121,18676
2021-04-15 21:30:00+00,16912,0,5361,2596,398,2536,2064,143,0,442,30452,236,10419,8355,2994,16912
2021-04-15 22:00:00+00,15934,0,5363,2583,398,2520,2097,143,0,0,29038,235,10441,8344,2981,15934
2021-04-15 22:30:00+00,14903,0,5366,2474,369,2550,2090,144,0,0,27896,230,10299,8209,2843,14903
2021-04-15 23:00:00+00,14634,0,5364,2460,332,2480,2087,144,0,0,27502,229,10243,8156,2792,14634
2021-04-15 23:30:00+00,14466,0,5356,2468,335,2490,2088,142,0,0,27345,228,10247,8159,2803,14466
2021-04-16 00:00:00+00,14555,0,5351,2515,336,2533,2092,141,0,0,27522,227,10294,8202,2851,14555
2021-04-16 00:30:00+00,14842,0,5348,2488,334,2668,2093,142,0,0,27915,230,10263,8170,2822,14842
2021-04-16 01:00:00+00,14905,0,5345,2395,317,2800,2089,141,0,0,27991,233,10146,8057,2712,14905
2021-04-16 01:30:00+00,14915,0,5337,2344,317,2724,2092,139,0,0,27868,232,10090,7998,2661,14915
2021-04-16 02:00:00+00,14697,0,5337,2295,316,2711,2110,141,0,0,27607,231,10058,7948,2611,14697
2021-04-16 02:30:00+00,14663,0,5339,2206,315,2773,2184,140,0,0,27620,232,10044,7860,2521,14663
2021-04-16 03:00:00+00,14811,0,5340,2163,294,2775,2184,141,0,0,27708,234,9981,7797,2457,14811
2021-04-16 03:30:00+00,14670,0,5344,2192,295,2765,2184,140,0,0,27590,233,10015,7831,2487,14670
2021-04-16 04:00:00+00,15354,70,5344,2214,326,2659,2289,142,0,0,28398,238,10173,7884,2540,15424
2021-04-16 04:30:00+00,15589,362,5351,2152,353,2701,2331,194,0,148,29181,246,10187,7856,2505,15951
2021-04-16 05:00:00+00,16473,857,5317,2136,416,2613,2465,250,23,176,30726,262,10357,7892,2575,17330
2021-04-16 05:30:00+00,16952,1292,5179,2139,497,2710,2616,279,364,646,32674,267,10795,8179,3000,18244
2021-04-16 06:00:00+00,17538,1461,5020,2072,778,2632,2773,283,1082,504,34144,265,11725,8952,3932,18999
2021-04-16 06:30:00+00,17903,1482,4885,1995,826,2566,2824,423,1957,1168,36029,256,12487,9663,4778,19385
2021-04-16 07:00:00+00,17857,1470,4815,1908,817,2503,2803,421,2860,1410,36864,247,13203,10400,5585,19327
2021-04-16 07:30:00+00,17920,1485,4809,1801,826,2492,2742,392,3878,1092,37437,244,14056,11314,6505,19405
2021-04-16 08:00:00+00,18058,1492,4788,1725,668,2590,2704,404,4644,740,37813,243,14529,11825,7037,19550
2021-04-16 08:30:00+00,18080,1487,4781,1645,510,2607,2704,393,5185,322,37714,244,14825,12121,7340,19567
2021-04-16 09:00:00+00,17764,1486,4774,1651,463,2647,2766,180,5860,348,37939,237,15514,12748,7974,19250
2021-04-16 09:30:00+00,17610,1476,4765,1692,428,2667,2785,151,6328,38,37939,235,15998,13213,8448,19086
2021-04-16 10:00:00+00,17425,1481,4762,1760,428,2735,2799,174,6339,154,38057,233,16088,13289,8527,18906
2021-04-16 10:30:00+00,17047,1489,4767,1808,437,2801,2869,230,6597,0,38045,231,16478,13609,8842,18536
2021-04-16 11:00:00+00,17048,1491,4763,1924,449,2917,2869,299,6650,0,38410,231,16655,13786,9023,18539
2021-04-16 11:30:00+00,17017,1382,4759,2090,448,2882,2868,238,6675,0,38359,227,16840,13972,9213,18399
2021-04-16 12:00:00+00,16779,996,4762,2253,368,2966,2869,154,6627,0,37774,216,16879,14010,9248,17775
2021-04-16 12:30:00+00,16304,736,4764,2313,289,2984,2865,143,6364,0,36762,211,16595,13730,8966,17040
2021-04-16 13:00:00+00,15350,871,4759,2454,290,3110,2865,143,6247,0,36089,209,16615,13750,8991,16221
2021-04-16 13:30:00+00,15092,999,4753,2617,292,3094,2727,142,6163,0,35879,210,16552,13825,9072,16091
2021-04-16 14:00:00+00,15247,790,4764,2817,294,3002,2623,141,5557,0,35235,208,16055,13432,8668,16037
2021-04-16 14:30:00+00,15346,690,4765,2942,314,3002,2629,147,4852,0,34687,210,15502,12873,8108,16036
2021-04-16 15:00:00+00,15590,703,4764,3019,332,2996,2632,191,4234,0,34461,215,14981,12349,7585,16293
2021-04-16 15:30:00+00,16428,998,4761,3123,404,3024,2631,210,3732,14,35325,228,14651,12020,7259,17426
2021-04-16 16:00:00+00,17296,1139,4762,3110,578,2430,2763,208,3087,530,35903,236,14300,11537,6775,18435
2021-04-16 16:30:00+00,17542,1357,4762,3170,602,2480,2874,210,2377,590,35964,246,13785,10911,6149,18899
2021-04-16 17:00:00+00,17528,1340,4761,3161,692,2312,2826,253,1586,1220,35679,247,13026,10200,5439,18868
2021-04-16 17:30:00+00,17600,1254,4761,3096,692,2338,2814,245,1026,1786,35612,247,12389,9575,4814,18854
2021-04-16 18:00:00+00,17605,1347,4755,2948,646,2914,2828,365,435,1332,35175,254,11612,8784,4029,18952
2021-04-16 18:30:00+00,17643,1447,4753,2795,609,2882,2834,367,78,1466,34874,259,11069,8235,3482,19090
2021-04-16 19:00:00+00,17531,1476,4756,2733,579,3138,2871,354,0,1342,34780,260,10939,8068,3312,19007
2021-04-16 19:30:00+00,17673,1484,4754,2616,563,3068,2836,355,0,1440,34789,261,10769,7933,3179,19157
2021-04-16 20:00:00+00,17553,1472,4752,2450,462,3004,2869,264,0,1092,33918,265,10533,7664,2912,19025
2021-04-16 20:30:00+00,17437,1306,4750,2312,430,3004,2838,267,0,92,32436,270,10330,7492,2742,18743
2021-04-16 21:00:00+00,17074,1094,4747,2202,393,2972,2523,164,0,40,31209,267,9865,7342,2595,18168
2021-04-16 21:30:00+00,16956,680,4753,2104,402,2972,1867,145,0,34,29913,261,9126,7259,2506,17636
2021-04-16 22:00:00+00,16289,664,4753,2003,376,3002,1309,149,0,0,28545,262,8441,7132,2379,16953
2021-04-16 22:30:00+00,15239,316,4763,1984,358,2996,1247,141,0,0,27044,249,8352,7105,2342,15555
2021-04-16 23:00:00+00,15337,219,4771,1921,347,2552,1195,141,0,0,26483,251,8234,7039,2268,15556
2021-04-16 23:30:00+00,15190,0,4754,1828,340,2542,1245,140,0,0,26039,245,8167,6922,2168,15190
2021-04-17 00:00:00+00,15259,0,4756,1731,341,2874,1244,140,0,0,26345,243,8072,6828,2072,15259
2021-04-17 00:30:00+00,15738,0,4750,1580,332,2878,1248,145,0,0,26671,247,7910,6662,1912,15738
2021-04-17 01:00:00+00,15807,0,4751,1487,304,2846,1276,144,0,0,26615,250,7818,6542,1791,15807
2021-04-17 01:30:00+00,15724,0,4750,1513,299,2914,1276,144,0,0,26620,250,7838,6562,1812,15724
2021-04-17 02:00:00+00,15848,0,4741,1498,298,2920,1306,145,0,0,26756,250,7843,6537,1796,15848
2021-04-17 02:30:00+00,15734,0,4739,1395,298,2908,1308,145,0,0,26527,251,7740,6432,1693,15734
2021-04-17 03:00:00+00,15849,0,4740,1343,293,2786,1325,145,0,0,26481,251,7701,6376,1636,15849
2021-04-17 03:30:00+00,15855,0,4746,1352,294,2792,1302,146,0,0,26487,251,7694,6392,1646,15855
2021-04-17 04:00:00+00,15451,0,4745,1393,310,2888,1305,141,0,0,26233,249,7753,6448,1703,15451
2021-04-17 04:30:00+00,15568,0,4750,1447,310,2970,1299,140,0,0,26484,250,7806,6507,1757,15568
2021-04-17 05:00:00+00,15727,0,4747,1466,353,3010,1300,142,40,0,26785,248,7906,6606,1859,15727
2021-04-17 05:30:00+00,16044,0,4749,1524,389,2992,1359,162,459,0,27678,244,8480,7121,2372,16044
2021-04-17 06:00:00+00,16327,0,4749,1560,534,3028,1498,257,1234,0,29187,237,9575,8077,3328,16327
2021-04-17 06:30:00+00,16519,0,4760,1501,600,3168,1526,329,2186,0,30589,232,10573,9047,4287,16519
2021-04-17 07:00:00+00,16764,0,4757,1458,590,3048,1524,316,3154,430,32041,222,11483,9959,5202,16764
2021-04-17 07:30:00+00,16575,0,4761,1406,550,3136,1466,250,4186,300,32630,216,12369,10903,6142,16575
2021-04-17 08:00:00+00,16328,0,4759,1431,440,3202,1400,176,5215,282,33233,209,13245,11845,7086,16328
2021-04-17 08:30:00+00,15811,0,4759,1535,425,3202,1275,148,6215,144,33514,200,14209,12934,8175,15811
2021-04-17 09:00:00+00,15301,0,4755,1622,396,3096,1286,149,7110,138,33853,191,15169,13883,9128,15301
2021-04-17 09:30:00+00,14839,0,4756,1804,376,3032,1101,146,7771,138,33963,183,15808,14707,9951,14839
2021-04-17 10:00:00+00,14190,0,4747,1919,379,3080,980,149,8357,0,33801,177,16382,15402,10655,14190
2021-04-17 10:30:00+00,13348,0,4737,2103,371,3214,983,148,8779,0,33683,170,16973,15990,11253,13348
2021-04-17 11:00:00+00,12988,0,4727,2185,341,3350,981,147,9124,0,33843,166,17358,16377,11650,12988
2021-04-17 11:30:00+00,12352,0,4726,2373,321,3402,979,147,9263,0,33563,161,17662,16683,11957,12352
2021-04-17 12:00:00+00,11713,0,4736,2624,264,3278,974,146,9215,0,32950,155,17813,16839,12103,11713
2021-04-17 12:30:00+00,11014,0,4730,2862,268,3166,982,148,9104,0,32274,148,17946,16964,12234,11014
2021-04-17 13:00:00+00,10445,0,4733,3011,269,3244,985,146,9015,0,31848,144,18013,17028,12295,10445
2021-04-17 13:30:00+00,9920,0,4721,3161,260,3154,955,141,8460,0,30772,141,17557,16602,11881,9920
2021-04-17 14:00:00+00,9949,0,4721,3355,259,3210,966,146,7819,0,30425,144,17120,16154,11433,9949
2021-04-17 14:30:00+00,10528,0,4731,3579,290,3080,976,142,6894,0,30220,150,16470,15494,10763,10528
2021-04-17 15:00:00+00,11678,20,4726,3761,297,3066,967,146,6006,0,30667,163,15757,14790,10064,11698
2021-04-17 15:30:00+00,13104,160,4737,3898,342,3110,964,144,4942,0,31401,182,14883,13919,9182,13264
2021-04-17 16:00:00+00,14427,407,4733,3921,525,2998,968,148,3897,58,32082,200,14044,13076,8343,14834
2021-04-17 16:30:00+00,14946,690,4742,3936,569,3070,976,173,3105,384,32591,213,13328,12352,7610,15636
2021-04-17 17:00:00+00,15523,970,4735,3842,601,3046,978,228,2233,826,32982,225,12389,11411,6676,16493
2021-04-17 17:30:00+00,15850,1341,4740,3741,609,3044,977,266,1301,1152,33021,239,11368,10391,5651,17191
2021-04-17 18:00:00+00,16130,1450,4736,3578,609,3038,974,406,651,886,32458,252,10548,9574,4838,17580
2021-04-17 18:30:00+00,16538,1467,4732,3417,615,3054,966,428,137,886,32240,260,9867,8901,4169,18005
2021-04-17 19:00:00+00,16668,1484,4728,3233,585,3150,957,426,0,1122,32353,262,9503,8546,3818,18152
2021-04-17 19:30:00+00,16738,1487,4727,3092,579,3062,957,423,0,1142,32207,263,9355,8398,3671,18225
2021-04-17 20:00:00+00,16663,1486,4729,3103,477,3004,995,420,0,586,31463,268,9304,8309,3580,18149
2021-04-17 20:30:00+00,16468,1435,4732,3149,448,3034,1026,345,0,0,30637,271,9355,8329,3597,17903
2021-04-17 21:00:00+00,16020,1175,4732,3224,417,2982,1023,279,0,0,29852,264,9396,8373,3641,17195
2021-04-17 21:30:00+00,15000,878,4729,3272,414,2884,1224,172,0,0,28573,249,9639,8415,3686,15878
2021-04-17 22:00:00+00,13646,549,4726,3236,395,2976,1347,145,0,0,27020,234,9704,8357,3631,14195
2021-04-17 22:30:00+00,13158,228,4733,3179,369,3054,1346,141,0,0,26208,224,9627,8281,3548,13386
2021-04-17 23:00:00+00,12933,0,4732,3181,278,3030,1352,141,0,0,25647,218,9543,8191,3459,12933
2021-04-17 23:30:00+00,12759,0,4736,3183,260,3024,1355,141,0,0,25458,216,9534,8179,3443,12759
2021-04-18 00:00:00+00,13024,0,4738,3179,262,3074,1358,140,0,0,25775,220,9537,8179,3441,13024
2021-04-18 00:30:00+00,13211,0,4734,3169,264,3058,1360,140,0,0,25936,221,9527,8167,3433,13211
2021-04-18 01:00:00+00,13352,0,4739,3198,265,3214,1244,149,0,0,26161,223,9446,8202,3463,13352
2021-04-18 01:30:00+00,13400,0,4731,3272,279,3140,1010,188,0,0,26020,224,9292,8282,3551,13400
2021-04-18 02:00:00+00,13132,0,4734,3325,278,3150,1120,188,0,0,25927,220,9457,8337,3603,13132
2021-04-18 02:30:00+00,12775,0,4727,3352,265,3008,1430,142,0,0,25699,215,9774,8344,3617,12775
2021-04-18 03:00:00+00,12649,0,4720,3338,243,2994,1355,140,0,0,25439,215,9656,8301,3581,12649
2021-04-18 03:30:00+00,12587,0,4725,3368,241,2990,1339,139,0,0,25389,214,9673,8334,3609,12587
2021-04-18 04:00:00+00,12669,0,4735,3372,241,2946,1365,139,0,0,25467,214,9713,8348,3613,12669
2021-04-18 04:30:00+00,12599,0,4731,3411,240,3044,1400,140,0,0,25565,215,9782,8382,3651,12599
2021-04-18 05:00:00+00,12677,0,4738,3334,284,3064,1428,140,52,0,25717,215,9836,8408,3670,12677
2021-04-18 05:30:00+00,12771,0,4730,3206,287,3152,1475,156,455,0,26232,214,10153,8678,3948,12771
2021-04-18 06:00:00+00,12682,0,4738,3172,361,3086,1504,246,1043,0,26832,208,10818,9314,4576,12682
2021-04-18 06:30:00+00,13266,0,4734,3085,362,2938,1405,214,1910,0,27914,205,11496,10091,5357,13266
2021-04-18 07:00:00+00,13739,0,4739,3039,420,2904,1193,220,2832,0,29086,201,12223,11030,6291,13739
2021-04-18 07:30:00+00,13893,0,4734,2977,454,2906,1109,223,3702,0,29998,196,12976,11867,7133,13893
2021-04-18 08:00:00+00,13990,0,4745,2948,428,2904,1110,237,4471,72,30905,192,13702,12592,7847,13990
2021-04-18 08:30:00+00,14087,0,4741,2921,428,2902,1107,224,5217,0,31627,189,14414,13307,8566,14087
2021-04-18 09:00:00+00,13967,0,4745,2930,411,3002,1108,180,6288,0,32631,181,15482,14374,9629,13967
2021-04-18 09:30:00+00,13753,0,4740,2930,393,3004,1107,146,6953,0,33026,176,16123,15016,10276,13753
2021-04-18 10:00:00+00,13624,0,4738,2974,376,3004,1104,143,7530,0,33493,172,16722,15618,10880,13624
2021-04-18 10:30:00+00,13366,0,4735,2941,363,3004,1107,143,8102,0,33761,168,17248,16141,11406,13366
2021-04-18 11:00:00+00,13376,0,4719,2917,363,3004,1108,144,8362,0,33993,167,17469,16361,11642,13376
2021-04-18 11:30:00+00,13254,0,4715,2780,343,3004,1108,144,8358,20,33726,167,17304,16196,11481,13254
2021-04-18 12:00:00+00,13208,0,4717,2590,262,3004,1103,143,8349,0,33376,168,17021,15918,11201,13208
2021-04-18 12:30:00+00,12901,0,4721,2512,241,3004,1101,142,8305,0,32927,166,16880,15779,11058,12901
2021-04-18 13:00:00+00,13270,0,4719,2439,241,2716,1102,143,8218,0,32848,171,16719,15617,10898,13270
2021-04-18 13:30:00+00,13471,0,4712,2350,241,2694,1101,142,7819,0,32530,175,16223,15122,10410,13471
2021-04-18 14:00:00+00,13551,0,4715,2281,244,2902,1104,143,6901,0,31841,180,15245,14141,9426,13551
2021-04-18 14:30:00+00,14126,83,4710,2307,252,2904,1105,142,6147,0,31776,190,14521,13416,8706,14209
2021-04-18 15:00:00+00,15364,297,4720,2207,293,3024,1099,143,5340,20,32507,207,13659,12560,7840,15661
2021-04-18 15:30:00+00,16529,608,4719,2108,337,3024,1102,143,4638,26,33234,225,12904,11802,7083,17137
2021-04-18 16:00:00+00,17804,1007,4722,2018,520,2874,1104,145,3372,242,33808,247,11736,10632,5910,18811
2021-04-18 16:30:00+00,18542,1251,4728,1907,540,2872,1104,169,2706,394,34213,259,10985,9881,5153,19793
2021-04-18 17:00:00+00,18955,1239,4726,1798,610,2376,1100,244,1908,1254,34210,263,10142,9042,4316,20194
2021-04-18 17:30:00+00,19343,1239,4731,1687,637,2340,1103,408,1152,1188,33828,272,9310,8207,3476,20582
2021-04-18 18:00:00+00,19405,1240,4727,1510,698,2838,1131,396,521,1188,33654,276,8587,7456,2729,20645
2021-04-18 18:30:00+00,19499,1166,4728,1332,698,2848,1139,395,83,1472,33360,277,7980,6841,2113,20665
2021-04-18 19:00:00+00,19539,1217,4722,1274,639,2766,1136,383,0,1426,33102,281,7771,6635,1913,20756
2021-04-18 19:30:00+00,19805,1259,4721,1231,620,2756,1136,342,0,1430,33300,283,7708,6572,1851,21064
2021-04-18 20:00:00+00,19505,1455,4722,1223,612,2504,1155,239,0,856,32271,293,7712,6557,1835,20960
2021-04-18 20:30:00+00,19187,1323,4715,1253,538,2502,1160,146,0,72,30896,297,7666,6506,1791,20510
2021-04-18 21:00:00+00,17921,1009,4722,1306,416,2678,1162,148,0,8,29370,286,7606,6444,1722,18930
2021-04-18 21:30:00+00,16549,553,4717,1343,428,2650,1163,146,0,40,27589,269,7651,6488,1771,17102
2021-04-18 22:00:00+00,16320,110,4717,1367,379,1874,1166,140,0,0,26073,264,7629,6463,1746,16430
2021-04-18 22:30:00+00,15753,0,4719,1464,326,1844,1167,140,0,0,25413,258,7676,6509,1790,15753
2021-04-18 23:00:00+00,15666,0,4718,1582,281,1593,1171,140,0,0,25151,259,7752,6581,1863,15666
2021-04-18 23:30:00+00,15397,0,4727,1737,279,1586,1181,141,0,0,25049,255,7924,6743,2016,15397
2021-04-19 00:00:00+00,15533,0,4724,1812,280,2001,1173,141,0,0,25664,254,7989,6816,2092,15533
2021-04-19 00:30:00+00,15939,0,4728,1891,281,1997,1172,140,0,0,26148,255,8072,6900,2172,15939
2021-04-19 01:00:00+00,16320,0,4728,1933,281,1640,1167,141,0,0,26210,259,8109,6942,2214,16320
2021-04-19 01:30:00+00,16128,0,4726,1981,281,1574,1156,140,0,0,25986,258,8144,6988,2262,16128
2021-04-19 02:00:00+00,16487,0,4722,1982,281,945,1162,141,0,0,25720,265,8147,6985,2263,16487
2021-04-19 02:30:00+00,16533,0,4720,1968,280,874,1204,142,0,0,25721,266,8172,6968,2248,16533
2021-04-19 03:00:00+00,16849,0,4714,1971,260,850,1236,142,0,0,26022,268,8181,6945,2231,16849
2021-04-19 03:30:00+00,16838,20,4711,2013,261,837,1268,142,0,0,26089,268,8253,6985,2274,16858
2021-04-19 04:00:00+00,17097,262,4718,2047,264,807,1341,146,0,0,26682,274,8370,7029,2311,17359
2021-04-19 04:30:00+00,17196,600,4717,2072,296,841,1595,140,0,0,27457,281,8680,7085,2368,17796
2021-04-19 05:00:00+00,18678,987,4721,2105,361,1007,1894,150,36,42,29981,293,9117,7223,2502,19665
2021-04-19 05:30:00+00,19761,1133,4718,2133,391,1181,2258,234,370,390,32568,292,9870,7612,2894,20894
2021-04-19 06:00:00+00,19841,1118,4723,2191,520,1144,2445,289,981,572,33824,282,10860,8415,3692,20959
2021-04-19 06:30:00+00,20257,1137,4723,2133,526,1182,2466,403,1713,948,35488,276,11561,9095,4372,21394
2021-04-19 07:00:00+00,20252,1367,4716,2118,461,1401,2468,394,2568,530,36275,274,12331,9863,5147,21619
2021-04-19 07:30:00+00,20064,1473,4727,2117,456,1251,2468,327,3553,464,36901,267,13321,10853,6126,21537
2021-04-19 08:00:00+00,19858,1491,4726,2229,433,1464,2467,166,4655,274,37763,258,14510,12043,7317,21349
2021-04-19 08:30:00+00,19386,1454,4732,2306,430,1390,2465,144,5845,0,38152,249,15778,13313,8581,20840
2021-04-19 09:00:00+00,19698,1491,4719,2317,380,794,2464,143,6849,0,38855,248,16729,14265,9546,21189
2021-04-19 09:30:00+00,18967,1491,4719,2458,345,770,2439,142,7668,0,38999,239,17629,15190,10471,20458
2021-04-19 10:00:00+00,18950,1473,4714,2521,330,998,2430,142,8331,0,39889,234,18326,15896,11182,20423
2021-04-19 10:30:00+00,18746,1255,4714,2640,310,1000,2432,143,8816,0,40056,226,18912,16480,11766,20001
2021-04-19 11:00:00+00,18220,1216,4696,2785,297,1000,2433,143,9160,0,39950,221,19371,16938,12242,19436
2021-04-19 11:30:00+00,17993,989,4692,2867,298,1000,2432,141,9322,0,39734,214,19611,17179,12487,18982
2021-04-19 12:00:00+00,17154,691,4691,2888,282,1000,2308,142,9302,0,38458,205,19471,17163,12472,17845
2021-04-19 12:30:00+00,16839,689,4687,2840,283,998,2209,145,9114,0,37804,205,19133,16924,12237,17528
2021-04-19 13:00:00+00,16990,688,4693,2867,283,852,2209,142,8797,0,37521,207,18849,16640,11947,17678
2021-04-19 13:30:00+00,17020,689,4694,2748,283,850,2207,141,8339,0,36971,211,18271,16064,11370,17709
2021-04-19 14:00:00+00,17109,689,4696,2692,286,812,2327,141,7723,0,36475,215,17724,15397,10701,17798
2021-04-19 14:30:00+00,17847,692,4689,2640,291,810,2427,143,6969,0,36508,223,17016,14589,9900,18539
2021-04-19 15:00:00+00,18383,890,4695,2675,308,882,2426,189,6044,0,36492,235,16148,13722,9027,19273
2021-04-19 15:30:00+00,19142,1088,4688,2683,350,882,2429,202,5032,24,36520,248,15182,12753,8065,20230
2021-04-19 16:00:00+00,19553,1103,4698,2623,490,1438,2428,195,4013,60,36601,253,14252,11824,7126,20656
2021-04-19 16:30:00+00,20222,1249,4692,2422,514,1476,2426,282,3034,28,36346,267,13088,10662,5970,21471
2021-04-19 17:00:00+00,20181,1423,4701,2303,533,1252,2422,324,2099,684,35922,274,12058,9636,4935,21604
2021-04-19 17:30:00+00,20209,1483,4696,2130,531,1280,2409,408,1259,1098,35503,279,11025,8616,3920,21692
2021-04-19 18:00:00+00,20267,1485,4705,1941,531,1948,2405,411,560,884,35137,285,10142,7737,3032,21752
2021-04-19 18:30:00+00,20531,1484,4698,1741,571,1966,2400,399,95,596,34481,293,9505,7105,2407,22015
2021-04-19 19:00:00+00,20440,1483,4704,1717,558,2084,2403,396,0,880,34665,290,9382,6979,2275,21923
2021-04-19 19:30:00+00,20681,1482,4694,1653,556,2066,2331,396,0,818,34677,292,9234,6903,2209,22163
2021-04-19 20:00:00+00,20943,1483,4696,1483,546,1780,2383,345,0,288,33947,302,9108,6725,2029,22426
2021-04-19 20:30:00+00,20400,1335,4699,1417,475,1758,2404,150,0,0,32638,301,8995,6591,1892,21735
2021-04-19 21:00:00+00,20119,833,4693,1349,374,860,2372,142,0,38,30780,298,8788,6416,1723,20952
2021-04-19 21:30:00+00,19466,412,4696,1279,421,858,2085,140,0,0,29357,289,8481,6396,1700,19878
2021-04-19 22:00:00+00,19677,55,4693,1213,362,888,1473,200,0,0,28561,286,7741,6268,1575,19732
2021-04-19 22:30:00+00,19301,0,4697,1242,362,888,1146,141,0,0,27777,285,7447,6301,1604,19301
2021-04-19 23:00:00+00,18508,0,4693,1179,331,880,1146,139,0,0,26876,283,7349,6203,1510,18508
2021-04-19 23:30:00+00,18245,0,4686,1188,330,880,1155,140,0,0,26624,282,7359,6204,1518,18245
2021-04-20 00:00:00+00,18359,0,4688,1118,325,926,1154,140,0,0,26710,283,7285,6131,1443,18359
2021-04-20 00:30:00+00,18574,0,4690,1048,330,927,1154,141,0,0,26864,284,7222,6068,1378,18574
2021-04-20 01:00:00+00,18924,0,4694,1073,330,1004,1154,145,0,0,27324,285,7251,6097,1403,18924
2021-04-20 01:30:00+00,19034,0,4693,1107,326,1002,1138,140,0,0,27440,285,7264,6126,1433,19034
2021-04-20 02:00:00+00,18896,0,4689,1112,324,1001,1143,139,0,0,27304,285,7268,6125,1436,18896
2021-04-20 02:30:00+00,18783,0,4692,1102,322,1046,1166,140,0,0,27251,284,7282,6116,1424,18783
2021-04-20 03:00:00+00,19376,0,4693,1122,305,662,1193,140,0,0,27491,288,7313,6120,1427,19376
2021-04-20 03:30:00+00,19281,0,4688,1141,303,612,1215,141,0,0,27381,287,7347,6132,1444,19281
2021-04-20 04:00:00+00,20065,141,4683,1209,307,38,1253,139,0,0,27834,296,7452,6199,1516,20206
2021-04-20 04:30:00+00,20177,481,4683,1187,318,69,1445,201,0,0,28561,302,7633,6188,1505,20658
2021-04-20 05:00:00+00,19328,964,4690,1250,374,60,1966,141,93,0,28866,305,8373,6407,1717,20292
2021-04-20 05:30:00+00,19664,1361,4684,1245,410,99,2209,210,524,286,30692,305,9072,6863,2179,21025
2021-04-20 06:00:00+00,20408,1425,4686,1136,458,590,2513,242,1163,728,33349,295,9956,7443,2757,21833
2021-04-20 06:30:00+00,20745,1485,4686,1065,472,637,2916,233,1927,1316,35482,284,11066,8150,3464,22230
2021-04-20 07:00:00+00,20679,1482,4684,894,473,1244,2788,199,2770,768,35981,280,11609,8821,4137,22161
2021-04-20 07:30:00+00,20584,1482,4688,727,478,1295,2751,410,3719,20,36154,280,12363,9612,4924,22066
2021-04-20 08:00:00+00,20263,1382,4685,693,467,1484,2789,257,4683,0,36704,269,13317,10528,5843,21645
2021-04-20 08:30:00+00,20242,992,4693,627,460,1514,2734,147,5537,0,36946,256,14051,11317,6624,21234
2021-04-20 09:00:00+00,20369,740,4682,642,459,1571,2733,140,6339,0,37675,246,14855,12122,7440,21109
2021-04-20 09:30:00+00,19694,701,4677,708,423,1602,2766,140,7059,0,37771,238,15633,12867,8190,20395
2021-04-20 10:00:00+00,19350,691,4676,838,391,1632,2713,139,7614,0,38044,232,16232,13519,8843,20041
2021-04-20 10:30:00+00,18766,689,4581,954,356,1663,2713,139,8045,0,37906,227,16649,13936,9355,19455
2021-04-20 11:00:00+00,19022,699,4505,1065,344,1698,2546,141,8010,0,38030,228,16470,13924,9419,19721
2021-04-20 11:30:00+00,18779,703,4666,1131,342,1727,2500,142,8048,42,38080,226,16687,14187,9521,19482
2021-04-20 12:00:00+00,18415,694,4668,1256,343,1733,2623,141,7712,0,37585,225,16602,13979,9311,19109
2021-04-20 12:30:00+00,17774,692,4662,1420,344,1759,2788,139,7262,0,36840,223,16476,13688,9026,18466
2021-04-20 13:00:00+00,16932,696,4660,1511,344,1765,2620,140,6904,0,35573,221,16039,13419,8759,17628
2021-04-20 13:30:00+00,16964,655,4659,1738,344,1792,2600,141,6176,0,35069,224,15517,12917,8258,17619
2021-04-20 14:00:00+00,17510,457,4659,1853,339,1816,2724,140,5479,0,34977,226,15054,12330,7671,17967
2021-04-20 14:30:00+00,18330,263,4661,1901,332,1845,2720,141,4617,0,34810,231,14231,11511,6850,18593
2021-04-20 15:00:00+00,19795,236,4664,2052,372,1929,2991,187,3743,4,35972,240,13822,10831,6167,20031
2021-04-20 15:30:00+00,20382,336,4662,2166,421,1962,3022,265,3237,366,36819,244,13508,10486,5824,20718
2021-04-20 16:00:00+00,20642,396,4668,2278,526,2082,3040,340,2735,354,37061,248,13247,10207,5539,21038
2021-04-20 16:30:00+00,20797,401,4670,2299,552,2120,3034,390,2082,594,36939,251,12637,9603,4933,21198
2021-04-20 17:00:00+00,20772,405,4674,2431,552,2249,3034,418,1451,874,36860,252,12142,9108,4434,21177
2021-04-20 17:30:00+00,20787,407,4671,2428,552,2281,3037,431,874,1182,36650,254,11562,8525,3854,21194
2021-04-20 18:00:00+00,20904,372,4673,2361,559,2318,3038,438,387,1082,36133,258,11018,7980,3307,21276
2021-04-20 18:30:00+00,21131,326,4677,2283,558,2356,3044,418,95,976,35864,261,10657,7613,2936,21457
2021-04-20 19:00:00+00,21372,286,4674,2294,549,2722,3045,341,1,504,35788,263,10563,7518,2844,21658
2021-04-20 19:30:00+00,21141,370,4679,2256,518,2678,3008,336,0,546,35532,264,10461,7453,2774,21511
2021-04-20 20:00:00+00,21289,381,4671,2202,506,1534,2848,375,0,594,34400,273,10227,7379,2708,21670
2021-04-20 20:30:00+00,20637,273,4670,2253,491,1480,2899,272,0,0,32975,272,10313,7414,2744,20910
2021-04-20 21:00:00+00,19666,0,4664,2242,423,980,2599,144,0,56,30774,268,9928,7329,2665,19666
2021-04-20 21:30:00+00,18332,0,4666,2329,408,976,2058,141,0,0,28910,264,9461,7403,2737,18332
2021-04-20 22:00:00+00,16630,0,4667,2372,358,1182,1748,139,0,0,27096,257,9145,7397,2730,16630
2021-04-20 22:30:00+00,15253,0,4665,2430,356,1152,1757,143,0,0,25756,249,9208,7451,2786,15253
2021-04-20 23:00:00+00,14822,0,4666,2396,327,913,1772,142,0,0,25038,249,9161,7389,2723,14822
2021-04-20 23:30:00+00,14446,0,4659,2372,329,914,1747,143,0,0,24610,247,9107,7360,2701,14446
2021-04-21 00:00:00+00,14517,0,4659,2536,312,936,1751,141,0,0,24852,245,9258,7507,2848,14517
2021-04-21 00:30:00+00,14618,0,4663,2921,327,934,1760,140,0,0,25363,242,9671,7911,3248,14618
2021-04-21 01:00:00+00,14322,0,4663,3137,352,952,1750,144,0,0,25320,238,9902,8152,3489,14322
2021-04-21 01:30:00+00,13982,0,4669,3358,353,952,1747,145,0,0,25206,233,10127,8380,3711,13982
2021-04-21 02:00:00+00,14367,0,4666,3596,353,952,1767,143,0,0,25844,233,10382,8615,3949,14367
2021-04-21 02:30:00+00,14136,0,4663,3807,350,950,1766,141,0,0,25813,230,10586,8820,4157,14136
2021-04-21 03:00:00+00,14332,0,4668,4069,330,700,1754,141,0,0,25994,230,10821,9067,4399,14332
2021-04-21 03:30:00+00,14520,0,4665,4098,331,614,1756,150,0,0,26134,232,10850,9094,4429,14520
2021-04-21 04:00:00+00,14476,0,4663,4205,328,4,1753,145,0,0,25574,233,10949,9196,4533,14476
2021-04-21 04:30:00+00,14664,0,4664,4783,349,4,1820,141,0,0,26425,229,11616,9796,5132,14664
2021-04-21 05:00:00+00,15466,0,4658,5130,394,96,2061,140,57,0,28002,228,12300,10239,5581,15466
2021-04-21 05:30:00+00,16406,0,4656,5352,424,110,2426,151,293,182,30000,227,13151,10725,6069,16406
2021-04-21 06:00:00+00,17040,77,4661,5409,514,627,2939,202,726,324,32518,223,14249,11310,6649,17116
2021-04-21 06:30:00+00,17383,153,4659,5699,485,714,3042,320,1343,558,34356,219,15228,12186,7527,17536
2021-04-21 07:00:00+00,17497,230,4666,6704,472,1480,2993,226,2042,154,36464,211,16876,13884,9218,17727
2021-04-21 07:30:00+00,17223,229,4663,7335,472,1502,2792,187,2875,134,37412,202,18137,15345,10682,17452
2021-04-21 08:00:00+00,17138,241,4659,7701,416,1366,2636,163,3555,0,37875,198,18967,16331,11672,17379
2021-04-21 08:30:00+00,16811,236,4659,7679,390,1340,2623,144,4130,0,38012,193,19481,16858,12199,17047
2021-04-21 09:00:00+00,16946,231,4662,7584,372,978,2788,110,4698,0,38369,192,20104,17316,12654,17177
2021-04-21 09:30:00+00,16581,242,4653,7272,340,980,2741,104,5104,60,38077,190,20110,17369,12716,16823
2021-04-21 10:00:00+00,16495,239,4657,6821,314,1004,2792,104,5677,0,38103,189,20261,17469,12812,16734
2021-04-21 10:30:00+00,16607,238,4656,6409,275,1004,2911,102,6051,0,38253,190,20302,17391,12735,16845
2021-04-21 11:00:00+00,16224,325,4659,5966,256,1385,2813,140,6452,0,38220,189,20146,17333,12674,16549
2021-04-21 11:30:00+00,16168,231,4657,5953,235,1475,2944,141,6694,0,38498,185,20483,17539,12882,16399
2021-04-21 12:00:00+00,15738,237,4652,5666,235,1686,2776,118,7025,30,38163,182,20354,17578,12926,15975
2021-04-21 12:30:00+00,15386,231,4651,5451,238,1700,2965,101,6840,0,37563,182,20145,17180,12529,15617
2021-04-21 13:00:00+00,15244,235,4644,5271,257,1678,2986,102,6732,0,37149,182,19890,16904,12260,15479
2021-04-21 13:30:00+00,15182,231,4659,5073,257,1680,2952,102,6413,0,36549,184,19354,16402,11743,15413
2021-04-21 14:00:00+00,14900,229,4647,5079,258,1840,2890,101,5911,0,35855,185,18785,15895,11248,15129
2021-04-21 14:30:00+00,15154,233,4649,5378,258,1844,2800,103,5579,0,35998,187,18664,15864,11215,15387
2021-04-21 15:00:00+00,15599,242,4647,5438,258,2114,2874,144,4942,0,36258,191,18159,15285,10638,15841
2021-04-21 15:30:00+00,16569,249,4639,5381,327,2150,2958,200,4205,86,36764,200,17510,14552,9913,16818
2021-04-21 16:00:00+00,17216,233,4647,5445,411,2246,2957,292,3482,0,36929,207,16942,13985,9338,17449
2021-04-21 16:30:00+00,17723,340,4639,5386,463,2259,2962,347,2781,44,36944,215,16231,13269,8630,18063
2021-04-21 17:00:00+00,18081,311,4649,5282,512,2307,2954,388,2064,622,37170,217,15461,12507,7858,18392
2021-04-21 17:30:00+00,17952,240,4644,5223,529,2309,2919,336,1289,886,36327,219,14604,11685,7041,18192
2021-04-21 18:00:00+00,18223,242,4645,5191,526,2325,2916,190,613,1032,35903,223,13891,10975,6330,18465
2021-04-21 18:30:00+00,18241,281,4651,5093,518,2349,2929,155,166,786,35168,229,13357,10428,5777,18522
2021-04-21 19:00:00+00,18230,260,4650,5063,461,2327,2963,148,3,766,34871,230,13140,10177,5527,18490
2021-04-21 19:30:00+00,18255,357,4650,4993,418,2352,2962,164,0,602,34753,234,13023,10061,5411,18612
2021-04-21 20:00:00+00,18222,393,4651,5036,355,2314,2958,210,0,650,34789,234,13000,10042,5391,18615
2021-04-21 20:30:00+00,18163,272,4648,4789,305,2341,2812,163,0,92,33585,238,12554,9742,5094,18435
2021-04-21 21:00:00+00,17997,136,4651,4907,293,2331,2657,135,0,94,33201,234,12508,9851,5200,18133
2021-04-21 21:30:00+00,16975,0,4641,4824,313,2298,2020,113,0,0,31183,229,11798,9778,5137,16975
2021-04-21 22:00:00+00,15373,0,4645,4891,306,2046,1467,104,0,0,28832,223,11309,9842,5197,15373
2021-04-21 22:30:00+00,14132,0,4648,4844,305,2077,1141,105,0,0,27251,216,10938,9797,5149,14132
2021-04-21 23:00:00+00,13723,0,4643,4834,285,2287,1145,105,0,0,27021,213,10907,9762,5119,13723
2021-04-21 23:30:00+00,13339,0,4643,4601,264,2315,1146,105,0,0,26413,212,10654,9508,4865,13339
2021-04-22 00:00:00+00,13937,0,4649,4361,245,2268,1148,105,0,0,26713,219,10403,9255,4606,13937
2021-04-22 00:30:00+00,14491,0,4646,4104,244,2299,1149,104,0,0,27037,224,10143,8994,4348,14491
2021-04-22 01:00:00+00,14512,0,4650,3822,228,2390,1150,104,0,0,26856,226,9850,8700,4050,14512
2021-04-22 01:30:00+00,14606,0,4651,3662,227,2411,1148,105,0,0,26810,228,9688,8540,3889,14606
2021-04-22 02:00:00+00,14492,0,4649,3529,227,2309,1135,105,0,0,26445,229,9540,8405,3756,14492
2021-04-22 02:30:00+00,14588,0,4651,3398,225,2328,1135,105,0,0,26430,231,9409,8274,3623,14588
2021-04-22 03:00:00+00,14895,0,4654,3330,208,2367,1133,104,0,0,26691,233,9325,8192,3538,14895
2021-04-22 03:30:00+00,15064,0,4652,3260,220,2417,1133,210,0,0,26956,235,9265,8132,3480,15064
2021-04-22 04:00:00+00,15576,0,4653,3192,223,2357,1194,268,0,160,27623,238,9262,8068,3415,15576
2021-04-22 04:30:00+00,16260,0,4650,3129,256,2346,1513,276,0,36,28466,242,9548,8035,3385,16260
2021-04-22 05:00:00+00,17512,0,4647,3123,326,2499,2014,257,116,118,30612,245,10226,8212,3565,17512
2021-04-22 05:30:00+00,17992,0,4642,3085,361,2680,2373,279,674,604,32690,240,11135,8762,4120,17992
2021-04-22 06:00:00+00,18343,0,4644,2940,498,2482,2790,314,1513,504,34028,233,12385,9595,4951,18343
2021-04-22 06:30:00+00,18518,0,4640,2802,548,2386,3026,434,2465,970,35789,224,13481,10455,5815,18518
2021-04-22 07:00:00+00,18426,0,4646,2656,483,2444,3067,437,3465,934,36558,218,14317,11250,6604,18426
2021-04-22 07:30:00+00,18324,0,4642,2629,430,2445,3062,423,4502,284,36741,215,15265,12203,7561,18324
2021-04-22 08:00:00+00,18201,0,4644,2682,349,2540,3061,338,5525,0,37340,210,16261,13200,8556,18201
2021-04-22 08:30:00+00,18044,0,4646,2658,324,2563,3061,254,6523,0,38074,204,17212,14151,9505,18044
2021-04-22 09:00:00+00,18153,0,4635,2618,280,2607,3041,304,7408,130,39176,199,17982,14941,10306,18153
2021-04-22 09:30:00+00,17619,0,4632,2500,278,2626,3044,328,8152,150,39330,194,18606,15562,10930,17619
2021-04-22 10:00:00+00,16850,0,4639,2405,247,2645,2691,303,8820,0,38601,188,18802,16111,11472,16850
2021-04-22 10:30:00+00,16403,0,4635,2332,224,2674,2655,264,9360,76,38623,183,19206,16551,11916,16403
2021-04-22 11:00:00+00,15983,0,4627,2242,175,2709,2758,151,9734,276,38655,178,19536,16778,12151,15983
2021-04-22 11:30:00+00,15715,0,4631,2223,176,2741,2786,157,9893,0,38322,177,19709,16923,12292,15715
2021-04-22 12:00:00+00,15009,0,4630,2192,177,2752,2618,35,9892,0,37305,173,19509,16891,12261,15009
2021-04-22 12:30:00+00,14455,0,4629,2174,177,2783,2608,32,9712,0,36570,170,19300,16692,12063,14455
2021-04-22 13:00:00+00,14573,21,4622,2182,176,2802,2634,30,9376,0,36416,173,18990,16356,11734,14594
2021-04-22 13:30:00+00,14508,42,4619,2152,175,2831,2588,29,8878,0,35822,176,18412,15824,11205,14550
2021-04-22 14:00:00+00,14486,62,4616,1992,201,2877,2759,30,8216,0,35239,179,17784,15025,10409,14548
2021-04-22 14:30:00+00,15229,83,4615,1720,205,2893,2884,32,7434,0,35095,190,16858,13974,9359,15312
2021-04-22 15:00:00+00,15800,269,4615,1696,228,2990,2907,74,6505,0,35084,202,15951,13044,8429,16069
2021-04-22 15:30:00+00,16800,389,4614,1661,277,2994,2869,93,5512,0,35209,215,14933,12064,7450,17189
2021-04-22 16:00:00+00,17932,441,4614,1622,445,2976,2962,99,4476,0,35567,227,14119,11157,6543,18373
2021-04-22 16:30:00+00,18622,478,4614,1602,493,3049,3033,109,3466,0,35466,238,13208,10175,5561,19100
2021-04-22 17:00:00+00,19017,450,4615,1587,524,3075,3048,197,2509,494,35515,241,12283,9235,4620,19467
2021-04-22 17:30:00+00,19460,495,4614,1482,524,3284,2972,223,1595,696,35345,251,11187,8215,3601,19955
2021-04-22 18:00:00+00,19707,499,4625,1421,541,3359,3001,187,802,876,35019,257,10390,7389,2764,20206
2021-04-22 18:30:00+00,19711,498,4616,1494,543,3371,3010,243,195,884,34565,261,9858,6848,2232,20209
2021-04-22 19:00:00+00,19852,453,4624,1523,450,3342,3032,203,5,884,34367,262,9634,6602,1978,20305
2021-04-22 19:30:00+00,19784,443,4620,1578,435,3375,3038,127,0,954,34354,261,9671,6633,2013,20227
2021-04-22 20:00:00+00,19809,497,4625,1656,377,3320,3054,140,0,244,33721,268,9712,6658,2033,20306
2021-04-22 20:30:00+00,18934,494,4623,1615,337,3146,3026,57,0,76,32309,266,9601,6575,1952,19428
2021-04-22 21:00:00+00,18597,408,4623,1652,314,3105,2728,147,0,30,31604,266,9317,6589,1966,19005
2021-04-22 21:30:00+00,17716,412,4620,1725,314,3053,2132,188,0,0,30160,265,8791,6659,2039,18128
2021-04-22 22:00:00+00,16142,283,4614,1717,297,3045,1472,46,0,0,27616,257,8100,6628,2014,16425
2021-04-22 22:30:00+00,15476,236,4616,1655,298,3095,1122,33,0,0,26531,255,7691,6569,1953,15712
2021-04-22 23:00:00+00,14994,223,4614,1607,281,3030,1109,34,0,0,25892,252,7611,6502,1888,15217
2021-04-22 23:30:00+00,14933,0,4614,1615,281,3039,1110,35,0,0,25627,245,7620,6510,1896,14933
2021-04-23 00:00:00+00,15311,0,4619,1666,263,3117,1101,31,0,0,26109,248,7649,6548,1929,15311
2021-04-23 00:30:00+00,15677,0,4618,1670,242,3150,1086,31,0,0,26474,250,7616,6530,1912,15677
2021-04-23 01:00:00+00,15256,0,4618,1637,220,3157,1088,32,0,0,26008,249,7563,6475,1857,15256
2021-04-23 01:30:00+00,15270,0,4613,1654,220,3169,1091,32,0,0,26049,249,7578,6487,1874,15270
2021-04-23 02:00:00+00,15405,0,4623,1729,220,3258,1094,33,0,0,26362,249,7666,6572,1949,15405
2021-04-23 02:30:00+00,15323,0,4620,1757,219,3168,1095,43,0,0,26225,248,7691,6596,1976,15323
2021-04-23 03:00:00+00,15149,0,4626,1783,201,3095,1092,34,0,0,25980,247,7702,6610,1984,15149
2021-04-23 03:30:00+00,14840,0,4623,1833,201,3097,1092,32,0,0,25718,245,7749,6657,2034,14840
2021-04-23 04:00:00+00,15592,0,4626,1816,239,2726,1095,35,0,0,26130,252,7776,6681,2055,15592
2021-04-23 04:30:00+00,16353,0,4653,1828,276,2654,1093,35,0,0,26892,255,7850,6757,2104,16353
2021-04-23 05:00:00+00,17072,0,4664,1853,303,2841,1191,36,133,0,28093,257,8144,6953,2289,17072
2021-04-23 05:30:00+00,18246,2,4674,1907,356,2977,1547,95,676,156,30636,255,9160,7613,2939,18248
2021-04-23 06:00:00+00,18446,163,4725,1932,462,3167,1704,132,1511,772,33014,245,10334,8630,3905,18609
2021-04-23 06:30:00+00,18587,228,4801,1854,461,3121,1712,188,2465,1368,34785,236,11293,9581,4780,18815
2021-04-23 07:00:00+00,18771,318,4812,1785,456,3009,1736,266,3468,1414,36035,231,12257,10521,5709,19089
2021-04-23 07:30:00+00,18098,261,4812,1750,465,2875,1707,199,4490,1346,36003,219,13224,11517,6705,18359
2021-04-23 08:00:00+00,18324,259,4810,1736,371,2946,1729,78,5502,618,36374,218,14148,12419,7609,18583
2021-04-23 08:30:00+00,18060,261,4816,1745,344,2934,1727,56,6482,0,36425,214,15114,13387,8571,18321
2021-04-23 09:00:00+00,17190,238,4820,1782,283,2970,1674,43,7400,0,36400,204,15959,14285,9465,17428
2021-04-23 09:30:00+00,16514,231,4829,1883,278,2995,1590,36,8223,0,36579,196,16803,15213,10384,16745
2021-04-23 10:00:00+00,15545,229,4828,2028,237,3004,1569,66,8864,0,36370,186,17526,15957,11129,15774
2021-04-23 10:30:00+00,14979,230,4824,2111,205,3006,1577,106,9367,0,36405,180,18084,16507,11683,15209
2021-04-23 11:00:00+00,14724,230,4852,2193,186,3004,1539,106,9691,0,36525,177,18461,16922,12070,14954
2021-04-23 11:30:00+00,14227,232,4858,2194,187,3006,1547,107,9828,0,36186,173,18614,17067,12209,14459
2021-04-23 12:00:00+00,13523,230,4884,2205,188,3004,1586,109,9802,0,35531,169,18665,17079,12195,13753
2021-04-23 12:30:00+00,13054,229,4892,2270,188,3006,1558,106,9559,0,34862,167,18467,16909,12017,13283
2021-04-23 13:00:00+00,12915,231,4883,2331,171,3006,1594,105,9196,0,34432,167,18175,16581,11698,13146
2021-04-23 13:30:00+00,12846,230,4878,2363,171,3006,1659,105,8680,0,33938,169,17751,16092,11214,13076
2021-04-23 14:00:00+00,12636,230,4878,2406,170,3006,1686,107,7945,0,33064,171,17085,15399,10521,12866
2021-04-23 14:30:00+00,13299,229,4877,2454,170,3006,1643,111,7099,0,32888,180,16243,14600,9723,13528
2021-04-23 15:00:00+00,14170,232,4873,2521,186,3026,1652,159,6147,0,32966,190,15379,13727,8854,14402
2021-04-23 15:30:00+00,14765,300,4869,2521,210,3060,1638,172,5221,0,32756,201,14459,12821,7952,15065
2021-04-23 16:00:00+00,15996,336,4939,2494,282,3206,1640,172,4203,0,33268,216,13558,11918,6979,16332
2021-04-23 16:30:00+00,16533,356,4992,2535,360,3412,1658,179,3303,180,33508,224,12848,11190,6198,16889
2021-04-23 17:00:00+00,17348,237,4999,2555,491,3348,1698,237,2290,206,33409,233,12033,10335,5336,17585
2021-04-23 17:30:00+00,17747,230,4992,2576,512,3406,1712,236,1438,486,33335,239,11230,9518,4526,17977
2021-04-23 18:00:00+00,17791,215,4996,2626,529,3516,1708,192,715,724,33012,241,10574,8866,3870,18006
2021-04-23 18:30:00+00,18373,179,4999,2674,529,3432,1695,186,203,646,32916,246,10100,8405,3406,18552
2021-04-23 19:00:00+00,18485,143,5007,2635,457,3584,1626,195,7,588,32727,250,9732,8106,3099,18628
2021-04-23 19:30:00+00,18543,108,5002,2758,437,3492,1689,161,0,496,32686,249,9886,8197,3195,18650
2021-04-23 20:00:00+00,18410,72,5002,2859,371,2906,1690,234,0,448,31991,247,9922,8232,3230,18482
2021-04-23 20:30:00+00,17698,36,5001,2948,313,2692,1704,280,0,20,30692,245,9966,8262,3261,17734
2021-04-23 21:00:00+00,16544,0,5003,3047,276,2992,1695,153,0,0,29710,236,10021,8326,3323,16544
2021-04-23 21:30:00+00,14804,0,5005,3284,327,3028,1427,105,0,14,27994,225,10043,8616,3611,14804
2021-04-23 22:00:00+00,13409,0,4996,3510,327,2842,1108,104,0,256,26552,216,9941,8833,3837,13409
2021-04-23 22:30:00+00,12112,0,4994,3640,326,3040,1143,105,0,0,25360,210,10103,8960,3966,12112
2021-04-23 23:00:00+00,11316,0,5013,3828,297,2906,1145,105,0,0,24610,202,10283,9138,4125,11316
2021-04-23 23:30:00+00,11114,0,5026,3886,275,2950,1143,105,0,0,24498,201,10330,9186,4160,11114
2021-04-24 00:00:00+00,11143,0,5038,3900,253,3076,1142,106,0,0,24658,198,10333,9191,4153,11143
2021-04-24 00:30:00+00,11172,0,5069,3858,254,3150,1146,106,0,0,24755,199,10327,9181,4112,11172
2021-04-24 01:00:00+00,11076,0,5074,3715,244,3258,1142,105,0,0,24614,201,10175,9033,3959,11076
2021-04-24 01:30:00+00,10865,0,5098,3828,238,3294,1138,105,0,0,24566,198,10302,9164,4066,10865
2021-04-24 02:00:00+00,10709,0,5106,3863,238,3278,1147,106,0,0,24447,196,10354,9207,4101,10709
2021-04-24 02:30:00+00,10683,0,5113,3828,236,3258,1149,104,0,0,24371,196,10326,9177,4064,10683
2021-04-24 03:00:00+00,10827,0,5149,3704,219,2998,1150,105,0,0,24152,199,10222,9072,3923,10827
2021-04-24 03:30:00+00,10790,0,5154,3592,219,3008,1150,105,0,0,24018,200,10115,8965,3811,10790
2021-04-24 04:00:00+00,10806,0,5186,3465,219,3176,1150,104,0,0,24106,199,10020,8870,3684,10806
2021-04-24 04:30:00+00,10792,0,5191,3381,219,3218,1152,104,0,0,24057,200,9943,8791,3600,10792
2021-04-24 05:00:00+00,11006,0,5191,3282,243,3144,1152,105,137,0,24260,203,10005,8853,3662,11006
2021-04-24 05:30:00+00,11523,0,5188,3110,244,3145,1151,106,668,130,25265,203,10361,9210,4022,11523
2021-04-24 06:00:00+00,12399,0,5189,3006,257,3480,1150,107,1391,62,27041,200,10993,9843,4654,12399
2021-04-24 06:30:00+00,13056,0,5183,2911,285,3528,1150,124,2232,0,28469,200,11761,10611,5428,13056
2021-04-24 07:00:00+00,13394,0,5182,2862,342,3322,1152,202,3086,176,29718,193,12624,11472,6290,13394
2021-04-24 07:30:00+00,13403,0,5187,2806,345,3386,1149,242,3923,288,30729,189,13410,12261,7074,13403
2021-04-24 08:00:00+00,13530,0,5174,2771,345,3354,1153,301,4836,56,31520,186,14279,13126,7952,13530
2021-04-24 08:30:00+00,13288,0,5184,2826,344,3300,1150,296,5705,0,32093,178,15209,14059,8875,13288
2021-04-24 09:00:00+00,12911,0,5163,2847,296,3046,1152,132,6393,0,31940,169,15851,14699,9536,12911
2021-04-24 09:30:00+00,12650,0,5161,2809,261,3004,1154,136,7232,4,32411,163,16617,15463,10302,12650
2021-04-24 10:00:00+00,12367,0,5167,2901,201,3004,1148,144,7667,0,32599,159,17084,15936,10769,12367
2021-04-24 10:30:00+00,11915,0,5175,3066,196,3004,1141,106,8330,0,32933,152,17908,16767,11592,11915
2021-04-24 11:00:00+00,11447,0,5174,3166,196,3004,1140,127,8661,0,32915,146,18337,17197,12023,11447
2021-04-24 11:30:00+00,10980,0,5164,3086,187,3004,1141,148,8975,0,32685,142,18553,17412,12248,10980
2021-04-24 12:00:00+00,10388,0,5167,3087,158,3004,1140,147,8966,0,32057,137,18518,17378,12211,10388
2021-04-24 12:30:00+00,9360,0,5167,3114,157,3004,1142,147,8822,0,30913,129,18402,17260,12093,9360
2021-04-24 13:00:00+00,9042,0,5162,3193,139,2858,1142,147,8644,0,30327,127,18280,17138,11976,9042
2021-04-24 13:30:00+00,8634,0,5164,3241,138,2874,1138,147,8229,0,29565,126,17910,16772,11608,8634
2021-04-24 14:00:00+00,8889,0,5173,3266,138,2872,1140,146,7597,0,29221,130,17314,16174,11001,8889
2021-04-24 14:30:00+00,9399,0,5163,3309,138,2872,1120,146,7091,0,29238,137,16821,15701,10538,9399
2021-04-24 15:00:00+00,9925,0,5154,3515,175,3038,1111,148,6258,0,29324,144,16213,15102,9948,9925
2021-04-24 15:30:00+00,10872,0,5149,3828,220,3038,1111,150,5161,0,29529,156,15469,14358,9209,10872
2021-04-24 16:00:00+00,11886,0,5161,4395,329,3038,1108,164,4317,0,30398,165,15310,14202,9041,11886
2021-04-24 16:30:00+00,13010,0,5188,4660,373,3122,1108,170,3355,4,30990,177,14684,13576,8388,13010
2021-04-24 17:00:00+00,13549,0,5198,4718,415,3224,1126,358,2446,66,31100,187,13903,12777,7579,13549
2021-04-24 17:30:00+00,13621,0,5196,4813,431,3282,1135,413,1580,264,30735,191,13155,12020,6824,13621
2021-04-24 18:00:00+00,13666,0,5201,4943,452,3446,1128,401,826,710,30772,194,12550,11422,6221,13666
2021-04-24 18:30:00+00,13677,0,5201,4860,449,3469,1135,455,239,816,30301,198,11884,10749,5548,13677
2021-04-24 19:00:00+00,13811,0,5208,4873,423,3520,1141,460,10,544,29991,202,11655,10514,5306,13811
2021-04-24 19:30:00+00,13882,0,5206,5395,393,3446,1148,313,0,544,30327,199,12142,10994,5788,13882
2021-04-24 20:00:00+00,13740,0,5211,5814,308,3288,1145,285,0,646,30437,194,12478,11333,6122,13740
2021-04-24 20:30:00+00,13379,0,5210,6098,296,3160,1146,269,0,42,29600,192,12750,11604,6394,13379
2021-04-24 21:00:00+00,12254,0,5211,6404,270,3006,1140,145,0,0,28430,183,13025,11885,6674,12254
2021-04-24 21:30:00+00,10793,0,5206,6530,289,2928,1143,144,0,0,27033,170,13168,12025,6819,10793
2021-04-24 22:00:00+00,9380,0,5219,6427,280,2794,1147,146,0,30,25423,159,13073,11926,6707,9380
2021-04-24 22:30:00+00,8629,0,5238,6244,279,2770,1145,144,0,0,24449,152,12906,11761,6523,8629
2021-04-24 23:00:00+00,9029,0,5239,5984,279,2416,1138,144,0,0,24228,158,12640,11502,6262,9029
2021-04-24 23:30:00+00,8840,0,5238,5787,249,2412,1132,147,0,0,23805,158,12406,11274,6036,8840
2021-04-25 00:00:00+00,8923,0,5248,5583,218,2330,1130,146,0,0,23578,161,12179,11049,5801,8923
2021-04-25 00:30:00+00,9031,0,5245,5423,218,2418,1136,148,0,0,23619,164,12022,10886,5641,9031
2021-04-25 01:00:00+00,8818,0,5246,5285,202,2556,1139,149,0,0,23395,163,11872,10733,5487,8818
2021-04-25 01:30:00+00,8499,0,5263,5015,204,2584,1139,147,0,0,22851,162,11621,10482,5219,8499
2021-04-25 02:00:00+00,8818,0,5298,4931,204,2578,1146,144,0,0,23119,165,11579,10433,5135,8818
2021-04-25 02:30:00+00,9002,0,5328,4842,202,2549,1145,143,0,0,23211,167,11517,10372,5044,9002
2021-04-25 03:00:00+00,8597,0,5349,4845,185,2672,1150,144,0,0,22941,164,11529,10379,5030,8597
2021-04-25 03:30:00+00,8394,0,5354,4930,159,2672,1148,140,0,0,22797,162,11591,10443,5089,8394
2021-04-25 04:00:00+00,8295,0,5368,4883,156,2646,1143,134,0,0,22625,161,11550,10407,5039,8295
2021-04-25 04:30:00+00,8127,0,5375,4881,156,2660,1139,132,0,0,22470,159,11551,10412,5037,8127
2021-04-25 05:00:00+00,8314,0,5367,5025,155,2860,1138,130,168,0,23157,159,11853,10715,5348,8314
2021-04-25 05:30:00+00,8828,0,5374,4835,169,2878,1127,118,690,0,24019,162,12195,11068,5694,8828
2021-04-25 06:00:00+00,9249,0,5371,4958,186,2676,1121,118,1393,0,25072,158,13029,11908,6537,9249
2021-04-25 06:30:00+00,9464,0,5369,5207,191,2576,1123,122,2220,0,26272,152,14110,12987,7618,9464
2021-04-25 07:00:00+00,9753,0,5370,5219,235,2854,1122,123,3123,0,27799,148,15069,13947,8577,9753
2021-04-25 07:30:00+00,9975,0,5365,5258,243,2856,1113,122,3940,0,28872,145,15919,14806,9441,9975
2021-04-25 08:00:00+00,10434,0,5359,5278,289,2858,1106,145,4538,0,30007,146,16570,15464,10105,10434
2021-04-25 08:30:00+00,10530,0,5363,4852,289,2858,1105,268,5415,0,30680,145,17024,15919,10556,10530
2021-04-25 09:00:00+00,10562,0,5349,4721,289,2856,1111,285,6164,14,31351,143,17634,16523,11174,10562
2021-04-25 09:30:00+00,10473,0,5346,4643,290,2856,1112,281,6798,44,31843,140,18189,17077,11731,10473
2021-04-25 10:00:00+00,10594,0,5343,4330,239,2782,1101,263,7365,192,32209,139,18378,17277,11934,10594
2021-04-25 10:30:00+00,10552,0,5342,3915,250,2780,1101,253,7700,110,32003,139,18308,17207,11865,10552
2021-04-25 11:00:00+00,10748,0,5345,3801,253,2784,1104,279,8115,64,32493,140,18618,17514,12169,10748
2021-04-25 11:30:00+00,10732,0,5349,3682,245,2784,1113,312,8339,0,32556,140,18728,17615,12266,10732
2021-04-25 12:00:00+00,10701,0,5349,3579,218,2784,1137,306,8550,0,32624,139,18833,17696,12347,10701
2021-04-25 12:30:00+00,10578,0,5355,3643,198,2784,1141,301,8586,0,32586,138,18923,17782,12427,10578
2021-04-25 13:00:00+00,10473,0,5354,3601,197,2782,1143,155,8270,0,31975,138,18565,17422,12068,10473
2021-04-25 13:30:00+00,10453,0,5354,3686,196,2782,1144,118,7721,0,31454,139,18101,16957,11603,10453
2021-04-25 14:00:00+00,10392,0,5359,3838,212,2794,1143,121,7038,0,30897,141,17590,16447,11088,10392
2021-04-25 14:30:00+00,10920,0,5358,4038,214,2794,1146,119,6545,0,31134,147,17301,16155,10797,10920
2021-04-25 15:00:00+00,11557,0,5377,4275,230,3002,1147,118,5661,0,31367,154,16690,15543,10166,11557
2021-04-25 15:30:00+00,12681,0,5381,4444,278,3004,1145,120,4931,0,31984,165,16179,15034,9653,12681
2021-04-25 16:00:00+00,13754,0,5380,4977,404,3024,1147,132,4120,0,32938,173,16028,14881,9501,13754
2021-04-25 16:30:00+00,14417,0,5371,5096,425,3024,1149,187,3320,52,33041,181,15361,14212,8841,14417
2021-04-25 17:00:00+00,14988,0,5379,5226,446,3018,1149,282,2408,304,33200,188,14608,13459,8080,14988
2021-04-25 17:30:00+00,15157,0,5378,5401,447,3018,1147,274,1566,454,32842,192,13939,12792,7414,15157
2021-04-25 18:00:00+00,15042,0,5381,5637,449,3018,1139,310,789,886,32651,192,13395,12256,6875,15042
2021-04-25 18:30:00+00,15001,0,5382,5639,449,3016,1141,307,231,940,32106,194,12842,11701,6319,15001
2021-04-25 19:00:00+00,15027,0,5378,5565,426,3014,1145,250,12,1098,31915,195,12526,11381,6003,15027
2021-04-25 19:30:00+00,15143,0,5380,5402,389,3014,1150,255,0,1066,31799,198,12321,11171,5791,15143
2021-04-25 20:00:00+00,15165,0,5381,5400,318,2992,1151,255,0,926,31588,199,12250,11099,5718,15165
2021-04-25 20:30:00+00,15004,0,5388,5373,278,2994,1109,184,0,88,30418,204,12148,11039,5651,15004
2021-04-25 21:00:00+00,14055,0,5381,5203,266,3004,1071,120,0,104,29204,199,11921,10850,5469,14055
2021-04-25 21:30:00+00,12953,0,5409,4973,304,3000,1090,119,0,52,27900,193,11776,10686,5277,12953
2021-04-25 22:00:00+00,11587,0,5457,4895,303,2710,1098,119,0,24,26193,184,11753,10655,5198,11587
2021-04-25 22:30:00+00,10521,0,5488,4747,301,2708,1109,119,0,0,24993,176,11645,10536,5048,10521
2021-04-25 23:00:00+00,10256,0,5494,4586,289,2704,1142,118,0,0,24589,175,11511,10369,4875,10256
2021-04-25 23:30:00+00,9916,0,5527,4587,256,2704,1135,118,0,0,24243,172,11505,10370,4843,9916
2021-04-26 00:00:00+00,10010,0,5545,4458,234,2708,1134,120,0,0,24209,177,11371,10237,4692,10010
2021-04-26 00:30:00+00,10345,0,5563,4317,234,2708,1137,122,0,0,24426,181,11251,10114,4551,10345
2021-04-26 01:00:00+00,10402,0,5596,4132,217,2708,1137,121,0,0,24313,183,11082,9945,4349,10402
2021-04-26 01:30:00+00,10399,0,5593,4036,219,2708,1137,119,0,0,24211,183,10985,9848,4255,10399
2021-04-26 02:00:00+00,10416,0,5598,4022,220,2708,1138,119,0,0,24221,183,10978,9840,4242,10416
2021-04-26 02:30:00+00,10573,0,5596,4048,218,2708,1138,119,0,0,24400,185,11000,9862,4266,10573
2021-04-26 03:00:00+00,10638,0,5603,4149,201,2708,1138,118,0,0,24555,184,11091,9953,4350,10638
2021-04-26 03:30:00+00,10760,3,5612,4250,200,2696,1136,116,0,0,24773,185,11198,10062,4450,10762
2021-04-26 04:00:00+00,11567,5,5608,4269,217,1788,1130,120,0,0,24704,196,11224,10094,4486,11572
2021-04-26 04:30:00+00,12178,25,5614,4365,213,1754,1136,118,0,0,25403,201,11328,10192,4578,12203
2021-04-26 05:00:00+00,14583,108,5611,4376,249,1398,1139,123,121,88,27796,220,11496,10357,4746,14691
2021-04-26 05:30:00+00,16529,259,5614,4414,248,1432,1136,201,553,100,30486,232,11966,10830,5216,16788
2021-04-26 06:00:00+00,17397,407,5612,4403,260,2740,1138,253,1106,390,33706,227,12519,11381,5769,17804
2021-04-26 06:30:00+00,18322,485,5611,4258,261,2770,1139,222,1749,1086,35903,225,13018,11879,6268,18807
2021-04-26 07:00:00+00,18493,490,5612,4106,261,2859,1137,359,2447,1408,37172,220,13563,12426,6814,18983
2021-04-26 07:30:00+00,18278,490,5612,4187,263,2860,1135,464,3099,1154,37542,217,14296,13161,7549,18768
2021-04-26 08:00:00+00,18317,486,5102,4266,283,3002,1134,417,3974,1248,38229,213,14759,13625,8523,18803
2021-04-26 08:30:00+00,18311,472,5087,4236,290,3004,1133,308,5174,606,38621,209,15920,14787,9700,18783
2021-04-26 09:00:00+00,18242,451,5084,4303,248,2674,1143,368,6178,94,38785,207,16956,15813,10729,18693
2021-04-26 09:30:00+00,17729,410,5103,4368,246,2644,1143,339,7132,0,39114,199,17992,16849,11746,18139
2021-04-26 10:00:00+00,17574,326,5091,4450,209,2514,1134,223,7966,0,39487,192,18850,17716,12625,17900
2021-04-26 10:30:00+00,16932,305,5101,4562,201,2510,1127,121,8464,0,39323,186,19455,18328,13227,17237
2021-04-26 11:00:00+00,16669,282,5084,4506,197,2412,1133,120,8772,0,39175,183,19692,18559,13475,16951
2021-04-26 11:30:00+00,16229,295,5088,4652,199,2406,1105,119,8970,0,39063,179,20014,18909,13821,16524
2021-04-26 12:00:00+00,15333,237,5085,4655,154,2990,1078,121,8911,0,38564,171,19883,18805,13720,15570
2021-04-26 12:30:00+00,14533,229,5096,4848,152,3004,1073,121,8820,0,37876,166,19989,18916,13820,14762
2021-04-26 13:00:00+00,14298,231,5092,5001,150,3004,1069,124,8381,0,37350,166,19693,18624,13532,14529
2021-04-26 13:30:00+00,14208,229,5097,5217,151,3004,1072,119,7899,0,36996,167,19436,18364,13267,14437
2021-04-26 14:00:00+00,14149,229,5092,5159,153,3004,1073,127,7380,0,36366,169,18857,17784,12692,14378
2021-04-26 14:30:00+00,14521,229,5093,5284,160,3006,1075,145,6447,0,35960,175,18059,16984,11891,14750
2021-04-26 15:00:00+00,15827,230,5093,5290,200,2880,1073,140,5674,0,36407,187,17330,16257,11164,16057
2021-04-26 15:30:00+00,16713,274,5088,5277,249,2876,1067,186,4830,0,36560,197,16511,15444,10356,16987
2021-04-26 16:00:00+00,17562,406,5089,5007,392,2990,1073,365,3908,122,36914,209,15469,14396,9307,17968
2021-04-26 16:30:00+00,17692,406,5091,4888,418,2990,1088,479,2908,710,36670,213,14393,13305,8214,18098
2021-04-26 17:00:00+00,18021,405,5097,4644,435,3024,1069,472,1999,1204,36370,219,13244,12175,7078,18426
2021-04-26 17:30:00+00,18469,414,5106,4393,438,3026,1063,476,1339,1214,35938,226,12339,11276,6170,18883
2021-04-26 18:00:00+00,18625,360,5117,4367,447,3022,1061,416,624,1458,35497,229,11616,10555,5438,18985
2021-04-26 18:30:00+00,18926,257,5116,4418,448,3024,1063,314,179,1420,35165,231,11224,10161,5045,19183
2021-04-26 19:00:00+00,18876,239,5120,4389,433,3024,1071,291,9,1560,35012,230,11022,9951,4831,19115
2021-04-26 19:30:00+00,18917,239,5124,4317,418,3026,1070,289,0,1392,34792,232,10929,9859,4735,19156
2021-04-26 20:00:00+00,18970,374,5124,4428,344,3006,1069,399,0,432,34146,242,10965,9896,4772,19344
2021-04-26 20:30:00+00,17738,248,5129,4603,299,3004,1112,213,0,12,32358,235,11143,10031,4902,17986
2021-04-26 21:00:00+00,17155,0,5128,4506,277,2542,1130,149,0,20,30907,230,11041,9911,4783,17155
2021-04-26 21:30:00+00,15256,0,5124,4496,285,2516,1135,137,0,18,28967,219,11040,9905,4781,15256
2021-04-26 22:00:00+00,12963,0,5124,4445,285,2994,1133,119,0,2,27065,202,10987,9854,4730,12963
2021-04-26 22:30:00+00,12558,0,5125,4394,283,3004,1137,116,0,0,26616,199,10939,9802,4677,12558
2021-04-26 23:00:00+00,12150,0,5127,4221,255,2850,1137,116,0,0,25855,198,10740,9603,4476,12150
2021-04-26 23:30:00+00,12193,0,5130,4101,232,2835,1144,119,0,0,25754,200,10607,9463,4333,12193
2021-04-27 00:00:00+00,12182,0,5129,3886,212,2889,1141,119,0,0,25557,203,10368,9227,4098,12182
2021-04-27 00:30:00+00,12270,0,5130,3538,212,2851,1139,121,0,0,25260,206,10019,8880,3750,12270
2021-04-27 01:00:00+00,12200,0,5123,3331,194,2810,1150,120,0,0,24927,208,9798,8648,3525,12200
2021-04-27 01:30:00+00,12003,0,5114,3294,193,2764,1185,120,0,0,24673,207,9786,8601,3487,12003
2021-04-27 02:00:00+00,11935,0,5096,3149,193,2708,1234,120,0,0,24435,208,9672,8438,3342,11935
2021-04-27 02:30:00+00,11916,0,5087,3052,191,2661,1297,118,0,0,24322,209,9627,8330,3243,11916
2021-04-27 03:00:00+00,11952,0,5073,2937,173,2493,1361,162,0,0,24152,212,9544,8183,3110,11952
2021-04-27 03:30:00+00,11879,0,5059,2850,173,2457,1451,217,0,0,24086,213,9533,8082,3023,11879
2021-04-27 04:00:00+00,12023,0,5043,2806,234,2037,1689,184,0,318,24333,213,9772,8083,3040,12023
2021-04-27 04:30:00+00,12150,0,5028,2878,241,1953,1966,154,1,136,24507,213,10114,8148,3120,12150
2021-04-27 05:00:00+00,12754,0,5010,2887,283,2059,2150,116,113,0,25372,216,10443,8293,3283,12754
2021-04-27 05:30:00+00,13542,120,4992,3007,283,2025,2570,132,457,6,27135,219,11309,8739,3747,13662
2021-04-27 06:00:00+00,14744,392,4977,3027,416,2267,2875,134,962,160,29954,225,12257,9382,4405,15136
2021-04-27 06:30:00+00,15779,489,4963,3066,431,2233,2927,184,1596,288,31957,227,12983,10056,5093,16268
2021-04-27 07:00:00+00,16773,480,4949,3137,434,2270,2887,210,2087,620,33847,227,13494,10607,5658,17253
2021-04-27 07:30:00+00,17243,353,4920,3207,430,2240,2881,150,2620,1044,35088,220,14058,11177,6257,17596
2021-04-27 08:00:00+00,17523,351,4707,3387,286,2277,2935,132,3223,798,35619,220,14538,11603,6896,17874
2021-04-27 08:30:00+00,17668,395,4702,3384,280,2048,2815,134,3602,534,35561,222,14783,11968,7266,18063
2021-04-27 09:00:00+00,17665,491,4705,3624,232,2011,2885,186,4006,42,35847,223,15452,12567,7862,18156
2021-04-27 09:30:00+00,17625,457,4702,3902,220,2120,2869,185,4346,0,36426,218,16039,13170,8468,18082
2021-04-27 10:00:00+00,17576,428,4701,4291,217,2061,2809,134,4620,126,36963,213,16638,13829,9128,18004
2021-04-27 10:30:00+00,17482,423,4696,4627,196,2018,2791,153,4816,80,37282,210,17126,14335,9639,17905
2021-04-27 11:00:00+00,17432,420,4698,4864,195,1987,2848,230,4607,0,37281,210,17212,14364,9666,17852
2021-04-27 11:30:00+00,17308,340,4693,5050,195,1955,2863,284,4658,0,37346,207,17459,14596,9903,17648
2021-04-27 12:00:00+00,17176,3,4693,5105,176,1899,2901,259,4861,122,37194,198,17736,14835,10142,17179
2021-04-27 12:30:00+00,16871,0,4692,5160,175,1861,2888,278,4961,44,36931,196,17876,14988,10296,16871
2021-04-27 13:00:00+00,16962,0,4698,5280,175,1811,2911,331,4805,0,36973,197,17869,14958,10260,16962
2021-04-27 13:30:00+00,16647,0,4697,5425,175,1769,2925,340,4281,0,36259,198,17503,14578,9881,16647
2021-04-27 14:00:00+00,16886,0,4699,5532,190,1748,3050,354,3735,0,36194,201,17206,14156,9457,16886
2021-04-27 14:30:00+00,17337,0,4695,5604,193,1704,3090,370,3366,174,36532,205,16948,13858,9163,17337
2021-04-27 15:00:00+00,17464,0,4702,5918,202,1630,3094,378,2899,180,36467,206,16815,13721,9019,17464
2021-04-27 15:30:00+00,17775,0,4701,6230,263,1609,3094,450,2285,656,37063,207,16573,13479,8778,17775
2021-04-27 16:00:00+00,18029,0,4701,6163,307,1672,3094,414,1680,770,36830,210,15945,12851,8150,18029
2021-04-27 16:30:00+00,18236,0,4697,6135,336,1654,3081,345,1249,802,36535,214,15498,12417,7720,18236
2021-04-27 17:00:00+00,18170,0,4695,6228,462,1736,3069,323,934,946,36563,213,15388,12319,7624,18170
2021-04-27 17:30:00+00,18099,0,4698,6504,463,1765,3072,270,579,742,36192,215,15316,12244,7546,18099
2021-04-27 18:00:00+00,18001,0,4702,6821,482,1661,3059,285,349,864,36224,213,15413,12354,7652,18001
2021-04-27 18:30:00+00,17729,0,4704,7162,481,1616,3072,278,115,538,35694,213,15534,12462,7758,17729
2021-04-27 19:00:00+00,17503,0,4703,7623,386,1627,3073,261,4,0,35179,214,15789,12716,8013,17503
2021-04-27 19:30:00+00,17272,0,4705,7859,338,1478,3070,186,0,0,34908,211,15972,12902,8197,17272
2021-04-27 20:00:00+00,17492,0,4703,7845,296,1266,3067,159,0,0,34828,214,15911,12844,8141,17492
2021-04-27 20:30:00+00,16446,0,4705,7581,266,882,3025,152,0,0,33057,212,15577,12552,7847,16446
2021-04-27 21:00:00+00,15284,0,4706,7374,252,966,2661,153,0,0,31396,207,14993,12332,7626,15284
2021-04-27 21:30:00+00,13776,0,4707,7499,249,966,2078,153,0,0,29428,199,14533,12455,7748,13776
2021-04-27 22:00:00+00,10541,0,4706,7721,231,1998,1501,151,0,0,26849,170,14159,12658,7952,10541
2021-04-27 22:30:00+00,9298,0,4704,7748,229,2528,1157,153,0,0,25817,160,13838,12681,7977,9298
2021-04-27 23:00:00+00,9046,0,4701,7835,204,2420,1159,152,0,0,25517,159,13899,12740,8039,9046
2021-04-27 23:30:00+00,8942,0,4698,7896,191,2432,1161,152,0,0,25472,158,13946,12785,8087,8942
2021-04-28 00:00:00+00,8946,0,4696,7952,174,2450,1162,154,0,0,25534,158,13984,12822,8126,8946
2021-04-28 00:30:00+00,9167,0,4694,7803,176,2521,1162,135,0,0,25658,162,13835,12673,7979,9167
2021-04-28 01:00:00+00,9383,0,4693,7611,161,2624,1162,124,0,0,25758,166,13627,12465,7772,9383
2021-04-28 01:30:00+00,9478,0,4693,7364,160,2617,1161,123,0,0,25596,168,13378,12217,7524,9478
2021-04-28 02:00:00+00,9309,0,4697,7326,157,2548,1160,120,0,0,25317,169,13340,12180,7483,9309
2021-04-28 02:30:00+00,9428,0,4695,7277,157,2438,1146,119,0,0,25260,169,13275,12129,7434,9428
2021-04-28 03:00:00+00,9348,0,4695,7313,139,2128,1144,122,0,0,24889,171,13291,12147,7452,9348
2021-04-28 03:30:00+00,9000,0,4692,7373,139,2074,1146,121,0,0,24545,168,13350,12204,7512,9000
2021-04-28 04:00:00+00,9648,0,4692,7506,197,1077,1146,121,0,0,24387,177,13541,12395,7703,9648
2021-04-28 04:30:00+00,10651,0,4695,7400,204,950,1168,117,4,14,25203,185,13471,12303,7608,10651
2021-04-28 05:00:00+00,12506,0,4702,7590,260,726,1499,117,88,0,27488,196,14139,12640,7938,12506
2021-04-28 05:30:00+00,13872,0,4699,7879,262,770,1751,120,305,0,29658,202,14896,13145,8446,13872
2021-04-28 06:00:00+00,14868,0,4700,8084,370,1606,1806,128,571,32,32165,197,15531,13725,9025,14868
2021-04-28 06:30:00+00,15862,0,4702,8329,372,1642,1793,180,1035,704,34619,193,16231,14438,9736,15862
2021-04-28 07:00:00+00,15822,0,4708,8892,372,2748,1759,163,1630,190,36284,185,17361,15602,10894,15822
2021-04-28 07:30:00+00,15784,0,4710,9224,389,2798,1753,129,2062,118,36967,181,18138,16385,11675,15784
2021-04-28 08:00:00+00,15688,0,4702,9537,300,2994,1752,133,2565,0,37671,176,18856,17104,12402,15688
2021-04-28 08:30:00+00,15617,0,4708,9626,280,2998,1724,127,3093,0,38174,173,19432,17708,13000,15617
2021-04-28 09:00:00+00,15749,0,4704,9379,199,2420,1749,125,3506,218,38049,174,19537,17788,13084,15749
2021-04-28 09:30:00+00,15947,0,4702,9346,205,2374,1764,122,3705,0,38165,176,19722,17958,13256,15947
2021-04-28 10:00:00+00,16027,0,4705,9286,201,2204,1777,124,3914,0,38238,176,19883,18106,13401,16027
2021-04-28 10:30:00+00,16056,0,4712,9259,183,2158,1780,120,3671,0,37939,178,19605,17825,13113,16056
2021-04-28 11:00:00+00,15915,0,4701,9179,182,2644,1778,131,3419,0,37949,177,19259,17481,12780,15915
2021-04-28 11:30:00+00,16014,0,4695,8897,181,2650,1767,121,3472,132,37929,178,19012,17245,12550,16014
2021-04-28 12:00:00+00,15419,0,4701,9297,166,2943,1773,118,3499,0,37915,172,19436,17663,12962,15419
2021-04-28 12:30:00+00,15274,0,4693,8961,163,2949,1788,119,3901,0,37848,171,19506,17718,13025,15274
2021-04-28 13:00:00+00,15477,0,4690,8703,141,2978,1785,122,4020,0,37916,173,19339,17554,12864,15477
2021-04-28 13:30:00+00,15457,0,4696,8631,141,2977,1784,119,3810,0,37615,174,19062,17278,12582,15457
2021-04-28 14:00:00+00,15500,0,4698,8761,137,2936,1789,121,3470,62,37474,175,18855,17066,12368,15500
2021-04-28 14:30:00+00,16165,0,4701,8665,139,2936,1943,129,3074,70,37822,181,18522,16579,11878,16165
2021-04-28 15:00:00+00,16477,0,4707,8695,179,3024,2096,224,2842,0,38244,184,18519,16423,11716,16477
2021-04-28 15:30:00+00,16774,0,4707,8672,200,3026,2078,329,2530,322,38638,186,18187,16109,11402,16774
2021-04-28 16:00:00+00,17154,0,4704,8477,364,2848,2178,345,1974,784,38828,188,17697,15519,10815,17154
2021-04-28 16:30:00+00,17499,0,4704,8388,432,2849,2263,289,1513,850,38787,192,17300,15037,10333,17499
2021-04-28 17:00:00+00,17507,0,4702,8290,577,2978,2202,252,1031,1252,38791,192,16802,14600,9898,17507
2021-04-28 17:30:00+00,17778,0,4699,8195,577,2974,2149,248,685,1038,38343,197,16305,14156,9457,17778
2021-04-28 18:00:00+00,18036,0,4696,8101,576,2952,2108,211,415,678,37773,202,15896,13788,9092,18036
2021-04-28 18:30:00+00,18087,0,4694,7829,560,2954,2106,234,165,584,37213,206,15354,13248,8554,18087
2021-04-28 19:00:00+00,18172,0,4695,7668,403,3022,2156,278,15,376,36785,210,14937,12781,8086,18172
2021-04-28 19:30:00+00,18113,0,4696,7430,350,3022,2166,262,0,460,36499,211,14642,12476,7780,18113
2021-04-28 20:00:00+00,17637,0,4701,7315,294,2950,2169,176,0,534,35776,209,14479,12310,7609,17637
2021-04-28 20:30:00+00,16535,0,4700,7402,264,2950,2005,128,0,40,34024,206,14371,12366,7666,16535
2021-04-28 21:00:00+00,15296,0,4700,7324,251,2744,1704,118,0,66,32203,201,13979,12275,7575,15296
2021-04-28 21:30:00+00,13989,0,4704,7125,263,2742,1482,118,0,0,30423,195,13574,12092,7388,13989
2021-04-28 22:00:00+00,12504,0,4710,7066,263,2708,1163,118,0,0,28532,186,13202,12039,7329,12504
2021-04-28 22:30:00+00,11166,0,4713,7076,260,2706,1164,118,0,0,27203,175,13213,12049,7336,11166
2021-04-28 23:00:00+00,11087,0,4712,7053,192,2708,1165,117,0,0,27034,175,13122,11957,7245,11087
2021-04-28 23:30:00+00,10953,0,4703,6892,172,2708,1162,120,0,0,26710,175,12929,11767,7064,10953
2021-04-29 00:00:00+00,11049,0,4709,6698,173,2710,1163,117,0,0,26619,178,12743,11580,6871,11049
2021-04-29 00:30:00+00,11452,0,4708,6488,173,2709,1164,118,0,0,26813,182,12533,11369,6661,11452
2021-04-29 01:00:00+00,11367,0,4711,6309,155,2709,1168,118,0,0,26537,183,12343,11175,6464,11367
2021-04-29 01:30:00+00,11526,0,4704,6284,155,2708,1170,117,0,0,26664,184,12313,11143,6439,11526
2021-04-29 02:00:00+00,11442,0,4703,6284,155,2708,1168,118,0,0,26578,184,12310,11142,6439,11442
2021-04-29 02:30:00+00,11273,0,4707,6305,153,2708,1166,119,0,0,26431,182,12331,11165,6458,11273
2021-04-29 03:00:00+00,11262,0,4711,6261,136,2710,1152,118,0,0,26350,182,12260,11108,6397,11262
2021-04-29 03:30:00+00,11044,0,4707,6318,138,2704,1153,123,0,0,26187,180,12316,11163,6456,11044
2021-04-29 04:00:00+00,11296,0,4709,6246,182,2210,1207,119,0,0,25969,185,12344,11137,6428,11296
2021-04-29 04:30:00+00,12215,0,4709,6115,190,2188,1335,119,9,0,26880,193,12358,11023,6314,12215
2021-04-29 05:00:00+00,13907,0,4712,6171,268,1905,1857,155,223,0,29198,202,13231,11374,6662,13907
2021-04-29 05:30:00+00,15431,0,4710,6140,278,1906,2396,215,733,100,31909,206,14257,11861,7151,15431
2021-04-29 06:00:00+00,16618,0,4709,6067,326,2742,2729,277,1351,370,35189,204,15182,12453,7744,16618
2021-04-29 06:30:00+00,16899,0,4713,6034,328,2770,2993,381,2148,774,37040,198,16216,13223,8510,16899
2021-04-29 07:00:00+00,17006,0,4710,6065,328,3002,2969,389,3074,578,38121,194,17146,14177,9467,17006
2021-04-29 07:30:00+00,16973,0,4718,6124,328,3006,2870,342,4036,412,38809,189,18076,15206,10488,16973
2021-04-29 08:00:00+00,17166,0,4714,6103,294,3001,2864,247,4577,124,39090,189,18552,15688,10974,17166
2021-04-29 08:30:00+00,17008,0,4714,6079,282,3006,2865,140,5071,0,39165,187,19011,16146,11432,17008
2021-04-29 09:00:00+00,17020,0,4713,6089,204,2036,2861,161,5432,486,39002,185,19299,16438,11725,17020
2021-04-29 09:30:00+00,17218,0,4706,5995,203,2016,2871,202,5072,304,38587,190,18847,15976,11270,17218
2021-04-29 10:00:00+00,17186,0,4704,5702,191,1868,2862,333,5589,690,39125,187,19048,16186,11482,17186
2021-04-29 10:30:00+00,17173,0,4711,5539,236,1862,2804,321,4814,904,38364,191,18104,15300,10589,17173
2021-04-29 11:00:00+00,17247,0,4705,5361,248,2872,2797,308,4755,666,38959,191,17866,15069,10364,17247
2021-04-29 11:30:00+00,17674,0,4707,5478,201,2894,2797,281,4771,754,39557,193,17954,15157,10450,17674
2021-04-29 12:00:00+00,17870,0,4704,5455,182,3006,2825,263,4815,164,39284,196,17981,15156,10452,17870
2021-04-29 12:30:00+00,17969,0,4708,5478,181,3006,2882,196,5213,2,39635,194,18462,15580,10872,17969
2021-04-29 13:00:00+00,18038,12,4710,5534,164,3008,2910,123,5243,0,39742,194,18561,15651,10941,18050
2021-04-29 13:30:00+00,17536,24,4709,4980,162,3006,2823,124,4630,4,37998,198,17304,14481,9772,17560
2021-04-29 14:00:00+00,17852,36,4712,4755,162,3006,2756,119,4602,0,38000,201,16987,14231,9519,17888
2021-04-29 14:30:00+00,18028,48,4715,5071,162,3006,2843,119,4710,0,38702,200,17501,14658,9943,18076
2021-04-29 15:00:00+00,18796,60,4729,4821,161,3026,2831,131,4034,0,38589,209,16576,13745,9016,18856
2021-04-29 15:30:00+00,19644,188,4737,4785,207,3026,2826,150,2921,0,38484,221,15476,12650,7913,19832
2021-04-29 16:00:00+00,19812,390,4734,5138,308,2792,2830,220,2213,172,38609,227,15223,12393,7659,20202
2021-04-29 16:30:00+00,20365,485,4719,4811,354,2790,2840,229,1855,396,38844,234,14579,11739,7020,20850
2021-04-29 17:00:00+00,20410,485,4713,4480,421,2464,2831,284,1403,1060,38551,236,13848,11017,6304,20895
2021-04-29 17:30:00+00,20512,488,4710,3972,423,2466,2810,287,960,1270,37898,241,12875,10065,5355,21000
2021-04-29 18:00:00+00,20559,453,4704,3698,423,2876,2810,313,591,1112,37539,244,12226,9416,4712,21012
2021-04-29 18:30:00+00,20511,452,4704,3338,425,2886,2808,276,184,1154,36738,249,11459,8651,3947,20963
2021-04-29 19:00:00+00,20637,488,4707,3191,407,2770,2877,312,18,1000,36407,253,11200,8323,3616,21125
2021-04-29 19:30:00+00,20605,489,4703,3048,378,2770,2888,316,0,1002,36199,255,11017,8129,3426,21094
2021-04-29 20:00:00+00,20510,490,4707,2951,343,2928,2900,273,0,828,35930,255,10901,8001,3294,21000
2021-04-29 20:30:00+00,19957,489,4708,2837,312,2930,2949,146,0,22,34350,260,10806,7857,3149,20446
2021-04-29 21:00:00+00,19203,376,4713,2810,279,2658,2944,117,0,0,33100,257,10746,7802,3089,19579
2021-04-29 21:30:00+00,17689,32,4711,2625,305,2630,2948,118,0,0,31058,244,10589,7641,2930,17721
2021-04-29 22:00:00+00,16387,0,4710,2195,292,2538,2933,122,0,0,29177,241,10130,7197,2487,16387
2021-04-29 22:30:00+00,15600,0,4714,2147,271,2542,2909,120,0,0,28303,238,10041,7132,2418,15600
2021-04-29 23:00:00+00,15330,0,4715,2186,222,2600,2903,116,0,0,28072,236,10026,7123,2408,15330
2021-04-29 23:30:00+00,15084,0,4711,2092,219,2602,2908,116,0,0,27732,235,9930,7022,2311,15084
2021-04-30 00:00:00+00,14902,0,4708,2066,189,2798,2799,115,0,0,27577,235,9762,6963,2255,14902
2021-04-30 00:30:00+00,14924,0,4703,2063,190,2800,2815,115,0,0,27610,235,9771,6956,2253,14924
2021-04-30 01:00:00+00,14877,0,4707,1915,175,2809,2769,115,0,0,27367,236,9566,6797,2090,14877
2021-04-30 01:30:00+00,14715,0,4701,1948,174,2815,2737,116,0,0,27206,235,9560,6823,2122,14715
2021-04-30 02:00:00+00,14927,0,4693,1903,175,2802,2759,117,0,0,27375,237,9530,6771,2078,14927
2021-04-30 02:30:00+00,14918,0,4696,1926,174,2808,2794,117,0,0,27433,236,9590,6796,2100,14918
2021-04-30 03:00:00+00,15241,0,4699,1981,159,2771,2950,116,0,0,27917,237,9789,6839,2140,15241
2021-04-30 03:30:00+00,15429,0,4701,2020,165,2771,2973,117,0,0,28176,238,9859,6886,2185,15429
2021-04-30 04:00:00+00,15575,0,4706,1954,203,2654,2973,117,0,0,28182,240,9836,6863,2157,15575
2021-04-30 04:30:00+00,16029,122,4704,1754,208,2651,2976,117,14,0,28575,247,9656,6680,1976,16151
2021-04-30 05:00:00+00,17223,343,4706,1771,243,2374,2974,119,237,0,29990,256,9931,6957,2251,17566
2021-04-30 05:30:00+00,18743,481,4702,1891,237,2374,2975,133,741,0,32277,261,10546,7571,2869,19224
2021-04-30 06:00:00+00,19561,489,4706,1814,286,2673,2952,150,1518,28,34177,257,11276,8324,3618,20050
2021-04-30 06:30:00+00,19759,468,4708,1753,286,2686,2950,248,2278,454,35590,250,11975,9025,4317,20227
2021-04-30 07:00:00+00,19877,457,4711,1798,284,2750,2954,273,3103,804,37011,241,12850,9896,5185,20334
2021-04-30 07:30:00+00,19619,461,4710,1903,284,2763,2784,376,4061,586,37547,236,13742,10958,6248,20080
2021-04-30 08:00:00+00,19349,449,4708,1915,272,2871,2807,254,4754,734,38112,228,14456,11649,6941,19798
2021-04-30 08:30:00+00,19176,453,4711,1913,268,2885,2935,370,5308,182,38201,227,15135,12200,7489,19629
2021-04-30 09:00:00+00,19196,463,4708,1831,213,2922,2942,369,5754,100,38498,226,15448,12506,7798,19659
2021-04-30 09:30:00+00,19035,443,4712,1816,197,2938,2931,369,5785,140,38365,224,15441,12510,7798,19478
2021-04-30 10:00:00+00,19072,450,4708,1664,181,2949,2930,330,5347,312,37943,227,14830,11900,7192,19522
2021-04-30 10:30:00+00,19091,451,4706,1570,178,2966,2893,301,5399,358,37913,228,14746,11853,7147,19542
2021-04-30 11:00:00+00,19174,451,4709,1526,177,2978,2919,312,5368,186,37799,229,14699,11780,7071,19625
2021-04-30 11:30:00+00,19246,441,4705,1426,177,2994,2947,358,4932,0,37226,234,14187,11240,6535,19687
2021-04-30 12:00:00+00,19137,444,4705,1461,175,2822,3011,345,5224,174,37498,230,14576,11565,6860,19581
2021-04-30 12:30:00+00,18928,445,4702,1457,176,2818,3012,234,5249,36,37057,230,14596,11584,6882,19373
2021-04-30 13:00:00+00,18693,445,4702,1460,171,2606,3008,241,4924,98,36348,231,14265,11257,6555,19138
2021-04-30 13:30:00+00,18694,445,4703,1415,176,2606,3010,297,4855,0,36201,232,14159,11149,6446,19139
2021-04-30 14:00:00+00,18664,448,4702,1394,165,2808,3006,378,4664,0,36229,234,13931,10925,6223,19112
2021-04-30 14:30:00+00,18907,448,4701,1391,164,2810,3005,382,4557,0,36365,235,13818,10813,6112,19355
2021-04-30 15:00:00+00,18953,404,4697,1357,177,3024,3014,367,4048,144,36184,237,13293,10279,5582,19357
2021-04-30 15:30:00+00,18975,450,4702,1358,223,3025,3010,423,3773,660,36599,236,13066,10056,5354,19425
2021-04-30 16:00:00+00,19009,450,4701,1395,397,3024,3013,408,3168,1034,36600,236,12674,9661,4960,19459
2021-04-30 16:30:00+00,18996,450,4704,1378,431,3026,3010,555,2503,1358,36411,239,12026,9016,4312,19446
2021-04-30 17:00:00+00,18956,450,4704,1313,443,3026,3017,611,1780,1556,35856,242,11257,8240,3536,19406
2021-04-30 17:30:00+00,19221,451,4706,1282,442,3026,3015,649,1155,1868,35815,246,10600,7585,2879,19672
2021-04-30 18:00:00+00,19463,451,4706,1286,432,3024,3003,648,647,1740,35400,251,10074,7071,2365,19914
2021-04-30 18:30:00+00,19603,449,4703,1139,431,3026,3014,625,236,1410,34636,258,9523,6509,1806,20052
2021-04-30 19:00:00+00,19676,449,4701,934,421,3026,3019,535,24,1436,34221,261,9099,6080,1379,20125
2021-04-30 19:30:00+00,19386,448,4702,831,421,3028,3016,497,0,1472,33801,261,8970,5954,1252,19834
2021-04-30 20:00:00+00,19353,450,4704,813,346,3006,3014,428,0,1160,33274,264,8877,5863,1159,19803
2021-04-30 20:30:00+00,19150,449,4699,787,308,3004,2980,304,0,680,32361,268,8774,5794,1095,19599
2021-04-30 21:00:00+00,18988,450,4367,803,280,3004,2818,194,0,284,31188,274,8268,5450,1083,19438
2021-04-30 21:30:00+00,18487,449,4368,817,301,3005,2463,134,0,32,30056,275,7949,5486,1118,18936
2021-04-30 22:00:00+00,17627,336,4364,793,291,3008,2328,119,0,0,28866,271,7776,5448,1084,17963
2021-04-30 22:30:00+00,16181,182,4370,763,279,3006,2299,123,0,0,27203,261,7711,5412,1042,16363
2021-04-30 23:00:00+00,15547,0,4369,815,239,3006,2174,121,0,0,26271,254,7597,5423,1054,15547
2021-04-30 23:30:00+00,15353,0,4374,827,239,3006,2122,117,0,0,26038,253,7562,5440,1066,15353
2021-05-01 00:00:00+00,15197,0,4371,873,208,3006,2140,117,0,0,25912,247,7592,5452,1081,15197
2021-05-01 00:30:00+00,15315,0,4371,947,208,3006,2241,116,0,0,26204,247,7767,5526,1155,15315
2021-05-01 01:00:00+00,15404,0,4366,912,189,3006,2304,116,0,0,26297,247,7771,5467,1101,15404
2021-05-01 01:30:00+00,15219,0,4370,871,189,3006,2305,115,0,0,26075,247,7735,5430,1060,15219
2021-05-01 02:00:00+00,15112,0,4366,944,187,3006,2312,117,0,0,26044,245,7809,5497,1131,15112
2021-05-01 02:30:00+00,14765,0,4365,1018,185,3006,2311,115,0,0,25765,243,7879,5568,1203,14765
2021-05-01 03:00:00+00,14411,0,4362,967,167,3006,2311,120,0,0,25345,241,7807,5496,1134,14411
2021-05-01 03:30:00+00,14340,0,4364,889,166,3007,2311,119,0,0,25196,242,7730,5419,1055,14340
2021-05-01 04:00:00+00,14433,0,4368,858,170,3007,2313,118,0,0,25268,242,7709,5396,1028,14433
2021-05-01 04:30:00+00,14404,0,4372,945,181,3008,2309,117,21,0,25357,241,7828,5519,1147,14404
2021-05-01 05:00:00+00,14939,0,4369,1089,218,3008,2312,118,264,0,26317,240,8252,5940,1571,14939
2021-05-01 05:30:00+00,15377,0,4368,1020,243,3008,2311,119,767,0,27213,239,8709,6398,2030,15377
2021-05-01 06:00:00+00,15964,0,4368,1103,295,3008,2311,122,1447,0,28618,235,9524,7213,2845,15964
2021-05-01 06:30:00+00,16182,0,4365,1132,293,3008,2292,168,2253,0,29693,230,10335,8043,3678,16182
2021-05-01 07:00:00+00,16317,0,4367,1069,293,3006,2291,311,3210,260,31124,222,11230,8939,4572,16317
2021-05-01 07:30:00+00,16546,0,4368,1003,292,3008,2289,307,4139,332,32284,217,12091,9802,5434,16546
2021-05-01 08:00:00+00,16762,0,4369,970,282,3006,2280,312,4555,90,32626,217,12456,10176,5807,16762
2021-05-01 08:30:00+00,16692,0,4373,1025,290,3008,2274,306,5064,8,33040,214,13026,10752,6379,16692
2021-05-01 09:00:00+00,16669,0,4368,1146,290,3008,2280,321,5472,0,33554,210,13556,11276,6908,16669
2021-05-01 09:30:00+00,16732,0,4368,1154,262,3008,2279,258,5521,4,33586,210,13584,11305,6937,16732
2021-05-01 10:00:00+00,16763,0,4375,1168,234,3007,2280,229,5097,0,33153,213,13154,10874,6499,16763
2021-05-01 10:30:00+00,16806,0,4370,1165,226,3006,2281,240,5071,168,33333,213,13113,10832,6462,16806
2021-05-01 11:00:00+00,16821,0,4368,1235,206,3006,2280,236,5207,238,33597,211,13296,11016,6648,16821
2021-05-01 11:30:00+00,16792,0,4373,1318,206,3008,2281,223,5286,16,33503,211,13464,11183,6810,16792
2021-05-01 12:00:00+00,16723,0,4370,1347,192,3008,2280,144,5509,0,33573,209,13698,11418,7048,16723
2021-05-01 12:30:00+00,16377,0,4375,1449,191,3006,2248,150,5395,0,33191,208,13658,11410,7035,16377
2021-05-01 13:00:00+00,16043,0,4367,1486,191,3008,2168,166,5304,0,32733,206,13516,11348,6981,16043
2021-05-01 13:30:00+00,15543,0,4365,1583,191,3007,2235,121,5004,0,32049,204,13378,11143,6778,15543
2021-05-01 14:00:00+00,15460,0,4363,1698,191,3006,2263,119,4741,0,31841,205,13256,10993,6630,15460
2021-05-01 14:30:00+00,15712,0,4364,1750,192,3006,2273,118,4034,0,31449,211,12613,10340,5976,15712
2021-05-01 15:00:00+00,16669,78,4366,1831,218,3026,2266,119,3311,0,31884,222,11992,9726,5360,16747
2021-05-01 15:30:00+00,17446,269,4368,1799,237,3026,2275,121,2839,0,32380,234,11518,9243,4875,17715
2021-05-01 16:00:00+00,18500,469,4367,1764,341,3028,2278,122,2606,0,33475,244,11356,9078,4711,18969
2021-05-01 16:30:00+00,19117,490,4367,1557,354,3026,2279,192,2233,36,33651,251,10790,8511,4144,19607
2021-05-01 17:00:00+00,19471,491,4372,1418,370,3024,2247,270,1712,604,33979,253,10119,7872,3500,19962
2021-05-01 17:30:00+00,19839,490,4371,1322,377,3026,2282,262,1189,614,33772,259,9541,7259,2888,20329
2021-05-01 18:00:00+00,19735,491,4372,1271,391,3024,2277,272,708,860,33401,261,9019,6742,2370,20226
2021-05-01 18:30:00+00,19831,491,4371,1121,391,3026,2279,261,277,886,32934,266,8439,6160,1789,20322
2021-05-01 19:00:00+00,19879,491,4368,1091,372,3024,2278,262,29,888,32682,269,8138,5860,1492,20370
2021-05-01 19:30:00+00,19956,490,4367,955,357,3024,2279,245,0,840,32513,271,7958,5679,1312,20446
2021-05-01 20:00:00+00,20002,488,4364,957,315,3006,2277,236,0,356,32001,276,7913,5636,1272,20490
2021-05-01 20:30:00+00,19513,455,4364,853,307,3004,2279,184,0,252,31211,275,7803,5524,1160,19968
2021-05-01 21:00:00+00,18850,484,4362,774,248,3004,2277,129,0,48,30176,276,7661,5384,1022,19334
2021-05-01 21:30:00+00,17958,408,4364,706,236,3004,2278,117,0,0,29071,271,7584,5306,942,18366
2021-05-01 22:00:00+00,16337,334,4361,652,235,3004,2333,118,0,52,27426,262,7581,5248,887,16671
2021-05-01 22:30:00+00,15546,25,4362,580,231,3006,2309,119,0,72,26250,251,7482,5173,811,15571
2021-05-01 23:00:00+00,14917,0,4359,568,209,2858,2372,118,0,20,25421,248,7508,5136,777,14917
2021-05-01 23:30:00+00,14425,0,4369,629,208,2859,2366,117,0,0,24973,245,7572,5206,837,14425
2021-05-02 00:00:00+00,14266,0,4370,696,188,2862,2292,118,0,0,24792,244,7546,5254,884,14266
2021-05-02 00:30:00+00,14401,0,4367,721,187,2860,2329,121,0,0,24986,244,7604,5275,908,14401
2021-05-02 01:00:00+00,14199,0,4368,742,169,2860,2377,116,0,0,24831,243,7656,5279,911,14199
2021-05-02 01:30:00+00,13902,0,4371,773,168,2860,2365,116,0,0,24555,241,7677,5312,941,13902
2021-05-02 02:00:00+00,13954,0,4365,820,168,2860,2373,118,0,0,24658,240,7726,5353,988,13954
2021-05-02 02:30:00+00,13918,0,4372,795,168,2860,2370,116,0,0,24599,240,7705,5335,963,13918
2021-05-02 03:00:00+00,13890,0,4366,829,168,2860,2370,116,0,0,24599,240,7733,5363,997,13890
2021-05-02 03:30:00+00,13883,0,4363,807,168,2860,2377,116,0,0,24574,240,7715,5338,975,13883
2021-05-02 04:00:00+00,13830,0,4361,772,168,2860,2376,119,0,0,24486,240,7677,5301,940,13830
2021-05-02 04:30:00+00,13463,0,4368,794,184,2860,2364,118,25,0,24176,237,7735,5371,1003,13463
2021-05-02 05:00:00+00,13615,0,4365,857,205,2860,2378,118,303,0,24701,235,8108,5730,1365,13615
2021-05-02 05:30:00+00,13527,0,4368,1040,231,2860,2370,121,882,0,25399,227,8891,6521,2153,13527
2021-05-02 06:00:00+00,13664,0,4363,1064,265,2860,2373,122,1635,0,26346,221,9700,7327,2964,13664
2021-05-02 06:30:00+00,14148,0,4365,688,270,2860,2376,121,2474,0,27302,220,10173,7797,3432,14148
2021-05-02 07:00:00+00,14282,0,4368,666,282,2862,2375,175,3286,26,28322,215,10977,8602,4234,14282
2021-05-02 07:30:00+00,14508,0,4369,732,263,2862,2374,241,4203,0,29552,209,11941,9567,5198,14508
2021-05-02 08:00:00+00,14492,0,4372,837,246,3008,2373,239,5281,0,30848,200,13109,10736,6364,14492
2021-05-02 08:30:00+00,14597,0,4369,761,246,3006,2280,173,5820,0,31252,198,13476,11196,6827,14597
2021-05-02 09:00:00+00,14930,0,4370,683,251,3006,2306,146,6003,0,31695,199,13613,11307,6937,14930
2021-05-02 09:30:00+00,15032,0,4373,745,232,3006,2285,270,6242,0,32185,199,13877,11592,7219,15032
2021-05-02 10:00:00+00,15457,0,4370,891,232,3006,2283,289,6348,10,32886,200,14124,11841,7471,15457
2021-05-02 10:30:00+00,15479,0,4369,1053,233,3006,2297,305,6136,0,32878,200,14088,11791,7422,15479
2021-05-02 11:00:00+00,15371,0,4372,1057,201,3006,2378,279,6034,34,32732,200,14042,11664,7292,15371
2021-05-02 11:30:00+00,15288,0,4367,1317,211,3006,2372,471,6472,56,33560,196,14739,12367,8000,15288
2021-05-02 12:00:00+00,15413,0,4364,1378,212,3006,2373,401,6144,36,33327,198,14471,12098,7734,15413
2021-05-02 12:30:00+00,15211,0,4363,1531,216,3004,2370,251,5972,0,32918,197,14452,12082,7719,15211
2021-05-02 13:00:00+00,15182,0,4363,1542,197,3006,2373,132,4949,0,31744,202,13424,11051,6688,15182
2021-05-02 13:30:00+00,15305,0,4364,1624,197,3006,2293,119,4932,0,31840,203,13410,11117,6753,15305
2021-05-02 14:00:00+00,15413,0,4358,1753,212,3006,2275,117,4956,0,32090,202,13554,11279,6921,15413
2021-05-02 14:30:00+00,15505,28,4358,1850,228,3006,2271,118,4806,0,32170,204,13513,11242,6884,15534
2021-05-02 15:00:00+00,15964,57,4356,1954,253,3024,2270,140,4378,34,32430,209,13211,10941,6585,16021
2021-05-02 15:30:00+00,16726,296,4358,1961,280,3024,2272,185,3456,182,32740,223,12327,10055,5697,17022
2021-05-02 16:00:00+00,17276,462,4363,1875,344,3024,2274,196,2904,552,33270,231,11760,9486,5123,17738
2021-05-02 16:30:00+00,17811,490,4366,1952,360,3024,2274,259,2136,480,33152,240,11088,8814,4448,18301
2021-05-02 17:00:00+00,17935,490,4367,1959,341,3026,2268,234,1461,810,32891,243,10396,8128,3761,18425
2021-05-02 17:30:00+00,18063,490,4366,1894,360,3024,2040,245,1087,1130,32699,245,9747,7707,3341,18553
2021-05-02 18:00:00+00,17890,489,4372,1935,516,3026,1361,322,612,1328,31851,248,8796,7435,3063,18379
2021-05-02 18:30:00+00,18272,488,4370,1856,480,3024,1312,309,209,898,31218,257,8227,6915,2545,18760
2021-05-02 19:00:00+00,18369,486,4371,1768,387,3024,1361,288,25,980,31059,260,7912,6551,2180,18855
2021-05-02 19:30:00+00,18238,488,4371,1848,368,3024,1662,302,0,728,31029,260,8249,6587,2216,18726
2021-05-02 20:00:00+00,17826,486,4370,1796,326,3004,1877,314,0,882,30881,256,8369,6492,2122,18312
2021-05-02 20:30:00+00,17761,446,4365,1748,298,3004,1997,170,0,282,30071,260,8408,6411,2046,18207
2021-05-02 21:00:00+00,17180,394,4365,1904,225,3004,1994,123,0,102,29291,257,8488,6494,2129,17574
2021-05-02 21:30:00+00,15693,384,4366,2161,225,3004,1998,168,0,0,27999,248,8750,6752,2386,16077
2021-05-02 22:00:00+00,14374,231,4368,2377,224,2858,1719,119,0,0,26270,237,8688,6969,2601,14605
2021-05-02 22:30:00+00,13408,239,4364,2430,221,2858,1280,117,0,42,24959,233,8295,7015,2651,13647
2021-05-02 23:00:00+00,12611,233,4366,2454,197,2566,1280,114,0,10,23831,230,8297,7017,2651,12844
2021-05-02 23:30:00+00,12025,270,4366,2457,194,2562,1282,114,0,0,23270,227,8299,7017,2651,12295
2021-05-03 00:00:00+00,11819,295,4368,2480,172,2562,1283,113,0,0,23092,226,8303,7020,2652,12114
2021-05-03 00:30:00+00,11617,391,4372,2568,171,2562,1479,114,0,0,23274,226,8590,7111,2739,12008
2021-05-03 01:00:00+00,10792,401,4372,2590,152,2562,2191,114,0,0,23174,217,9305,7114,2742,11193
2021-05-03 01:30:00+00,10191,317,4373,2743,151,2602,2338,114,0,0,22829,208,9605,7267,2894,10508
2021-05-03 02:00:00+00,10311,220,4368,2827,151,2728,2237,117,0,0,22959,207,9583,7346,2978,10531
2021-05-03 02:30:00+00,10680,147,4368,2775,151,2862,2041,113,0,0,23137,210,9335,7294,2926,10827
2021-05-03 03:00:00+00,10610,73,4364,2766,151,3090,2042,113,0,0,23209,211,9323,7281,2917,10683
2021-05-03 03:30:00+00,10742,0,4363,2634,151,3146,2058,115,0,0,23209,212,9206,7148,2785,10742
2021-05-03 04:00:00+00,11038,0,4360,2721,164,2054,2140,174,0,0,22651,226,9385,7245,2885,11038
2021-05-03 04:30:00+00,10802,0,4361,3001,168,1986,2227,193,41,0,22779,222,9798,7571,3210,10802
2021-05-03 05:00:00+00,10902,0,4360,3571,182,2030,2300,194,274,0,23813,215,10687,8387,4027,10902
2021-05-03 05:30:00+00,10984,0,4361,3995,212,2042,2289,232,625,0,24740,208,11482,9193,4832,10984
2021-05-03 06:00:00+00,10550,0,4365,4569,264,2293,2297,273,1031,0,25642,194,12526,10229,5864,10550
2021-05-03 06:30:00+00,10624,0,4363,5529,269,2346,2367,155,1610,0,27262,182,14138,11771,7408,10624
2021-05-03 07:00:00+00,10934,0,4367,6342,338,2465,2373,183,2112,0,29114,176,15532,13159,8792,10934
2021-05-03 07:30:00+00,10875,0,4367,7195,342,2517,2359,186,2657,0,30498,167,16920,14561,10194,10875
2021-05-03 08:00:00+00,10401,0,4373,7993,343,2696,2286,130,3033,0,31255,156,18028,15742,11369,10401
2021-05-03 08:30:00+00,10282,0,4370,8706,343,2747,2241,121,3116,0,31926,151,18776,16535,12165,10282
2021-05-03 09:00:00+00,10423,0,4377,9844,331,2817,2225,194,3102,14,33327,147,19879,17654,13277,10423
2021-05-03 09:30:00+00,9867,0,4372,10771,290,2849,2208,128,3623,0,34108,137,21264,19056,14684,9867
2021-05-03 10:00:00+00,8147,0,4372,11694,263,2781,2124,119,3391,0,32892,120,21844,19720,15348,8147
2021-05-03 10:30:00+00,7668,0,4372,12736,262,2793,2104,120,3273,8,33336,113,22746,20642,16270,7668
2021-05-03 11:00:00+00,7704,0,4369,13487,242,2766,2212,120,2877,24,33800,111,23187,20975,16606,7704
2021-05-03 11:30:00+00,7437,0,4375,14066,244,2771,2287,115,2405,0,33701,108,23377,21090,16715,7437
2021-05-03 12:00:00+00,7283,0,4372,15092,196,2570,2107,116,2240,0,33976,103,24007,21900,17528,7283
2021-05-03 12:30:00+00,6667,0,4366,16249,188,2518,2006,119,2042,4,34159,94,24851,22845,18479,6667
2021-05-03 13:00:00+00,6374,0,4370,16795,187,2613,2107,117,1698,0,34261,92,25157,23050,18680,6374
2021-05-03 13:30:00+00,5938,0,4366,17394,192,2555,2112,117,1436,0,34110,87,25500,23388,19022,5938
2021-05-03 14:00:00+00,6363,0,4369,17814,184,2688,2084,122,1234,0,34858,91,25685,23601,19232,6363
2021-05-03 14:30:00+00,7027,0,4371,17782,174,2691,2185,117,1028,0,35375,97,25540,23355,18984,7027
2021-05-03 15:00:00+00,7434,0,4367,17812,200,2648,2230,222,825,0,35738,100,25434,23204,18837,7434
2021-05-03 15:30:00+00,7913,0,4369,18566,216,2764,2233,287,687,212,37247,103,26071,23838,19469,7913
2021-05-03 16:00:00+00,8343,0,4365,18363,265,3124,2359,311,509,718,38357,105,25861,23502,19137,8343
2021-05-03 16:30:00+00,8839,0,4371,17730,289,3108,2363,294,363,1434,38791,109,25116,22753,18382,8839
2021-05-03 17:00:00+00,8935,0,4373,17188,285,3239,2337,324,309,1226,38216,114,24492,22155,17782,8935
2021-05-03 17:30:00+00,9092,0,4376,16533,281,3359,2333,289,312,1110,37685,118,23835,21502,17126,9092
2021-05-03 18:00:00+00,9100,0,4378,16170,355,3373,2322,273,252,722,36945,121,23477,21155,16777,9100
2021-05-03 18:30:00+00,8775,0,4373,15613,360,3379,2338,248,89,696,35871,119,22773,20435,16062,8775
2021-05-03 19:00:00+00,8875,0,4372,14622,267,3344,2333,250,16,892,34971,123,21610,19277,14905,8875
2021-05-03 19:30:00+00,8751,0,4374,14039,316,3362,2317,298,0,766,34223,125,21046,18729,14355,8751
2021-05-03 20:00:00+00,8436,0,4370,14187,316,3258,2307,296,0,126,33296,124,21180,18873,14503,8436
2021-05-03 20:30:00+00,7777,0,4367,13423,256,3267,2287,222,0,0,31599,122,20333,18046,13679,7777
2021-05-03 21:00:00+00,6336,0,4370,13871,195,3164,2094,118,0,0,30148,107,20530,18436,14066,6336
2021-05-03 21:30:00+00,6178,0,4368,14216,201,3178,1490,117,0,0,29749,104,20275,18785,14417,6178
2021-05-03 22:00:00+00,6021,0,4369,14695,193,2740,1518,114,0,0,29650,101,20775,19257,14888,6021
2021-05-03 22:30:00+00,5134,0,4372,15440,191,2729,1521,112,0,0,29499,90,21524,20003,15631,5134
2021-05-03 23:00:00+00,4504,0,4372,16197,192,2300,1415,113,0,0,29093,80,22176,20761,16389,4504
2021-05-03 23:30:00+00,4056,0,4374,16731,185,2039,1282,112,0,0,28779,70,22572,21290,16916,4056
2021-05-04 00:00:00+00,3651,0,4372,16895,123,2034,1248,113,0,0,28435,63,22638,21390,17018,3651
2021-05-04 00:30:00+00,3860,0,4372,16958,117,2081,1373,118,0,0,28879,66,22820,21447,17075,3860
2021-05-04 01:00:00+00,3573,0,4378,17194,98,2086,1439,113,0,0,28881,60,23110,21670,17292,3573
2021-05-04 01:30:00+00,3370,0,4377,17001,97,2133,1438,114,0,0,28530,59,22913,21475,17098,3370
2021-05-04 02:00:00+00,3484,0,4373,16696,115,2042,1451,116,0,0,28277,61,22635,21184,16811,3484
2021-05-04 02:30:00+00,3326,0,4379,16839,118,2052,1410,113,0,0,28236,59,22746,21336,16957,3326
2021-05-04 03:00:00+00,3511,0,4372,16593,118,1951,1409,117,0,0,28071,62,22492,21083,16711,3511
2021-05-04 03:30:00+00,3525,0,4352,16673,118,1957,1406,116,0,0,28147,62,22549,21143,16791,3525
2021-05-04 04:00:00+00,3675,0,4341,16802,129,1928,1383,113,0,0,28371,63,22655,21272,16931,3675
2021-05-04 04:30:00+00,4071,0,4318,16919,130,1920,1333,117,15,0,28823,67,22715,21382,17064,4071
2021-05-04 05:00:00+00,4646,0,4300,17485,149,2036,1605,114,194,0,30528,70,23733,22128,17828,4646
2021-05-04 05:30:00+00,5420,0,4292,17809,186,2075,1935,120,520,0,32357,77,24742,22807,18515,5420
2021-05-04 06:00:00+00,5809,0,4291,18052,292,2328,2086,120,868,14,33860,78,25589,23503,19212,5809
2021-05-04 06:30:00+00,6659,0,4275,18092,303,2337,2219,126,1369,238,35618,84,26258,24039,19764,6659
2021-05-04 07:00:00+00,7624,0,4262,18100,314,2533,2332,168,1734,208,37275,92,26742,24410,20148,7624
2021-05-04 07:30:00+00,8155,0,4256,17901,331,2553,2321,202,2118,0,37836,97,26927,24606,20350,8155
2021-05-04 08:00:00+00,8403,0,4246,17755,337,2772,2304,241,2586,294,38938,99,27228,24924,20678,8403
2021-05-04 08:30:00+00,8363,0,4230,17827,354,2674,2308,305,3104,204,39370,96,27823,25515,21285,8363
2021-05-04 09:00:00+00,8362,0,4221,17732,349,2726,2307,302,3724,0,39723,96,28333,26026,21805,8362
2021-05-04 09:30:00+00,8259,0,4220,17682,292,2680,2305,232,4169,0,39839,93,28668,26363,22143,8259
2021-05-04 10:00:00+00,8182,0,4218,17596,258,2809,2310,130,4839,0,40342,92,29221,26911,22693,8182
2021-05-04 10:30:00+00,8283,0,4219,17553,249,2932,2258,121,4878,0,40493,93,29157,26899,22680,8283
2021-05-04 11:00:00+00,8318,0,4218,17393,196,3073,2202,116,5390,0,40906,94,29399,27197,22979,8318
2021-05-04 11:30:00+00,7982,0,4219,17323,179,3028,2212,117,5813,20,40893,90,29746,27534,23315,7982
2021-05-04 12:00:00+00,7913,0,4212,16953,178,3024,2240,118,6224,0,40862,89,29807,27567,23355,7913
2021-05-04 12:30:00+00,7790,0,4216,16730,176,2796,2297,118,5977,0,40100,87,29396,27099,22883,7790
2021-05-04 13:00:00+00,7534,0,4213,16472,176,2788,2296,117,6248,0,39844,85,29405,27109,22896,7534
2021-05-04 13:30:00+00,7390,0,4215,16349,175,2710,2291,117,5872,0,39119,84,28902,26611,22396,7390
2021-05-04 14:00:00+00,7424,0,4212,16285,151,2724,2298,116,5425,0,38635,86,28371,26073,21861,7424
2021-05-04 14:30:00+00,7710,0,4215,16420,178,2914,2280,120,4799,0,38636,91,27892,25612,21397,7710
2021-05-04 15:00:00+00,8024,0,4215,16222,239,3496,2248,163,4361,60,39028,97,27285,25037,20822,8024
2021-05-04 15:30:00+00,9257,0,4214,15857,255,3568,2282,177,3466,256,39332,109,26074,23792,19578,9257
2021-05-04 16:00:00+00,9995,0,4215,15688,337,3296,2282,147,3186,276,39422,113,25708,23426,19211,9995
2021-05-04 16:30:00+00,10844,0,4211,15473,372,3286,2276,142,2758,280,39642,121,25090,22814,18603,10844
2021-05-04 17:00:00+00,11544,0,4215,14843,400,3176,2291,161,2055,470,39155,131,23804,21513,17298,11544
2021-05-04 17:30:00+00,11873,0,4205,14112,398,3318,2286,262,1472,674,38600,139,22473,20187,15982,11873
2021-05-04 18:00:00+00,11944,0,4205,13583,391,3630,2271,303,729,744,37800,145,21179,18908,14703,11944
2021-05-04 18:30:00+00,12069,0,4204,12970,371,3602,2291,324,300,788,36919,149,20136,17845,13641,12069
2021-05-04 19:00:00+00,11978,0,4209,12854,303,3612,2287,325,50,798,36416,149,19703,17416,13207,11978
2021-05-04 19:30:00+00,11917,0,4206,12450,302,3384,2267,327,0,974,35827,148,19225,16958,12752,11917
2021-05-04 20:00:00+00,11852,0,4222,11888,284,3116,2260,328,0,1490,35440,146,18654,16394,12172,11852
2021-05-04 20:30:00+00,11565,0,4234,11520,256,3014,2279,278,0,462,33608,149,18289,16010,11776,11565
2021-05-04 21:00:00+00,11329,0,4249,10996,245,2590,2292,137,0,232,32070,151,17782,15490,11241,11329
2021-05-04 21:30:00+00,10603,0,4265,10351,254,2536,2269,116,0,0,30394,149,17139,14870,10605,10603
2021-05-04 22:00:00+00,9081,0,4281,10500,239,2196,2224,116,0,0,28637,138,17244,15020,10739,9081
2021-05-04 22:30:00+00,7235,0,4292,10445,204,2336,2258,117,0,0,26887,123,17199,14941,10649,7235
2021-05-04 23:00:00+00,5993,0,4324,10566,178,2398,2287,117,0,0,25863,111,17355,15068,10744,5993
2021-05-04 23:30:00+00,5876,0,4335,10181,175,2330,2281,123,0,0,25301,110,16972,14691,10356,5876
2021-05-05 00:00:00+00,6081,0,4352,10361,153,2316,2260,119,0,0,25642,113,17126,14866,10514,6081
2021-05-05 00:30:00+00,6268,0,4356,10480,151,2402,2262,119,0,0,26038,116,17249,14987,10631,6268
2021-05-05 01:00:00+00,6218,0,4360,10619,117,2356,2259,118,0,0,26047,114,17355,15096,10736,6218
2021-05-05 01:30:00+00,5776,0,4365,10754,116,2320,2296,120,0,0,25747,108,17531,15235,10870,5776
2021-05-05 02:00:00+00,5629,0,4367,10769,117,2282,2286,120,0,0,25570,106,17539,15253,10886,5629
2021-05-05 02:30:00+00,5779,0,4367,10597,117,2146,2220,121,0,0,25347,106,17301,15081,10714,5779
2021-05-05 03:00:00+00,5531,0,4370,10793,117,2072,2237,119,0,0,25239,102,17517,15280,10910,5531
2021-05-05 03:30:00+00,6136,0,4368,10503,117,2114,2268,122,0,0,25628,110,17256,14988,10620,6136
2021-05-05 04:00:00+00,6273,0,4373,10259,147,1814,2406,119,0,0,25391,114,17185,14779,10406,6273
2021-05-05 04:30:00+00,6831,0,4373,10336,167,1720,2553,119,56,0,26155,119,17485,14932,10559,6831
2021-05-05 05:00:00+00,9136,0,4368,10173,259,1844,2705,123,403,0,29011,139,17908,15203,10835,9136
2021-05-05 05:30:00+00,11407,0,4365,10036,258,1886,2731,165,1058,0,31906,155,18448,15717,11352,11407
2021-05-05 06:00:00+00,13375,70,4365,9857,272,2077,2731,271,1827,138,34983,166,19052,16321,11956,13445
2021-05-05 06:30:00+00,14262,207,4362,9887,275,2072,2725,309,2760,168,37027,170,20009,17284,12922,14469
2021-05-05 07:00:00+00,14077,234,4366,9771,298,2986,2698,299,3678,212,38619,163,20811,18113,13747,14311
2021-05-05 07:30:00+00,14317,234,4368,9443,298,3006,2693,251,4593,20,39223,163,21395,18702,14334,14551
2021-05-05 08:00:00+00,14564,282,4370,9314,271,3006,2628,179,5383,0,39997,162,21966,19338,14968,14846
2021-05-05 08:30:00+00,14586,245,4372,9183,268,3006,2395,166,5937,0,40158,160,22155,19760,15388,14831
2021-05-05 09:00:00+00,14670,232,4372,8972,246,2698,2546,142,6269,24,40171,161,22405,19859,15487,14902
2021-05-05 09:30:00+00,14696,250,4374,8915,260,2680,2672,142,6629,0,40618,160,22850,20178,15804,14946
2021-05-05 10:00:00+00,14393,300,4376,8615,224,3002,2662,140,6736,0,40448,159,22613,19951,15575,14693
2021-05-05 10:30:00+00,14352,307,4377,8688,214,3006,2729,136,6994,0,40803,157,23002,20273,15896,14659
2021-05-05 11:00:00+00,14701,332,4370,8331,174,3006,2746,135,7065,20,40880,161,22686,19940,15570,15033
2021-05-05 11:30:00+00,14849,357,4374,7432,168,3006,2742,179,6572,180,39859,167,21288,18546,14172,15206
2021-05-05 12:00:00+00,14957,334,4371,7293,142,3008,2721,354,6397,62,39639,170,20924,18203,13832,15291
2021-05-05 12:30:00+00,15036,278,4371,7331,143,3008,2738,366,5643,0,38914,173,20226,17488,13117,15314
2021-05-05 13:00:00+00,14999,232,4373,7333,144,3008,2735,340,5264,0,38428,173,19849,17114,12741,15231
2021-05-05 13:30:00+00,15196,231,4366,7099,143,3006,2727,189,4370,0,37327,179,18705,15978,11612,15427
2021-05-05 14:00:00+00,15672,229,4364,7011,143,3006,2725,115,4876,0,38141,180,19119,16394,12030,15901
2021-05-05 14:30:00+00,16028,229,4374,7204,147,3006,2713,120,4771,0,38592,181,19209,16496,12122,16257
2021-05-05 15:00:00+00,16648,273,4366,7281,203,3026,2647,156,4353,0,38953,187,18850,16203,11837,16921
2021-05-05 15:30:00+00,17235,310,4360,7318,217,3026,2651,249,3281,86,38733,196,17827,15176,10816,17545
2021-05-05 16:00:00+00,18048,415,4357,6936,272,3026,2628,270,3208,194,39354,204,17401,14773,10416,18463
2021-05-05 16:30:00+00,18367,475,4359,6673,312,3026,2587,298,2715,420,39232,209,16646,14059,9700,18842
2021-05-05 17:00:00+00,18416,489,4360,6153,553,3026,2562,320,2059,942,38880,212,15687,13125,8765,18905
2021-05-05 17:30:00+00,18943,488,4359,5640,575,3026,2512,311,1484,1318,38656,218,14570,12058,7699,19431
2021-05-05 18:00:00+00,18995,487,4365,5179,610,3028,2555,325,982,1290,37816,224,13691,11136,6771,19482
2021-05-05 18:30:00+00,19213,489,4363,4955,615,3027,2584,322,409,952,36929,232,12926,10342,5979,19702
2021-05-05 19:00:00+00,19405,490,4361,4501,509,3026,2593,324,73,1214,36496,237,12037,9444,5083,19895
2021-05-05 19:30:00+00,19353,489,4368,4054,506,3028,2598,325,0,1034,35755,242,11526,8928,4560,19842
2021-05-05 20:00:00+00,19297,490,4366,3922,467,3008,2674,326,0,704,35254,244,11429,8755,4389,19787
2021-05-05 20:30:00+00,18739,384,4368,4052,390,3008,2678,293,0,412,34324,241,11488,8810,4442,19123
2021-05-05 21:00:00+00,17869,233,4370,4295,251,2994,2669,185,0,8,32874,236,11585,8916,4546,18102
2021-05-05 21:30:00+00,16581,180,4365,4233,269,2992,2506,116,0,0,31242,229,11373,8867,4502,16761
2021-05-05 22:00:00+00,14840,0,4366,3957,218,2942,2549,115,0,0,28987,217,11090,8541,4175,14840
2021-05-05 22:30:00+00,13451,0,4363,3902,212,2941,2626,112,0,0,27607,208,11103,8477,4114,13451
2021-05-05 23:00:00+00,13267,0,4366,4033,166,2810,2610,113,0,0,27365,207,11175,8565,4199,13267
2021-05-05 23:30:00+00,13092,0,4370,4186,150,2806,2614,113,0,0,27331,205,11320,8706,4336,13092
2021-05-06 00:00:00+00,12839,0,4367,4354,126,2680,2622,114,0,0,27102,206,11469,8847,4480,12839
2021-05-06 00:30:00+00,12901,0,4367,4145,126,2675,2673,115,0,0,27001,208,11311,8638,4271,12901
2021-05-06 01:00:00+00,12799,0,4366,4058,110,2529,2643,114,0,0,26619,209,11177,8534,4168,12799
2021-05-06 01:30:00+00,12563,0,4367,3864,110,2526,2631,116,0,0,26177,209,10972,8341,3974,12563
2021-05-06 02:00:00+00,12443,0,4370,3700,110,2560,2596,112,0,0,25890,209,10776,8180,3810,12443
2021-05-06 02:30:00+00,12352,0,4371,3600,110,2560,2616,113,0,0,25722,209,10697,8081,3710,12352
2021-05-06 03:00:00+00,12277,0,4377,3849,110,2604,2613,113,0,0,25943,206,10949,8336,3959,12277
2021-05-06 03:30:00+00,12114,0,4372,3931,114,2602,2609,114,0,0,25856,204,11026,8417,4045,12114
2021-05-06 04:00:00+00,12213,0,4373,4236,168,2106,2626,114,0,0,25836,206,11403,8777,4404,12213
2021-05-06 04:30:00+00,12356,12,4370,4253,178,2028,2566,115,60,0,25937,207,11427,8861,4491,12368
2021-05-06 05:00:00+00,12959,151,4373,4079,248,1893,2586,112,316,0,26717,214,11602,9016,4643,13110
2021-05-06 05:30:00+00,13721,400,4369,3910,290,1870,2587,112,709,0,27968,223,11865,9278,4909,14121
2021-05-06 06:00:00+00,14938,667,4369,3931,477,2748,2585,152,1123,0,30989,227,12485,9900,5531,15605
2021-05-06 06:30:00+00,15956,806,4362,3921,480,2782,2553,247,1692,132,32931,230,13008,10455,6093,16762
2021-05-06 07:00:00+00,16853,869,4362,4188,452,3004,2501,293,2727,536,35786,225,14230,11729,7367,17722
2021-05-06 07:30:00+00,17312,775,4360,4298,451,3014,2208,237,3346,578,36578,221,14663,12455,8095,18087
2021-05-06 08:00:00+00,17586,731,4359,4192,365,3006,2180,237,3691,908,37255,218,14787,12607,8248,18317
2021-05-06 08:30:00+00,17721,758,4365,4176,363,3006,2188,294,4064,444,37379,220,15156,12968,8603,18479
2021-05-06 09:00:00+00,17765,833,4366,4418,342,3008,2338,295,4479,0,37844,220,15943,13605,9239,18598
2021-05-06 09:30:00+00,17727,678,4362,4576,313,3007,2329,306,5164,86,38547,212,16744,14415,10053,18405
2021-05-06 10:00:00+00,17679,734,4365,4571,250,2918,2523,269,6178,536,40023,205,17887,15364,10999,18413
2021-05-06 10:30:00+00,17601,682,4372,4786,225,2946,2665,252,6679,34,40242,203,18727,16062,11690,18283
2021-05-06 11:00:00+00,17504,469,4372,5228,199,3180,2677,157,6613,0,40399,195,19089,16412,12040,17973
2021-05-06 11:30:00+00,17487,301,4364,5102,212,3194,2552,150,7158,162,40682,189,19388,16836,12472,17788
2021-05-06 12:00:00+00,17269,237,4366,5185,193,3754,2626,145,6028,0,39803,190,18398,15772,11406,17506
2021-05-06 12:30:00+00,16824,229,4370,5406,193,3782,2636,144,6590,0,40174,184,19195,16559,12189,17053
2021-05-06 13:00:00+00,17229,290,4372,5487,193,2515,2630,221,6641,0,39578,192,19323,16693,12321,17519
2021-05-06 13:30:00+00,16681,302,4372,5893,185,2451,2621,182,6296,0,38983,189,19367,16746,12374,16983
2021-05-06 14:00:00+00,16517,249,4366,5882,174,2386,2676,174,6257,0,38681,188,19355,16679,12313,16766
2021-05-06 14:30:00+00,16272,258,4353,6526,197,2370,2684,188,5760,0,38608,186,19520,16836,12483,16530
2021-05-06 15:00:00+00,16846,249,4337,6810,238,2170,2712,199,5170,0,38731,192,19267,16555,12218,17095
2021-05-06 15:30:00+00,17381,239,4327,6741,237,2168,2696,309,4596,0,38694,198,18597,15901,11574,17620
2021-05-06 16:00:00+00,17619,383,4315,6560,295,2528,2694,478,4105,0,38977,203,17969,15275,10960,18002
2021-05-06 16:30:00+00,18166,494,4294,6423,317,2528,2719,494,2926,0,38361,215,16679,13960,9666,18660
2021-05-06 17:00:00+00,18418,495,4286,6263,505,2324,2716,396,2212,420,38035,218,15982,13266,8980,18913
2021-05-06 17:30:00+00,18607,502,4270,5951,518,2332,2718,434,1593,706,37631,223,15050,12332,8062,19109
2021-05-06 18:00:00+00,18411,499,4274,5527,466,3014,2712,465,965,636,36969,226,13944,11232,6958,18910
2021-05-06 18:30:00+00,18373,488,4263,5752,462,3028,2715,465,403,560,36509,229,13595,10880,6617,18861
2021-05-06 19:00:00+00,18576,495,4248,5631,355,3028,2717,446,76,778,36350,232,13027,10310,6062,19071
2021-05-06 19:30:00+00,18300,500,4242,5679,331,3028,2712,413,0,768,35973,231,12964,10252,6010,18800
2021-05-06 20:00:00+00,18347,500,4224,5575,245,3008,2716,467,0,566,35648,234,12760,10044,5820,18847
2021-05-06 20:30:00+00,18147,461,4214,5134,241,3008,2710,456,0,0,34371,239,12299,9589,5375,18608
2021-05-06 21:00:00+00,17531,307,4213,5032,224,1924,2738,362,0,42,32373,239,12207,9469,5256,17838
2021-05-06 21:30:00+00,15759,230,4210,5371,209,1922,2747,180,0,0,30628,226,12537,9790,5580,15989
2021-05-06 22:00:00+00,13054,239,4206,5799,207,2610,2729,175,0,0,29019,204,12941,10212,6006,13293
2021-05-06 22:30:00+00,11740,234,4205,5994,198,2622,2775,168,0,0,27936,193,13172,10397,6192,11974
2021-05-06 23:00:00+00,10976,232,4210,6083,165,2672,2781,167,0,0,27286,187,13239,10458,6248,11208
2021-05-06 23:30:00+00,10825,241,4207,5944,148,2670,2793,170,0,0,26998,187,13092,10299,6092,11066
2021-05-07 00:00:00+00,10819,233,4207,5723,138,2634,2794,168,0,0,26716,188,12862,10068,5861,11052
2021-05-07 00:30:00+00,11003,234,4205,5476,138,2634,2804,170,0,0,26664,191,12623,9819,5614,11237
2021-05-07 01:00:00+00,11333,278,4210,5037,123,2634,2789,171,0,0,26575,198,12159,9370,5160,11611
2021-05-07 01:30:00+00,11474,316,4207,4775,123,2634,2788,167,0,0,26484,202,11893,9105,4898,11790
2021-05-07 02:00:00+00,11381,311,4210,4723,105,2634,2786,110,0,0,26260,202,11824,9038,4828,11692
2021-05-07 02:30:00+00,11328,321,4212,4650,104,2633,2782,107,0,0,26138,202,11748,8966,4754,11649
2021-05-07 03:00:00+00,11207,243,4214,4646,104,2635,2788,106,0,0,25942,199,11752,8964,4750,11450
2021-05-07 03:30:00+00,11469,286,4217,4268,104,2634,2787,108,0,0,25873,205,11376,8589,4372,11755
2021-05-07 04:00:00+00,11185,326,4214,4114,133,2613,2790,107,0,0,25482,205,11252,8462,4248,11511
2021-05-07 04:30:00+00,11895,362,4222,4143,135,2614,2805,107,68,0,26351,210,11373,8568,4346,12257
2021-05-07 05:00:00+00,14155,677,4217,3730,225,2624,2825,107,440,72,29072,232,11437,8612,4395,14832
2021-05-07 05:30:00+00,15604,1074,4217,3548,245,2626,2826,155,1094,212,31601,243,11930,9104,4887,16678
2021-05-07 06:00:00+00,16851,1421,4217,3394,305,2976,2824,352,1862,222,34424,249,12602,9778,5561,18272
2021-05-07 06:30:00+00,17323,1486,4214,3257,414,2984,2828,470,2801,426,36203,245,13514,10686,6472,18809
2021-05-07 07:00:00+00,17783,1490,4211,3003,424,3006,2819,388,3608,580,37312,243,14065,11246,7035,19273
2021-05-07 07:30:00+00,17863,1474,4213,2897,424,3006,2817,311,4525,272,37802,239,14876,12059,7846,19337
2021-05-07 08:00:00+00,18019,1485,4207,2691,301,2996,2738,275,5189,24,37925,240,15126,12388,8181,19504
2021-05-07 08:30:00+00,17914,1486,4211,2685,299,2996,2738,198,5967,0,38494,235,15900,13162,8951,19400
2021-05-07 09:00:00+00,17653,1461,4208,2659,279,2976,2740,120,5927,174,38197,232,15813,13073,8865,19114
2021-05-07 09:30:00+00,17769,1425,4216,2563,278,2976,2713,181,6518,66,38705,230,16288,13575,9359,19194
2021-05-07 10:00:00+00,17216,1251,4210,2535,247,3744,2768,260,6746,0,38977,219,16506,13738,9528,18467
2021-05-07 10:30:00+00,17472,982,4210,2533,247,3790,2806,108,6770,54,38972,214,16566,13760,9550,18454
2021-05-07 11:00:00+00,17243,988,4214,2667,226,3996,2763,227,7396,10,39730,210,17266,14503,10289,18231
2021-05-07 11:30:00+00,16913,983,4219,2763,226,3998,2753,205,7299,0,39359,208,17260,14507,10288,17896
2021-05-07 12:00:00+00,16623,989,4216,2851,214,3999,2763,152,6956,0,38763,208,17000,14237,10021,17612
2021-05-07 12:30:00+00,16258,946,4221,2811,207,3998,2779,125,6706,0,38052,207,16724,13945,9724,17204
2021-05-07 13:00:00+00,16067,688,4216,2763,191,3934,2770,153,6960,0,37742,200,16900,14130,9914,16755
2021-05-07 13:30:00+00,15812,625,4218,2594,194,3936,2748,169,6615,0,36911,200,16369,13621,9403,16437
2021-05-07 14:00:00+00,15331,625,4214,2544,212,3954,2751,173,6324,0,36128,200,16045,13294,9080,15956
2021-05-07 14:30:00+00,15541,671,4206,2592,213,3954,2668,176,5703,0,35724,205,15382,12714,8508,16212
2021-05-07 15:00:00+00,16069,848,4206,2556,238,4012,2626,189,4785,0,35529,217,14411,11785,7579,16917
2021-05-07 15:30:00+00,16739,969,4203,2521,259,4012,2685,202,4016,0,35606,227,13684,10999,6796,17708
2021-05-07 16:00:00+00,17448,982,4211,2421,388,4020,2688,199,3238,0,35595,236,12946,10258,6047,18430
2021-05-07 16:30:00+00,17896,982,4210,2228,416,4020,2699,199,2878,104,35632,241,12431,9732,5522,18878
2021-05-07 17:00:00+00,18057,983,4207,2119,513,3992,2658,258,2215,566,35568,243,11712,9054,4847,19040
2021-05-07 17:30:00+00,18051,984,4208,2116,616,4060,2720,217,1590,602,35164,247,11250,8530,4322,19035
2021-05-07 18:00:00+00,17868,985,4208,2121,619,3756,2744,216,950,818,34285,253,10642,7898,3690,18853
2021-05-07 18:30:00+00,17572,986,4209,2149,614,3862,2736,236,449,586,33399,258,10157,7421,3212,18558
2021-05-07 19:00:00+00,17177,986,4214,2016,508,4244,2734,276,79,164,32398,265,9551,6817,2603,18163
2021-05-07 19:30:00+00,16579,986,4214,1993,506,4354,2742,282,0,18,31674,265,9455,6713,2499,17565
2021-05-07 20:00:00+00,15989,987,4213,2012,386,4348,2715,266,0,40,30956,266,9326,6611,2398,16976
2021-05-07 20:30:00+00,15066,986,4211,1984,324,4346,2696,193,0,0,29806,263,9215,6519,2308,16052
2021-05-07 21:00:00+00,14017,856,4213,1971,248,3888,2456,170,0,6,27824,260,8888,6432,2219,14873
2021-05-07 21:30:00+00,12685,533,4210,1876,274,3870,1930,174,0,0,25552,248,8290,6360,2150,13218
2021-05-07 22:00:00+00,11452,370,4212,1893,271,4871,1578,193,0,0,24840,231,7954,6376,2164,11822
2021-05-07 22:30:00+00,10298,344,4212,2004,264,4896,1566,191,0,276,24051,218,8046,6480,2268,10642
2021-05-07 23:00:00+00,9377,473,4209,2166,250,4474,1568,172,0,220,22909,216,8193,6625,2416,9850
2021-05-07 23:30:00+00,8789,349,4211,2485,255,4362,1574,169,0,0,22194,205,8525,6951,2740,9138
2021-05-08 00:00:00+00,8635,237,4209,2928,268,4478,1586,170,0,0,22511,194,8991,7405,3196,8872
2021-05-08 00:30:00+00,8586,229,4215,3365,252,4510,1579,169,0,0,22904,190,9411,7832,3617,8815
2021-05-08 01:00:00+00,8374,239,4210,3668,252,4320,1564,170,0,0,22797,187,9694,8130,3920,8613
2021-05-08 01:30:00+00,8046,237,4212,3904,248,4315,1601,170,0,0,22732,182,9965,8364,4152,8283
2021-05-08 02:00:00+00,7854,245,4212,4079,191,4122,1602,171,0,0,22476,181,10084,8482,4270,8099
2021-05-08 02:30:00+00,7707,238,4219,4506,184,4120,1600,168,0,0,22742,176,10509,8909,4690,7945
2021-05-08 03:00:00+00,7574,233,4237,5411,184,4114,1565,168,0,0,23486,168,11397,9832,5595,7807
2021-05-08 03:30:00+00,6999,241,4255,6109,184,4116,1487,168,0,0,23559,158,12035,10548,6293,7240
2021-05-08 04:00:00+00,6346,255,4270,7106,202,3908,1398,168,0,0,23653,146,12976,11578,7308,6601
2021-05-08 04:30:00+00,5925,249,4280,7459,218,3904,1230,177,4,0,23446,139,13191,11961,7681,6174
2021-05-08 05:00:00+00,6228,233,4299,8045,244,3794,1225,169,30,0,24267,139,13843,12618,8319,6461
2021-05-08 05:30:00+00,6096,234,4308,8778,243,3668,1267,169,91,0,24854,131,14687,13420,9112,6330
2021-05-08 06:00:00+00,5831,230,4308,10153,283,4058,1421,173,154,0,26611,119,16319,14898,10590,6061
2021-05-08 06:30:00+00,5835,229,4308,11354,297,4011,1550,173,265,0,28022,113,17774,16224,11916,6064
2021-05-08 07:00:00+00,6215,230,4305,12231,388,3850,1560,174,405,96,29454,110,18889,17329,13024,6445
2021-05-08 07:30:00+00,6270,229,4310,13137,388,3784,1556,174,532,152,30532,106,19923,18367,14057,6499
2021-05-08 08:00:00+00,6260,235,4317,14136,299,3991,1564,181,631,162,31776,104,20947,19383,15066,6495
2021-05-08 08:30:00+00,6050,241,4329,15063,290,3884,1561,178,692,334,32622,97,21935,20374,16045,6291
2021-05-08 09:00:00+00,6332,301,4340,15719,304,3722,1555,122,866,290,33551,97,22784,21229,16889,6633
2021-05-08 09:30:00+00,6095,370,4347,16197,285,3576,1561,123,922,318,33794,93,23312,21751,17404,6465
2021-05-08 10:00:00+00,6481,441,4353,16531,252,3242,1568,143,1054,296,34361,96,23758,22190,17837,6922
2021-05-08 10:30:00+00,6625,438,4358,16576,249,3232,1579,169,1252,320,34798,97,24014,22435,18077,7063
2021-05-08 11:00:00+00,6883,425,4357,16450,208,3224,1593,180,1337,232,34889,99,23945,22352,17995,7308
2021-05-08 11:30:00+00,7050,343,4363,16045,197,3204,1599,242,1504,82,34629,100,23708,22109,17746,7393
2021-05-08 12:00:00+00,7127,344,4362,15722,186,2926,1573,241,1507,318,34306,101,23350,21777,17415,7471
2021-05-08 12:30:00+00,6946,353,4367,15662,182,2920,1574,242,1542,54,33842,101,23327,21753,17386,7299
2021-05-08 13:00:00+00,6714,379,4364,15621,172,2920,1603,241,1534,0,33548,100,23294,21691,17327,7093
2021-05-08 13:30:00+00,7345,365,4368,15101,141,2920,1584,239,1474,0,33537,107,22668,21084,16716,7710
2021-05-08 14:00:00+00,7200,232,4366,14749,158,3022,1578,199,1636,0,33140,102,22487,20909,16543,7432
2021-05-08 14:30:00+00,7091,285,4367,14218,171,3016,1573,191,1685,8,32605,104,22014,20441,16074,7376
2021-05-08 15:00:00+00,7161,384,4369,13794,221,3042,1566,174,1576,278,32565,108,21526,19960,15591,7545
2021-05-08 15:30:00+00,7882,422,4356,13240,229,3152,1576,182,1527,442,33008,118,20928,19352,14996,8304
2021-05-08 16:00:00+00,8405,361,4352,12999,310,3644,1522,204,1289,736,33822,121,20472,18950,14598,8766
2021-05-08 16:30:00+00,8957,437,4354,12670,359,3658,1499,202,981,888,34005,129,19863,18364,14010,9394
2021-05-08 17:00:00+00,8612,418,4356,12462,431,3830,1506,250,757,1150,33772,126,19512,18006,13650,9030
2021-05-08 17:30:00+00,8591,321,4353,12319,510,3746,1532,257,460,1336,33425,123,19174,17642,13289,8912
2021-05-08 18:00:00+00,8842,325,4356,12215,512,3734,1529,241,268,874,32896,128,18880,17351,12995,9167
2021-05-08 18:30:00+00,8565,234,4351,12101,488,3788,1538,203,125,736,32129,125,18603,17065,12714,8799
2021-05-08 19:00:00+00,8477,241,4350,12382,409,3662,1554,193,18,734,32020,123,18713,17159,12809,8718
2021-05-08 19:30:00+00,8554,291,4350,11918,406,3630,1564,192,0,646,31551,127,18238,16674,12324,8845
2021-05-08 20:00:00+00,9062,417,4352,11500,350,3558,1695,196,0,0,31130,141,17897,16202,11850,9479
2021-05-08 20:30:00+00,8296,346,4351,11385,290,3554,1697,196,0,0,30115,133,17723,16026,11675,8642
2021-05-08 21:00:00+00,7623,325,4348,11100,219,3158,1694,174,0,4,28645,131,17361,15667,11319,7948
2021-05-08 21:30:00+00,7094,265,4346,10851,260,2990,1515,170,0,0,27491,123,16972,15457,11111,7359
2021-05-08 22:00:00+00,5952,317,4352,10732,260,2866,1447,172,0,12,26110,115,16791,15344,10992,6269
2021-05-08 22:30:00+00,4588,231,4353,10846,251,3170,1292,170,0,0,24901,100,16742,15450,11097,4819
2021-05-08 23:00:00+00,4431,285,4354,10957,173,2098,1272,169,0,0,23739,105,16756,15484,11130,4716
2021-05-08 23:30:00+00,4456,307,4354,10947,171,1960,1276,168,0,0,23639,106,16748,15472,11118,4763
2021-05-09 00:00:00+00,4480,297,4351,10658,135,2144,1248,170,0,0,23483,109,16392,15144,10793,4777
2021-05-09 00:30:00+00,5074,283,4353,10354,132,2226,1358,170,0,0,23950,119,16197,14839,10486,5357
2021-05-09 01:00:00+00,5065,326,4355,10277,132,2248,1447,170,0,0,24020,119,16211,14764,10409,5391
2021-05-09 01:30:00+00,4830,324,4355,10074,132,2256,1452,170,0,0,23593,117,16013,14561,10206,5154
2021-05-09 02:00:00+00,4747,311,4356,9929,132,2022,1452,169,0,0,23118,118,15869,14417,10061,5058
2021-05-09 02:30:00+00,4921,304,4354,9842,132,1996,1451,169,0,0,23169,121,15779,14328,9974,5225
2021-05-09 03:00:00+00,4827,319,4354,9885,132,1664,1451,170,0,0,22802,122,15822,14371,10017,5146
2021-05-09 03:30:00+00,4505,306,4354,9824,136,1670,1290,169,0,0,22254,118,15604,14314,9960,4811
2021-05-09 04:00:00+00,4657,260,4356,9989,151,1080,1256,169,0,0,21918,119,15752,14496,10140,4917
2021-05-09 04:30:00+00,4257,236,4359,10002,165,1148,1331,168,32,0,21698,114,15889,14558,10199,4493
2021-05-09 05:00:00+00,3837,231,4357,10032,164,2134,1235,168,206,0,22364,105,15994,14759,10402,4068
2021-05-09 05:30:00+00,3894,240,4355,9948,166,2180,1252,169,575,0,22779,105,16296,15044,10689,4134
2021-05-09 06:00:00+00,3799,243,4357,9882,186,3482,1250,172,907,0,24278,97,16582,15332,10975,4042
2021-05-09 06:30:00+00,4137,233,4360,10046,213,3502,1298,170,1492,0,25451,98,17409,16111,11751,4370
2021-05-09 07:00:00+00,4623,242,4355,10195,323,3582,1150,182,2076,8,26736,100,18099,16949,12594,4865
2021-05-09 07:30:00+00,4997,244,4359,10671,327,3586,1151,182,2610,0,28127,100,19118,17967,13608,5241
2021-05-09 08:00:00+00,5432,402,4352,10731,327,3588,1150,184,3180,54,29400,107,19740,18590,14238,5834
2021-05-09 08:30:00+00,5738,492,4353,10826,327,3590,1144,237,3799,0,30506,111,20449,19305,14952,6230
2021-05-09 09:00:00+00,5357,464,4351,11300,329,3588,1145,331,4508,0,31373,103,21633,20488,16137,5821
2021-05-09 09:30:00+00,4609,450,4343,11980,300,3584,1149,223,4971,10,31619,91,22743,21594,17251,5059
2021-05-09 10:00:00+00,4459,372,4341,11884,260,3582,1152,211,5532,0,31793,86,23169,22017,17676,4831
2021-05-09 10:30:00+00,4639,270,4342,11704,257,3580,1152,173,5811,56,31984,85,23266,22114,17772,4909
2021-05-09 11:00:00+00,5237,340,4343,11326,224,3584,1152,178,6018,164,32566,92,23063,21911,17568,5577
2021-05-09 11:30:00+00,5337,473,4343,11169,224,3582,1151,179,5508,128,32094,99,22395,21244,16901,5810
2021-05-09 12:00:00+00,5138,291,4347,11197,184,3744,1152,210,5465,10,31738,92,22345,21193,16846,5429
2021-05-09 12:30:00+00,4880,243,4347,11558,204,3644,1152,212,5001,0,31241,87,22262,21110,16763,5123
2021-05-09 13:00:00+00,5009,258,4351,11938,215,3746,1151,170,4644,62,31544,90,22299,21148,16797,5267
2021-05-09 13:30:00+00,4926,300,4356,12219,213,3748,1149,170,4029,8,31118,91,21966,20817,16461,5226
2021-05-09 14:00:00+00,5037,285,4357,12499,232,3612,1148,171,3565,0,30906,92,21801,20653,16296,5322
2021-05-09 14:30:00+00,5263,245,4354,12774,232,3668,1152,172,3223,24,31107,94,21735,20583,16229,5508
2021-05-09 15:00:00+00,6332,265,4354,12761,269,3938,1152,180,2795,0,32046,105,21331,20179,15825,6597
2021-05-09 15:30:00+00,7870,322,4358,12347,264,3882,1150,178,2523,0,32894,121,20642,19492,15134,8192
2021-05-09 16:00:00+00,8988,237,4350,12266,427,4054,1150,173,2172,22,33839,125,20365,19215,14865,9225
2021-05-09 16:30:00+00,9509,287,4348,12290,510,3970,1152,174,1719,42,34001,130,20019,18867,14519,9796
2021-05-09 17:00:00+00,9703,234,4350,12040,540,4154,1151,173,1397,0,33742,132,19478,18327,13977,9937
2021-05-09 17:30:00+00,10087,234,4346,11661,565,4170,1150,176,897,0,33286,139,18619,17469,13123,10321
2021-05-09 18:00:00+00,10428,238,4348,11495,565,3786,1147,175,612,110,32904,148,18167,17020,12672,10666
2021-05-09 18:30:00+00,10611,236,4348,11113,546,3796,1132,174,307,20,32283,154,17446,16314,11966,10847
2021-05-09 19:00:00+00,10704,295,4348,10575,408,4092,1132,173,75,0,31802,158,16538,15406,11058,10999
2021-05-09 19:30:00+00,10892,326,4348,9892,375,3990,1129,266,1,98,31317,163,15745,14616,10268,11218
2021-05-09 20:00:00+00,11011,344,4347,9304,329,4052,1132,363,0,408,31290,164,15112,13980,9633,11355
2021-05-09 20:30:00+00,10449,321,4352,9588,304,3912,1139,348,0,10,30423,159,15383,14244,9892,10770
2021-05-09 21:00:00+00,9668,239,4349,9554,234,3262,1352,240,0,102,29000,151,15489,14137,9788,9907
2021-05-09 21:30:00+00,9260,189,4346,8946,236,3206,1458,173,0,76,27890,149,14986,13528,9182,9449
2021-05-09 22:00:00+00,8245,94,4351,8762,223,2830,1538,278,0,6,26327,140,14874,13336,8985,8340
2021-05-09 22:30:00+00,7124,0,4348,8651,201,2930,1448,305,0,0,25007,128,14648,13200,8852,7124
2021-05-09 23:00:00+00,6325,0,4352,9014,112,2988,1446,249,0,0,24486,118,14924,13478,9126,6325
2021-05-09 23:30:00+00,5498,0,4348,9184,111,2890,1461,202,0,0,23694,106,15104,13643,9295,5498
2021-05-10 00:00:00+00,5674,0,4348,9028,93,2880,1459,170,0,0,23652,111,14928,13469,9121,5674
2021-05-10 00:30:00+00,6294,0,4348,8692,91,3014,1472,183,0,0,24094,121,14603,13131,8783,6294
2021-05-10 01:00:00+00,6174,0,4347,8798,108,3006,1532,182,0,0,24147,119,14785,13253,8906,6174
2021-05-10 01:30:00+00,5886,0,4345,8874,111,2928,1457,178,0,0,23779,115,14787,13330,8985,5886
2021-05-10 02:00:00+00,5261,0,4345,9002,111,2980,1451,175,0,0,23325,107,14909,13458,9113,5261
2021-05-10 02:30:00+00,4635,0,4347,9212,111,3020,1452,199,0,0,22976,99,15122,13670,9323,4635
2021-05-10 03:00:00+00,4596,0,4345,8997,111,2916,1477,199,0,34,22675,98,14930,13453,9108,4596
2021-05-10 03:30:00+00,4596,5,4345,9162,122,2858,1522,195,0,0,22805,96,15151,13629,9284,4601
2021-05-10 04:00:00+00,4969,179,4346,8907,122,2782,1535,173,0,200,23213,106,14910,13375,9029,5148
2021-05-10 04:30:00+00,5279,234,4350,9345,131,2876,1523,169,31,0,23938,112,15380,13857,9507,5513
2021-05-10 05:00:00+00,6352,393,4351,9309,183,3150,1725,181,278,140,26062,125,15846,14121,9770,6745
2021-05-10 05:30:00+00,8028,490,4352,9180,179,3180,1971,174,710,134,28398,142,16392,14421,10069,8518
2021-05-10 06:00:00+00,9832,499,4352,9094,367,3598,2087,198,1357,86,31470,152,17256,15170,10818,10331
2021-05-10 06:30:00+00,10317,498,4350,9131,368,3606,2192,285,1905,530,33182,151,17946,15754,11404,10815
2021-05-10 07:00:00+00,10495,499,4353,9251,381,3802,2324,292,2613,988,34998,146,18922,16598,12245,10994
2021-05-10 07:30:00+00,10481,497,4353,9375,386,3804,2324,274,3057,946,35497,143,19495,17171,12818,10978
2021-05-10 08:00:00+00,10536,494,4353,9822,296,3804,2322,262,3408,486,35783,142,20201,17879,13526,11030
2021-05-10 08:30:00+00,10126,497,4348,10256,305,3805,2323,208,4001,228,36097,136,21233,18910,14562,10623
2021-05-10 09:00:00+00,10076,497,4354,10528,248,3470,2318,181,4558,108,36338,134,22006,19688,15334,10573
2021-05-10 09:30:00+00,9782,392,4349,10679,249,3463,2304,256,5003,160,36637,127,22584,20280,15931,10174
2021-05-10 10:00:00+00,9443,230,4343,10952,231,3606,2293,240,5428,114,36880,119,23247,20954,16611,9673
2021-05-10 10:30:00+00,9292,230,4344,11515,230,3608,2290,196,5588,52,37345,116,23967,21677,17333,9522
2021-05-10 11:00:00+00,8982,229,4344,11760,214,3416,2293,174,5537,276,37225,113,24148,21855,17511,9211
2021-05-10 11:30:00+00,8616,36,4345,11884,212,3414,2239,152,6516,222,37636,102,25196,22957,18612,8652
2021-05-10 12:00:00+00,8530,0,4348,12292,192,3416,2075,143,6874,0,37870,99,25781,23706,19358,8530
2021-05-10 12:30:00+00,8022,0,4345,12567,205,3412,2095,143,7351,0,38140,94,26563,24468,20123,8022
2021-05-10 13:00:00+00,7692,0,4348,12596,188,3408,2051,145,6678,0,37106,93,25861,23810,19462,7692
2021-05-10 13:30:00+00,7065,0,4353,13087,172,3400,1956,144,6648,0,36825,86,26216,24260,19907,7065
2021-05-10 14:00:00+00,6751,0,4349,13311,170,3096,2191,144,6065,0,36077,85,26086,23895,19546,6751
2021-05-10 14:30:00+00,6697,0,4353,13774,186,3088,2266,142,5729,0,36235,85,26308,24042,19689,6697
2021-05-10 15:00:00+00,7085,0,4351,13954,274,3186,2263,154,5269,0,36536,88,26111,23848,19497,7085
2021-05-10 15:30:00+00,7884,0,4354,13808,307,3186,2217,157,4399,0,36312,97,25085,22868,18514,7884
2021-05-10 16:00:00+00,9054,0,4348,13503,451,2676,2234,168,3904,0,36338,110,24440,22206,17858,9054
2021-05-10 16:30:00+00,9492,0,4343,13934,479,2660,2179,167,3194,0,36448,114,24129,21950,17607,9492
2021-05-10 17:00:00+00,9325,0,4342,13999,510,3032,1973,152,2343,290,35966,113,23167,21194,16852,9325
2021-05-10 17:30:00+00,9277,0,4341,13684,512,3090,2066,162,1722,290,35144,116,22325,20259,15918,9277
2021-05-10 18:00:00+00,9836,0,4343,13437,500,3006,2165,155,1037,0,34479,127,21482,19317,14974,9836
2021-05-10 18:30:00+00,9861,0,4342,13320,493,2930,2252,146,481,0,33825,129,20888,18636,14294,9861
2021-05-10 19:00:00+00,9924,0,4338,12998,335,3158,2230,147,113,58,33301,134,20014,17784,13446,9924
2021-05-10 19:30:00+00,9902,0,4343,12609,323,3124,2109,145,1,44,32600,136,19385,17276,12933,9902
2021-05-10 20:00:00+00,9275,0,4342,12101,274,3654,2178,145,0,214,32183,129,18895,16717,12375,9275
2021-05-10 20:30:00+00,9102,0,4348,11667,242,3494,2203,143,0,78,31277,128,18460,16257,11909,9102
2021-05-10 21:00:00+00,8497,0,4348,11457,205,2930,2182,144,0,22,29785,127,18192,16010,11662,8497
2021-05-10 21:30:00+00,7240,0,4346,11221,205,2868,2251,143,0,38,28312,116,18023,15772,11426,7240
2021-05-10 22:00:00+00,6159,0,4345,10963,166,3046,2238,142,0,0,27059,106,17712,15474,11129,6159
2021-05-10 22:30:00+00,5777,0,4342,10629,148,3290,2229,142,0,0,26557,106,17348,15119,10777,5777
2021-05-10 23:00:00+00,5855,0,4343,10505,108,2810,2212,141,0,0,25974,106,17168,14956,10613,5855
2021-05-10 23:30:00+00,5562,0,4345,10175,107,2816,2215,140,0,0,25360,105,16842,14627,10282,5562
2021-05-11 00:00:00+00,5594,0,4345,9549,88,3160,2190,141,0,0,25067,109,16172,13982,9637,5594
2021-05-11 00:30:00+00,6139,0,4341,9026,100,3268,2195,143,0,0,25212,119,15662,13467,9126,6139
2021-05-11 01:00:00+00,6496,0,4339,8603,100,3214,2234,143,0,0,25129,127,15276,13042,8703,6496
2021-05-11 01:30:00+00,6594,0,4341,8233,100,3232,2238,144,0,0,24882,130,14912,12674,8333,6594
2021-05-11 02:00:00+00,6772,0,4340,7511,100,3312,2208,222,0,0,24465,138,14159,11951,7611,6772
2021-05-11 02:30:00+00,6928,0,4342,6938,100,3310,2231,263,0,0,24112,143,13611,11380,7038,6928
2021-05-11 03:00:00+00,7019,0,4339,6320,106,3396,2264,261,0,0,23705,149,13029,10765,6426,7019
2021-05-11 03:30:00+00,7314,0,4346,6185,111,3292,2275,223,0,0,23746,151,12917,10642,6296,7314
2021-05-11 04:00:00+00,7436,0,4344,5806,169,3466,2346,142,1,0,23710,154,12666,10320,5976,7436
2021-05-11 04:30:00+00,8440,0,4347,5696,190,3464,2384,140,129,0,24790,163,12746,10362,6015,8440
2021-05-11 05:00:00+00,10071,0,4344,5763,239,3210,2544,142,414,0,26727,176,13304,10760,6416,10071
2021-05-11 05:30:00+00,11911,0,4350,5803,231,3144,2726,141,759,8,29073,187,13869,11143,6793,11911
2021-05-11 06:00:00+00,13997,0,4348,5811,418,2840,2730,157,1379,270,31950,194,14686,11956,7608,13997
2021-05-11 06:30:00+00,14926,0,4352,5837,521,2790,2732,208,1979,428,33773,195,15421,12689,8337,14926
2021-05-11 07:00:00+00,14930,0,4348,5788,554,3780,2735,319,2844,0,35298,187,16269,13534,9186,14930
2021-05-11 07:30:00+00,14905,0,4350,5646,461,3820,2732,265,3480,76,35735,184,16669,13937,9587,14905
2021-05-11 08:00:00+00,14580,0,4346,5735,366,4410,2734,225,4450,100,36946,178,17631,14897,10551,14580
2021-05-11 08:30:00+00,14103,0,4353,5977,343,4460,2657,147,5137,0,37177,171,18467,15810,11457,14103
2021-05-11 09:00:00+00,14408,0,4345,5972,304,3562,2717,144,5394,0,36846,173,18732,16015,11670,14408
2021-05-11 09:30:00+00,14243,0,4342,5993,200,3458,2863,142,5557,0,36798,172,18955,16092,11750,14243
2021-05-11 10:00:00+00,14113,0,4338,5678,227,3638,2907,143,5892,0,36936,168,19042,16135,11797,14113
2021-05-11 10:30:00+00,14100,0,4340,5662,320,3596,2848,140,6193,0,37199,166,19363,16515,12175,14100
2021-05-11 11:00:00+00,13796,0,4340,5626,300,3856,2856,139,7163,198,38274,159,20284,17428,13088,13796
2021-05-11 11:30:00+00,13853,0,4346,5348,298,3768,2848,140,6884,230,37715,160,19724,16876,12530,13853
2021-05-11 12:00:00+00,13594,0,4345,5151,299,3996,2846,141,6440,16,36828,161,19081,16235,11890,13594
2021-05-11 12:30:00+00,13232,0,4346,5015,283,3998,2831,141,6164,86,36096,160,18639,15808,11462,13232
2021-05-11 13:00:00+00,13153,0,4344,4992,282,4000,2822,142,5913,60,35708,161,18353,15531,11187,13153
2021-05-11 13:30:00+00,13218,0,4315,4897,282,4000,2667,142,5858,0,35379,163,18019,15352,11037,13218
2021-05-11 14:00:00+00,13357,0,4293,4923,283,4000,2596,143,5105,0,34700,167,17200,14604,10311,13357
2021-05-11 14:30:00+00,14203,0,4298,4848,284,4000,2799,149,5099,44,35724,173,17328,14529,10231,14203
2021-05-11 15:00:00+00,14809,67,4292,4683,286,4020,2935,238,4514,4,35848,182,16710,13775,9483,14876
2021-05-11 15:30:00+00,15244,266,4274,4476,634,4020,2935,343,3421,84,35697,194,15740,12805,8531,15510
2021-05-11 16:00:00+00,15718,415,4271,4647,769,3998,2891,332,2602,326,35969,201,15180,12289,8018,16133
2021-05-11 16:30:00+00,16157,483,4240,4534,780,3996,2876,389,1871,588,35914,208,14301,11425,7185,16640
2021-05-11 17:00:00+00,16257,485,4223,4487,832,3998,2856,385,1535,1034,36092,208,13933,11077,6854,16742
2021-05-11 17:30:00+00,16421,498,4219,4539,847,3998,2895,410,1113,948,35888,212,13613,10718,6499,16919
2021-05-11 18:00:00+00,16506,499,4218,4384,845,4022,2899,345,746,1104,35568,214,13092,10193,5975,17005
2021-05-11 18:30:00+00,16534,487,4222,4267,833,4022,2891,297,290,872,34715,219,12503,9612,5390,17021
2021-05-11 19:00:00+00,16632,494,4216,4368,746,4020,2915,242,74,672,34379,222,12319,9404,5188,17126
2021-05-11 19:30:00+00,16754,499,4213,4510,564,4020,2896,190,1,606,34253,224,12184,9288,5075,17253
2021-05-11 20:00:00+00,16671,497,4217,4723,387,3990,2887,180,0,70,33622,227,12214,9327,5110,17168
2021-05-11 20:30:00+00,15759,333,4214,5078,348,3988,2882,168,0,8,32778,217,12522,9640,5426,16092
2021-05-11 21:00:00+00,14434,257,4220,5277,232,3798,2845,172,0,0,31235,208,12574,9729,5509,14691
2021-05-11 21:30:00+00,13116,334,4213,5053,243,3788,2481,149,0,0,29377,204,11990,9509,5296,13450
2021-05-11 22:00:00+00,11919,326,4209,5220,239,3422,2016,143,0,0,27494,198,11684,9668,5459,12245
2021-05-11 22:30:00+00,10849,270,4210,5647,232,3414,1740,141,0,0,26503,186,11829,10089,5879,11119
2021-05-11 23:00:00+00,10292,135,4207,5648,198,3412,1724,142,0,0,25758,178,11777,10053,5846,10427
2021-05-11 23:30:00+00,10029,0,4206,5871,148,3410,1666,143,0,0,25473,171,11891,10225,6019,10029
2021-05-12 00:00:00+00,10150,0,4209,5684,149,3410,1696,142,0,0,25440,173,11738,10042,5833,10150
2021-05-12 00:30:00+00,10473,0,4226,5649,148,3410,1699,142,0,0,25747,176,11722,10023,5797,10473
2021-05-12 01:00:00+00,10530,0,4225,5498,144,3414,1698,144,0,0,25653,177,11565,9867,5642,10530
2021-05-12 01:30:00+00,10404,0,4239,5406,138,3412,1695,142,0,0,25436,177,11478,9783,5544,10404
2021-05-12 02:00:00+00,9995,0,4251,5608,131,3314,1691,141,0,0,25131,172,11681,9990,5739,9995
2021-05-12 02:30:00+00,9542,0,4247,5802,130,3314,1646,133,0,0,24814,167,11825,10179,5932,9542
2021-05-12 03:00:00+00,9641,0,4244,5634,130,3314,1647,142,0,0,24752,169,11655,10008,5764,9641
2021-05-12 03:30:00+00,10114,0,4251,5209,132,3312,1672,142,0,0,24832,176,11264,9592,5341,10114
2021-05-12 04:00:00+00,10710,3,4253,4893,155,2908,1691,141,1,0,24755,185,10993,9302,5049,10713
2021-05-12 04:30:00+00,11204,28,4249,4544,204,2886,1695,158,91,0,25059,192,10783,9088,4839,11232
2021-05-12 05:00:00+00,12610,117,4249,4257,274,3058,1852,301,451,216,27385,202,11083,9231,4982,12727
2021-05-12 05:30:00+00,14156,259,4251,4119,285,3062,2206,316,997,172,29823,212,11858,9652,5401,14415
2021-05-12 06:00:00+00,15534,495,4252,4012,316,3726,2313,292,1671,364,32975,216,12564,10251,5999,16029
2021-05-12 06:30:00+00,16109,809,4257,3756,381,3754,2310,329,2433,484,34622,221,13137,10827,6570,16918
2021-05-12 07:00:00+00,16352,933,4259,3455,460,3992,2310,348,3195,554,35858,220,13679,11369,7110,17285
2021-05-12 07:30:00+00,16426,986,4257,3278,479,4000,2306,341,3736,264,36073,221,14056,11750,7493,17412
2021-05-12 08:00:00+00,16484,990,4255,3218,447,4002,2292,338,4205,244,36475,219,14417,12125,7870,17474
2021-05-12 08:30:00+00,16486,988,4257,2946,446,4002,2279,289,4646,162,36501,218,14574,12295,8038,17474
2021-05-12 09:00:00+00,16344,990,4256,2844,323,4002,2263,263,5221,176,36682,215,14907,12644,8388,17334
2021-05-12 09:30:00+00,16077,988,4250,2892,295,4002,2258,263,5907,404,37336,208,15602,13344,9094,17065
2021-05-12 10:00:00+00,16125,982,4213,3123,271,4002,2388,293,6210,252,37859,207,16205,13817,9604,17107
2021-05-12 10:30:00+00,15850,989,4210,3341,273,4000,2643,335,6313,0,37954,204,16780,14137,9927,16839
2021-05-12 11:00:00+00,15916,992,4206,3397,272,3798,2825,359,6409,112,38286,204,17109,14284,10078,16908
2021-05-12 11:30:00+00,16102,992,4202,3255,272,3798,2824,293,6529,0,38267,205,17082,14258,10056,17094
2021-05-12 12:00:00+00,16060,990,4210,2830,272,3730,2824,235,6459,116,37726,207,16596,13772,9562,17050
2021-05-12 12:30:00+00,16011,990,4212,2518,259,3728,2822,253,5837,54,36684,212,15648,12826,8614,17001
2021-05-12 13:00:00+00,15924,990,4212,2324,263,3724,2846,306,5812,0,36401,214,15457,12611,8399,16914
2021-05-12 13:30:00+00,15818,964,4209,2257,260,3724,2849,232,5952,0,36265,212,15527,12678,8469,16782
2021-05-12 14:00:00+00,15859,992,4235,2344,285,3902,2850,133,5312,0,35912,215,15026,12176,7941,16851
2021-05-12 14:30:00+00,16215,991,4258,2404,320,3904,2825,168,4311,0,35396,222,14118,11293,7035,17206
2021-05-12 15:00:00+00,16514,990,4263,2479,433,4020,2841,269,4136,220,36165,222,14152,11311,7048,17504
2021-05-12 15:30:00+00,17122,991,4263,2431,567,4022,2862,346,3607,322,36533,228,13730,10868,6605,18113
2021-05-12 16:00:00+00,17711,930,4265,2434,696,4022,2867,375,2662,954,36916,232,12924,10057,5792,18641
2021-05-12 16:30:00+00,18131,989,4288,2495,721,4022,2867,388,2040,1006,36947,238,12411,9544,5256,19120
2021-05-12 17:00:00+00,18237,990,4296,2576,725,4022,2807,543,1549,1006,36751,241,11953,9146,4850,19227
2021-05-12 17:30:00+00,18184,990,4292,2540,724,4022,2846,551,1191,1026,36366,243,11593,8747,4455,19174
2021-05-12 18:00:00+00,18091,989,4288,2648,673,4022,2785,568,718,1076,35858,244,11112,8327,4039,19080
2021-05-12 18:30:00+00,18206,990,4287,2627,663,4022,2777,471,344,848,35235,249,10698,7921,3634,19196
2021-05-12 19:00:00+00,18309,991,4285,2627,664,4022,2736,484,105,542,34765,253,10417,7681,3396,19300
2021-05-12 19:30:00+00,18190,991,4289,2700,633,4022,2761,456,2,136,34180,256,10385,7624,3335,19181
2021-05-12 20:00:00+00,18148,988,4288,2765,566,4000,2828,288,0,146,34017,256,10447,7619,3331,19136
2021-05-12 20:30:00+00,17562,807,4284,2825,481,4000,2708,164,0,0,32831,251,10298,7590,3306,18369
2021-05-12 21:00:00+00,16604,672,4290,2822,392,4000,2204,142,0,0,31126,246,9708,7504,3214,17276
2021-05-12 21:30:00+00,15251,551,4288,2900,427,4000,1777,146,0,0,29340,237,9392,7615,3327,15802
2021-05-12 22:00:00+00,13858,461,4311,2799,390,4000,1635,147,0,0,27601,228,9135,7500,3189,14319
2021-05-12 22:30:00+00,12716,469,4334,2684,256,3996,1635,143,0,0,26233,223,8909,7274,2940,13185
2021-05-12 23:00:00+00,12644,564,4342,2491,179,3710,1631,143,0,0,25704,230,8643,7012,2670,13208
2021-05-12 23:30:00+00,12211,584,4343,2543,166,3706,1628,142,0,0,25323,227,8680,7052,2709,12795
2021-05-13 00:00:00+00,12264,568,4337,2452,164,3706,1631,136,0,0,25258,226,8584,6953,2616,12832
2021-05-13 00:30:00+00,12530,642,4336,2227,164,3706,1626,140,0,0,25371,232,8353,6727,2391,13172
2021-05-13 01:00:00+00,12381,604,4341,2117,149,3706,1629,140,0,0,25067,231,8236,6607,2266,12985
2021-05-13 01:30:00+00,12098,541,4338,2100,148,3706,1629,143,0,0,24703,228,8215,6586,2248,12639
2021-05-13 02:00:00+00,11743,514,4341,2013,158,3706,1631,141,0,0,24247,225,8143,6512,2171,12257
2021-05-13 02:30:00+00,11696,486,4336,1947,158,3706,1628,141,0,0,24098,225,8069,6441,2105,12182
2021-05-13 03:00:00+00,11998,615,4336,2061,158,3706,1623,141,0,0,24638,229,8178,6555,2219,12613
2021-05-13 03:30:00+00,11845,594,4337,2189,178,3706,1612,141,0,0,24602,226,8316,6704,2367,12439
2021-05-13 04:00:00+00,11857,479,4337,2177,204,3806,1606,141,0,0,24607,222,8324,6718,2381,12336
2021-05-13 04:30:00+00,12425,468,4338,2207,211,3808,1617,142,71,0,25287,225,8444,6827,2489,12893
2021-05-13 05:00:00+00,13535,482,4337,2283,271,3998,1944,141,257,0,27248,227,9092,7148,2811,14017
2021-05-13 05:30:00+00,15171,671,4338,2230,286,4002,2456,142,510,0,29806,237,9820,7364,3026,15842
2021-05-13 06:00:00+00,16949,718,4335,2208,367,4002,2743,151,815,174,32462,242,10468,7725,3390,17667
2021-05-13 06:30:00+00,17693,925,4338,2263,539,4002,2810,200,1080,300,34150,245,11030,8220,3882,18618
2021-05-13 07:00:00+00,17794,986,4339,2189,545,4002,2855,360,1382,772,35224,242,11310,8455,4116,18780
2021-05-13 07:30:00+00,17944,984,4341,2102,560,4002,2851,422,1699,546,35451,243,11553,8702,4361,18928
2021-05-13 08:00:00+00,17904,979,4345,2016,544,4002,2850,436,2274,572,35922,239,12029,9179,4834,18883
2021-05-13 08:30:00+00,17946,985,4347,2106,542,4002,2849,429,2855,436,36497,236,12699,9850,5503,18931
2021-05-13 09:00:00+00,17820,990,4342,2111,508,4002,2850,387,3349,662,37021,231,13160,10310,5968,18810
2021-05-13 09:30:00+00,17777,989,4344,2152,499,4002,2826,351,3620,434,36994,230,13441,10615,6271,18766
2021-05-13 10:00:00+00,17568,987,4342,2121,458,4002,2829,435,3694,170,36606,231,13444,10615,6273,18555
2021-05-13 10:30:00+00,17216,988,4337,2200,411,4002,2802,441,3839,200,36436,228,13589,10787,6450,18204
2021-05-13 11:00:00+00,17507,989,4332,2364,399,4002,2750,421,3848,260,36872,228,13693,10943,6611,18496
2021-05-13 11:30:00+00,17561,990,4331,2450,306,4002,2736,399,3550,64,36389,232,13373,10637,6306,18551
2021-05-13 12:00:00+00,17820,988,4330,2585,230,4004,2736,360,3105,34,36192,235,12986,10250,5920,18808
2021-05-13 12:30:00+00,17737,961,4335,2718,243,4002,2731,299,3057,22,36105,234,13084,10353,6018,18698
2021-05-13 13:00:00+00,17723,864,4328,2831,200,4002,2740,279,2950,0,35917,232,13049,10309,5981,18587
2021-05-13 13:30:00+00,17379,972,4328,2997,196,4002,2796,280,2916,0,35866,231,13233,10437,6109,18351
2021-05-13 14:00:00+00,17268,988,4333,3097,208,4002,2848,299,2636,0,35679,232,13122,10274,5941,18256
2021-05-13 14:30:00+00,17519,988,4333,3269,210,4002,2862,316,2592,0,36091,232,13266,10404,6071,18507
2021-05-13 15:00:00+00,17910,988,4333,3289,332,4022,2839,337,2077,44,36171,237,12870,10031,5698,18898
2021-05-13 15:30:00+00,18338,988,4337,3086,386,4022,2896,342,1753,386,36534,239,12458,9562,5225,19326
2021-05-13 16:00:00+00,18400,990,4333,2902,577,4024,2923,348,1540,956,36993,237,12275,9352,5019,19390
2021-05-13 16:30:00+00,18563,986,4338,2761,823,4022,2920,370,1273,916,36972,241,12115,9195,4857,19549
2021-05-13 17:00:00+00,18670,986,4334,2613,872,4022,2907,401,902,702,36409,246,11628,8721,4387,19656
2021-05-13 17:30:00+00,18522,988,4336,2583,874,4023,2901,406,690,758,36080,247,11384,8483,4147,19510
2021-05-13 18:00:00+00,18452,987,4335,2556,875,4023,2912,422,412,596,35570,250,11090,8178,3843,19439
2021-05-13 18:30:00+00,18425,990,4328,2634,781,4023,2953,404,192,572,35302,249,10888,7935,3607,19415
2021-05-13 19:00:00+00,18359,990,4327,2620,668,4024,2963,263,35,400,34648,252,10613,7650,3323,19349
2021-05-13 19:30:00+00,18251,991,4328,2575,651,4024,2974,152,0,94,34040,255,10528,7554,3226,19242
2021-05-13 20:00:00+00,17822,990,4324,2640,596,4003,2986,152,0,44,33557,253,10546,7560,3236,18812
2021-05-13 20:30:00+00,17389,822,4327,2588,499,4003,2964,153,0,0,32744,249,10378,7414,3087,18211
2021-05-13 21:00:00+00,16443,516,4328,2713,273,4000,2691,147,0,0,31111,239,10005,7314,2986,16959
2021-05-13 21:30:00+00,15476,513,4330,2525,268,4000,2048,145,0,24,29329,238,9171,7123,2793,15989
2021-05-13 22:00:00+00,14150,489,4333,2511,263,4002,1711,142,0,0,27601,232,8818,7107,2774,14639
2021-05-13 22:30:00+00,13001,462,4329,2540,262,4002,1652,142,0,0,26390,224,8783,7131,2802,13463
2021-05-13 23:00:00+00,12012,505,4329,2538,199,3714,1645,142,0,0,25084,222,8711,7066,2737,12517
2021-05-13 23:30:00+00,11518,466,4330,2472,188,3708,1620,142,0,0,24444,218,8610,6990,2660,11984
2021-05-14 00:00:00+00,11678,463,4326,2423,187,3710,1614,142,0,0,24543,220,8550,6936,2610,12141
2021-05-14 00:30:00+00,11902,508,4328,2333,181,3706,1680,144,0,0,24782,223,8522,6842,2514,12410
2021-05-14 01:00:00+00,11806,614,4332,2258,147,3708,1695,147,0,0,24707,226,8432,6737,2405,12420
2021-05-14 01:30:00+00,11624,556,4324,2366,147,3708,1711,146,0,0,24582,222,8548,6837,2513,12180
2021-05-14 02:00:00+00,11405,463,4301,2370,148,3708,1715,121,0,0,24231,218,8534,6819,2518,11868
2021-05-14 02:30:00+00,11362,464,4294,2550,149,3706,1699,121,0,0,24345,216,8692,6993,2699,11826
2021-05-14 03:00:00+00,11240,459,4274,2795,148,3706,1723,137,0,0,24482,213,8940,7217,2943,11699
2021-05-14 03:30:00+00,10977,468,4270,3157,174,3708,1643,142,0,0,24539,209,9244,7601,3331,11445
2021-05-14 04:00:00+00,11124,468,4245,3289,193,3714,1713,142,0,0,24888,208,9440,7727,3482,11592
2021-05-14 04:30:00+00,11558,483,4237,3186,204,3718,1855,142,21,0,25404,212,9503,7648,3411,12041
2021-05-14 05:00:00+00,12807,521,4223,3018,251,3882,2354,142,123,0,27321,219,9969,7615,3392,13328
2021-05-14 05:30:00+00,14565,754,4213,2875,269,3882,2755,143,297,0,29753,233,10409,7654,3441,15319
2021-05-14 06:00:00+00,16441,927,4194,2872,498,4000,2967,146,476,118,32639,241,11007,8040,3846,17368
2021-05-14 06:30:00+00,18056,940,4189,2766,550,4002,2967,147,750,188,34555,247,11222,8255,4066,18996
2021-05-14 07:00:00+00,18673,984,4149,2558,619,4002,2969,253,1070,640,35917,247,11365,8396,4247,19657
2021-05-14 07:30:00+00,18935,987,4049,2313,623,4002,2967,405,1317,594,36192,249,11269,8302,4253,19922
2021-05-14 08:00:00+00,19114,975,3576,2183,722,4002,2970,417,1662,1212,36833,246,11113,8143,4567,20089
2021-05-14 08:30:00+00,19296,980,3561,1951,771,4002,2977,421,2061,896,36916,248,11321,8344,4783,20276
2021-05-14 09:00:00+00,19673,987,3561,1733,707,4002,2983,421,2302,638,37007,253,11286,8303,4742,20660
2021-05-14 09:30:00+00,19957,990,3562,1594,588,4002,2980,421,2502,328,36924,256,11226,8246,4684,20947
2021-05-14 10:00:00+00,20063,988,3558,1468,463,4002,2998,435,2629,334,36938,258,11116,8118,4560,21051
2021-05-14 10:30:00+00,19999,989,3557,1387,551,4002,3007,429,2970,294,37185,255,11472,8465,4908,20988
2021-05-14 11:00:00+00,20227,988,3558,1275,585,4000,2998,358,3451,86,37526,256,11867,8869,5311,21215
2021-05-14 11:30:00+00,20211,988,3557,1162,623,4000,2992,363,3403,0,37299,258,11737,8745,5188,21199
2021-05-14 12:00:00+00,19859,985,3555,1059,588,4000,2988,335,3367,0,36736,256,11557,8569,5014,20844
2021-05-14 12:30:00+00,19765,988,3551,985,391,4000,2978,293,3625,0,36576,255,11530,8552,5001,20753
2021-05-14 13:00:00+00,19584,988,3550,944,346,4000,2972,255,3689,0,36328,253,11501,8529,4979,20572
2021-05-14 13:30:00+00,19178,988,3551,925,281,4000,2974,230,3759,0,35886,252,11490,8516,4965,20166
2021-05-14 14:00:00+00,18857,989,3553,984,254,4000,2979,268,3548,0,35432,252,11318,8339,4786,19846
2021-05-14 14:30:00+00,18814,987,3556,911,293,4000,2987,288,3050,0,34886,255,10797,7810,4254,19801
2021-05-14 15:00:00+00,18781,989,3558,847,475,4020,2987,336,2736,0,34729,257,10603,7616,4058,19770
2021-05-14 15:30:00+00,18621,986,3558,836,590,4020,2930,339,2459,388,34727,255,10373,7443,3885,19607
2021-05-14 16:00:00+00,18742,987,3560,877,690,4020,2917,280,2019,1272,35364,251,10063,7146,3586,19729
2021-05-14 16:30:00+00,18776,986,3559,928,727,4020,2922,283,1691,1266,35158,253,9827,6905,3346,19762
2021-05-14 17:00:00+00,18935,988,3522,1001,728,4020,2936,331,1319,1000,34780,258,9506,6570,3048,19923
2021-05-14 17:30:00+00,19249,987,3489,1063,724,4020,2925,356,1008,956,34777,262,9209,6284,2795,20236
2021-05-14 18:00:00+00,19249,988,3514,1086,696,4020,2914,247,552,886,34152,266,8762,5848,2334,20237
2021-05-14 18:30:00+00,19080,986,3538,1194,683,4020,2905,239,252,438,33335,270,8572,5667,2129,20066
2021-05-14 19:00:00+00,19008,971,3530,1295,590,4032,2901,169,56,146,32698,273,8372,5471,1941,19979
2021-05-14 19:30:00+00,18956,987,3515,1173,579,4020,2931,97,1,226,32485,274,8199,5268,1753,19943
2021-05-14 20:00:00+00,18799,988,3518,1222,470,3990,2968,166,0,110,32231,275,8178,5210,1692,19787
2021-05-14 20:30:00+00,18344,846,3516,1364,333,3990,2967,126,0,0,31486,271,8180,5213,1697,19190
2021-05-14 21:00:00+00,17157,522,3516,1356,275,3998,2918,87,0,0,29829,260,8065,5147,1631,17679
2021-05-14 21:30:00+00,16069,428,3515,1319,247,3992,2623,74,0,0,28267,255,7704,5081,1566,16497
2021-05-14 22:00:00+00,15488,281,3532,1368,238,3670,2077,75,0,0,26729,254,7215,5138,1606,15769
2021-05-14 22:30:00+00,14676,47,3520,1399,224,3800,1495,75,0,0,25236,247,6638,5143,1623,14723
2021-05-14 23:00:00+00,13985,0,3524,1440,189,3644,1440,75,0,0,24297,243,6593,5153,1629,13985
2021-05-14 23:30:00+00,13262,0,3539,1603,182,3620,1424,75,0,0,23705,237,6748,5324,1785,13262
2021-05-15 00:00:00+00,13136,0,3552,1828,161,3524,1424,75,0,0,23700,233,6965,5541,1989,13136
2021-05-15 00:30:00+00,13291,0,3567,1912,159,3526,1398,75,0,0,23928,233,7036,5638,2071,13291
2021-05-15 01:00:00+00,13120,0,3606,2043,124,3520,1419,75,0,0,23907,231,7192,5773,2167,13120
2021-05-15 01:30:00+00,12821,0,3610,2142,124,3428,1430,75,0,0,23630,227,7306,5876,2266,12821
2021-05-15 02:00:00+00,12693,0,3627,2141,124,3423,1450,75,0,0,23533,226,7342,5892,2265,12693
2021-05-15 02:30:00+00,12635,0,3647,2271,124,3417,1453,74,0,0,23621,224,7495,6042,2395,12635
2021-05-15 03:00:00+00,12315,0,3676,2272,124,3412,1405,75,0,0,23279,221,7477,6072,2396,12315
2021-05-15 03:30:00+00,12317,0,3749,2247,124,3412,1444,75,0,0,23368,221,7564,6120,2371,12317
2021-05-15 04:00:00+00,12375,0,3755,2306,124,3410,1449,75,1,0,23495,220,7635,6186,2431,12375
2021-05-15 04:30:00+00,12412,0,3758,2384,142,3410,1418,75,40,0,23639,220,7742,6324,2566,12412
2021-05-15 05:00:00+00,12686,86,3758,2509,142,3412,1431,75,146,0,24245,222,7986,6555,2797,12772
2021-05-15 05:30:00+00,13217,172,3760,2604,162,3414,1501,75,331,0,25236,225,8358,6857,3097,13389
2021-05-15 06:00:00+00,13852,383,3757,2741,180,3416,1618,78,639,0,26664,230,8935,7317,3560,14235
2021-05-15 06:30:00+00,14551,466,3758,2837,219,3412,1713,83,1037,0,28076,232,9564,7851,4093,15017
2021-05-15 07:00:00+00,15579,562,3759,2874,416,3796,1723,83,1276,0,30068,233,10048,8325,4566,16141
2021-05-15 07:30:00+00,15969,789,3760,2937,430,3810,1718,84,1586,8,31091,237,10431,8713,4953,16758
2021-05-15 08:00:00+00,15950,925,3761,2966,621,4000,1717,99,1878,30,31947,235,10943,9226,5465,16875
2021-05-15 08:30:00+00,16037,981,3761,2840,629,4000,1719,137,2288,40,32432,235,11237,9518,5757,17018
2021-05-15 09:00:00+00,16033,979,3762,2773,618,4000,1720,159,2708,206,32958,231,11581,9861,6099,17012
2021-05-15 09:30:00+00,16086,972,3764,2846,595,4000,1716,139,3112,94,33324,229,12033,10317,6553,17058
2021-05-15 10:00:00+00,16113,975,3761,3065,396,4000,1714,116,3267,0,33407,228,12203,10489,6728,17088
2021-05-15 10:30:00+00,15966,977,3762,3210,364,4000,1717,105,3581,0,33682,225,12634,10917,7155,16943
2021-05-15 11:00:00+00,15903,976,3762,3156,442,4000,1721,96,4089,0,34145,221,13170,11449,7687,16879
2021-05-15 11:30:00+00,15782,933,3760,3232,422,4000,1721,96,4160,0,34106,219,13295,11574,7814,16715
2021-05-15 12:00:00+00,15314,626,3758,3270,375,4000,1716,75,4029,80,33243,210,13148,11432,7674,15940
2021-05-15 12:30:00+00,15277,472,3756,3329,216,4000,1716,72,3881,78,32797,208,12898,11182,7426,15749
2021-05-15 13:00:00+00,14875,458,3757,3455,181,4000,1700,71,3724,0,32221,206,12817,11117,7360,15333
2021-05-15 13:30:00+00,14623,467,3759,3532,181,4000,1677,71,4027,0,32337,202,13176,11499,7740,15090
2021-05-15 14:00:00+00,14302,464,3759,3524,221,3958,1680,71,4041,0,32020,200,13225,11545,7786,14766
2021-05-15 14:30:00+00,14027,464,3759,3652,222,3958,1607,71,3784,0,31544,200,13024,11417,7658,14491
2021-05-15 15:00:00+00,14809,486,3760,3710,275,3772,1647,75,3391,6,31931,207,12783,11136,7376,15295
2021-05-15 15:30:00+00,15788,571,3772,3740,319,3772,1684,80,3062,96,32884,215,12577,10893,7121,16359
2021-05-15 16:00:00+00,16099,790,3779,3385,669,3808,1686,101,2602,226,33145,224,12121,10435,6656,16889
2021-05-15 16:30:00+00,16380,951,3767,3179,740,3808,1688,83,2264,136,32996,233,11638,9950,6183,17331
2021-05-15 17:00:00+00,16373,980,3765,3144,846,3818,1684,95,1764,788,33257,232,11203,9519,5754,17353
2021-05-15 17:30:00+00,16336,982,3772,3099,846,3818,1683,152,1311,660,32659,237,10711,9028,5256,17318
2021-05-15 18:00:00+00,16443,964,3768,2962,726,4020,1682,197,812,588,32162,242,9950,8268,4500,17407
2021-05-15 18:30:00+00,16485,974,3765,2793,684,4019,1685,243,402,588,31638,247,9329,7644,3879,17459
2021-05-15 19:00:00+00,16468,980,3767,2521,647,4021,1697,265,112,360,30837,253,8744,7047,3280,17448
2021-05-15 19:30:00+00,16414,982,3768,2312,632,4020,1707,265,5,440,30545,255,8424,6717,2949,17396
2021-05-15 20:00:00+00,16636,985,3771,2175,424,3960,1716,295,0,284,30246,261,8086,6370,2599,17621
2021-05-15 20:30:00+00,16507,985,3774,2262,392,3960,1712,188,0,230,30010,260,8140,6428,2654,17492
2021-05-15 21:00:00+00,15630,840,3770,2352,229,3970,1721,87,0,198,28797,254,8072,6351,2581,16470
2021-05-15 21:30:00+00,14718,618,3807,2343,320,3970,1723,76,0,184,27759,242,8193,6470,2663,15336
2021-05-15 22:00:00+00,13461,642,3856,2425,245,3804,1719,69,0,84,26305,238,8245,6526,2670,14103
2021-05-15 22:30:00+00,12501,529,3862,2273,194,3800,1717,77,0,0,24953,231,8046,6329,2467,13030
2021-05-15 23:00:00+00,12019,266,3866,2250,168,3608,1723,72,0,0,23972,222,8007,6284,2418,12285
2021-05-15 23:30:00+00,11815,178,3868,2160,164,3606,1719,85,0,0,23595,219,7911,6192,2324,11993
2021-05-16 00:00:00+00,11899,0,3865,2231,129,3606,1717,141,0,0,23588,213,7942,6225,2360,11899
2021-05-16 00:30:00+00,12009,0,3880,2225,128,3606,1717,141,0,0,23706,214,7950,6233,2353,12009
2021-05-16 01:00:00+00,11732,0,3901,2190,105,3606,1709,142,0,0,23384,212,7904,6196,2294,11732
2021-05-16 01:30:00+00,11556,0,3910,2290,100,3606,1718,142,0,0,23322,210,8018,6300,2390,11556
2021-05-16 02:00:00+00,11449,0,3926,2303,100,3608,1721,141,0,0,23248,209,8050,6329,2403,11449
2021-05-16 02:30:00+00,11367,0,3943,2352,100,3606,1720,142,0,0,23230,208,8115,6395,2452,11367
2021-05-16 03:00:00+00,11162,0,3959,2342,100,3412,1723,142,0,0,22840,207,8124,6401,2442,11162
2021-05-16 03:30:00+00,11263,0,3979,2175,100,3410,1657,142,0,0,22726,210,7911,6254,2275,11263
2021-05-16 04:00:00+00,11015,0,3993,2084,99,3410,1722,142,5,0,22470,208,7903,6181,2188,11015
2021-05-16 04:30:00+00,10971,0,4007,1987,97,3410,1722,142,151,0,22487,207,7964,6242,2235,10971
2021-05-16 05:00:00+00,11181,0,4016,2032,95,3410,1719,142,516,0,23111,205,8378,6659,2643,11181
2021-05-16 05:30:00+00,11676,0,4016,1934,95,3410,1720,142,1029,0,24022,206,8794,7074,3058,11676
2021-05-16 06:00:00+00,11932,0,4017,1804,156,3604,1759,143,1514,0,24929,202,9250,7491,3474,11932
2021-05-16 06:30:00+00,12392,0,4018,1795,167,3610,1839,143,2053,0,26017,201,9872,8033,4015,12392
2021-05-16 07:00:00+00,12761,0,4015,1686,201,3990,2083,144,2737,0,27617,196,10722,8639,4624,12761
2021-05-16 07:30:00+00,13315,89,4012,1620,219,4000,2292,242,3457,0,29247,198,11600,9308,5296,13404
2021-05-16 08:00:00+00,13871,179,4010,1658,277,4000,2308,291,4023,0,30617,199,12276,9968,5958,14050
2021-05-16 08:30:00+00,14417,321,4010,1686,288,4000,2269,154,4357,0,31502,203,12610,10341,6331,14738
2021-05-16 09:00:00+00,14881,358,4009,1702,308,4000,2187,162,4612,0,32219,205,12818,10631,6622,15239
2021-05-16 09:30:00+00,15048,321,4012,1640,297,4000,2130,304,5342,96,33190,201,13421,11291,7279,15369
2021-05-16 10:00:00+00,15068,321,4011,1790,294,4000,2134,326,5992,24,33961,197,14221,12087,8076,15389
2021-05-16 10:30:00+00,15197,335,4015,1597,338,4001,2296,335,6262,0,34376,197,14508,12212,8197,15532
2021-05-16 11:00:00+00,15370,360,4020,1701,338,4001,2322,334,6064,0,34510,199,14445,12123,8103,15730
2021-05-16 11:30:00+00,15094,342,4023,2127,327,3999,2315,320,5975,0,34522,195,14767,12452,8429,15436
2021-05-16 12:00:00+00,15079,352,4016,2073,211,4001,2316,216,5907,0,34171,197,14523,12207,8191,15431
2021-05-16 12:30:00+00,14937,325,4013,2120,190,4002,2313,146,5894,0,33940,195,14530,12217,8204,15262
2021-05-16 13:00:00+00,15048,259,4008,2068,165,4002,2317,144,5253,0,33264,198,13811,11494,7486,15307
2021-05-16 13:30:00+00,14831,231,4012,2170,166,4000,2317,144,4307,0,32178,201,12972,10655,6643,15062
2021-05-16 14:00:00+00,14554,340,4013,2472,197,4000,2321,149,4460,0,32506,199,13463,11142,7129,14894
2021-05-16 14:30:00+00,14403,524,4013,2776,202,4000,2331,150,3837,0,32236,205,13159,10828,6815,14927
2021-05-16 15:00:00+00,14878,612,4012,2856,255,4020,2332,175,3509,80,32729,210,12964,10632,6620,15490
2021-05-16 15:30:00+00,15329,613,4012,2897,275,4036,2324,226,3397,320,33429,212,12905,10581,6569,15942
2021-05-16 16:00:00+00,15861,572,4014,2930,493,4018,2325,333,2784,826,34156,213,12546,10221,6207,16433
2021-05-16 16:30:00+00,16258,488,4016,2886,557,4020,2331,353,2002,990,33901,218,11792,9461,5445,16746
2021-05-16 17:00:00+00,16372,477,4051,2964,575,4018,2330,385,1213,816,33201,223,11133,8803,4752,16849
2021-05-16 17:30:00+00,16326,465,4105,2975,618,4054,2327,392,863,890,33015,224,10888,8561,4456,16791
2021-05-16 18:00:00+00,16104,474,4106,3213,619,4058,2330,355,544,738,32541,225,10812,8482,4376,16578
2021-05-16 18:30:00+00,16186,466,4107,3222,579,4004,2324,334,313,726,32261,227,10545,8221,4114,16652
2021-05-16 19:00:00+00,16191,461,4106,2956,531,4008,2314,299,98,664,31628,230,10005,7691,3585,16652
2021-05-16 19:30:00+00,16190,460,4106,3005,529,4008,2322,220,5,230,31075,234,9967,7645,3539,16650
2021-05-16 20:00:00+00,15988,529,4101,3140,453,3998,2321,151,0,68,30749,235,10015,7694,3593,16517
2021-05-16 20:30:00+00,15498,548,4100,3068,359,3998,2282,147,0,0,30000,235,9809,7527,3427,16046
2021-05-16 21:00:00+00,14756,340,4160,2974,251,3998,2221,143,0,0,28843,227,9606,7385,3225,15096
2021-05-16 21:30:00+00,13522,231,4201,2833,319,3996,1944,119,0,0,27165,218,9297,7353,3152,13753
2021-05-16 22:00:00+00,12546,272,4200,2599,316,3804,1614,123,0,0,25474,217,8729,7115,2915,12818
2021-05-16 22:30:00+00,11763,248,4195,2443,282,3802,1562,141,0,0,24436,213,8482,6920,2725,12011
2021-05-16 23:00:00+00,11846,311,4198,2182,227,3800,1409,141,0,0,24114,218,8016,6607,2409,12157
2021-05-16 23:30:00+00,11719,237,4256,2101,224,3802,1336,141,0,0,23816,216,7917,6581,2325,11956
2021-05-17 00:00:00+00,11713,232,4270,2107,204,3802,1427,141,0,0,23896,217,8008,6581,2311,11945
2021-05-17 00:30:00+00,12034,242,4266,2021,204,3802,1490,142,0,0,24201,220,7981,6491,2225,12276
2021-05-17 01:00:00+00,11794,235,4265,1976,189,3804,1480,141,0,0,23884,219,7910,6430,2165,12029
2021-05-17 01:30:00+00,11679,230,4264,1906,187,3804,1475,141,0,0,23686,218,7832,6357,2093,11909
2021-05-17 02:00:00+00,11508,229,4265,1885,185,3800,1475,141,0,0,23488,217,7810,6335,2070,11737
2021-05-17 02:30:00+00,11362,234,4268,1823,188,3800,1487,141,0,0,23303,217,7766,6279,2011,11596
2021-05-17 03:00:00+00,11211,235,4269,1959,188,3802,1493,141,0,0,23298,214,7909,6416,2147,11446
2021-05-17 03:30:00+00,11143,232,4272,2163,188,3800,1505,141,0,0,23444,212,8128,6623,2351,11375
2021-05-17 04:00:00+00,11372,238,4274,2200,189,3732,1513,148,0,0,23666,214,8176,6663,2389,11610
2021-05-17 04:30:00+00,11845,387,4274,2135,178,3732,1637,142,60,0,24390,221,8284,6647,2373,12232
2021-05-17 05:00:00+00,13516,507,4280,2127,236,2982,2037,142,298,50,26175,237,8978,6941,2661,14023
2021-05-17 05:30:00+00,15310,603,4278,2233,274,2964,2274,143,585,22,28686,245,9644,7370,3092,15913
2021-05-17 06:00:00+00,16961,676,4275,2514,362,3456,2310,180,1024,210,31968,243,10485,8175,3900,17637
2021-05-17 06:30:00+00,17647,864,4276,2515,521,3468,2295,392,1470,488,33936,244,11077,8782,4506,18511
2021-05-17 07:00:00+00,18166,893,4273,2409,636,3494,2313,395,1941,584,35104,243,11572,9259,4986,19059
2021-05-17 07:30:00+00,18411,853,4272,2238,519,3494,2315,320,2364,900,35686,240,11708,9393,5121,19264
2021-05-17 08:00:00+00,18573,909,4272,2116,520,3494,2308,337,2913,1146,36588,238,12129,9821,5549,19482
2021-05-17 08:30:00+00,18444,919,4276,2285,519,3494,2301,355,3167,896,36656,236,12548,10247,5971,19363
2021-05-17 09:00:00+00,18379,982,4276,2392,401,3494,2304,399,3539,406,36572,238,12912,10608,6332,19361
2021-05-17 09:30:00+00,18237,927,4282,2501,344,3494,2299,320,3948,414,36766,233,13374,11075,6793,19164
2021-05-17 10:00:00+00,18432,906,4294,2615,274,3494,2305,311,4544,276,37451,230,14032,11727,7433,19338
2021-05-17 10:30:00+00,18446,953,4273,2592,274,3494,2310,284,5109,104,37839,229,14558,12248,7975,19399
2021-05-17 11:00:00+00,18312,980,4274,2586,267,3494,2311,277,5542,300,38343,225,14980,12669,8395,19292
2021-05-17 11:30:00+00,18149,983,4277,2674,272,3494,2304,267,4968,0,37388,229,14494,12190,7914,19132
2021-05-17 12:00:00+00,18129,984,4275,2805,186,3494,2299,154,4896,310,37532,227,14461,12162,7887,19113
2021-05-17 12:30:00+00,17689,858,4280,2935,200,3494,2261,191,5541,0,37449,220,15217,12956,8676,18547
2021-05-17 13:00:00+00,17477,625,4276,2974,196,3494,2148,170,4924,0,36284,218,14518,12370,8094,18102
2021-05-17 13:30:00+00,17118,535,4271,3000,187,3494,2169,144,5576,0,36494,210,15203,13034,8763,17653
2021-05-17 14:00:00+00,17155,491,4262,3330,186,3494,2294,146,5086,0,36444,210,15158,12864,8602,17646
2021-05-17 14:30:00+00,17251,559,4259,3591,187,3490,2460,147,4456,0,36400,214,14953,12493,8234,17810
2021-05-17 15:00:00+00,17520,652,4259,3802,248,3440,2531,159,3920,0,36530,219,14760,12228,7970,18172
2021-05-17 15:30:00+00,18404,684,4261,3708,264,3440,2638,173,3302,0,36874,227,14173,11535,7274,19088
2021-05-17 16:00:00+00,18651,877,4260,3675,368,3514,2756,175,2901,40,37217,233,13960,11204,6944,19528
2021-05-17 16:30:00+00,18792,926,4266,3360,436,3514,2729,184,2749,414,37370,235,13540,10811,6545,19718
2021-05-17 17:00:00+00,19079,902,4270,2915,497,3512,2796,289,2253,600,37113,241,12731,9935,5665,19981
2021-05-17 17:30:00+00,19095,833,4272,2873,526,3512,2724,304,1594,766,36499,243,11989,9265,4993,19928
2021-05-17 18:00:00+00,19172,905,4271,2983,577,3514,2786,298,1020,536,36062,249,11637,8851,4580,20077
2021-05-17 18:30:00+00,19064,887,4275,3148,570,3514,2736,286,647,440,35567,251,11376,8640,4365,19951
2021-05-17 19:00:00+00,18756,906,4276,3166,492,3514,2788,259,219,288,34664,253,10941,8153,3877,19662
2021-05-17 19:30:00+00,18767,920,4276,2830,414,3514,2839,196,20,0,33776,260,10379,7540,3264,19687
2021-05-17 20:00:00+00,18454,960,4277,2596,293,3492,2826,278,0,66,33242,262,9992,7166,2889,19414
2021-05-17 20:30:00+00,17825,852,4274,2285,267,3494,2811,285,0,20,32113,261,9637,6826,2552,18677
2021-05-17 21:00:00+00,16716,743,4277,2297,201,3494,2834,245,0,0,30807,254,9609,6775,2498,17459
2021-05-17 21:30:00+00,15050,576,4275,2449,237,3492,2878,209,0,0,29166,240,9839,6961,2686,15626
2021-05-17 22:00:00+00,13875,227,4274,2252,210,3352,2918,142,0,0,27250,227,9654,6736,2462,14102
2021-05-17 22:30:00+00,12678,1,4275,2171,209,3344,2930,142,0,0,25750,214,9585,6655,2380,12679
2021-05-17 23:00:00+00,12327,0,4271,2046,196,3202,2933,141,0,0,25116,214,9446,6513,2242,12327
2021-05-17 23:30:00+00,11626,0,4273,2038,191,3202,2936,142,0,0,24408,209,9438,6502,2229,11626
2021-05-18 00:00:00+00,11682,0,4273,2150,138,3200,2918,142,0,0,24503,210,9479,6561,2288,11682
2021-05-18 00:30:00+00,11693,0,4274,2254,138,3200,2842,139,0,0,24540,209,9508,6666,2392,11693
2021-05-18 01:00:00+00,11641,0,4275,2351,139,3200,2841,142,0,0,24589,208,9606,6765,2490,11641
2021-05-18 01:30:00+00,11720,0,4276,2406,235,3200,2466,142,0,0,24445,209,9383,6917,2641,11720
2021-05-18 02:00:00+00,11762,0,4270,2452,235,3200,2346,142,0,0,24407,209,9303,6957,2687,11762
2021-05-18 02:30:00+00,11492,1,4272,2417,223,3200,2341,142,0,0,24087,208,9253,6912,2640,11493
2021-05-18 03:00:00+00,11660,1,4276,2458,137,3202,2333,142,0,0,24210,209,9204,6871,2595,11661
2021-05-18 03:30:00+00,11474,2,4276,2326,137,3194,2331,142,0,0,23882,209,9070,6739,2463,11476
2021-05-18 04:00:00+00,11597,158,4280,2260,135,2952,2272,142,10,0,23806,217,8957,6685,2405,11755
2021-05-18 04:30:00+00,12389,234,4277,2193,137,2944,2276,142,157,0,24749,224,9040,6764,2487,12623
2021-05-18 05:00:00+00,13760,257,4275,1928,220,3004,2249,147,440,116,26396,232,9112,6864,2588,14017
2021-05-18 05:30:00+00,15084,319,4275,1730,247,3002,2285,233,944,372,28491,236,9481,7196,2921,15403
2021-05-18 06:00:00+00,16893,371,4276,1526,440,3480,2297,239,1702,432,31656,237,10241,7944,3668,17264
2021-05-18 06:30:00+00,17384,631,4277,1556,551,3494,2373,391,2404,552,33613,238,11161,8788,4511,18015
2021-05-18 07:00:00+00,17488,897,4273,1537,578,3494,2385,422,2972,986,35032,238,11745,9360,5087,18385
2021-05-18 07:30:00+00,17564,982,4275,1503,618,3494,2387,411,3453,692,35379,238,12236,9849,5574,18546
2021-05-18 08:00:00+00,17613,988,4273,1445,615,3494,2389,345,4139,874,36175,233,12861,10472,6199,18601
2021-05-18 08:30:00+00,17477,935,4276,1404,570,3494,2393,313,4929,868,36659,227,13572,11179,6903,18412
2021-05-18 09:00:00+00,17415,983,4278,1366,477,3444,2474,259,5604,600,36900,225,14199,11725,7447,18398
2021-05-18 09:30:00+00,17313,971,4280,1479,345,3442,2799,233,5903,132,36897,225,14806,12007,7727,18284
2021-05-18 10:00:00+00,17482,965,4280,1569,281,3494,2980,224,5977,170,37422,224,15087,12107,7827,18447
2021-05-18 10:30:00+00,17613,985,4278,1550,236,3496,2909,180,6606,0,37853,223,15579,12670,8392,18598
2021-05-18 11:00:00+00,17942,985,4279,1707,204,3496,2831,152,6675,32,38303,223,15696,12865,8586,18927
2021-05-18 11:30:00+00,17839,803,4280,1808,195,3496,2876,143,6350,0,37790,220,15509,12633,8353,18642
2021-05-18 12:00:00+00,17639,651,4278,1877,156,3496,2955,143,6699,0,37894,214,15965,13010,8732,18290
2021-05-18 12:30:00+00,17377,650,4276,1982,146,3496,2985,154,6357,0,37423,214,15746,12761,8485,18027
2021-05-18 13:00:00+00,17441,558,4276,2038,132,3494,2982,152,5908,0,36981,215,15336,12354,8078,17999
2021-05-18 13:30:00+00,17216,469,4276,2172,132,3494,2860,161,5960,0,36740,212,15400,12540,8264,17685
2021-05-18 14:00:00+00,17567,465,4274,2339,133,3494,2747,160,4833,0,36012,219,14326,11579,7305,18032
2021-05-18 14:30:00+00,17995,578,4271,2432,149,3494,2816,146,4370,0,36251,226,14038,11222,6951,18573
2021-05-18 15:00:00+00,18169,883,4267,2639,225,3514,2953,167,4368,0,37185,230,14452,11499,7232,19052
2021-05-18 15:30:00+00,18530,906,4262,3076,366,3514,2942,201,3784,0,37581,232,14430,11488,7226,19436
2021-05-18 16:00:00+00,18869,943,4261,3119,528,3514,2995,267,3108,0,37604,238,14011,11016,6755,19812
2021-05-18 16:30:00+00,19250,906,4254,2985,591,3514,2968,265,2491,138,37362,242,13289,10321,6067,20156
2021-05-18 17:00:00+00,19112,785,4270,3001,622,3514,2925,297,1920,452,36898,241,12738,9813,5543,19897
2021-05-18 17:30:00+00,19232,860,4273,2959,624,3514,2813,274,1477,310,36336,247,12146,9333,5060,20092
2021-05-18 18:00:00+00,19307,990,4274,2736,623,3514,3005,275,955,458,36137,254,11593,8588,4314,20297
2021-05-18 18:30:00+00,19134,970,4277,2729,620,3514,3012,258,497,442,35453,256,11135,8123,3846,20104
2021-05-18 19:00:00+00,18989,974,4279,2538,542,3122,3030,208,149,398,34229,262,10538,7508,3229,19963
2021-05-18 19:30:00+00,19007,929,4276,2448,514,3118,3050,156,11,144,33653,265,10299,7249,2973,19936
2021-05-18 20:00:00+00,18499,894,4276,2478,333,3486,3053,149,0,144,33312,261,10140,7087,2811,19393
2021-05-18 20:30:00+00,17924,677,4271,2546,230,3494,3058,147,0,138,32485,255,10105,7047,2776,18601
2021-05-18 21:00:00+00,16972,470,4264,2509,166,3494,3059,139,0,0,31073,248,9998,6939,2675,17442
2021-05-18 21:30:00+00,15500,229,4265,2558,179,3494,2916,137,0,0,29278,235,9918,7002,2737,15729
2021-05-18 22:00:00+00,13690,183,4263,2514,169,3350,2725,144,0,0,27038,225,9671,6946,2683,13873
2021-05-18 22:30:00+00,13059,0,4258,2186,163,3348,2434,144,0,0,25592,220,9041,6607,2349,13059
2021-05-18 23:00:00+00,12859,0,4252,1988,148,3338,2408,140,0,0,25133,221,8796,6388,2136,12859
2021-05-18 23:30:00+00,12718,0,4251,1846,147,3338,2425,141,0,0,24866,221,8669,6244,1993,12718
2021-05-19 00:00:00+00,12694,0,4258,1766,109,3328,2435,141,0,0,24731,222,8568,6133,1875,12694
2021-05-19 00:30:00+00,12935,0,4255,1715,109,3328,2440,141,0,0,24923,224,8519,6079,1824,12935
2021-05-19 01:00:00+00,12997,0,4258,1641,109,3348,2442,112,0,0,24907,225,8450,6008,1750,12997
2021-05-19 01:30:00+00,12606,0,4261,1620,108,3348,2439,99,0,0,24481,223,8428,5989,1728,12606
2021-05-19 02:00:00+00,12305,0,4259,1547,108,3348,2422,101,0,0,24090,221,8336,5914,1655,12305
2021-05-19 02:30:00+00,12389,0,4260,1695,126,3348,2398,104,0,0,24320,220,8479,6081,1821,12389
2021-05-19 03:00:00+00,12430,0,4261,1630,140,3308,2405,105,0,0,24279,221,8436,6031,1770,12430
2021-05-19 03:30:00+00,12358,0,4275,1595,139,3310,2391,110,0,0,24178,221,8400,6009,1734,12358
2021-05-19 04:00:00+00,12889,0,4279,1621,140,2550,2417,122,9,0,24027,229,8466,6049,1770,12889
2021-05-19 04:30:00+00,13164,3,4279,1568,152,2554,2397,126,135,0,24378,231,8531,6134,1855,13167
2021-05-19 05:00:00+00,13817,172,4280,1579,240,3278,2494,145,465,0,26470,231,9058,6564,2284,13989
2021-05-19 05:30:00+00,15143,243,4281,1535,275,3306,2879,146,896,56,28760,235,9866,6987,2706,15386
2021-05-19 06:00:00+00,16813,452,4280,1537,361,3490,2919,200,1540,354,31946,239,10637,7718,3438,17265
2021-05-19 06:30:00+00,17549,487,4286,1460,387,3494,3032,400,2167,520,33782,237,11332,8300,4014,18036
2021-05-19 07:00:00+00,18323,467,4280,1492,509,3494,3059,400,2820,474,35318,236,12160,9101,4821,18790
2021-05-19 07:30:00+00,18534,485,4281,1474,514,3494,3046,372,3627,362,36189,233,12942,9896,5615,19019
2021-05-19 08:00:00+00,18696,484,4279,1495,469,3494,3030,333,4555,142,36977,229,13828,10798,6519,19180
2021-05-19 08:30:00+00,18518,460,4281,1503,425,3494,2944,214,5404,124,37367,223,14557,11613,7332,18978
2021-05-19 09:00:00+00,18234,365,4287,1526,313,3444,2964,118,6126,0,37377,216,15216,12252,7965,18599
2021-05-19 09:30:00+00,18130,252,4302,1588,283,3444,3045,113,6734,0,37891,210,15952,12907,8605,18382
2021-05-19 10:00:00+00,17946,263,4286,1661,235,3298,3087,115,6616,0,37507,210,15885,12798,8512,18209
2021-05-19 10:30:00+00,17910,195,4284,1724,231,3294,3084,113,6767,0,37602,208,16090,13006,8722,18105
2021-05-19 11:00:00+00,18085,156,4281,1891,244,3492,3094,111,6997,0,38351,204,16507,13413,9132,18241
2021-05-19 11:30:00+00,17783,117,4283,2046,220,3494,3098,106,6601,0,37748,204,16248,13150,8867,17900
2021-05-19 12:00:00+00,17511,78,4284,2248,161,3494,3006,106,6791,0,37678,200,16490,13484,9200,17589
2021-05-19 12:30:00+00,16757,39,4285,2533,154,3494,2966,104,7694,0,38026,189,17632,14666,10381,16796
2021-05-19 13:00:00+00,16396,0,4281,2689,155,3494,2908,111,7161,0,37195,188,17194,14286,10005,16396
2021-05-19 13:30:00+00,16150,0,4280,2840,158,3494,2990,113,6366,0,36391,190,16634,13644,9364,16150
2021-05-19 14:00:00+00,15918,0,4283,3015,158,3494,3010,107,6373,0,36358,188,16839,13829,9546,15918
2021-05-19 14:30:00+00,16649,0,4284,3063,186,3494,2985,107,5894,0,36662,194,16412,13427,9143,16649
2021-05-19 15:00:00+00,17076,0,4283,3015,308,3514,2969,119,5038,0,36322,201,15613,12644,8361,17076
2021-05-19 15:30:00+00,18223,0,4280,2816,345,3514,2955,133,4218,0,36484,212,14614,11659,7379,18223
2021-05-19 16:00:00+00,19069,0,4282,2784,481,3514,2942,130,3784,0,36986,218,14273,11331,7049,19069
2021-05-19 16:30:00+00,19576,0,4284,2613,522,3514,2933,168,3144,168,36922,224,13496,10563,6279,19576
2021-05-19 17:00:00+00,19493,0,4285,2693,631,3238,2911,254,2489,712,36706,226,13009,10098,5813,19493
2021-05-19 17:30:00+00,19326,0,4289,2937,664,3226,2883,264,1641,864,36094,228,12414,9531,5242,19326
2021-05-19 18:00:00+00,19357,0,4288,3005,794,3394,2929,264,1174,486,35691,231,12190,9261,4973,19357
2021-05-19 18:30:00+00,19249,0,4288,2856,720,3394,2983,249,638,584,34961,235,11485,8502,4214,19249
2021-05-19 19:00:00+00,19503,0,4288,2390,421,3440,3087,194,247,650,34220,242,10433,7346,3058,19503
2021-05-19 19:30:00+00,19511,0,4234,1830,428,3440,3099,205,24,604,33375,248,9615,6516,2282,19511
2021-05-19 20:00:00+00,19453,0,4217,1416,547,3494,3105,274,0,626,33132,250,9286,6180,1964,19453
2021-05-19 20:30:00+00,19133,0,4220,1211,365,3494,3088,192,0,312,32015,254,8884,5796,1576,19133
2021-05-19 21:00:00+00,18470,0,4222,1159,213,3362,3096,143,0,206,30871,254,8690,5594,1372,18470
2021-05-19 21:30:00+00,16956,0,4220,1111,214,3360,3091,142,0,88,29182,249,8636,5545,1325,16956
2021-05-19 22:00:00+00,14698,0,4218,1216,202,3494,3050,143,0,302,27323,233,8686,5636,1418,14698
2021-05-19 22:30:00+00,13330,0,4218,1358,201,3492,3089,142,0,58,25888,225,8866,5777,1559,13330
2021-05-19 23:00:00+00,12348,0,4214,1421,188,3278,2944,142,0,94,24629,220,8767,5823,1609,12348
2021-05-19 23:30:00+00,11329,0,4214,1495,180,3274,3087,142,0,30,23751,212,8976,5889,1675,11329
2021-05-20 00:00:00+00,10736,0,4212,1579,173,3274,3068,142,0,8,23192,206,9032,5964,1752,10736
2021-05-20 00:30:00+00,10764,0,4213,1737,173,3288,2806,143,0,64,23188,206,8929,6123,1910,10764
2021-05-20 01:00:00+00,10751,0,4213,1957,176,3414,2436,142,0,0,23089,207,8782,6346,2133,10751
2021-05-20 01:30:00+00,10628,0,4213,1874,176,3495,2415,142,0,0,22943,208,8678,6263,2050,10628
2021-05-20 02:00:00+00,10926,0,4211,1924,157,3138,2438,142,0,0,22936,215,8730,6292,2081,10926
2021-05-20 02:30:00+00,10730,0,4210,1938,156,3200,2440,142,0,0,22816,215,8744,6304,2094,10730
2021-05-20 03:00:00+00,10869,0,4213,2092,156,2740,2436,142,0,0,22648,223,8897,6461,2248,10869
2021-05-20 03:30:00+00,10738,0,4190,2245,156,2780,2423,142,0,0,22674,223,9014,6591,2401,10738
2021-05-20 04:00:00+00,11456,0,4086,2489,142,1952,2351,142,31,28,22677,235,9099,6748,2662,11456
2021-05-20 04:30:00+00,12079,0,4075,2786,145,1956,2262,142,243,0,23688,235,9511,7249,3174,12079
2021-05-20 05:00:00+00,13093,0,4072,3156,234,2652,2046,143,580,56,26032,229,10088,8042,3970,13093
2021-05-20 05:30:00+00,13963,0,4073,3905,250,2604,2253,151,815,372,28386,221,11296,9043,4970,13963
2021-05-20 06:00:00+00,14411,0,4076,4441,333,3994,2374,153,973,370,31125,206,12197,9823,5747,14411
2021-05-20 06:30:00+00,15228,0,4080,5250,383,4216,2434,185,1169,144,33089,207,13316,10882,6802,15228
2021-05-20 07:00:00+00,15960,0,4079,5956,414,3632,2433,160,1348,284,34266,206,14230,11797,7718,15960
2021-05-20 07:30:00+00,15711,0,4081,6836,414,3486,2430,170,1543,288,34959,198,15304,12874,8793,15711
2021-05-20 08:00:00+00,15274,0,4128,7748,413,3924,2419,173,1736,124,35939,188,16444,14025,9897,15274
2021-05-20 08:30:00+00,14502,0,4157,8777,406,3814,2393,155,1992,70,36266,177,17725,15332,11175,14502
2021-05-20 09:00:00+00,13892,0,4158,9697,365,3730,2396,149,2373,0,36760,168,18989,16593,12435,13892
2021-05-20 09:30:00+00,13172,0,4166,10933,333,3598,2335,149,2385,0,37071,157,20152,17817,13651,13172
2021-05-20 10:00:00+00,12104,0,4216,12290,275,3532,2346,147,2344,0,37254,144,21471,19125,14909,12104
2021-05-20 10:30:00+00,11466,0,4237,13405,253,3534,2380,145,2071,0,37491,136,22346,19966,15729,11466
2021-05-20 11:00:00+00,10950,0,4254,14166,244,3642,2369,143,1949,0,37717,129,22982,20613,16359,10950
2021-05-20 11:30:00+00,10150,0,4260,15015,237,3632,2392,143,1925,0,37754,120,23829,21437,17177,10150
2021-05-20 12:00:00+00,9267,0,4263,15846,147,3506,2296,144,2144,0,37613,113,24696,22400,18137,9267
2021-05-20 12:30:00+00,8359,0,4263,16144,143,3478,2269,143,2178,0,36977,105,24997,22728,18465,8359
2021-05-20 13:00:00+00,7627,0,4265,16559,137,3338,2341,146,2691,0,37104,95,25993,23652,19387,7627
2021-05-20 13:30:00+00,7490,0,4265,16932,137,3298,2073,145,2293,0,36633,94,25700,23627,19362,7490
2021-05-20 14:00:00+00,7220,0,4270,17083,137,3268,2134,142,2123,0,36377,91,25747,23613,19343,7220
2021-05-20 14:30:00+00,7419,0,4262,17059,143,3388,2197,146,2117,0,36731,94,25778,23581,19319,7419
2021-05-20 15:00:00+00,8067,0,4265,16905,203,3294,2186,154,1780,0,36854,99,25339,23153,18888,8067
2021-05-20 15:30:00+00,8703,0,4267,16969,245,3332,2194,171,1612,138,37631,105,25287,23093,18826,8703
2021-05-20 16:00:00+00,8642,0,4311,17176,404,3208,2306,217,1414,536,38214,102,25611,23305,18994,8642
2021-05-20 16:30:00+00,8513,0,4358,17298,393,3260,2371,233,1304,512,38242,101,25724,23353,18995,8513
2021-05-20 17:00:00+00,8196,0,4357,17365,373,3214,2361,233,911,824,37834,99,25367,23006,18649,8196
2021-05-20 17:30:00+00,8114,0,4351,17579,297,3202,2369,235,626,818,37591,98,25222,22853,18502,8114
2021-05-20 18:00:00+00,7711,0,4352,17459,329,3370,2379,167,329,772,36868,96,24848,22469,18117,7711
2021-05-20 18:30:00+00,7496,0,4354,17211,348,3320,2373,149,180,676,36107,95,24466,22093,17739,7496
2021-05-20 19:00:00+00,7053,0,4357,17080,314,3130,2317,143,45,544,34983,93,24113,21796,17439,7053
2021-05-20 19:30:00+00,6620,0,4351,17024,288,3138,2285,141,1,506,34354,89,23949,21664,17313,6620
2021-05-20 20:00:00+00,6259,0,4353,16972,263,3214,2376,142,0,244,33823,89,23964,21588,17235,6259
2021-05-20 20:30:00+00,5191,0,4360,16905,260,3054,2287,142,0,200,32399,77,23812,21525,17165,5191
2021-05-20 21:00:00+00,4320,0,4357,16867,196,2384,2033,128,0,158,30443,69,23453,21420,17063,4320
2021-05-20 21:30:00+00,3666,0,4364,16859,199,2284,1712,121,0,0,29205,61,23134,21422,17058,3666
2021-05-20 22:00:00+00,4131,0,4359,16941,194,692,1420,119,0,0,27856,70,22914,21494,17135,4131
2021-05-20 22:30:00+00,3292,0,4364,16705,157,780,1373,114,0,0,26785,63,22599,21226,16862,3292
2021-05-20 23:00:00+00,3974,0,4362,16492,141,576,1370,114,0,0,27029,74,22365,20995,16633,3974
2021-05-20 23:30:00+00,3856,0,4359,16612,141,440,1393,122,0,0,26923,71,22505,21112,16753,3856
2021-05-21 00:00:00+00,3961,0,4365,16763,127,550,1352,125,0,0,27243,70,22607,21255,16890,3961
2021-05-21 00:30:00+00,4257,0,4356,16773,125,661,1361,129,0,0,27662,75,22615,21254,16898,4257
2021-05-21 01:00:00+00,4338,0,4358,16679,125,490,1413,130,0,0,27533,76,22575,21162,16804,4338
2021-05-21 01:30:00+00,3898,0,4356,16778,125,497,1413,128,0,0,27195,69,22672,21259,16903,3898
2021-05-21 02:00:00+00,3420,0,4358,16691,125,505,1371,125,0,0,26595,64,22545,21174,16816,3420
2021-05-21 02:30:00+00,3423,0,4358,16562,125,512,1374,124,0,0,26477,64,22419,21045,16687,3423
2021-05-21 03:00:00+00,3463,0,4359,16419,125,623,1371,119,0,0,26479,65,22274,20903,16544,3463
2021-05-21 03:30:00+00,3699,0,4359,16108,125,617,1377,120,0,0,26405,68,21969,20592,16233,3699
2021-05-21 04:00:00+00,4014,0,4360,15725,125,625,1381,120,6,0,26356,75,21597,20216,15856,4014
2021-05-21 04:30:00+00,4371,0,4368,15775,124,658,1482,121,69,0,26968,79,21818,20336,15968,4371
2021-05-21 05:00:00+00,5209,0,4365,15893,133,605,1475,116,207,0,28003,87,22073,20598,16233,5209
2021-05-21 05:30:00+00,6592,0,4369,15769,203,626,1524,118,482,0,29683,100,22347,20823,16454,6592
2021-05-21 06:00:00+00,6613,0,4366,15948,263,2005,1309,120,557,0,31182,93,22443,21134,16768,6613
2021-05-21 06:30:00+00,8499,0,4368,15771,309,2036,1078,125,922,198,33306,107,22448,21370,17002,8499
2021-05-21 07:00:00+00,9251,0,4367,15791,317,2159,1179,122,1205,742,35133,110,22859,21680,17313,9251
2021-05-21 07:30:00+00,9399,0,4370,15866,318,2217,1173,141,1355,708,35546,111,23082,21909,17539,9399
2021-05-21 08:00:00+00,9538,0,4368,16068,314,2361,1118,146,1635,840,36388,110,23503,22385,18017,9538
2021-05-21 08:30:00+00,9385,0,4358,16333,435,2433,1003,148,1937,908,36941,106,24066,23063,18705,9385
2021-05-21 09:00:00+00,9479,0,4362,16485,472,2525,992,151,1978,492,36936,107,24289,23297,18935,9479
2021-05-21 09:30:00+00,9446,0,4357,16799,464,2592,1009,145,2135,362,37309,106,24764,23755,19398,9446
2021-05-21 10:00:00+00,9681,0,4358,16752,460,2662,1010,121,2403,224,37671,107,24983,23973,19615,9681
2021-05-21 10:30:00+00,9589,0,4364,16903,309,2749,1060,117,2533,148,37771,106,25169,24109,19745,9589
2021-05-21 11:00:00+00,9588,0,4358,16718,284,2836,1077,124,2828,396,38209,105,25265,24188,19830,9588
2021-05-21 11:30:00+00,9427,0,4362,16883,250,2912,1098,125,2950,140,38147,103,25543,24445,20083,9427
2021-05-21 12:00:00+00,8959,0,4376,16866,218,3192,1033,136,2875,138,37793,100,25368,24335,19959,8959
2021-05-21 12:30:00+00,8542,0,4389,17061,212,3198,1011,169,2624,0,37206,97,25297,24286,19897,8542
2021-05-21 13:00:00+00,7948,0,4418,17390,144,3236,990,170,2526,0,36822,92,25468,24478,20060,7948
2021-05-21 13:30:00+00,7420,0,4437,17663,141,3192,981,127,2461,0,36422,87,25683,24702,20265,7420
2021-05-21 14:00:00+00,7660,0,4432,17811,141,2724,1083,125,2441,0,36417,89,25908,24825,20393,7660
2021-05-21 14:30:00+00,7880,0,4435,17716,141,2764,1101,126,2182,0,36345,93,25575,24474,20039,7880
2021-05-21 15:00:00+00,8209,0,4435,18178,198,2708,1069,133,1863,0,36793,94,25743,24674,20239,8209
2021-05-21 15:30:00+00,8662,0,4436,18312,254,2826,1073,147,1574,0,37284,99,25649,24576,20140,8662
2021-05-21 16:00:00+00,9171,0,4435,18292,415,2824,1103,148,1297,0,37685,104,25542,24439,20004,9171
2021-05-21 16:30:00+00,9143,0,4436,18052,405,3028,1120,168,1013,120,37485,107,25026,23906,19470,9143
2021-05-21 17:00:00+00,9069,0,4434,17668,412,2898,1116,198,882,264,36941,108,24512,23396,18962,9069
2021-05-21 17:30:00+00,8962,0,4452,17536,413,2860,1111,175,646,526,36681,107,24158,23047,18595,8962
2021-05-21 18:00:00+00,8752,0,4452,17432,405,2868,1109,145,383,568,36114,106,23781,22672,18220,8752
2021-05-21 18:30:00+00,8723,0,4449,17171,379,2806,1060,132,213,392,35325,107,23272,22212,17763,8723
2021-05-21 19:00:00+00,8366,0,4452,16967,368,2904,1114,122,60,140,34493,107,22961,21847,17395,8366
2021-05-21 19:30:00+00,8233,0,4454,16656,389,2718,1187,120,3,0,33760,105,22689,21502,17048,8233
2021-05-21 20:00:00+00,7467,0,4473,16272,315,3364,1125,121,0,0,33137,98,22185,21060,16587,7467
2021-05-21 20:30:00+00,6955,0,4478,15815,272,3220,1169,120,0,6,32035,93,21734,20565,16087,6955
2021-05-21 21:00:00+00,6443,0,4485,15235,159,2884,1400,124,0,0,30730,92,21279,19879,15394,6443
2021-05-21 21:30:00+00,5677,0,4493,14523,152,2820,1577,122,0,0,29364,86,20745,19168,14675,5677
2021-05-21 22:00:00+00,4819,0,4510,14122,164,2764,1644,121,0,0,28144,78,20440,18796,14286,4819
2021-05-21 22:30:00+00,3594,0,4523,13907,159,2722,1652,120,0,0,26677,64,20241,18589,14066,3594
2021-05-21 23:00:00+00,3690,0,4522,13961,132,1890,1726,120,0,0,26041,67,20341,18615,14093,3690
2021-05-21 23:30:00+00,3590,0,4521,13917,133,1848,1755,121,0,0,25885,66,20326,18571,14050,3590
2021-05-22 00:00:00+00,3608,0,4540,13856,134,2044,1751,120,0,0,26053,66,20281,18530,13990,3608
2021-05-22 00:30:00+00,3840,0,4554,13628,134,2048,1680,121,0,0,26005,70,19996,18316,13762,3840
2021-05-22 01:00:00+00,4154,0,4566,13238,135,1952,1675,121,0,0,25841,75,19614,17939,13373,4154
2021-05-22 01:30:00+00,4106,0,4565,12827,135,1950,1641,120,0,0,25344,75,19168,17527,12962,4106
2021-05-22 02:00:00+00,3956,0,4544,12654,135,1610,1641,120,0,0,24660,75,18974,17333,12789,3956
2021-05-22 02:30:00+00,4003,0,4398,12491,135,1606,1642,121,0,0,24396,77,18666,17024,12626,4003
2021-05-22 03:00:00+00,3875,0,4367,12170,135,1800,1676,121,0,0,24144,76,18348,16672,12304,3875
2021-05-22 03:30:00+00,4067,0,4368,11750,135,1800,1755,120,0,0,23995,80,18008,16253,11885,4067
2021-05-22 04:00:00+00,4293,0,4382,11370,135,1506,1887,121,9,0,23703,85,17783,15896,11514,4293
2021-05-22 04:30:00+00,4547,0,4467,10896,197,1498,2120,178,55,0,23958,90,17735,15615,11148,4547
2021-05-22 05:00:00+00,4990,0,4588,10313,414,1558,2265,275,188,0,24591,97,17768,15503,10915,4990
2021-05-22 05:30:00+00,5683,0,4620,9733,495,1664,2555,301,444,0,25495,106,17847,15292,10672,5683
2021-05-22 06:00:00+00,6831,0,4622,9560,290,2542,2464,297,816,0,27422,115,17752,15288,10666,6831
2021-05-22 06:30:00+00,8395,0,4618,9396,273,2558,2454,171,1219,24,29108,128,17960,15506,10888,8395
2021-05-22 07:00:00+00,9627,0,4619,9152,320,3002,2455,121,1591,140,31027,135,18137,15682,11063,9627
2021-05-22 07:30:00+00,10616,0,4620,9187,355,3022,2466,314,1989,36,32605,143,18617,16151,11531,10616
2021-05-22 08:00:00+00,11206,0,4618,9051,408,3406,2479,338,2255,192,33953,144,18811,16332,11714,11206
2021-05-22 08:30:00+00,11985,0,4619,8859,415,3412,2492,340,2539,0,34661,150,18924,16432,11813,11985
2021-05-22 09:00:00+00,12163,0,4615,8584,416,3508,2499,338,2754,0,34877,151,18868,16369,11754,12163
2021-05-22 09:30:00+00,12253,0,4611,8220,398,3510,2500,336,3083,76,34987,152,18812,16312,11701,12253
2021-05-22 10:00:00+00,12431,0,4617,8034,354,3510,2498,339,3484,0,35267,153,18987,16489,11872,12431
2021-05-22 10:30:00+00,12686,0,4616,7860,354,3510,2497,329,3977,0,35829,153,19304,16807,12191,12686
2021-05-22 11:00:00+00,12841,0,4613,7610,300,3508,2496,319,4293,0,35980,154,19312,16816,12203,12841
2021-05-22 11:30:00+00,12812,0,4633,7246,254,3512,2488,267,4558,0,35770,154,19179,16691,12058,12812
2021-05-22 12:00:00+00,12604,0,4645,6913,172,3800,2488,120,4494,70,35306,153,18712,16224,11579,12604
2021-05-22 12:30:00+00,12203,0,4661,6588,164,3804,2411,119,4222,0,34172,153,18046,15634,10974,12203
2021-05-22 13:00:00+00,11721,0,4674,6455,164,3804,2421,121,4523,0,33883,149,18237,15816,11142,11721
2021-05-22 13:30:00+00,11414,0,4673,6406,164,3804,2426,124,4781,0,33792,146,18450,16024,11351,11414
2021-05-22 14:00:00+00,11306,0,4618,6297,164,3998,2433,119,4759,0,33694,145,18271,15838,11220,11306
2021-05-22 14:30:00+00,11379,0,4478,6183,174,4000,2437,116,4405,0,33172,148,17677,15240,10762,11379
2021-05-22 15:00:00+00,11671,0,4452,6001,208,3970,2433,117,4134,0,32986,152,17228,14795,10343,11671
2021-05-22 15:30:00+00,12685,0,4448,5858,241,3970,2438,118,3952,0,33710,161,16937,14499,10051,12685
2021-05-22 16:00:00+00,14097,0,4441,5527,407,3920,2428,154,3525,0,34499,174,16328,13900,9459,14097
2021-05-22 16:30:00+00,14512,0,4516,5240,424,3920,2447,211,2694,296,34260,180,15321,12874,8358,14512
2021-05-22 17:00:00+00,15050,0,4559,4696,469,3968,2492,213,2023,246,33716,190,14239,11747,7188,15050
2021-05-22 17:30:00+00,15302,0,4578,4384,478,3968,2495,268,1512,350,33335,195,13447,10952,6374,15302
2021-05-22 18:00:00+00,15513,0,4600,3964,461,3846,2497,172,1033,1080,33166,198,12555,10058,5458,15513
2021-05-22 18:30:00+00,15437,0,4649,3487,451,3846,2495,298,630,1056,32349,203,11712,9217,4568,15437
2021-05-22 19:00:00+00,15516,0,4660,3199,368,3754,2495,294,310,1124,31720,208,11032,8537,3877,15516
2021-05-22 19:30:00+00,15432,0,4662,3094,334,3752,2495,158,47,1046,31020,210,10632,8137,3475,15432
2021-05-22 20:00:00+00,15542,0,4669,2732,293,3994,2498,200,0,636,30564,215,10192,7694,3025,15542
2021-05-22 20:30:00+00,15717,0,4682,2550,414,3998,2494,269,0,456,30580,218,10140,7646,2964,15717
2021-05-22 21:00:00+00,15347,0,4704,2397,324,3990,2496,170,0,34,29462,221,9921,7425,2721,15347
2021-05-22 21:30:00+00,14309,0,4719,2504,294,3988,2492,130,0,0,28436,214,10009,7517,2798,14309
2021-05-22 22:00:00+00,13066,0,4726,2518,272,3806,2499,115,0,0,27002,207,10015,7516,2790,13066
2021-05-22 22:30:00+00,11863,0,4736,2302,267,3798,2483,115,0,60,25624,199,9788,7305,2569,11863
2021-05-22 23:00:00+00,10892,0,4735,2349,224,3418,2470,114,0,0,24202,195,9778,7308,2573,10892
2021-05-22 23:30:00+00,10186,0,4678,2400,215,3468,2472,114,0,0,23533,189,9765,7293,2615,10186
2021-05-23 00:00:00+00,9866,0,4586,2572,207,3326,2480,114,0,0,23151,188,9845,7365,2779,9866
2021-05-23 00:30:00+00,9426,0,4582,2862,198,3502,2479,114,0,0,23163,184,10121,7642,3060,9426
2021-05-23 01:00:00+00,8685,0,4593,3237,198,3592,2447,115,0,0,22867,175,10475,8028,3435,8685
2021-05-23 01:30:00+00,8029,0,4620,3571,196,3502,2444,115,0,0,22477,165,10831,8387,3767,8029
2021-05-23 02:00:00+00,7514,0,4647,3715,179,3424,2446,117,0,0,22042,161,10987,8541,3894,7514
2021-05-23 02:30:00+00,7144,0,4663,3889,167,3422,2441,120,0,0,21846,156,11160,8719,4056,7144
2021-05-23 03:00:00+00,6841,0,4777,4055,138,3494,2447,120,0,0,21872,152,11417,8970,4193,6841
2021-05-23 03:30:00+00,6443,0,4897,4205,138,3474,2437,119,0,0,21713,145,11677,9240,4343,6443
2021-05-23 04:00:00+00,6647,0,4904,4351,138,3606,2390,118,23,0,22177,148,11806,9416,4512,6647
2021-05-23 04:30:00+00,6183,0,4906,4792,136,3694,2405,115,249,0,22480,140,12488,10083,5177,6183
2021-05-23 05:00:00+00,6429,0,4915,4844,136,3630,2440,116,650,0,23160,139,12985,10545,5630,6429
2021-05-23 05:30:00+00,6502,0,4929,5116,136,3514,2427,116,1044,0,23784,134,13652,11225,6296,6502
2021-05-23 06:00:00+00,6533,0,4936,5339,170,3584,2391,124,1599,0,24676,128,14435,12044,7108,6533
2021-05-23 06:30:00+00,6957,0,4936,5844,170,3504,2397,125,2048,0,25981,126,15395,12998,8062,6957
2021-05-23 07:00:00+00,7147,0,4936,6428,200,3572,2410,119,2507,0,27319,121,16481,14071,9135,7147
2021-05-23 07:30:00+00,7320,0,4937,7086,228,3454,2448,119,2847,0,28439,117,17546,15098,10161,7320
2021-05-23 08:00:00+00,7244,0,4937,7745,244,3544,2439,123,3344,0,29620,112,18709,16270,11333,7244
2021-05-23 08:30:00+00,6788,0,4946,8847,233,3470,2443,124,3826,46,30723,102,20295,17852,12906,6788
2021-05-23 09:00:00+00,6470,0,4946,9934,233,3410,2461,122,4334,138,32048,93,21908,19447,14501,6470
2021-05-23 09:30:00+00,5770,0,4946,10985,225,3406,2382,122,4610,138,32584,82,23148,20766,15820,5770
2021-05-23 10:00:00+00,5798,0,4945,11719,135,3214,2455,119,4438,138,32961,82,23692,21237,16292,5798
2021-05-23 10:30:00+00,5654,0,4881,12783,116,3210,2485,117,4509,178,33933,78,24774,22289,17408,5654
2021-05-23 11:00:00+00,5885,0,4763,13263,114,3210,2491,116,4461,230,34533,79,25092,22601,17838,5885
2021-05-23 11:30:00+00,5409,0,4756,13858,99,3210,2458,115,4551,138,34594,73,25722,23264,18508,5409
2021-05-23 12:00:00+00,5351,0,4754,14413,106,3214,2213,117,4201,0,34369,72,25687,23474,18720,5351
2021-05-23 12:30:00+00,5184,0,4754,14913,106,3214,2052,116,4273,0,34612,70,26098,24046,19292,5184
2021-05-23 13:00:00+00,5048,0,4755,15030,106,3210,2057,118,3819,0,34143,69,25767,23710,18955,5048
2021-05-23 13:30:00+00,5285,0,4769,14963,105,3216,2246,118,3453,0,34155,72,25536,23290,18521,5285
2021-05-23 14:00:00+00,5150,0,4877,15212,89,3220,2376,117,3346,0,34387,71,25900,23524,18647,5150
2021-05-23 14:30:00+00,5045,0,4899,15512,89,3214,2601,116,2462,0,33938,71,25563,22962,18063,5045
2021-05-23 15:00:00+00,5488,0,4901,15790,143,3212,2950,119,2358,0,34961,75,26142,23192,18291,5488
2021-05-23 15:30:00+00,6554,0,4888,15733,192,3216,2971,119,2038,182,35893,85,25822,22851,17963,6554
2021-05-23 16:00:00+00,6934,0,4792,15875,362,3600,2966,117,1770,214,36630,88,25765,22799,18007,6934
2021-05-23 16:30:00+00,7131,0,4774,15665,384,3608,3016,119,1221,166,36084,91,25060,22044,17270,7131
2021-05-23 17:00:00+00,7681,0,4771,14673,409,3606,2996,168,888,990,36182,98,23737,20741,15970,7681
2021-05-23 17:30:00+00,8063,0,4768,13883,509,3606,3006,324,542,660,35361,105,22708,19702,14934,8063
2021-05-23 18:00:00+00,8152,0,4768,13281,609,3418,3026,336,356,822,34768,108,22040,19014,14246,8152
2021-05-23 18:30:00+00,8191,0,4769,12904,599,3410,3043,324,202,908,34350,110,21517,18474,13705,8191
2021-05-23 19:00:00+00,8304,0,4768,12386,560,3400,3045,304,77,1048,33892,113,20836,17791,13023,8304
2021-05-23 19:30:00+00,8334,0,4770,11928,530,3398,3036,337,13,782,33128,116,20277,17241,12471,8334
2021-05-23 20:00:00+00,8176,0,4781,11650,457,3210,3050,335,0,854,32513,116,19938,16888,12107,8176
2021-05-23 20:30:00+00,8004,0,4827,11437,334,3208,3040,243,0,268,31361,117,19638,16598,11771,8004
2021-05-23 21:00:00+00,7523,0,4887,11295,256,3020,3015,128,0,80,30204,114,19453,16438,11551,7523
2021-05-23 21:30:00+00,6466,0,5026,10940,284,3014,2708,116,0,70,28624,104,18958,16250,11224,6466
2021-05-23 22:00:00+00,6423,0,5133,10657,214,2748,2108,117,0,0,27400,105,18112,16004,10871,6423
2021-05-23 22:30:00+00,6010,0,5176,10423,193,2746,1767,116,0,0,26431,102,17559,15792,10616,6010
2021-05-23 23:00:00+00,5846,0,5182,10126,158,2746,1740,117,0,0,25915,101,17206,15466,10284,5846
2021-05-23 23:30:00+00,5635,0,5185,9958,151,2746,1664,116,0,0,25455,99,16958,15294,10109,5635
2021-05-24 00:00:00+00,5396,0,5190,10201,97,2744,1686,115,0,0,25429,96,17174,15488,10298,5396
2021-05-24 00:30:00+00,5714,0,5186,9857,87,2744,1667,119,0,0,25374,101,16797,15130,9944,5714
2021-05-24 01:00:00+00,5987,0,5188,9374,73,2740,1672,117,0,0,25151,106,16307,14635,9447,5987
2021-05-24 01:30:00+00,6125,0,5194,9310,73,2740,1702,118,0,0,25262,108,16279,14577,9383,6125
2021-05-24 02:00:00+00,5809,0,5195,8368,73,2742,1724,118,0,0,24029,108,15360,13636,8441,5809
2021-05-24 02:30:00+00,5808,0,5191,7773,73,2742,1730,118,0,0,23435,111,14767,13037,7846,5808
2021-05-24 03:00:00+00,5816,0,5140,7373,73,2742,1724,115,0,0,22983,113,14310,12586,7446,5816
2021-05-24 03:30:00+00,6040,0,5102,7118,73,2742,1679,116,0,0,22870,118,13972,12293,7191,6040
2021-05-24 04:00:00+00,6118,0,5111,6951,73,2742,1657,114,28,0,22794,119,13820,12163,7052,6118
2021-05-24 04:30:00+00,6638,0,5110,6683,72,2742,1814,114,227,66,23466,125,13906,12092,6982,6638
2021-05-24 05:00:00+00,8060,0,5104,6556,72,3488,2269,116,651,8,26324,137,14652,12384,7280,8060
2021-05-24 05:30:00+00,9829,0,5104,6411,74,3508,2734,116,1276,44,29096,149,15599,12865,7761,9829
2021-05-24 06:00:00+00,12298,0,5104,6364,118,3986,2860,117,1980,0,32827,162,16426,13566,8462,12298
2021-05-24 06:30:00+00,13459,0,5104,6300,139,3996,2860,224,2569,62,34713,168,16972,14112,9008,13459
2021-05-24 07:00:00+00,14115,0,5103,6213,195,3996,2871,296,3193,92,36074,169,17575,14704,9601,14115
2021-05-24 07:30:00+00,14221,0,5105,6164,232,3996,2882,320,3705,178,36803,167,18088,15206,10101,14221
2021-05-24 08:00:00+00,14173,0,5099,6173,203,3996,2884,291,4476,288,37583,163,18835,15951,10852,14173
2021-05-24 08:30:00+00,13936,0,5101,6647,193,3996,2883,183,4897,290,38126,157,19721,16838,11737,13936
2021-05-24 09:00:00+00,13746,0,5086,6896,177,3996,2880,122,5473,2,38378,154,20512,17632,12546,13746
2021-05-24 09:30:00+00,13366,0,4968,7075,159,3996,2880,171,5272,92,37979,152,20354,17474,12506,13366
2021-05-24 10:00:00+00,12802,0,4964,7478,129,3996,2878,327,5302,284,38160,147,20751,17873,12909,12802
2021-05-24 10:30:00+00,12678,0,4962,7988,130,3996,2879,320,5413,174,38540,144,21372,18493,13531,12678
2021-05-24 11:00:00+00,12659,0,4979,8465,108,3996,2881,302,4722,0,38112,145,21155,18274,13295,12659
2021-05-24 11:30:00+00,12579,0,5076,8626,110,3996,2882,290,5104,0,38663,142,21798,18916,13840,12579
2021-05-24 12:00:00+00,12461,0,5099,8624,122,3996,2877,128,5334,0,38641,140,22056,19179,14080,12461
2021-05-24 12:30:00+00,11453,0,5094,9115,145,4026,2835,116,4901,0,37685,133,22090,19255,14161,11453
2021-05-24 13:00:00+00,10746,0,5094,9380,169,4166,2785,116,5213,34,37703,127,22641,19856,14762,10746
2021-05-24 13:30:00+00,10101,0,5098,9210,168,4128,2856,116,4783,0,36460,124,22114,19258,14160,10101
2021-05-24 14:00:00+00,10277,0,4981,9178,192,3996,2873,116,4390,20,36023,126,21614,18741,13760,10277
2021-05-24 14:30:00+00,11241,0,4970,9102,208,3996,2876,128,3671,60,36252,136,20827,17951,12981,11241
2021-05-24 15:00:00+00,12176,0,4986,8585,246,4078,2872,132,3399,8,36482,146,20088,17216,12230,12176
2021-05-24 15:30:00+00,13082,0,5092,8144,277,4294,2887,129,3499,0,37404,154,19899,17012,11920,13082
2021-05-24 16:00:00+00,13909,0,5216,7759,377,4420,2887,133,3357,304,38362,161,19596,16709,11493,13909
2021-05-24 16:30:00+00,14102,0,5231,7491,376,4714,2903,142,2704,490,38153,167,18705,15802,10571,14102
2021-05-24 17:00:00+00,14112,0,5227,7255,374,4786,2952,144,1900,874,37624,171,17708,14756,9529,14112
2021-05-24 17:30:00+00,14313,0,5233,6877,374,4780,2966,174,1659,862,37238,175,17109,14143,8910,14313
2021-05-24 18:00:00+00,14468,0,5228,6543,374,4464,2996,302,1274,924,36573,180,16415,13419,8191,14468
2021-05-24 18:30:00+00,14141,0,5225,6269,374,4460,3000,158,635,1010,35272,182,15503,12503,7278,14141
2021-05-24 19:00:00+00,14266,0,5225,6073,374,4492,2998,124,257,670,34479,187,14927,11929,6704,14266
2021-05-24 19:30:00+00,13886,0,5230,6050,369,4496,2995,124,33,170,33353,189,14677,11682,6452,13886
2021-05-24 20:00:00+00,13586,0,5222,5905,310,4718,2998,118,0,110,32967,188,14435,11437,6215,13586
2021-05-24 20:30:00+00,12725,0,5225,6048,303,4696,2970,115,0,0,32082,182,14546,11576,6351,12725
2021-05-24 21:00:00+00,11209,0,5225,6316,259,4600,2873,115,0,0,30597,169,14673,11800,6575,11209
2021-05-24 21:30:00+00,10053,0,5221,6198,275,4330,2595,114,0,0,28786,159,14289,11694,6473,10053
2021-05-24 22:00:00+00,9206,0,5080,6542,258,3608,2031,118,0,30,26873,153,13911,11880,6800,9206
2021-05-24 22:30:00+00,7613,0,5046,6762,255,3898,1700,118,0,16,25408,142,13763,12063,7017,7613
2021-05-24 23:00:00+00,6968,0,5044,6773,247,3386,1705,111,0,90,24324,138,13769,12064,7020,6968
2021-05-24 23:30:00+00,6201,0,5049,7135,237,3300,1696,110,0,0,23728,127,14117,12421,7372,6201
2021-05-25 00:00:00+00,5891,0,5054,7318,216,3268,1699,114,0,0,23560,122,14287,12588,7534,5891
2021-05-25 00:30:00+00,5534,0,5065,7877,215,3278,1690,114,0,0,23773,116,14847,13157,8092,5534
2021-05-25 01:00:00+00,5015,0,5178,8514,189,3194,1667,114,0,0,23871,105,15548,13881,8703,5015
2021-05-25 01:30:00+00,4590,0,5250,8853,190,3100,1632,114,0,0,23729,96,15925,14293,9043,4590
2021-05-25 02:00:00+00,4444,0,5251,9490,189,2836,1647,114,0,0,23971,88,16577,14930,9679,4444
2021-05-25 02:30:00+00,4299,0,5248,10043,186,2742,1655,114,0,0,24287,83,17132,15477,10229,4299
2021-05-25 03:00:00+00,4428,0,5243,10098,178,2488,1649,115,0,0,24199,85,17168,15519,10276,4428
2021-05-25 03:30:00+00,4401,0,5243,10122,178,2474,1654,114,0,0,24186,85,17197,15543,10300,4401
2021-05-25 04:00:00+00,4681,0,5244,9996,226,2364,1649,114,23,0,24297,89,17138,15489,10245,4681
2021-05-25 04:30:00+00,5023,0,5248,9953,225,2478,1703,115,191,0,24936,94,17320,15617,10369,5023
2021-05-25 05:00:00+00,5479,0,5245,10029,281,3122,2194,116,382,0,26848,97,18131,15937,10692,5479
2021-05-25 05:30:00+00,7364,0,5248,9879,300,3044,2768,115,700,68,29486,114,18895,16127,10879,7364
2021-05-25 06:00:00+00,9429,0,5253,9752,358,3448,2925,118,1133,94,32510,129,19421,16496,11243,9429
2021-05-25 06:30:00+00,10352,0,5248,9545,546,3454,2943,154,1649,414,34305,134,19931,16988,11740,10352
2021-05-25 07:00:00+00,10940,0,5247,9336,583,3798,2951,376,2000,534,35765,137,20117,17166,11919,10940
2021-05-25 07:30:00+00,11277,0,5250,9241,607,3804,2913,385,2363,462,36302,138,20374,17461,12211,11277
2021-05-25 08:00:00+00,11555,0,5184,9032,627,3802,2898,392,2706,904,37100,139,20447,17549,12365,11555
2021-05-25 08:30:00+00,11943,0,5059,8907,640,3802,2905,398,2945,664,37263,142,20456,17551,12492,11943
2021-05-25 09:00:00+00,12352,0,5041,8838,613,3817,2923,361,3103,442,37490,146,20518,17595,12554,12352
2021-05-25 09:30:00+00,12676,0,5038,8760,613,3808,2914,298,3444,386,37937,147,20769,17855,12817,12676
2021-05-25 10:00:00+00,13182,0,5038,8654,562,3797,2925,345,3749,50,38302,151,20928,18003,12965,13182
2021-05-25 10:30:00+00,13158,0,5074,8738,576,3792,2913,356,4115,0,38722,149,21416,18503,13429,13158
2021-05-25 11:00:00+00,13257,0,5204,8610,454,3794,2923,366,4156,192,38956,149,21347,18424,13220,13257
2021-05-25 11:30:00+00,13409,0,5242,8244,364,3794,2927,362,4323,30,38695,152,21100,18173,12931,13409
2021-05-25 12:00:00+00,13114,0,5248,8100,334,3864,2921,359,4170,0,38110,151,20773,17852,12604,13114
2021-05-25 12:30:00+00,12945,0,5248,8086,266,3860,2919,316,4205,0,37844,150,20724,17805,12557,12945
2021-05-25 13:00:00+00,12898,0,5244,7810,167,3844,2925,252,4449,2,37591,150,20595,17670,12426,12898
2021-05-25 13:30:00+00,12960,0,5249,7436,183,3839,2923,201,4078,174,37043,153,19869,16946,11697,12960
2021-05-25 14:00:00+00,13148,0,5250,7292,235,3060,2932,180,3753,86,35936,158,19462,16530,11280,13148
2021-05-25 14:30:00+00,13644,0,5249,7089,259,3856,2925,192,3913,88,37215,159,19435,16510,11261,13644
2021-05-25 15:00:00+00,14337,0,5243,7044,331,3928,2918,180,3495,0,37476,165,19031,16113,10870,14337
2021-05-25 15:30:00+00,15317,0,5219,6315,363,3937,2933,270,3263,424,38041,174,18093,15160,9941,15317
2021-05-25 16:00:00+00,15800,0,5077,5794,709,4031,2931,396,2734,768,38240,178,17245,14314,9237,15800
2021-05-25 16:30:00+00,16117,0,5037,5492,831,4043,2927,392,2295,868,38002,183,16582,13655,8618,16117
2021-05-25 17:00:00+00,15784,0,5031,5381,832,4090,2926,402,1829,1164,37439,183,15999,13073,8042,15784
2021-05-25 17:30:00+00,15632,0,5026,5361,809,4088,2930,286,1504,1290,36926,183,15630,12700,7674,15632
2021-05-25 18:00:00+00,15785,0,5029,5463,611,4089,2930,257,997,1138,36299,187,15030,12100,7071,15785
2021-05-25 18:30:00+00,15909,0,5028,5274,566,4086,2940,220,573,892,35487,192,14381,11441,6413,15909
2021-05-25 19:00:00+00,16116,0,5030,4465,598,4031,2940,219,266,816,34481,200,13299,10359,5329,16116
2021-05-25 19:30:00+00,15961,0,5035,4331,510,4018,2934,189,42,544,33564,203,12852,9918,4883,15961
2021-05-25 20:00:00+00,15641,0,5159,4253,339,3998,2936,176,0,420,32922,203,12687,9751,4592,15641
2021-05-25 20:30:00+00,15306,0,5243,4462,317,3998,2874,127,0,100,32427,202,12896,10022,4779,15306
2021-05-25 21:00:00+00,14560,0,5246,4623,256,3998,2785,116,0,16,31600,197,12910,10125,4879,14560
2021-05-25 21:30:00+00,12844,0,5246,4600,239,3996,2429,117,0,0,29471,187,12514,10085,4839,12844
2021-05-25 22:00:00+00,11933,0,5247,4237,225,3806,1998,110,0,0,27556,185,11707,9709,4462,11933
2021-05-25 22:30:00+00,11044,0,5249,3871,222,3796,1686,113,0,0,25981,181,11028,9342,4093,11044
2021-05-25 23:00:00+00,10773,0,5166,3602,206,3414,1691,119,0,20,24991,184,10665,8974,3808,10773
2021-05-25 23:30:00+00,10548,0,5047,3476,204,3408,1692,117,0,0,24492,184,10419,8727,3680,10548
2021-05-26 00:00:00+00,10576,0,5044,3405,164,3408,1685,120,0,0,24402,186,10298,8613,3569,10576
2021-05-26 00:30:00+00,10700,0,5052,3406,164,3410,1693,119,0,0,24544,187,10315,8622,3570,10700
2021-05-26 01:00:00+00,10677,0,5052,3547,143,3410,1698,117,0,0,24644,186,10440,8742,3690,10677
2021-05-26 01:30:00+00,10297,0,5119,3894,124,3410,1690,121,0,0,24655,180,10827,9137,4018,10297
2021-05-26 02:00:00+00,10258,0,5237,3817,123,3410,1693,116,0,0,24654,179,10870,9177,3940,10258
2021-05-26 02:30:00+00,10249,0,5255,3811,123,3410,1675,115,0,0,24638,179,10864,9189,3934,10249
2021-05-26 03:00:00+00,10131,0,5255,4130,122,3412,1666,115,0,0,24831,176,11173,9507,4252,10131
2021-05-26 03:30:00+00,9606,0,5254,4431,123,3412,1667,114,0,0,24607,169,11475,9808,4554,9606
2021-05-26 04:00:00+00,9907,0,5259,4602,176,3450,1677,116,15,0,25202,170,11729,10052,4793,9907
2021-05-26 04:30:00+00,10378,0,5269,4698,174,3452,1782,114,148,0,26015,172,12071,10289,5020,10378
2021-05-26 05:00:00+00,11255,0,5276,4708,195,3250,2299,114,470,0,27568,176,12949,10650,5373,11255
2021-05-26 05:30:00+00,12932,0,5286,4867,216,3242,2289,115,993,38,29977,184,13650,11361,6076,12932
2021-05-26 06:00:00+00,14657,0,5291,5252,365,3530,2132,118,1494,246,33085,187,14534,12402,7111,14657
2021-05-26 06:30:00+00,15004,0,5295,5563,400,3540,2264,137,2161,340,34705,182,15684,13420,8124,15004
2021-05-26 07:00:00+00,14959,0,5303,5837,417,3782,2262,187,2740,388,35875,177,16559,14297,8994,14959
2021-05-26 07:30:00+00,15218,0,5310,5776,403,3784,2265,198,3090,36,36081,179,16845,14580,9269,15218
2021-05-26 08:00:00+00,15425,14,5312,5689,425,3860,2274,196,3794,150,37139,177,17494,15220,9908,15439
2021-05-26 08:30:00+00,15354,29,5310,5689,417,3860,2270,173,4292,94,37487,175,17978,15708,10398,15383
2021-05-26 09:00:00+00,15059,43,5298,6170,430,3624,2485,266,4695,18,38087,171,19077,16592,11295,15102
2021-05-26 09:30:00+00,14731,0,5284,5950,358,3622,2768,115,4877,76,37781,166,19237,16469,11185,14731
2021-05-26 10:00:00+00,14824,0,5284,6201,292,3462,2842,117,4858,32,37912,167,19477,16635,11351,14824
2021-05-26 10:30:00+00,14923,0,5288,6200,270,3472,2841,115,5192,22,38323,166,19791,16950,11662,14923
2021-05-26 11:00:00+00,14751,0,5300,6004,222,3982,2853,137,5026,268,38543,165,19405,16552,11252,14751
2021-05-26 11:30:00+00,15090,0,5310,5757,182,3998,2818,157,5115,140,38567,169,19182,16364,11054,15090
2021-05-26 12:00:00+00,15253,0,5320,5661,158,3998,2826,167,5312,0,38695,170,19277,16451,11131,15253
2021-05-26 12:30:00+00,14871,0,5327,5473,159,3998,2825,141,5080,0,37875,169,18865,16040,10712,14871
2021-05-26 13:00:00+00,14624,0,5334,5496,125,3998,2830,143,4751,0,37301,169,18536,15706,10372,14624
2021-05-26 13:30:00+00,13926,0,5341,5780,152,3998,2825,142,4407,0,36571,165,18505,15680,10339,13926
2021-05-26 14:00:00+00,13466,0,5344,6074,152,3998,2881,143,4126,14,36198,162,18577,15696,10352,13466
2021-05-26 14:30:00+00,14081,0,5348,6122,164,3998,2860,142,4048,48,36811,166,18542,15682,10334,14081
2021-05-26 15:00:00+00,14651,13,5346,6171,248,4016,2871,156,3628,0,37100,171,18264,15393,10047,14664
2021-05-26 15:30:00+00,15526,36,5347,6097,304,4016,2872,157,3249,46,37650,178,17869,14997,9650,15562
2021-05-26 16:00:00+00,16083,91,5345,6024,461,4018,2881,189,3129,226,38447,182,17840,14959,9614,16174
2021-05-26 16:30:00+00,16073,219,5351,5856,480,4018,2901,294,2347,446,37985,188,16935,14034,8683,16292
2021-05-26 17:00:00+00,15836,231,5354,5809,537,4018,2867,419,1912,712,37695,188,16479,13612,8258,16067
2021-05-26 17:30:00+00,15779,232,5355,5636,513,4018,2867,435,1485,926,37246,190,15856,12989,7634,16011
2021-05-26 18:00:00+00,16037,237,5355,5357,569,4018,2890,357,1037,892,36749,195,15208,12318,6963,16274
2021-05-26 18:30:00+00,16111,249,5353,5103,570,4018,2857,286,541,656,35744,201,14424,11567,6214,16360
2021-05-26 19:00:00+00,16015,247,5352,4742,582,4016,2899,218,226,350,34647,205,13801,10902,5550,16262
2021-05-26 19:30:00+00,15951,237,5352,4361,483,4016,2904,195,41,320,33860,209,13141,10237,4885,16188
2021-05-26 20:00:00+00,15867,238,5348,4071,376,3994,2902,167,0,260,33223,212,12697,9795,4447,16105
2021-05-26 20:30:00+00,15675,215,5350,3649,440,3990,2817,145,0,40,32321,214,12256,9439,4089,15890
2021-05-26 21:00:00+00,15168,1,5358,3325,298,3718,2758,143,0,28,30797,210,11739,8981,3623,15169
2021-05-26 21:30:00+00,14567,0,5349,3056,283,3718,2399,143,0,0,29515,210,11087,8688,3339,14567
2021-05-26 22:00:00+00,13444,0,5352,2961,273,3610,1885,142,0,0,27667,206,10471,8586,3234,13444
2021-05-26 22:30:00+00,12067,0,5346,2942,270,3606,1542,142,0,0,25915,198,10100,8558,3212,12067
2021-05-26 23:00:00+00,11253,0,5351,3030,158,3606,1553,142,0,0,25093,192,10092,8539,3188,11253
2021-05-26 23:30:00+00,11085,0,5347,2951,151,3606,1589,141,0,0,24870,191,10038,8449,3102,11085
2021-05-27 00:00:00+00,11147,0,5344,2992,129,3606,1620,141,0,0,24979,192,10085,8465,3121,11147
2021-05-27 00:30:00+00,11285,0,5342,2912,129,3606,1653,145,0,0,25072,194,10036,8383,3041,11285
2021-05-27 01:00:00+00,11339,0,5349,2852,129,3608,1666,141,0,0,25084,195,9996,8330,2981,11339
2021-05-27 01:30:00+00,10999,0,5355,2892,130,3608,1668,141,0,0,24793,192,10045,8377,3022,10999
2021-05-27 02:00:00+00,10837,0,5353,2914,130,3564,1674,144,0,0,24616,191,10071,8397,3044,10837
2021-05-27 02:30:00+00,10882,0,5357,2796,130,3564,1675,143,0,0,24546,192,9958,8283,2926,10882
2021-05-27 03:00:00+00,11365,0,5359,2580,130,3339,1661,142,0,0,24576,199,9730,8069,2710,11365
2021-05-27 03:30:00+00,11132,0,5386,2564,137,3332,1643,142,0,0,24336,197,9730,8087,2701,11132
2021-05-27 04:00:00+00,11070,0,5388,2759,191,3370,1647,142,36,0,24603,196,10021,8374,2986,11070
2021-05-27 04:30:00+00,11121,0,5387,2916,194,3501,1685,144,252,0,25200,195,10434,8749,3362,11121
2021-05-27 05:00:00+00,11248,0,5384,3103,243,4036,2008,142,632,0,26796,189,11370,9362,3978,11248
2021-05-27 05:30:00+00,13147,0,5386,3102,259,4028,2146,150,1149,16,29383,199,12042,9896,4510,13147
2021-05-27 06:00:00+00,14980,0,5385,2981,415,3764,2116,197,1724,96,31658,203,12621,10505,5120,14980
2021-05-27 06:30:00+00,15889,0,5387,2792,449,3640,2161,230,2347,20,32915,205,13136,10975,5588,15889
2021-05-27 07:00:00+00,16290,0,5387,2559,487,3912,2271,189,2994,194,34283,203,13698,11427,6040,16290
2021-05-27 07:30:00+00,16210,0,5395,2446,482,3924,2261,185,3851,0,34754,199,14435,12174,6779,16210
2021-05-27 08:00:00+00,16127,0,5392,2324,434,3962,2262,156,4748,190,35594,194,15160,12898,7506,16127
2021-05-27 08:30:00+00,15880,0,5404,2142,428,3890,2430,150,5362,0,35686,191,15766,13336,7932,15880
2021-05-27 09:00:00+00,15676,0,5404,1970,346,3566,2735,144,6093,146,36080,188,16548,13813,8409,15676
2021-05-27 09:30:00+00,15559,0,5417,1789,310,3642,2809,180,6448,8,36162,188,16773,13964,8547,15559
2021-05-27 10:00:00+00,15061,0,5420,1720,291,4026,2828,143,6720,0,36209,184,16979,14151,8731,15061
2021-05-27 10:30:00+00,15006,0,5408,1607,286,4118,2601,143,7307,0,36476,182,17209,14608,9200,15006
2021-05-27 11:00:00+00,15041,0,5404,1524,247,4220,2719,168,7516,0,36839,182,17410,14691,9287,15041
2021-05-27 11:30:00+00,14966,0,5408,1496,245,4190,2692,169,7512,0,36678,181,17353,14661,9253,14966
2021-05-27 12:00:00+00,15048,0,5404,1413,204,3954,2493,144,7565,26,36251,181,17079,14586,9182,15048
2021-05-27 12:30:00+00,14449,0,5404,1420,202,3942,2497,143,7673,40,35770,176,17196,14699,9295,14449
2021-05-27 13:00:00+00,14161,0,5395,1307,242,4068,2498,143,7336,44,35194,175,16778,14280,8885,14161
2021-05-27 13:30:00+00,13849,0,5401,1148,276,4000,2477,143,7197,30,34521,174,16499,14022,8621,13849
2021-05-27 14:00:00+00,13843,0,5397,1152,284,3996,2634,143,6804,0,34253,176,16271,13637,8240,13843
2021-05-27 14:30:00+00,14366,0,5401,1235,261,3950,2780,143,6128,34,34298,182,15805,13025,7624,14366
2021-05-27 15:00:00+00,14947,0,5400,1364,297,3772,2902,161,5420,112,34376,188,15384,12482,7082,14947
2021-05-27 15:30:00+00,16041,0,5403,1339,353,3770,2906,180,4732,108,34832,198,14733,11827,6424,16041
2021-05-27 16:00:00+00,16373,0,5406,1332,480,4016,2919,282,4203,468,35479,200,14340,11421,6015,16373
2021-05-27 16:30:00+00,16696,0,5409,1363,483,4018,2932,364,3402,590,35257,206,13589,10657,5248,16696
2021-05-27 17:00:00+00,17056,0,5406,1373,484,4018,2938,389,2604,618,34886,212,12805,9867,4461,17056
2021-05-27 17:30:00+00,17067,0,5413,1343,526,4018,2938,383,2001,954,34643,214,12221,9283,3870,17067
2021-05-27 18:00:00+00,17023,0,5409,1314,528,4018,2933,354,1325,1092,33996,217,11509,8576,3167,17023
2021-05-27 18:30:00+00,16953,0,5412,1150,526,4018,2932,378,730,1148,33247,222,10750,7818,2406,16953
2021-05-27 19:00:00+00,17000,0,5411,1063,510,4016,2930,419,299,600,32248,229,10213,7283,1872,17000
2021-05-27 19:30:00+00,16825,0,5411,1015,490,4018,2914,335,50,610,31668,231,9880,6966,1555,16825
2021-05-27 20:00:00+00,16990,0,5411,1003,456,3998,2883,291,0,384,31416,234,9753,6870,1459,16990
2021-05-27 20:30:00+00,16880,0,5412,986,405,3998,2918,198,0,22,30819,236,9721,6803,1391,16880
2021-05-27 21:00:00+00,15973,0,5407,970,320,3998,2912,163,0,0,29743,232,9609,6697,1290,15973
2021-05-27 21:30:00+00,14976,0,5410,975,332,3996,2627,144,0,0,28460,227,9344,6717,1307,14976
2021-05-27 22:00:00+00,13894,0,5411,1014,316,3804,2041,141,0,0,26621,224,8782,6741,1330,13894
2021-05-27 22:30:00+00,12717,0,5410,1107,289,3800,1697,141,0,0,25161,216,8503,6806,1396,12717
2021-05-27 23:00:00+00,12084,0,5412,1144,207,3604,1704,141,0,0,24296,214,8467,6763,1351,12084
2021-05-27 23:30:00+00,11591,0,5409,1159,200,3602,1701,141,0,0,23803,210,8469,6768,1359,11591
2021-05-28 00:00:00+00,11602,0,5413,1214,157,3602,1701,142,0,0,23831,210,8485,6784,1371,11602
2021-05-28 00:30:00+00,11728,0,5412,1252,156,3602,1703,143,0,0,23996,210,8523,6820,1408,11728
2021-05-28 01:00:00+00,11735,0,5411,1272,155,3600,1705,142,0,0,24020,210,8543,6838,1427,11735
2021-05-28 01:30:00+00,11590,0,5413,1230,155,3112,1702,143,0,0,23345,214,8500,6798,1385,11590
2021-05-28 02:00:00+00,12170,0,5420,1179,156,2610,1712,142,0,0,23389,222,8467,6755,1335,12170
2021-05-28 02:30:00+00,12015,0,5419,1147,157,2610,1706,142,0,0,23196,221,8429,6723,1304,12015
2021-05-28 03:00:00+00,12020,0,5419,1105,156,2662,1695,142,0,0,23199,222,8375,6680,1261,12020
2021-05-28 03:30:00+00,11932,0,5424,1062,156,2662,1694,141,0,0,23071,221,8336,6642,1218,11932
2021-05-28 04:00:00+00,12195,0,5422,1035,154,2706,1693,141,41,0,23387,223,8345,6652,1230,12195
2021-05-28 04:30:00+00,12360,0,5424,964,164,2706,1876,141,234,0,23869,222,8662,6786,1362,12360
2021-05-28 05:00:00+00,13298,0,5420,933,267,2858,2219,141,527,0,25663,223,9366,7147,1727,13298
2021-05-28 05:30:00+00,14761,55,5416,888,271,2862,2496,141,908,0,27798,230,9979,7483,2067,14816
2021-05-28 06:00:00+00,16842,231,5417,861,393,3000,2753,143,1389,78,31107,238,10813,8060,2643,17073
2021-05-28 06:30:00+00,17622,385,5409,819,497,3006,2937,316,1861,188,33040,240,11523,8586,3177,18007
2021-05-28 07:00:00+00,17693,485,5411,852,519,3006,2939,407,2370,592,34274,236,12091,9152,3741,18178
2021-05-28 07:30:00+00,17702,490,5414,891,476,3006,2934,405,3079,570,34967,231,12794,9860,4446,18192
2021-05-28 08:00:00+00,17836,463,5415,903,465,3006,2934,396,3876,438,35732,228,13593,10659,5244,18299
2021-05-28 08:30:00+00,17804,413,5414,931,471,3006,2922,282,4356,326,35925,224,14094,11172,5758,18217
2021-05-28 09:00:00+00,17589,463,5413,968,345,3006,2912,284,4880,400,36260,220,14518,11606,6193,18052
2021-05-28 09:30:00+00,17454,453,5416,945,355,3006,2900,227,5222,250,36228,218,14838,11938,6522,17907
2021-05-28 10:00:00+00,17266,486,5418,932,377,3006,2881,214,5545,0,36125,217,15153,12272,6854,17752
2021-05-28 10:30:00+00,17192,486,5421,924,389,3006,2848,285,5766,0,36317,216,15348,12500,7079,17678
2021-05-28 11:00:00+00,17260,488,5423,958,381,3006,2844,290,5631,6,36287,217,15237,12393,6970,17748
2021-05-28 11:30:00+00,17279,439,5420,985,368,3006,2864,236,5497,30,36124,217,15134,12270,6850,17718
2021-05-28 12:00:00+00,16493,464,5422,1025,234,3956,2738,153,5577,0,36062,208,14996,12258,6836,16957
2021-05-28 12:30:00+00,16148,477,5422,1094,213,3998,2694,148,5623,0,35817,206,15046,12352,6930,16625
2021-05-28 13:00:00+00,16119,379,5418,1081,237,3998,2742,143,5441,0,35558,205,14919,12177,6759,16498
2021-05-28 13:30:00+00,15731,241,5411,1144,254,3998,2870,143,4906,0,34698,202,14585,11715,6304,15972
2021-05-28 14:00:00+00,15809,248,5409,1214,235,3998,2787,155,4506,0,34361,205,14151,11364,5955,16057
2021-05-28 14:30:00+00,16067,343,5419,1344,237,3998,2802,178,3947,0,34335,211,13749,10947,5528,16410
2021-05-28 15:00:00+00,16464,386,5421,1362,274,4018,2900,184,3512,0,34521,216,13469,10569,5148,16850
2021-05-28 15:30:00+00,16561,485,5424,1347,298,4018,2917,183,3093,142,34468,220,13079,10162,4738,17046
2021-05-28 16:00:00+00,16653,487,5427,1379,465,4018,2916,378,2500,620,34843,221,12687,9771,4344,17140
2021-05-28 16:30:00+00,16767,457,5428,1318,484,4018,2891,327,2001,976,34667,222,12122,9231,3803,17224
2021-05-28 17:00:00+00,16801,447,5428,1248,504,3968,2849,438,1471,1102,34256,226,11500,8651,3223,17248
2021-05-28 17:30:00+00,16845,455,5427,1215,508,3968,2862,401,1065,1006,33752,230,11077,8215,2788,17300
2021-05-28 18:00:00+00,16717,413,5430,1159,483,4018,2863,364,688,1044,33179,231,10623,7760,2330,17130
2021-05-28 18:30:00+00,16835,246,5428,1101,471,4018,2881,326,383,972,32661,231,10264,7383,1955,17081
2021-05-28 19:00:00+00,16812,230,5428,995,426,4018,2884,289,183,554,31819,235,9916,7032,1604,17042
2021-05-28 19:30:00+00,16782,235,5424,982,407,4018,2895,180,33,378,31334,237,9741,6846,1422,17017
2021-05-28 20:00:00+00,16619,230,5429,1024,375,3998,2896,155,0,156,30882,238,9724,6828,1399,16849
2021-05-28 20:30:00+00,16171,10,5427,1023,352,3998,2899,150,0,174,30204,231,9701,6802,1375,16181
2021-05-28 21:00:00+00,15217,0,5432,1035,286,3996,2666,202,0,246,29080,226,9419,6753,1321,15217
2021-05-28 21:30:00+00,14701,0,5427,1107,278,3996,2145,199,0,78,27931,226,8957,6812,1385,14701
2021-05-28 22:00:00+00,13892,0,5427,1191,242,3790,1570,146,0,0,26258,225,8430,6860,1433,13892
2021-05-28 22:30:00+00,12976,0,5425,1225,233,3784,1519,141,0,0,25303,218,8402,6883,1458,12976
2021-05-28 23:00:00+00,12282,0,5425,1373,124,3572,1481,142,0,0,24399,215,8403,6922,1497,12282
2021-05-28 23:30:00+00,11532,0,5422,1466,119,3560,1499,142,0,0,23740,208,8506,7007,1585,11532
2021-05-29 00:00:00+00,11821,0,5416,1440,97,3392,1501,141,0,0,23808,209,8454,6953,1537,11821
2021-05-29 00:30:00+00,11813,0,5415,1374,97,3390,1506,141,0,0,23736,210,8392,6886,1471,11813
2021-05-29 01:00:00+00,11887,0,5414,1206,87,3522,1493,142,0,0,23751,211,8200,6707,1293,11887
2021-05-29 01:30:00+00,11443,0,5413,1174,86,3528,1505,147,0,0,23296,208,8178,6673,1260,11443
2021-05-29 02:00:00+00,11410,0,5417,1119,86,3470,1513,148,0,0,23163,208,8135,6622,1205,11410
2021-05-29 02:30:00+00,11398,0,5420,1053,86,3466,1504,141,0,0,23068,209,8063,6559,1139,11398
2021-05-29 03:00:00+00,11225,0,5426,1026,86,3560,1498,142,0,0,22963,207,8036,6538,1112,11225
2021-05-29 03:30:00+00,10922,0,5431,1053,86,3564,1481,142,0,0,22679,204,8051,6570,1139,10922
2021-05-29 04:00:00+00,10936,0,5432,1097,94,3402,1491,142,35,0,22629,205,8149,6658,1226,10936
2021-05-29 04:30:00+00,10942,0,5432,1082,104,3394,1485,141,165,0,22745,204,8268,6783,1351,10942
2021-05-29 05:00:00+00,10970,0,5432,1072,149,3488,1493,142,415,0,23161,201,8561,7068,1636,10970
2021-05-29 05:30:00+00,11273,0,5429,972,169,3500,1796,143,825,0,24107,199,9191,7395,1966,11273
2021-05-29 06:00:00+00,11764,0,5430,858,276,3782,2105,145,1352,0,25712,196,10021,7916,2486,11764
2021-05-29 06:30:00+00,12516,0,5428,804,281,3790,2269,220,1846,0,27154,199,10628,8359,2931,12516
2021-05-29 07:00:00+00,13032,0,5425,750,398,3996,2381,334,2417,0,28733,197,11371,8990,3565,13032
2021-05-29 07:30:00+00,13412,0,5424,727,450,3998,2382,378,3180,0,29951,194,12163,9781,4357,13412
2021-05-29 08:00:00+00,13448,0,5427,777,466,3998,2391,423,4310,264,31504,186,13371,10980,5553,13448
2021-05-29 08:30:00+00,13193,0,5429,759,424,3998,2402,463,5182,362,32212,179,14196,11794,6365,13193
2021-05-29 09:00:00+00,13284,0,5427,785,356,3998,2418,401,5846,0,32515,178,14832,12414,6987,13284
2021-05-29 09:30:00+00,13180,0,5440,830,335,3998,2423,202,6248,0,32656,174,15276,12853,7413,13180
2021-05-29 10:00:00+00,12821,0,5440,919,321,3998,2406,149,6766,0,32820,168,15852,13446,8006,12821
2021-05-29 10:30:00+00,12401,0,5445,1051,304,3998,2278,149,7107,0,32733,163,16185,13907,8462,12401
2021-05-29 11:00:00+00,12080,0,5443,1118,237,3998,2327,149,7507,0,32859,158,16632,14305,8862,12080
2021-05-29 11:30:00+00,11592,0,5443,1177,236,3998,2249,150,7900,0,32745,153,17005,14756,9313,11592
2021-05-29 12:00:00+00,11415,0,5441,1256,195,3006,2315,143,7900,140,31811,155,17107,14792,9351,11415
2021-05-29 12:30:00+00,10962,0,5432,1395,196,3006,2379,143,7725,0,31238,152,17127,14748,9316,10962
2021-05-29 13:00:00+00,10658,0,5433,1391,168,3006,2407,145,7557,0,30765,151,16956,14549,9116,10658
2021-05-29 13:30:00+00,10722,0,5432,1490,168,3006,2295,147,7128,0,30388,153,16513,14218,8786,10722
2021-05-29 14:00:00+00,10941,0,5427,1522,168,3006,2292,146,6530,0,30032,158,15939,13647,8220,10941
2021-05-29 14:30:00+00,11257,0,5427,1517,175,3006,2314,144,6049,0,29889,163,15482,13168,7741,11257
2021-05-29 15:00:00+00,12084,0,5432,1535,218,3026,2410,119,5310,0,30134,172,14905,12495,7063,12084
2021-05-29 15:30:00+00,12993,0,5428,1626,246,3026,2457,143,4498,0,30417,183,14255,11798,6370,12993
2021-05-29 16:00:00+00,13623,0,5429,1689,391,3026,2318,222,3759,252,30709,190,13586,11268,5839,13623
2021-05-29 16:30:00+00,14227,0,5440,1772,496,3056,2361,424,3147,220,31143,197,13216,10855,5415,14227
2021-05-29 17:00:00+00,14078,0,5441,1867,461,3882,2355,237,2429,492,31242,193,12553,10198,4757,14078
2021-05-29 17:30:00+00,14290,0,5439,1885,434,3884,2350,233,1702,878,31095,196,11810,9460,4021,14290
2021-05-29 18:00:00+00,14930,0,5446,1849,537,3068,2423,341,1156,868,30618,209,11411,8988,3542,14930
2021-05-29 18:30:00+00,15124,0,5444,1804,455,3026,2462,328,694,772,30109,215,10859,8397,2953,15124
2021-05-29 19:00:00+00,15003,0,5447,1652,358,3026,2461,244,301,798,29290,218,10219,7758,2311,15003
2021-05-29 19:30:00+00,15048,0,5441,1525,328,3026,2466,227,57,610,28728,223,9817,7351,1910,15048
2021-05-29 20:00:00+00,15042,0,5443,1463,279,3006,2464,196,0,366,28259,226,9649,7185,1742,15042
2021-05-29 20:30:00+00,15087,0,5438,1439,263,3006,2469,164,0,66,27932,229,9609,7140,1702,15087
2021-05-29 21:00:00+00,14950,0,5443,1409,201,3006,2456,149,0,92,27706,229,9509,7053,1610,14950
2021-05-29 21:30:00+00,14422,0,5443,1278,210,3006,2185,147,0,96,26787,228,9116,6931,1488,14422
2021-05-29 22:00:00+00,13212,0,5440,1248,193,3472,1576,144,0,320,25605,217,8457,6881,1441,13212
2021-05-29 22:30:00+00,12065,0,5440,1308,184,3498,1509,142,0,118,24264,210,8441,6932,1492,12065
2021-05-29 23:00:00+00,11512,0,5439,1327,133,3026,1535,144,0,26,23142,210,8434,6899,1460,11512
2021-05-29 23:30:00+00,10651,0,5442,1323,132,3018,1525,142,0,152,22385,202,8422,6897,1455,10651
2021-05-30 00:00:00+00,10417,0,5438,1299,111,3016,1526,141,0,14,21962,201,8374,6848,1410,10417
2021-05-30 00:30:00+00,10342,0,5440,1245,111,3014,1532,142,0,62,21888,200,8328,6796,1356,10342
2021-05-30 01:00:00+00,10299,0,5439,1180,111,2826,1529,142,0,128,21654,201,8259,6730,1291,10299
2021-05-30 01:30:00+00,9953,0,5439,1176,112,2824,1524,142,0,0,21170,199,8251,6727,1288,9953
2021-05-30 02:00:00+00,10089,0,5443,1164,112,2822,1523,141,0,0,21294,201,8242,6719,1276,10089
2021-05-30 02:30:00+00,9947,0,5447,1127,111,2822,1526,141,0,0,21121,200,8211,6685,1238,9947
2021-05-30 03:00:00+00,9670,0,5448,1148,111,2824,1534,141,0,0,20876,197,8241,6707,1259,9670
2021-05-30 03:30:00+00,9344,0,5452,1188,111,2824,1511,140,0,0,20570,194,8262,6751,1299,9344
2021-05-30 04:00:00+00,9134,0,5456,1305,111,2822,1506,141,27,0,20502,190,8405,6899,1443,9134
2021-05-30 04:30:00+00,8993,0,5459,1436,115,2822,1512,142,200,0,20679,186,8722,7210,1751,8993
2021-05-30 05:00:00+00,9101,0,5456,1546,191,2820,1516,141,520,0,21291,182,9229,7713,2257,9101
2021-05-30 05:30:00+00,9234,0,5458,1560,197,2834,1847,233,1019,0,22382,179,10081,8234,2776,9234
2021-05-30 06:00:00+00,9044,0,5459,1557,225,2832,2186,329,1619,0,23251,172,11046,8860,3401,9044
2021-05-30 06:30:00+00,8983,0,5457,1583,258,2818,2416,373,2290,0,24178,166,12004,9588,4131,8983
2021-05-30 07:00:00+00,9289,0,5452,1586,410,2822,2486,396,3020,146,25607,162,12954,10468,5016,9289
2021-05-30 07:30:00+00,9448,0,5453,1546,460,2824,2485,398,3923,276,26813,157,13867,11382,5929,9448
2021-05-30 08:00:00+00,9608,0,5449,1572,495,3110,2494,418,4937,260,28343,151,14947,12453,7004,9608
2021-05-30 08:30:00+00,9423,0,5453,1631,503,3114,2514,412,5807,156,29013,145,15908,13394,7941,9423
2021-05-30 09:00:00+00,9447,0,5449,1739,460,3116,2517,403,6720,32,29883,141,16885,14368,8919,9447
2021-05-30 09:30:00+00,9232,0,5453,1771,410,3116,2519,377,7668,0,30546,135,17821,15302,9849,9232
2021-05-30 10:00:00+00,8882,0,5455,1749,366,3118,2514,273,8511,0,30868,128,18595,16081,10626,8882
2021-05-30 10:30:00+00,8675,0,5454,1835,365,3118,2507,156,9199,102,31411,123,19360,16853,11399,8675
2021-05-30 11:00:00+00,8599,0,5450,1816,331,3116,2487,143,9573,70,31585,121,19657,17170,11720,8599
2021-05-30 11:30:00+00,8324,0,5452,1830,309,3116,2480,143,9693,44,31391,118,19764,17284,11832,8324
2021-05-30 12:00:00+00,7883,0,5451,1885,224,3218,2478,143,9643,72,30997,114,19681,17203,11752,7883
2021-05-30 12:30:00+00,7385,0,5449,1946,218,3212,2476,142,9469,0,30297,110,19558,17082,11633,7385
2021-05-30 13:00:00+00,7142,0,5443,2113,179,3214,2476,143,9090,0,29800,109,19301,16825,11382,7142
2021-05-30 13:30:00+00,6732,0,5438,2333,180,3214,2475,143,8654,0,29169,106,19080,16605,11167,6732
2021-05-30 14:00:00+00,6611,0,5442,2528,177,3218,2462,143,8135,0,28716,105,18744,16282,10840,6611
2021-05-30 14:30:00+00,6878,0,5442,2795,189,3214,2408,144,7417,0,28487,110,18251,15843,10401,6878
2021-05-30 15:00:00+00,7256,0,5445,3147,227,3406,2409,147,6704,0,28741,114,17932,15523,10078,7256
2021-05-30 15:30:00+00,7941,0,5448,3300,264,3412,2465,183,5805,2,28820,124,17282,14817,9369,7941
2021-05-30 16:00:00+00,8768,0,5452,3382,394,3602,2483,248,4806,28,29163,134,16517,14034,8582,8768
2021-05-30 16:30:00+00,9795,0,5450,3476,415,3606,2480,219,3841,0,29282,147,15662,13182,7732,9795
2021-05-30 17:00:00+00,10518,0,5456,3614,454,3604,2467,155,2977,84,29329,157,14968,12501,7045,10518
2021-05-30 17:30:00+00,10882,0,5451,3702,454,3604,2467,156,2251,390,29357,162,14325,11858,6407,10882
2021-05-30 18:00:00+00,10685,0,5457,3783,453,3608,2482,153,1568,744,28933,161,13743,11261,5804,10685
2021-05-30 18:30:00+00,10682,0,5455,3918,453,3606,2427,165,942,850,28498,164,13195,10768,5313,10682
2021-05-30 19:00:00+00,10774,0,5459,3837,412,3606,2422,205,411,780,27906,169,12541,10119,4660,10774
2021-05-30 19:30:00+00,10851,0,5461,3690,360,3616,2427,166,93,798,27462,172,12031,9604,4143,10851
2021-05-30 20:00:00+00,11162,0,5463,3570,325,3626,2428,196,1,556,27327,178,11787,9359,3896,11162
2021-05-30 20:30:00+00,11356,0,5458,3471,316,3606,2416,212,0,456,27291,181,11661,9245,3787,11356
2021-05-30 21:00:00+00,11345,0,5459,3470,263,3604,2207,202,0,320,26870,182,11399,9192,3733,11345
2021-05-30 21:30:00+00,10859,0,5458,3583,251,3604,1868,142,0,140,25905,179,11160,9292,3834,10859
2021-05-30 22:00:00+00,10366,0,5455,3576,217,3084,1524,144,0,480,24846,178,10772,9248,3793,10366
2021-05-30 22:30:00+00,9417,0,5459,3633,206,3026,1508,142,0,120,23511,171,10806,9298,3839,9417
2021-05-30 23:00:00+00,8858,0,5452,3593,152,2927,1520,143,0,0,22645,168,10717,9197,3745,8858
2021-05-30 23:30:00+00,8296,0,5453,3559,150,2925,1526,142,0,0,22050,162,10688,9162,3709,8296
2021-05-31 00:00:00+00,8256,0,5453,3463,131,2920,1523,142,0,0,21888,164,10570,9047,3594,8256
2021-05-31 00:30:00+00,8365,0,5455,3275,131,2920,1531,142,0,0,21819,166,10392,8861,3406,8365
2021-05-31 01:00:00+00,8460,0,5452,3159,131,2922,1546,143,0,0,21813,168,10288,8742,3290,8460
2021-05-31 01:30:00+00,8431,0,5447,3130,131,2922,1528,144,0,0,21733,168,10236,8708,3261,8431
2021-05-31 02:00:00+00,8372,0,5444,3054,131,2838,1548,145,0,0,21532,169,10177,8629,3185,8372
2021-05-31 02:30:00+00,8583,0,5444,2901,130,2854,1555,145,0,0,21611,172,10030,8475,3031,8583
2021-05-31 03:00:00+00,8579,0,5448,2861,130,2869,1549,145,0,0,21581,173,9988,8439,2991,8579
2021-05-31 03:30:00+00,8207,0,5447,2862,130,2912,1552,145,0,0,21254,170,9991,8439,2992,8207
2021-05-31 04:00:00+00,7877,0,5454,2972,147,2536,1551,142,37,0,20716,168,10161,8610,3156,7877
2021-05-31 04:30:00+00,7654,0,5455,3131,148,2624,1558,139,262,0,20971,164,10554,8996,3541,7654
2021-05-31 05:00:00+00,8210,0,5453,3203,223,2576,1549,140,633,0,21987,165,11061,9512,4059,8210
2021-05-31 05:30:00+00,8863,0,5454,3187,227,2436,1552,142,1114,0,22975,167,11534,9982,4528,8863
2021-05-31 06:00:00+00,9360,0,5454,3086,244,2794,1752,158,1659,0,24507,165,12195,10443,4989,9360
2021-05-31 06:30:00+00,9387,0,5454,2975,342,2804,1889,354,2256,188,25649,161,12916,11027,5573,9387
2021-05-31 07:00:00+00,9611,0,5449,3031,403,3100,1896,368,3041,388,27287,155,13820,11924,6475,9611
2021-05-31 07:30:00+00,9613,0,5453,3208,477,3112,1875,369,3915,442,28464,149,14928,13053,7600,9613
2021-05-31 08:00:00+00,9741,0,5448,3338,486,3114,1882,391,4879,444,29723,144,16033,14151,8703,9741
2021-05-31 08:30:00+00,9571,0,5448,3399,435,3114,1881,391,5936,390,30565,138,17099,15218,9770,9571
2021-05-31 09:00:00+00,9329,0,5446,3372,489,3114,1881,322,6956,156,31065,132,18144,16263,10817,9329
2021-05-31 09:30:00+00,8882,0,5453,3560,457,3114,1881,305,7843,6,31501,125,19194,17313,11860,8882
2021-05-31 10:00:00+00,8370,0,5451,3890,303,3114,1749,234,8625,0,31736,116,20018,18269,12818,8370
2021-05-31 10:30:00+00,7598,0,5454,4219,280,3114,1646,142,9214,0,31667,106,20813,19167,13713,7598
2021-05-31 11:00:00+00,7299,0,5453,4383,222,3121,1659,142,9565,0,31845,101,21282,19623,14170,7299
2021-05-31 11:30:00+00,6861,0,5449,4446,216,3125,1670,143,9723,0,31633,97,21504,19834,14385,6861
2021-05-31 12:00:00+00,7037,0,5453,4654,191,2366,1700,142,9687,0,31230,100,21685,19985,14532,7037
2021-05-31 12:30:00+00,6747,0,5458,5032,177,2258,1624,142,9498,0,30936,97,21789,20165,14707,6747
2021-05-31 13:00:00+00,6747,0,5452,5212,156,2023,1655,143,9211,0,30599,98,21686,20031,14579,6747
2021-05-31 13:30:00+00,6599,0,5456,5318,147,2019,1659,142,8740,0,30080,98,21320,19661,14205,6599
2021-05-31 14:00:00+00,6547,0,5446,5384,147,2164,1700,142,8070,0,29600,99,20747,19047,13601,6547
2021-05-31 14:30:00+00,6864,0,5445,5444,143,2266,1746,144,7328,0,29380,106,20106,18360,12915,6864
2021-05-31 15:00:00+00,7151,0,5448,5644,152,2564,1700,155,6460,0,29274,110,19404,17704,12256,7151
2021-05-31 15:30:00+00,8093,0,5449,5955,201,2519,1769,162,5601,0,29749,120,18975,17206,11757,8093
2021-05-31 16:00:00+00,8773,0,5456,6098,309,3014,1867,166,4705,0,30388,127,18435,16568,11112,8773
2021-05-31 16:30:00+00,9406,0,5457,6436,311,3074,1865,192,3850,118,30709,134,17919,16054,10597,9406
2021-05-31 17:00:00+00,9425,0,5459,6801,338,3534,1883,190,3010,226,30866,135,17491,15608,10149,9425
2021-05-31 17:30:00+00,9315,0,5456,6998,339,3648,1892,217,2168,650,30683,136,16853,14961,9505,9315
2021-05-31 18:00:00+00,9701,0,5456,7050,347,3864,1897,217,1509,602,30643,142,16259,14362,8906,9701
2021-05-31 18:30:00+00,9984,0,5457,6978,339,3966,1891,218,922,552,30307,149,15587,13696,8239,9984
2021-05-31 19:00:00+00,9821,0,5456,6959,324,3994,1887,181,417,590,29629,150,15043,13156,7700,9821
2021-05-31 19:30:00+00,9858,0,5455,6898,310,3880,1824,153,90,542,29010,152,14577,12753,7298,9858
2021-05-31 20:00:00+00,10138,0,5457,6771,261,4030,1883,149,1,8,28698,160,14373,12490,7033,10138
2021-05-31 20:30:00+00,10097,0,5459,6739,258,3834,1891,149,0,6,28433,158,14347,12456,6997,10097
2021-05-31 21:00:00+00,9855,0,5461,6859,193,3310,1889,144,0,88,27799,155,14402,12513,7052,9855
2021-05-31 21:30:00+00,8878,0,5462,6842,216,3204,1802,143,0,0,26547,146,14322,12520,7058,8878
2021-05-31 22:00:00+00,7945,0,5457,6652,180,2920,1718,146,0,0,25018,141,14007,12289,6832,7945
2021-05-31 22:30:00+00,6868,0,5458,6463,161,2834,1699,143,0,0,23626,130,13781,12082,6624,6868
2021-05-31 23:00:00+00,6676,0,5457,6515,110,2626,1666,142,0,0,23192,128,13748,12082,6625,6676
2021-05-31 23:30:00+00,6274,0,5458,6574,107,2624,1552,141,0,0,22730,123,13691,12139,6681,6274
2021-06-01 00:00:00+00,6297,0,5461,6811,88,2542,1540,136,0,0,22875,122,13900,12360,6899,6297
2021-06-01 00:30:00+00,5897,0,5456,6994,89,2544,1536,132,0,0,22648,117,14075,12539,7083,5897
2021-06-01 01:00:00+00,6001,0,5460,7076,89,2544,1525,131,0,0,22826,117,14150,12625,7165,6001
2021-06-01 01:30:00+00,5601,0,5457,6994,89,2540,1536,132,0,0,22349,113,14076,12540,7083,5601
2021-06-01 02:00:00+00,5815,0,5453,6863,89,2546,1556,136,0,0,22458,116,13961,12405,6952,5815
2021-06-01 02:30:00+00,5900,0,5451,6798,89,2546,1559,136,0,0,22479,118,13897,12338,6887,5900
2021-06-01 03:00:00+00,5810,0,5448,6709,89,2544,1564,137,0,0,22301,117,13810,12246,6798,5810
2021-06-01 03:30:00+00,5752,0,5452,6540,89,2550,1562,138,0,0,22082,117,13642,12080,6628,5752
2021-06-01 04:00:00+00,5778,0,5452,6235,89,2606,1553,137,74,0,21924,119,13403,11850,6398,5778
2021-06-01 04:30:00+00,6498,0,5456,5775,90,2612,1611,140,388,0,22570,128,13320,11709,6253,6498
2021-06-01 05:00:00+00,8616,0,5463,5373,168,2302,1668,141,856,0,24587,152,13528,11860,6397,8616
2021-06-01 05:30:00+00,10262,0,5466,5058,215,2298,1821,141,1478,0,26739,164,14038,12217,6751,10262
2021-06-01 06:00:00+00,11933,0,5468,4668,259,2574,2234,148,2187,0,29471,174,14816,12582,7114,11933
2021-06-01 06:30:00+00,12975,0,5469,4378,290,2584,2507,160,2987,14,31364,177,15631,13124,7655,12975
2021-06-01 07:00:00+00,13359,0,5467,4060,337,2980,2469,254,3907,346,33179,174,16240,13771,8304,13359
2021-06-01 07:30:00+00,13498,0,5469,3769,336,2990,2475,168,4860,378,33943,171,16909,14434,8965,13498
2021-06-01 08:00:00+00,13364,0,5463,3698,337,2990,2539,212,5792,120,34515,167,17829,15290,9827,13364
2021-06-01 08:30:00+00,13124,0,5460,3515,337,2991,2367,178,6662,366,35000,161,18341,15974,10514,13124
2021-06-01 09:00:00+00,13127,0,5461,3486,280,2992,2279,154,7448,32,35259,159,18954,16675,11214,13127
2021-06-01 09:30:00+00,12703,0,5460,3409,230,2991,2449,142,8150,0,35534,154,19698,17249,11789,12703
2021-06-01 10:00:00+00,12259,0,5484,3396,178,2990,2513,142,8721,0,35683,148,20292,17779,12295,12259
2021-06-01 10:30:00+00,12020,0,5472,3414,174,2990,2514,142,9137,0,35863,145,20711,18197,12725,12020
2021-06-01 11:00:00+00,12020,0,5458,3465,166,2990,2525,142,9389,0,36155,144,21003,18478,13020,12020
2021-06-01 11:30:00+00,11679,0,5457,3664,166,2990,2532,141,9491,0,36120,140,21310,18778,13321,11679
2021-06-01 12:00:00+00,11406,0,5446,3936,119,2990,2364,141,9420,0,35822,138,21285,18921,13475,11406
2021-06-01 12:30:00+00,10960,0,5448,4149,104,2990,2234,141,9101,0,35127,135,21036,18802,13354,10960
2021-06-01 13:00:00+00,10715,0,5440,4288,104,2990,2252,142,8808,0,34739,134,20892,18640,13200,10715
2021-06-01 13:30:00+00,10691,0,5456,4532,104,2990,2292,141,8478,0,34684,134,20862,18570,13114,10691
2021-06-01 14:00:00+00,10672,0,5460,4752,107,2990,2420,141,7906,0,34448,135,20645,18225,12765,10672
2021-06-01 14:30:00+00,10797,0,5458,4834,114,2990,2520,141,7156,0,34010,139,20082,17562,12104,10797
2021-06-01 15:00:00+00,11445,0,5451,5010,114,3010,2457,158,6332,0,33977,146,19364,16907,11456,11445
2021-06-01 15:30:00+00,12409,0,5451,5131,112,3010,2522,171,5407,0,34213,157,18623,16101,10650,12409
2021-06-01 16:00:00+00,12852,0,5454,5458,273,3010,2524,170,4758,0,34499,161,18467,15943,10489,12852
2021-06-01 16:30:00+00,12923,0,5452,5839,380,3004,2523,176,3824,288,34409,162,18018,15495,10043,12923
2021-06-01 17:00:00+00,12955,0,5453,6151,434,3126,2521,191,2966,478,34275,163,17525,15004,9551,12955
2021-06-01 17:30:00+00,12918,0,5452,6265,402,3642,2530,185,2149,88,33631,166,16798,14268,8816,12918
2021-06-01 18:00:00+00,12712,0,5460,6274,365,4008,2528,167,1457,520,33491,164,16084,13556,8096,12712
2021-06-01 18:30:00+00,13075,0,5457,6215,359,4010,2519,166,890,204,32895,172,15440,12921,7464,13075
2021-06-01 19:00:00+00,12902,0,5462,6353,419,3708,2514,190,430,0,31978,174,15178,12664,7202,12902
2021-06-01 19:30:00+00,12191,0,5464,6799,347,3702,2517,142,94,0,31256,169,15221,12704,7240,12191
2021-06-01 20:00:00+00,11371,0,5464,7374,269,3620,2420,142,1,0,30661,161,15528,13108,7644,11371
2021-06-01 20:30:00+00,10659,0,5465,7943,252,3616,2412,143,0,0,30490,153,16072,13660,8195,10659
2021-06-01 21:00:00+00,10251,0,5462,8032,147,3210,2416,143,0,10,29671,151,16057,13641,8179,10251
2021-06-01 21:30:00+00,9295,0,5463,8093,148,3208,1998,142,0,0,28347,143,15702,13704,8241,9295
2021-06-01 22:00:00+00,8520,0,5471,7944,147,2750,1558,143,0,18,26551,139,15120,13562,8091,8520
2021-06-01 22:30:00+00,7063,0,5505,7948,134,2740,1426,143,0,0,24959,124,15013,13587,8082,7063
2021-06-01 23:00:00+00,6074,0,5498,7988,94,2742,1449,144,0,0,23989,113,15029,13580,8082,6074
2021-06-01 23:30:00+00,5763,0,5504,7778,92,2742,1440,142,0,0,23461,110,14814,13374,7870,5763
2021-06-02 00:00:00+00,6011,0,5524,7439,71,2740,1450,142,0,0,23377,114,14484,13034,7510,6011
2021-06-02 00:30:00+00,5862,0,5521,7211,73,2740,1470,143,0,0,23020,114,14275,12805,7284,5862
2021-06-02 01:00:00+00,5755,0,5532,7099,62,2738,1509,142,0,0,22837,113,14202,12693,7161,5755
2021-06-02 01:30:00+00,5594,0,5532,6945,63,2738,1539,143,0,0,22554,112,14079,12540,7008,5594
2021-06-02 02:00:00+00,5522,0,5535,6788,63,2739,1537,143,0,0,22327,111,13923,12386,6851,5522
2021-06-02 02:30:00+00,5423,0,5539,6848,63,2740,1586,141,0,0,22340,110,14036,12450,6911,5423
2021-06-02 03:00:00+00,5117,0,5538,6893,63,2742,1613,142,0,0,22108,106,14107,12494,6956,5117
2021-06-02 03:30:00+00,5053,0,5535,6738,64,2740,1635,142,0,0,21907,106,13972,12337,6802,5053
2021-06-02 04:00:00+00,5085,0,5537,6675,96,2734,1604,142,78,0,21951,106,13990,12386,6849,5085
2021-06-02 04:30:00+00,5285,0,5537,6778,101,2734,1577,142,374,0,22528,106,14367,12790,7253,5285
2021-06-02 05:00:00+00,6917,0,5539,6610,120,3100,1586,142,819,0,24833,123,14674,13088,7549,6917
2021-06-02 05:30:00+00,8128,0,5543,6764,146,3108,1585,137,1385,0,26796,132,15423,13838,8295,8128
2021-06-02 06:00:00+00,9660,0,5540,6741,196,3500,1655,143,2065,0,29500,141,16197,14542,9002,9660
2021-06-02 06:30:00+00,10509,0,5546,6705,203,3506,1762,162,2905,0,31298,144,17121,15359,9813,10509
2021-06-02 07:00:00+00,11571,0,5545,6587,286,2814,1751,252,3722,414,32942,151,17891,16140,10595,11571
2021-06-02 07:30:00+00,11890,0,5545,6408,287,2784,1741,347,4490,508,34000,150,18471,16730,11185,11890
2021-06-02 08:00:00+00,11672,0,5545,6436,286,2783,1738,258,5288,672,34678,144,19293,17555,12010,11672
2021-06-02 08:30:00+00,11496,0,5549,6724,415,2782,1722,189,6092,276,35245,139,20502,18780,13231,11496
2021-06-02 09:00:00+00,11575,0,5544,7006,243,2782,1743,204,6643,0,35740,138,21179,19436,13892,11575
2021-06-02 09:30:00+00,11203,0,5551,7224,176,2782,1735,181,6936,0,35788,134,21622,19887,14336,11203
2021-06-02 10:00:00+00,10852,0,5540,7341,168,2782,1718,204,7377,0,35982,129,22144,20426,14886,10852
2021-06-02 10:30:00+00,10708,0,5543,7481,186,2786,1717,218,7625,0,36264,127,22552,20835,15292,10708
2021-06-02 11:00:00+00,10862,0,5541,7485,166,2784,1694,163,7489,0,36184,128,22375,20681,15140,10862
2021-06-02 11:30:00+00,10722,0,5540,7961,132,2784,1704,133,7374,0,36350,126,22711,21007,15467,10722
2021-06-02 12:00:00+00,10602,0,5535,8527,78,2782,1730,140,7460,0,36854,123,23330,21600,16065,10602
2021-06-02 12:30:00+00,10365,0,5532,8820,76,2780,1731,142,7050,0,36496,122,23209,21478,15946,10365
2021-06-02 13:00:00+00,10306,0,5532,8892,77,2780,1723,141,6531,0,35982,123,22755,21032,15500,10306
2021-06-02 13:30:00+00,10318,0,5535,8931,82,2780,1725,141,5897,0,35409,125,22170,20445,14910,10318
2021-06-02 14:00:00+00,10448,0,5533,8900,89,2780,1730,141,5744,0,35365,126,21996,20266,14733,10448
2021-06-02 14:30:00+00,10650,0,5531,8878,106,2782,1735,164,5086,36,34968,130,21336,19601,14070,10650
2021-06-02 15:00:00+00,11100,0,5535,8806,205,2928,1735,153,4475,66,35003,135,20756,19021,13486,11100
2021-06-02 15:30:00+00,11292,0,5535,8754,298,2928,1735,200,3885,616,35243,137,20207,18472,12937,11292
2021-06-02 16:00:00+00,11234,0,5534,8845,426,3002,1730,271,3210,1108,35360,136,19745,18015,12481,11234
2021-06-02 16:30:00+00,11680,0,5535,8980,459,3002,1738,309,2404,1116,35223,142,19116,17378,11843,11680
2021-06-02 17:00:00+00,11819,0,5536,8900,503,2996,1729,380,1765,1312,34940,146,18433,16704,11168,11819
2021-06-02 17:30:00+00,12441,0,5535,8926,453,2996,1727,403,1303,882,34666,154,17944,16217,10682,12441
2021-06-02 18:00:00+00,12809,0,5536,8653,471,2784,1731,368,786,602,33740,162,17177,15446,9910,12809
2021-06-02 18:30:00+00,12782,0,5534,8393,495,2780,1733,298,410,880,33305,163,16565,14832,9298,12782
2021-06-02 19:00:00+00,12534,0,5540,8185,442,2746,1729,372,155,244,31947,168,16051,14322,8782,12534
2021-06-02 19:30:00+00,12691,0,5539,7318,441,2746,1740,336,30,404,31245,173,15068,13328,7789,12691
2021-06-02 20:00:00+00,12676,0,5543,6926,415,2706,1733,359,0,350,30708,176,14617,12884,7341,12676
2021-06-02 20:30:00+00,12683,0,5547,6710,405,2708,1675,321,0,290,30339,178,14337,12662,7115,12683
2021-06-02 21:00:00+00,12107,0,5552,6414,322,2544,1671,192,0,254,29056,176,13959,12288,6736,12107
2021-06-02 21:30:00+00,11211,0,5549,6290,203,2562,1677,133,0,0,27625,172,13719,12042,6493,11211
2021-06-02 22:00:00+00,9487,0,5548,6617,197,2804,1677,141,0,0,26471,154,14039,12362,6814,9487
2021-06-02 22:30:00+00,8068,0,5547,6869,185,2820,1672,141,0,0,25302,139,14273,12601,7054,8068
2021-06-02 23:00:00+00,7268,0,5549,7123,102,2822,1596,143,0,0,24603,129,14370,12774,7225,7268
2021-06-02 23:30:00+00,6625,0,5548,7259,98,2822,1651,143,0,0,24146,122,14556,12905,7357,6625
2021-06-03 00:00:00+00,6438,0,5545,7006,76,2820,1670,140,0,0,23695,121,14297,12627,7082,6438
2021-06-03 00:30:00+00,6569,0,5548,6772,76,2820,1664,143,0,0,23592,123,14060,12396,6848,6569
2021-06-03 01:00:00+00,6538,0,5547,6723,76,2818,1619,158,0,0,23479,123,13965,12346,6799,6538
2021-06-03 01:30:00+00,6378,0,5544,6636,76,2818,1578,142,0,0,23172,122,13834,12256,6712,6378
2021-06-03 02:00:00+00,6340,0,5543,6536,77,2818,1574,141,0,0,23029,122,13730,12156,6613,6340
2021-06-03 02:30:00+00,6341,0,5543,6355,77,2829,1566,141,0,0,22852,123,13541,11975,6432,6341
2021-06-03 03:00:00+00,6368,0,5543,6006,77,2842,1541,142,0,0,22519,126,13167,11626,6083,6368
2021-06-03 03:30:00+00,6310,0,5547,5869,81,2826,1610,141,0,0,22384,126,13107,11497,5950,6310
2021-06-03 04:00:00+00,6528,0,5544,5541,110,1654,1686,141,24,0,21228,138,12905,11219,5675,6528
2021-06-03 04:30:00+00,6796,0,5543,5447,114,1514,1615,141,136,0,21306,140,12855,11240,5697,6796
2021-06-03 05:00:00+00,7514,0,5543,5480,219,2025,1612,142,336,0,22872,142,13190,11578,6035,7514
2021-06-03 05:30:00+00,8389,0,5540,5389,252,2029,1778,142,607,0,24126,149,13566,11788,6248,8389
2021-06-03 06:00:00+00,9677,0,5540,5276,268,2660,1803,144,1037,0,26405,157,13924,12121,6581,9677
2021-06-03 06:30:00+00,10803,0,5545,5300,273,2722,1886,144,1433,8,28114,164,14437,12551,7006,10803
2021-06-03 07:00:00+00,11814,0,5547,5091,300,3540,2075,147,2059,112,30684,164,15072,12997,7450,11814
2021-06-03 07:30:00+00,12385,0,5548,4804,302,3580,2305,143,2737,46,31850,166,15696,13391,7843,12385
2021-06-03 08:00:00+00,12816,0,5550,4488,300,3632,2374,145,2884,0,32189,170,15596,13222,7672,12816
2021-06-03 08:30:00+00,13057,0,5551,4497,292,3636,2375,146,3244,0,32797,170,15959,13584,8033,13057
2021-06-03 09:00:00+00,13191,0,5550,4605,196,3960,2376,143,3649,0,33670,167,16376,14000,8450,13191
2021-06-03 09:30:00+00,13242,0,5550,4616,174,3966,2379,142,4372,0,34441,164,17091,14712,9162,13242
2021-06-03 10:00:00+00,13295,0,5550,4544,158,3994,2370,142,5135,0,35188,161,17757,15387,9837,13295
2021-06-03 10:30:00+00,13316,0,5545,4488,158,3996,2374,142,5516,0,35535,160,18081,15707,10162,13316
2021-06-03 11:00:00+00,13427,0,5533,4528,158,3996,2374,142,5960,0,36118,159,18553,16179,10646,13427
2021-06-03 11:30:00+00,12967,0,5533,4688,157,3996,2351,141,5980,0,35813,155,18709,16358,10825,12967
2021-06-03 12:00:00+00,12239,0,5531,4807,132,4026,2167,142,6493,0,35537,148,19130,16963,11432,12239
2021-06-03 12:30:00+00,11881,0,5526,4794,130,4026,2230,142,6412,0,35141,146,19092,16862,11336,11881
2021-06-03 13:00:00+00,12132,0,5527,4760,130,3700,2355,141,6355,0,35100,151,19127,16772,11245,12132
2021-06-03 13:30:00+00,11855,0,5528,4906,130,3794,2358,142,6457,0,35170,149,19379,17021,11493,11855
2021-06-03 14:00:00+00,11620,0,5528,4941,130,4164,2341,143,5983,0,34850,148,18923,16582,11054,11620
2021-06-03 14:30:00+00,11830,0,5535,4918,129,4184,2367,155,5435,0,34553,152,18384,16017,10482,11830
2021-06-03 15:00:00+00,12393,0,5530,4809,177,4276,2369,146,4811,0,34511,159,17696,15327,9797,12393
2021-06-03 15:30:00+00,12984,0,5529,4843,191,4252,2339,193,4130,98,34559,166,17032,14693,9164,12984
2021-06-03 16:00:00+00,13242,0,5522,5082,430,4016,2301,320,3341,286,34540,169,16676,14375,8853,13242
2021-06-03 16:30:00+00,13431,0,5522,5252,403,4300,2341,295,2429,180,34153,177,15947,13606,8084,13431
2021-06-03 17:00:00+00,13479,0,5521,5397,319,4640,2285,249,2043,400,34333,177,15565,13280,7759,13479
2021-06-03 17:30:00+00,13680,0,5521,5315,319,4632,2312,158,1383,486,33806,181,14850,12538,7017,13680
2021-06-03 18:00:00+00,13579,0,5519,5360,365,4556,2335,193,1070,552,33529,181,14649,12314,6795,13579
2021-06-03 18:30:00+00,13650,0,5520,5678,418,4564,2343,193,632,184,33182,184,14591,12248,6728,13650
2021-06-03 19:00:00+00,13559,0,5523,5670,238,4518,2315,150,283,20,32276,186,14029,11714,6191,13559
2021-06-03 19:30:00+00,13313,0,5526,5459,232,4384,2249,141,110,140,31554,185,13576,11327,5801,13313
2021-06-03 20:00:00+00,13230,0,5530,5506,242,3954,2299,141,3,0,30905,186,13580,11281,5751,13230
2021-06-03 20:30:00+00,13063,0,5535,5245,228,3798,2321,141,0,4,30335,185,13329,11008,5473,13063
2021-06-03 21:00:00+00,12568,0,5542,5031,156,3054,2335,141,0,304,29131,184,13064,10729,5187,12568
2021-06-03 21:30:00+00,11425,0,5542,5117,184,3030,2312,140,0,0,27750,177,13155,10843,5301,11425
2021-06-03 22:00:00+00,9784,0,5544,5246,163,3206,2260,141,0,0,26344,162,13213,10953,5409,9784
2021-06-03 22:30:00+00,8345,0,5544,5003,151,3366,2307,141,0,0,24857,152,13005,10698,5154,8345
2021-06-03 23:00:00+00,7878,0,5544,4750,113,3178,2366,141,0,0,23970,150,12773,10407,4863,7878
2021-06-03 23:30:00+00,7402,0,5546,4492,113,3226,2382,141,0,0,23302,147,12533,10151,4605,7402
2021-06-04 00:00:00+00,7306,0,5544,4353,117,3304,2374,141,0,0,23139,150,12388,10014,4470,7306
2021-06-04 00:30:00+00,7196,0,5547,4384,118,3374,2363,141,0,0,23123,149,12412,10049,4502,7196
2021-06-04 01:00:00+00,7181,0,5536,4273,118,3370,2340,141,0,0,22959,150,12267,9927,4391,7181
2021-06-04 01:30:00+00,7043,0,5539,4098,118,3280,2305,141,0,0,22524,149,12060,9755,4216,7043
2021-06-04 02:00:00+00,6914,0,5534,4051,118,3186,2270,123,0,0,22196,146,11973,9703,4169,6914
2021-06-04 02:30:00+00,6882,0,5531,3924,118,3226,2314,99,0,0,22094,147,11887,9573,4042,6882
2021-06-04 03:00:00+00,6817,0,5529,3981,114,3182,2322,99,0,0,22044,148,11946,9624,4095,6817
2021-06-04 03:30:00+00,6694,0,5533,3888,114,3080,2293,100,0,0,21702,146,11828,9535,4002,6694
2021-06-04 04:00:00+00,7311,0,5536,3876,111,2260,2342,99,54,0,21589,155,11919,9577,4041,7311
2021-06-04 04:30:00+00,8016,0,5534,3571,114,2296,2376,100,278,0,22285,164,11873,9497,3963,8016
2021-06-04 05:00:00+00,9670,0,5539,3416,224,2264,2383,99,628,0,24223,175,12190,9807,4268,9670
2021-06-04 05:30:00+00,10988,0,5536,3327,226,2220,2379,100,1029,0,25805,184,12497,10118,4582,10988
2021-06-04 06:00:00+00,11966,0,5533,3361,226,3378,2380,101,1649,0,28594,181,13149,10769,5236,11966
2021-06-04 06:30:00+00,12627,0,5534,3384,254,3424,2377,134,2140,370,30244,180,13689,11312,5778,12627
2021-06-04 07:00:00+00,13085,0,5533,3474,308,3980,2382,114,2678,470,32024,177,14375,11993,6460,13085
2021-06-04 07:30:00+00,13470,0,5537,3662,308,3996,2380,105,3367,418,33243,175,15254,12874,7337,13470
2021-06-04 08:00:00+00,13344,0,5540,3878,302,3996,2382,106,4046,494,34088,169,16148,13766,8226,13344
2021-06-04 08:30:00+00,13599,0,5538,3891,285,3996,2190,106,4467,306,34378,170,16371,14181,8643,13599
2021-06-04 09:00:00+00,13878,0,5542,3928,191,3996,2115,105,5336,2,35093,169,17112,14997,9455,13878
2021-06-04 09:30:00+00,13943,0,5542,3904,169,3996,2053,101,5842,0,35550,167,17510,15457,9915,13943
2021-06-04 10:00:00+00,13936,0,5556,3767,130,3996,1981,101,6294,60,35821,166,17728,15747,10191,13936
2021-06-04 10:30:00+00,13924,0,5540,3666,131,3996,2067,101,6604,0,36029,165,18008,15941,10401,13924
2021-06-04 11:00:00+00,13774,0,5540,3515,131,3964,2194,101,7168,0,36387,162,18548,16354,10814,13774
2021-06-04 11:30:00+00,13441,0,5535,3508,131,3904,2338,101,7097,12,36067,160,18609,16271,10736,13441
2021-06-04 12:00:00+00,13140,0,5535,3490,105,3716,2424,101,7130,304,35945,157,18684,16260,10725,13140
2021-06-04 12:30:00+00,13086,0,5533,3552,111,3716,2453,101,7015,68,35635,158,18664,16211,10678,13086
2021-06-04 13:00:00+00,12733,0,5525,3372,104,3840,2466,101,7038,114,35293,156,18505,16039,10514,12733
2021-06-04 13:30:00+00,12781,0,5522,3149,105,3842,2439,101,6834,0,34773,159,18049,15610,10088,12781
2021-06-04 14:00:00+00,12590,0,5522,3203,104,3870,2406,101,6488,0,34284,159,17723,15317,9795,12590
2021-06-04 14:30:00+00,12673,0,5522,3308,105,3870,2379,101,6007,0,33965,161,17321,14942,9420,12673
2021-06-04 15:00:00+00,12927,0,5515,3380,150,3978,2418,112,5356,0,33836,165,16819,14401,8886,12927
2021-06-04 15:30:00+00,13360,0,5517,3420,160,3978,2458,112,4660,0,33665,171,16215,13757,8240,13360
2021-06-04 16:00:00+00,13995,0,5509,3519,306,4010,2476,116,3944,70,33945,177,15754,13278,7769,13995
2021-06-04 16:30:00+00,14111,0,5511,3641,324,4010,2488,116,3259,48,33508,181,15223,12735,7224,14111
2021-06-04 17:00:00+00,14205,0,5511,3724,358,3610,2492,117,2537,608,33162,184,14622,12130,6619,14205
2021-06-04 17:30:00+00,14162,0,5515,3717,363,3604,2465,119,1982,982,32909,185,14042,11577,6062,14162
2021-06-04 18:00:00+00,14256,0,5516,3560,376,3754,2433,106,1473,894,32368,189,13358,10925,5409,14256
2021-06-04 18:30:00+00,14137,0,5511,3390,359,3762,2427,105,927,880,31498,193,12614,10186,4676,14137
2021-06-04 19:00:00+00,13998,0,5513,2995,285,3756,2426,104,467,818,30362,198,11686,9260,3747,13998
2021-06-04 19:30:00+00,14100,0,5507,2656,244,3756,2415,105,146,434,29363,206,10968,8553,3046,14100
2021-06-04 20:00:00+00,13984,0,5515,2527,207,3984,2405,105,10,186,28923,208,10664,8259,2744,13984
2021-06-04 20:30:00+00,13998,0,5513,2384,175,3988,2396,103,0,124,28681,210,10468,8072,2559,13998
2021-06-04 21:00:00+00,13973,0,5522,2227,134,3926,2392,100,0,78,28352,211,10275,7883,2361,13973
2021-06-04 21:30:00+00,13335,0,5524,2078,143,3916,2386,100,0,26,27508,209,10131,7745,2221,13335
2021-06-04 22:00:00+00,12306,0,5526,1974,128,3416,2348,100,0,12,25810,206,9976,7628,2102,12306
2021-06-04 22:30:00+00,11096,0,5531,1994,98,3404,2321,100,0,0,24544,197,9944,7623,2092,11096
2021-06-04 23:00:00+00,10166,0,5530,1989,74,3212,2281,100,0,0,23352,190,9874,7593,2063,10166
2021-06-04 23:30:00+00,9635,0,5532,1924,74,3210,2234,99,0,0,22708,186,9764,7530,1998,9635
2021-06-05 00:00:00+00,9247,0,5533,1882,74,3020,2345,100,0,0,22201,183,9834,7489,1956,9247
2021-06-05 00:30:00+00,9060,0,5535,1927,74,3018,2440,100,0,0,22154,180,9976,7536,2001,9060
2021-06-05 01:00:00+00,8992,0,5534,1908,74,3014,2448,100,0,0,22070,180,9964,7516,1982,8992
2021-06-05 01:30:00+00,8626,0,5535,2003,74,3014,2450,99,0,0,21801,176,10062,7612,2077,8626
2021-06-05 02:00:00+00,8602,0,5532,2048,74,3014,2419,100,0,0,21789,175,10073,7654,2122,8602
2021-06-05 02:30:00+00,8503,0,5531,2074,74,3014,2430,99,0,0,21725,174,10109,7679,2148,8503
2021-06-05 03:00:00+00,8569,0,5526,2056,70,3014,2419,100,0,0,21754,175,10071,7652,2126,8569
2021-06-05 03:30:00+00,8319,0,5529,2149,68,3014,2325,99,0,0,21503,172,10071,7746,2217,8319
2021-06-05 04:00:00+00,8384,0,5527,2327,67,3016,2271,103,63,0,21758,171,10255,7984,2457,8384
2021-06-05 04:30:00+00,8408,0,5528,2323,67,3016,2347,100,367,0,22156,168,10632,8285,2757,8408
2021-06-05 05:00:00+00,8437,0,5528,2375,128,3014,2662,99,799,0,23042,164,11492,8830,3302,8437
2021-06-05 05:30:00+00,8391,0,5530,2397,133,3028,2771,99,1378,0,23727,159,12209,9438,3908,8391
2021-06-05 06:00:00+00,8663,0,5526,2326,148,3280,2747,100,2081,0,24871,156,12828,10081,4555,8663
2021-06-05 06:30:00+00,9198,0,5526,2113,148,3284,2927,101,2895,0,26192,157,13609,10682,5156,9198
2021-06-05 07:00:00+00,10056,0,5526,2082,164,3006,3049,107,3587,46,27623,161,14408,11359,5833,10056
2021-06-05 07:30:00+00,10229,0,5524,2030,172,3000,3028,118,4320,238,28659,157,15074,12046,6522,10229
2021-06-05 08:00:00+00,10146,0,5526,1964,243,2790,3088,152,5295,596,29800,150,16116,13028,7502,10146
2021-06-05 08:30:00+00,9911,0,5547,1923,244,2786,3083,159,6166,346,30165,145,16963,13880,8333,9911
2021-06-05 09:00:00+00,9828,0,5534,2079,229,2974,3092,160,6893,202,30991,141,17827,14735,9201,9828
2021-06-05 09:30:00+00,9681,0,5529,2228,225,2978,3085,139,7485,352,31702,136,18552,15467,9938,9681
2021-06-05 10:00:00+00,9605,0,5531,2278,203,3110,3072,108,7962,148,32017,133,19046,15974,10443,9605
2021-06-05 10:30:00+00,9616,0,5526,2217,176,3110,3082,101,8269,20,32117,133,19270,16188,10662,9616
2021-06-05 11:00:00+00,9301,0,5531,2146,167,3358,3077,101,8347,104,32132,130,19268,16191,10660,9301
2021-06-05 11:30:00+00,9071,0,5532,2136,165,3362,3076,101,8118,138,31699,129,19027,15951,10419,9071
2021-06-05 12:00:00+00,9075,0,5532,2223,108,3374,3062,100,8039,0,31513,130,18964,15902,10370,9075
2021-06-05 12:30:00+00,8738,0,5531,2295,102,3374,3062,100,7711,0,30913,128,18701,15639,10108,8738
2021-06-05 13:00:00+00,8534,0,5531,2321,102,3408,3055,99,7240,0,30290,128,18249,15194,9663,8534
2021-06-05 13:30:00+00,8375,0,5521,2387,102,3408,3057,100,6730,0,29680,129,17797,14740,9219,8375
2021-06-05 14:00:00+00,8546,0,5519,2494,117,3136,3051,99,6262,0,29224,132,17443,14392,8873,8546
2021-06-05 14:30:00+00,8955,0,5512,2548,117,3130,3042,102,5576,0,28982,138,16795,13753,8241,8955
2021-06-05 15:00:00+00,9558,0,5512,2543,117,3144,3018,107,5109,0,29108,146,16299,13281,7769,9558
2021-06-05 15:30:00+00,10482,0,5508,2514,137,3150,3005,153,4157,204,29310,157,15321,12316,6808,10482
2021-06-05 16:00:00+00,11313,0,5504,2558,215,3332,2847,161,3329,430,29689,166,14453,11606,6102,11313
2021-06-05 16:30:00+00,11906,0,5509,2616,232,3338,2799,161,2746,566,29873,172,13902,11103,5594,11906
2021-06-05 17:00:00+00,12056,0,5506,2644,340,3202,2796,178,1876,956,29554,176,13162,10366,4860,12056
2021-06-05 17:30:00+00,12262,0,5502,2612,359,3212,2832,208,1203,1256,29446,180,12508,9676,4174,12262
2021-06-05 18:00:00+00,12176,0,5507,2542,359,3728,2703,149,841,1226,29231,181,11952,9249,3742,12176
2021-06-05 18:30:00+00,12189,0,5510,2392,344,3740,2671,182,523,970,28521,185,11440,8769,3259,12189
2021-06-05 19:00:00+00,12168,0,5511,2274,315,3734,2738,162,212,866,27980,189,11050,8312,2801,12168
2021-06-05 19:30:00+00,12227,0,5505,2117,298,3734,2763,165,50,572,27431,194,10733,7970,2465,12227
2021-06-05 20:00:00+00,12181,0,5510,2058,255,3762,2765,121,3,328,26983,196,10591,7826,2316,12181
2021-06-05 20:30:00+00,12277,0,5510,2016,234,3808,2821,120,0,210,26996,198,10581,7760,2250,12277
2021-06-05 21:00:00+00,12267,0,5513,1842,162,3866,2897,102,0,30,26679,200,10414,7517,2004,12267
2021-06-05 21:30:00+00,11746,0,5519,1899,164,3828,2878,100,0,0,26134,196,10460,7582,2063,11746
2021-06-05 22:00:00+00,10791,0,5535,1925,161,3562,2754,99,0,32,24859,190,10375,7621,2086,10791
2021-06-05 22:30:00+00,9834,0,5587,1896,148,3550,2726,100,0,0,23841,183,10357,7631,2044,9834
2021-06-05 23:00:00+00,9048,0,5618,1754,130,3216,2716,100,0,16,22598,178,10218,7502,1884,9048
2021-06-05 23:30:00+00,8511,0,5623,1574,125,3212,2705,100,0,0,21850,175,10027,7322,1699,8511
2021-06-06 00:00:00+00,8290,0,5623,1541,88,3212,2708,99,0,0,21561,172,9960,7252,1629,8290
2021-06-06 00:30:00+00,8136,0,5615,1516,87,3210,2706,99,0,0,21369,171,9924,7218,1603,8136
2021-06-06 01:00:00+00,8105,0,5639,1585,70,3016,2708,99,0,0,21222,171,10002,7294,1655,8105
2021-06-06 01:30:00+00,7994,0,5638,1663,67,3014,2708,99,0,0,21183,170,10076,7368,1730,7994
2021-06-06 02:00:00+00,7913,0,5640,1657,67,2870,2711,99,0,0,20957,169,10075,7364,1724,7913
2021-06-06 02:30:00+00,7831,0,5638,1600,67,2886,2697,99,0,0,20818,169,10002,7305,1667,7831
2021-06-06 03:00:00+00,7943,0,5636,1504,67,3016,2586,100,0,0,20852,171,9793,7207,1571,7943
2021-06-06 03:30:00+00,7672,0,5642,1509,66,3018,2528,99,0,0,20534,168,9745,7217,1575,7672
2021-06-06 04:00:00+00,7688,0,5638,1545,66,2926,2401,99,34,0,20397,168,9684,7283,1645,7688
2021-06-06 04:30:00+00,7824,0,5631,1515,66,2926,2518,100,167,0,20747,169,9897,7379,1748,7824
2021-06-06 05:00:00+00,7736,0,5631,1509,102,3016,2708,100,398,0,21200,165,10348,7640,2009,7736
2021-06-06 05:30:00+00,7797,0,5628,1459,102,3016,2686,99,707,0,21494,164,10582,7896,2268,7797
2021-06-06 06:00:00+00,8203,0,5626,1316,102,2928,2619,101,1124,0,22019,166,10787,8168,2542,8203
2021-06-06 06:30:00+00,9032,0,5629,1172,99,2920,2618,101,1639,0,23210,172,11157,8539,2910,9032
2021-06-06 07:00:00+00,10101,0,5631,1106,180,3304,2489,101,2204,0,25116,175,11610,9121,3490,10101
2021-06-06 07:30:00+00,10999,0,5626,1066,186,3310,2400,101,2896,10,26594,179,12174,9774,4148,10999
2021-06-06 08:00:00+00,11661,0,5620,960,206,3776,2299,101,3284,20,27927,182,12369,10070,4450,11661
2021-06-06 08:30:00+00,12138,0,5629,902,207,3800,2294,101,3600,0,28671,184,12632,10338,4709,12138
2021-06-06 09:00:00+00,12437,0,5659,883,238,4050,2299,101,3953,54,29674,185,13032,10733,5074,12437
2021-06-06 09:30:00+00,12665,0,5683,902,236,4100,2298,101,4531,0,30516,183,13650,11352,5669,12665
2021-06-06 10:00:00+00,12546,0,5681,908,197,4518,2191,101,4879,12,31033,181,13856,11665,5984,12546
2021-06-06 10:30:00+00,12795,0,5684,901,197,4534,2194,101,5373,30,31809,180,14349,12155,6471,12795
2021-06-06 11:00:00+00,12665,0,5684,892,197,4958,2290,101,5679,26,32492,178,14742,12452,6768,12665
2021-06-06 11:30:00+00,12504,0,5688,881,193,4970,2354,101,6485,0,33176,173,15601,13247,7559,12504
2021-06-06 12:00:00+00,12038,0,5751,892,131,4694,2310,101,6025,0,31942,170,15109,12799,7048,12038
2021-06-06 12:30:00+00,11976,0,5767,959,130,4634,1896,101,5967,0,31430,170,14719,12823,7056,11976
2021-06-06 13:00:00+00,11913,0,5769,1015,104,4100,2002,101,6184,0,31188,164,15074,13072,7303,11913
2021-06-06 13:30:00+00,11887,0,5769,1053,102,4100,1883,101,5982,0,30877,165,14789,12906,7137,11887
2021-06-06 14:00:00+00,11846,0,5767,1105,102,3922,1958,101,5304,0,30105,169,14236,12278,6511,11846
2021-06-06 14:30:00+00,12042,0,5793,1090,102,3924,2111,102,4863,0,30027,172,13959,11848,6055,12042
2021-06-06 15:00:00+00,12564,0,5792,1075,119,4118,2142,102,4623,0,30535,177,13751,11609,5817,12564
2021-06-06 15:30:00+00,13105,0,5791,1049,122,4118,2309,102,4227,0,30823,183,13498,11189,5398,13105
2021-06-06 16:00:00+00,13671,0,5789,986,161,4118,2238,117,3894,68,31042,188,13068,10830,5041,13671
2021-06-06 16:30:00+00,13732,0,5789,835,225,4120,2210,218,3061,620,30810,191,12120,9910,4121,13732
2021-06-06 17:00:00+00,13830,0,5787,793,371,4120,2134,231,2566,982,30814,193,11651,9517,3730,13830
2021-06-06 17:30:00+00,14093,0,5784,797,374,4120,2262,210,1980,754,30374,199,11197,8935,3151,14093
2021-06-06 18:00:00+00,14241,0,5780,755,376,4120,2315,233,1503,720,30043,204,10729,8414,2634,14241
2021-06-06 18:30:00+00,14415,0,5786,686,373,4120,2307,236,925,732,29580,209,10077,7770,1984,14415
2021-06-06 19:00:00+00,14384,0,5786,663,357,4120,2311,234,409,738,29002,213,9526,7215,1429,14384
2021-06-06 19:30:00+00,14397,0,5783,610,312,4118,2311,213,125,600,28469,217,9141,6830,1047,14397
2021-06-06 20:00:00+00,14126,0,5782,601,238,4100,2309,207,9,652,28024,216,8939,6630,848,14126
2021-06-06 20:30:00+00,14103,0,5781,612,195,4098,2312,207,0,332,27640,219,8900,6588,807,14103
2021-06-06 21:00:00+00,14132,0,5781,626,153,4068,2310,136,0,156,27362,221,8870,6560,779,14132
2021-06-06 21:30:00+00,13028,0,5777,654,171,4058,2313,122,0,68,26191,214,8915,6602,825,13028
2021-06-06 22:00:00+00,11510,0,5777,646,163,4222,2315,113,0,0,24746,211,8901,6586,809,11510
2021-06-06 22:30:00+00,10185,0,5793,582,128,4292,2317,105,0,0,23402,202,8820,6503,710,10185
2021-06-06 23:00:00+00,9450,0,5807,567,77,4200,2319,99,0,0,22519,195,8770,6451,644,9450
2021-06-06 23:30:00+00,9092,0,5844,584,77,4200,2189,99,0,0,22085,192,8694,6505,661,9092
2021-06-07 00:00:00+00,8772,0,5875,583,77,4320,2183,99,0,0,21909,193,8718,6535,660,8772
2021-06-07 00:30:00+00,8743,0,5876,592,76,4322,2235,99,0,0,21943,192,8779,6544,668,8743
2021-06-07 01:00:00+00,8910,0,5877,614,75,4076,2302,99,0,0,21953,191,8868,6566,689,8910
2021-06-07 01:30:00+00,8876,0,5880,648,74,4068,2304,99,0,0,21949,191,8906,6602,722,8876
2021-06-07 02:00:00+00,8905,0,5883,727,73,3596,2247,99,0,0,21530,189,8930,6683,800,8905
2021-06-07 02:30:00+00,8935,0,5887,826,73,3588,2204,99,0,0,21612,188,8990,6786,899,8935
2021-06-07 03:00:00+00,9231,0,5882,894,72,3250,2058,99,0,0,21486,189,8906,6848,966,9231
2021-06-07 03:30:00+00,9161,0,5885,919,72,3230,2048,103,0,0,21418,188,8924,6876,991,9161
2021-06-07 04:00:00+00,9517,0,5880,926,71,2362,2022,102,60,0,20940,198,8959,6937,1057,9517
2021-06-07 04:30:00+00,10129,0,5886,977,83,2406,2173,100,322,0,22076,202,9441,7268,1382,10129
2021-06-07 05:00:00+00,12066,0,5886,992,199,2496,2032,99,698,0,24468,214,9807,7775,1889,12066
2021-06-07 05:30:00+00,13476,0,5881,975,200,2456,2107,101,1076,0,26272,220,10239,8132,2251,13476
2021-06-07 06:00:00+00,13677,0,5878,1007,219,4048,2158,108,1667,226,28988,212,10929,8771,2893,13677
2021-06-07 06:30:00+00,14569,0,5878,1028,222,4320,2064,108,2293,510,30992,211,11485,9421,3543,14569
2021-06-07 07:00:00+00,15434,0,5874,1064,258,4540,2165,109,2906,256,32606,208,12267,10102,4228,15434
2021-06-07 07:30:00+00,15690,0,5873,1054,259,4556,2170,108,3417,228,33355,206,12773,10603,4730,15690
2021-06-07 08:00:00+00,15676,0,5868,1088,259,4602,2167,108,4072,50,33890,204,13454,11287,5419,15676
2021-06-07 08:30:00+00,15601,0,5860,1131,261,4604,2170,111,4545,76,34359,201,13967,11797,5937,15601
2021-06-07 09:00:00+00,15269,0,5861,1256,219,4696,2174,112,5240,0,34827,194,14750,12576,6715,15269
2021-06-07 09:30:00+00,15056,0,5860,1346,201,4694,2168,112,5763,0,35200,190,15338,13170,7310,15056
2021-06-07 10:00:00+00,14718,0,5860,1557,163,4612,2172,105,5982,0,35169,186,15734,13562,7702,14718
2021-06-07 10:30:00+00,14504,0,5869,1746,151,4612,2166,114,6217,0,35379,183,16149,13983,8114,14504
2021-06-07 11:00:00+00,14412,0,5881,1909,146,4292,2147,152,7052,0,35991,177,17135,14988,9107,14412
2021-06-07 11:30:00+00,13971,0,5881,1989,137,4284,2150,148,7121,0,35681,173,17278,15128,9247,13971
2021-06-07 12:00:00+00,13727,0,5880,2168,108,3850,2193,111,7307,152,35496,170,17656,15463,9583,13727
2021-06-07 12:30:00+00,13687,0,5874,2423,104,3402,2220,103,7055,0,34868,172,17676,15456,9582,13687
2021-06-07 13:00:00+00,13411,0,5879,2888,105,2836,2273,103,6855,0,34350,170,18000,15727,9848,13411
2021-06-07 13:30:00+00,13001,0,5877,3278,105,2982,2281,104,6596,0,34224,167,18137,15856,9979,13001
2021-06-07 14:00:00+00,12755,0,5878,3624,106,3266,2277,103,6318,0,34327,162,18203,15926,10048,12755
2021-06-07 14:30:00+00,12963,0,5875,3965,117,3360,2262,104,5919,52,34617,164,18138,15876,10001,12963
2021-06-07 15:00:00+00,14049,0,5875,4105,161,2966,2261,111,5364,0,34892,174,17766,15505,9630,14049
2021-06-07 15:30:00+00,14632,0,5875,4336,200,3022,2258,125,4740,98,35286,180,17409,15151,9276,14632
2021-06-07 16:00:00+00,14677,0,5876,4375,305,3636,2273,128,4064,178,35512,180,16893,14620,8744,14677
2021-06-07 16:30:00+00,14775,0,5877,4509,308,3722,2283,164,3430,418,35486,183,16407,14124,8247,14775
2021-06-07 17:00:00+00,14990,0,5880,4714,328,3642,2278,193,2602,484,35111,186,15802,13524,7644,14990
2021-06-07 17:30:00+00,14745,0,5873,4999,326,3632,2280,123,2044,480,34502,186,15522,13242,7369,14745
2021-06-07 18:00:00+00,14483,0,5871,5215,309,3816,2290,107,1601,372,34064,186,15286,12996,7125,14483
2021-06-07 18:30:00+00,14505,0,5868,5143,308,3768,2289,105,957,298,33241,190,14565,12276,6408,14505
2021-06-07 19:00:00+00,14636,0,5870,4893,241,3070,2285,100,570,644,32309,196,13859,11574,5704,14636
2021-06-07 19:30:00+00,14579,0,5879,4840,222,3008,2306,99,193,172,31298,201,13440,11134,5255,14579
2021-06-07 20:00:00+00,14060,0,5870,4828,192,3106,2310,99,12,176,30653,198,13212,10902,5032,14060
2021-06-07 20:30:00+00,13285,0,5867,5060,168,3066,2316,99,0,28,29889,193,13411,11095,5228,13285
2021-06-07 21:00:00+00,12741,0,5865,5122,153,2712,2311,99,0,192,29195,190,13451,11140,5275,12741
2021-06-07 21:30:00+00,11122,0,5867,5366,184,2620,2312,99,0,92,27662,177,13729,11417,5550,11122
2021-06-07 22:00:00+00,8195,0,5870,5406,179,3854,2309,99,0,0,25912,157,13764,11455,5585,8195
2021-06-07 22:30:00+00,6838,0,5866,5264,141,3946,2312,99,0,16,24482,146,13583,11271,5405,6838
2021-06-07 23:00:00+00,6543,0,5868,5060,85,3370,2306,99,0,108,23439,141,13319,11013,5145,6543
2021-06-07 23:30:00+00,6377,0,5867,5045,85,3312,2305,99,0,0,23090,139,13302,10997,5130,6377
2021-06-08 00:00:00+00,6583,0,5887,4924,84,3322,2317,99,0,0,23216,143,13212,10895,5008,6583
2021-06-08 00:30:00+00,6546,0,5901,4587,84,3330,2320,99,0,0,22866,144,12892,10572,4671,6546
2021-06-08 01:00:00+00,6347,0,5909,4429,84,3318,2306,100,0,0,22493,144,12728,10422,4513,6347
2021-06-08 01:30:00+00,6028,0,5906,4237,84,3228,2313,99,0,0,21895,140,12540,10227,4321,6028
2021-06-08 02:00:00+00,5848,0,5904,4093,84,2994,2318,99,0,0,21339,138,12399,10081,4177,5848
2021-06-08 02:30:00+00,5713,0,5906,3954,84,2984,2314,99,0,0,21054,137,12258,9944,4038,5713
2021-06-08 03:00:00+00,5599,0,5907,3897,84,3044,2291,99,0,0,20921,137,12179,9888,3981,5599
2021-06-08 03:30:00+00,5394,0,5907,3917,84,3028,2315,99,0,0,20744,134,12223,9908,4001,5394
2021-06-08 04:00:00+00,5466,0,5905,3824,84,2736,2311,99,85,10,20519,130,12208,9898,3992,5466
2021-06-08 04:30:00+00,5595,0,5904,3700,90,2856,2313,99,372,0,20929,133,12379,10066,4162,5595
2021-06-08 05:00:00+00,6179,0,5903,3401,170,2562,2315,99,860,202,21690,138,12649,10334,4431,6179
2021-06-08 05:30:00+00,6925,0,5902,3105,180,2538,2304,101,1537,184,22776,144,13028,10724,4822,6925
2021-06-08 06:00:00+00,8096,0,5905,2883,246,3640,2272,109,2066,98,25315,153,13372,11100,5195,8096
2021-06-08 06:30:00+00,9115,0,5906,2730,349,3774,2273,250,2843,298,27538,158,14101,11828,5922,9115
2021-06-08 07:00:00+00,10012,0,5904,2741,362,4480,2275,257,3524,392,29947,162,14806,12531,6627,10012
2021-06-08 07:30:00+00,10473,0,5902,2892,346,4502,2268,207,4450,662,31702,159,15858,13590,7688,10473
2021-06-08 08:00:00+00,10758,0,5895,2915,243,4502,2262,186,5277,592,32630,157,16592,14330,8435,10758
2021-06-08 08:30:00+00,10910,0,5894,2877,229,4502,2268,169,5920,590,33359,156,17188,14920,9026,10910
2021-06-08 09:00:00+00,11013,0,5891,2766,211,4498,2204,121,6744,194,33642,155,17816,15612,9721,11013
2021-06-08 09:30:00+00,11010,0,5884,2938,204,4496,2237,101,7364,0,34235,152,18627,16390,10506,11010
2021-06-08 10:00:00+00,11012,0,5882,3162,140,4432,2242,101,7904,74,34948,149,19330,17088,11206,11012
2021-06-08 10:30:00+00,10984,0,5880,3586,128,4402,2254,101,8298,0,35633,146,20146,17892,12012,10984
2021-06-08 11:00:00+00,11003,0,5879,3671,128,4412,2241,101,8683,0,36118,144,20602,18361,12482,11003
2021-06-08 11:30:00+00,10698,0,5890,3804,129,4410,2223,100,8900,0,36154,140,20946,18723,12833,10698
2021-06-08 12:00:00+00,10155,0,5890,3851,111,4444,2248,100,9161,0,35960,135,21261,19013,13123,10155
2021-06-08 12:30:00+00,9675,0,5894,4036,103,4378,2247,100,9104,0,35537,131,21384,19137,13243,9675
2021-06-08 13:00:00+00,9978,0,5908,4123,103,3694,2246,100,8831,0,34983,132,21211,18965,13057,9978
2021-06-08 13:30:00+00,10033,0,5918,4259,93,3628,2185,123,8534,0,34773,133,20989,18804,12886,10033
2021-06-08 14:00:00+00,9981,0,5903,4325,88,3618,2219,100,7944,0,34178,133,20479,18260,12357,9981
2021-06-08 14:30:00+00,10489,0,5904,4402,93,3760,2261,132,7200,0,34241,141,19860,17599,11695,10489
2021-06-08 15:00:00+00,10976,0,5903,4315,127,4196,2270,122,6432,4,34345,151,19047,16777,10874,10976
2021-06-08 15:30:00+00,11897,0,5906,4271,185,4252,2302,137,5637,72,34659,161,18301,15999,10093,11897
2021-06-08 16:00:00+00,12420,0,5897,4369,324,4662,2289,168,4639,204,34972,168,17518,15229,9332,12420
2021-06-08 16:30:00+00,12879,0,5894,4215,390,4882,2287,223,3820,366,34956,176,16606,14319,8425,12879
2021-06-08 17:00:00+00,12840,0,5932,4268,312,4810,2308,183,2995,1000,34648,177,15815,13507,7575,12840
2021-06-08 17:30:00+00,12782,0,5934,4486,325,4874,2305,194,2288,1142,34330,179,15338,13033,7099,12782
2021-06-08 18:00:00+00,12913,0,5944,4469,322,4982,2307,217,1543,1128,33825,184,14585,12278,6334,12913
2021-06-08 18:30:00+00,12852,0,5935,4458,323,4988,2309,204,975,1128,33172,187,14000,11691,5756,12852
2021-06-08 19:00:00+00,12842,0,5933,4363,289,4894,2309,167,533,1012,32342,192,13427,11118,5185,12842
2021-06-08 19:30:00+00,12837,0,5931,4354,272,4766,2306,158,168,682,31474,195,13031,10725,4794,12837
2021-06-08 20:00:00+00,12778,0,5931,4279,211,4830,2296,130,12,158,30625,200,12729,10433,4502,12778
2021-06-08 20:30:00+00,12599,0,5932,4249,173,4752,2312,120,0,0,30137,200,12666,10354,4422,12599
2021-06-08 21:00:00+00,12608,0,5935,4381,140,4062,2310,103,0,64,29603,199,12766,10456,4521,12608
2021-06-08 21:30:00+00,11186,0,5927,4635,153,3890,2312,100,0,0,28203,186,13027,10715,4788,11186
2021-06-08 22:00:00+00,9232,0,5928,4864,152,3938,2314,101,0,0,26529,172,13258,10944,5016,9232
2021-06-08 22:30:00+00,7594,0,5930,5000,139,3994,2301,102,0,0,25060,158,13370,11069,5139,7594
2021-06-08 23:00:00+00,7011,0,5927,4996,75,3486,2285,99,0,18,23897,150,13283,10998,5071,7011
2021-06-08 23:30:00+00,6618,0,5927,5050,71,3294,2284,99,0,0,23343,143,13332,11048,5121,6618
2021-06-09 00:00:00+00,6664,0,5931,4838,72,3448,2272,101,0,0,23326,145,13113,10841,4910,6664
2021-06-09 00:30:00+00,6702,0,5927,4744,71,3494,2272,100,0,0,23310,147,13014,10742,4815,6702
2021-06-09 01:00:00+00,7048,0,5937,4586,72,3548,2262,101,0,0,23554,152,12857,10595,4658,7048
2021-06-09 01:30:00+00,6455,0,5939,4839,71,3434,2256,102,0,0,23096,143,13105,10849,4910,6455
2021-06-09 02:00:00+00,6124,0,5947,5139,71,3474,2077,104,0,0,22936,138,13234,11157,5210,6124
2021-06-09 02:30:00+00,6147,0,5940,5005,69,3442,2112,99,0,0,22814,139,13126,11014,5074,6147
2021-06-09 03:00:00+00,6196,0,5947,5003,68,3222,2134,102,0,0,22672,137,13152,11018,5071,6196
2021-06-09 03:30:00+00,5904,0,5943,5058,67,3228,1997,100,0,0,22297,134,13065,11068,5125,5904
2021-06-09 04:00:00+00,6226,0,5940,5024,80,2582,1834,99,72,0,21857,138,12950,11116,5176,6226
2021-06-09 04:30:00+00,6675,0,5942,5216,102,2708,1907,100,368,0,23018,142,13535,11628,5686,6675
2021-06-09 05:00:00+00,8171,0,5938,5379,179,2422,2290,99,815,6,25299,151,14601,12311,6373,8171
2021-06-09 05:30:00+00,9292,0,5945,5382,182,2550,2651,123,1373,18,27516,158,15533,12882,6937,9292
2021-06-09 06:00:00+00,10022,0,5943,5251,229,3990,2618,121,2069,28,30271,160,16110,13492,7549,10022
2021-06-09 06:30:00+00,10615,0,5947,5183,233,4152,2591,106,2767,238,31832,161,16721,14130,8183,10615
2021-06-09 07:00:00+00,10665,0,5948,5191,276,4300,2671,107,3550,314,33022,157,17636,14965,9017,10665
2021-06-09 07:30:00+00,10584,0,5947,5360,257,4170,2679,105,4365,288,33755,150,18608,15929,9982,10584
2021-06-09 08:00:00+00,10452,0,5946,5571,254,4184,2712,104,5148,282,34653,145,19631,16919,10973,10452
2021-06-09 08:30:00+00,9975,0,5943,5796,207,4150,2609,105,5916,242,34943,138,20471,17862,11919,9975
2021-06-09 09:00:00+00,10188,0,5940,5884,179,3758,2662,101,6515,24,35251,137,21180,18518,12578,10188
2021-06-09 09:30:00+00,9621,0,5938,6187,172,3756,2656,101,6962,0,35393,130,21915,19259,13321,9621
2021-06-09 10:00:00+00,8924,0,5936,6452,110,4204,2638,100,7310,0,35674,123,22446,19808,13872,8924
2021-06-09 10:30:00+00,8743,0,5928,6485,123,4208,2672,100,7696,0,35955,120,22904,20232,14304,8743
2021-06-09 11:00:00+00,8778,0,5938,6741,123,4306,2672,100,7823,0,36481,119,23297,20625,14687,8778
2021-06-09 11:30:00+00,8615,0,5946,6873,108,4304,2666,122,7614,0,36248,118,23207,20541,14595,8615
2021-06-09 12:00:00+00,8500,0,5903,7277,82,4120,2636,152,7268,0,35938,117,23166,20530,14627,8500
2021-06-09 12:30:00+00,8305,0,5877,7413,80,4116,2639,153,7057,48,35688,116,23066,20427,14550,8305
2021-06-09 13:00:00+00,8338,0,5875,7671,80,4134,2600,155,6523,30,35406,118,22749,20149,14274,8338
2021-06-09 13:30:00+00,8363,0,5881,7715,83,4130,2638,153,6005,2,34970,120,22322,19684,13803,8363
2021-06-09 14:00:00+00,8922,0,5881,7852,81,3874,2598,141,5437,0,34786,125,21849,19251,13370,8922
2021-06-09 14:30:00+00,9528,0,5882,7734,83,3866,2582,145,5164,134,35118,131,21445,18863,12981,9528
2021-06-09 15:00:00+00,9735,0,5887,8062,164,3812,2565,557,4618,106,35506,135,21296,18731,12844,9735
2021-06-09 15:30:00+00,10012,0,5883,8315,221,3854,2613,629,3581,278,35386,140,20613,18000,12117,10012
2021-06-09 16:00:00+00,10169,0,5883,8351,338,4200,2620,613,2945,692,35811,140,20137,17517,11634,10169
2021-06-09 16:30:00+00,10097,0,5885,8520,350,4206,2670,627,2388,974,35717,140,19813,17143,11258,10097
2021-06-09 17:00:00+00,10519,0,5870,8121,350,4220,2676,602,1936,1106,35400,144,18953,16277,10407,10519
2021-06-09 17:30:00+00,10783,0,5845,7727,347,4224,2683,548,1486,1324,34967,149,18088,15405,9560,10783
2021-06-09 18:00:00+00,10826,0,5816,7544,347,4362,2685,538,1055,1140,34313,154,17447,14762,8946,10826
2021-06-09 18:30:00+00,10660,0,5822,7263,351,4362,2685,471,568,1100,33282,155,16689,14004,8182,10660
2021-06-09 19:00:00+00,10691,0,5815,7135,352,4392,2682,198,293,808,32366,159,16277,13595,7780,10691
2021-06-09 19:30:00+00,10626,0,5817,7224,322,4388,2682,171,81,570,31881,160,16126,13444,7627,10626
2021-06-09 20:00:00+00,10643,0,5799,7027,204,4170,2685,146,3,392,31069,163,15718,13033,7234,10643
2021-06-09 20:30:00+00,10737,0,5774,6769,152,4156,2656,140,0,224,30608,166,15351,12695,6921,10737
2021-06-09 21:00:00+00,10641,0,5772,6571,136,3600,2642,140,0,238,29740,167,15121,12479,6707,10641
2021-06-09 21:30:00+00,9669,0,5776,6346,132,3588,2667,140,0,114,28432,161,14921,12254,6478,9669
2021-06-09 22:00:00+00,8053,0,5769,6261,132,3392,2690,140,0,416,26853,148,14852,12162,6393,8053
2021-06-09 22:30:00+00,7027,0,5773,6165,131,3470,2676,141,0,68,25451,142,14745,12069,6296,7027
2021-06-09 23:00:00+00,6186,0,5765,5765,52,3354,2681,142,0,42,23987,134,14263,11582,5817,6186
2021-06-09 23:30:00+00,5707,0,5773,5889,49,3410,2642,140,0,0,23610,129,14353,11711,5938,5707
2021-06-10 00:00:00+00,5379,0,5778,6128,48,3574,2557,140,0,0,23604,128,14511,11954,6176,5379
2021-06-10 00:30:00+00,4899,0,5787,6282,47,3670,2544,141,0,0,23370,123,14660,12116,6329,4899
2021-06-10 01:00:00+00,4927,0,5784,6207,38,3650,2386,141,0,0,23133,123,14415,12029,6245,4927
2021-06-10 01:30:00+00,4949,0,5787,6393,36,3650,2186,140,0,0,23141,122,14402,12216,6429,4949
2021-06-10 02:00:00+00,4847,0,5787,6471,36,3640,2113,140,0,0,23034,121,14407,12294,6507,4847
2021-06-10 02:30:00+00,5003,0,5791,6563,35,3640,2058,140,0,0,23230,122,14447,12389,6598,5003
2021-06-10 03:00:00+00,4988,0,5791,6491,35,3084,2501,140,0,0,23030,119,14818,12317,6526,4988
2021-06-10 03:30:00+00,4820,0,5796,6584,35,3040,2732,141,0,0,23148,116,15147,12415,6619,4820
2021-06-10 04:00:00+00,4959,0,5794,6810,35,2570,2580,141,30,0,22919,118,15249,12669,6875,4959
2021-06-10 04:30:00+00,5458,0,5794,6469,59,2614,2552,142,161,0,23249,126,15035,12483,6689,5458
2021-06-10 05:00:00+00,6277,0,5791,6239,174,3346,2713,142,405,162,25249,138,15322,12609,6818,6277
2021-06-10 05:30:00+00,8366,0,5792,6162,181,3264,2794,178,705,68,27510,155,15634,12840,7048,8366
2021-06-10 06:00:00+00,9308,0,5795,6450,192,4190,2799,144,1080,136,30094,156,16316,13517,7722,9308
2021-06-10 06:30:00+00,10341,0,5796,6481,208,4280,2728,148,1529,56,31567,163,16742,14014,8218,10341
2021-06-10 07:00:00+00,10572,0,5797,6733,227,4416,2709,166,1899,584,33103,157,17365,14656,8859,10572
2021-06-10 07:30:00+00,10812,0,5799,6671,290,4394,2635,218,2384,650,33853,156,17779,15144,9345,10812
2021-06-10 08:00:00+00,10926,0,5797,7022,340,4632,2605,266,2893,282,34763,156,18657,16052,10255,10926
2021-06-10 08:30:00+00,10704,0,5797,7392,220,4584,2612,280,3398,282,35269,151,19419,16807,11010,10704
2021-06-10 09:00:00+00,10582,0,5799,7514,138,4830,2662,167,3554,36,35282,151,19667,17005,11206,10582
2021-06-10 09:30:00+00,10665,0,5794,7540,137,4746,2701,151,3337,210,35281,151,19509,16808,11014,10665
2021-06-10 10:00:00+00,10531,0,5792,7665,103,4792,2648,149,3442,318,35440,149,19650,17002,11210,10531
2021-06-10 10:30:00+00,10360,0,5793,7800,103,4738,2587,194,3724,0,35299,147,20007,17420,11627,10360
2021-06-10 11:00:00+00,9996,0,5793,8136,103,4804,2540,169,4515,0,36056,141,21087,18547,12754,9996
2021-06-10 11:30:00+00,9447,0,5806,8385,103,4808,2475,147,4878,282,36331,133,21647,19172,13366,9447
2021-06-10 12:00:00+00,9262,0,5810,8629,104,4698,2695,143,4752,138,36231,131,21990,19295,13485,9262
2021-06-10 12:30:00+00,9038,0,5806,8630,110,4604,2737,141,4393,0,35459,130,21676,18939,13133,9038
2021-06-10 13:00:00+00,8936,0,5797,8931,109,4268,2703,140,4339,0,35223,128,21879,19176,13379,8936
2021-06-10 13:30:00+00,8868,0,5795,9179,115,4216,2613,175,4176,0,35137,127,21878,19265,13470,8868
2021-06-10 14:00:00+00,8915,0,5800,9173,115,4168,2640,141,4128,0,35080,130,21856,19216,13416,8915
2021-06-10 14:30:00+00,9348,0,5800,9208,112,4138,2740,144,3991,0,35481,133,21851,19111,13311,9348
2021-06-10 15:00:00+00,9849,0,5798,9075,127,4074,2763,152,3646,0,35484,137,21409,18646,12848,9849
2021-06-10 15:30:00+00,10105,0,5800,9106,155,4316,2763,165,3344,0,35754,142,21168,18405,12605,10105
2021-06-10 16:00:00+00,10034,0,5804,8966,239,4966,2771,167,2882,0,35829,144,20662,17891,12087,10034
2021-06-10 16:30:00+00,9582,0,5801,9327,245,5088,2766,160,2192,458,35619,141,20331,17565,11764,9582
2021-06-10 17:00:00+00,9795,0,5800,9165,296,4914,2774,182,1892,592,35410,144,19927,17153,11353,9795
2021-06-10 17:30:00+00,9882,0,5798,8917,266,4912,2768,157,1411,590,34701,148,19160,16392,10594,9882
2021-06-10 18:00:00+00,10089,0,5794,8925,233,4518,2774,162,925,588,34008,149,18651,15877,10083,10089
2021-06-10 18:30:00+00,9839,0,5795,9168,199,4480,2742,153,575,444,33395,148,18479,15737,9942,9839
2021-06-10 19:00:00+00,10105,0,5790,9121,123,3778,2747,151,369,214,32398,154,18150,15403,9613,10105
2021-06-10 19:30:00+00,10171,0,5794,9093,111,3650,2740,157,81,0,31797,157,17819,15079,9285,10171
2021-06-10 20:00:00+00,10376,0,5793,9075,112,2400,2740,292,2,118,30908,165,17722,14982,9189,10376
2021-06-10 20:30:00+00,10098,0,5796,8897,106,2196,2698,149,0,182,30122,162,17497,14799,9003,10098
2021-06-10 21:00:00+00,9727,0,5797,8998,86,1900,2718,141,0,0,29367,160,17599,14881,9084,9727
2021-06-10 21:30:00+00,8479,0,5802,9207,96,1758,2500,145,0,0,27987,147,17605,15105,9303,8479
2021-06-10 22:00:00+00,5976,0,5799,9418,95,3300,1840,142,0,0,26570,116,17152,15312,9513,5976
2021-06-10 22:30:00+00,4763,0,5789,9682,93,3312,1518,143,0,0,25300,101,17082,15564,9775,4763
2021-06-10 23:00:00+00,4497,0,5788,9753,53,2978,1526,150,0,0,24745,96,17120,15594,9806,4497
2021-06-10 23:30:00+00,4316,0,5789,9699,46,2942,1526,143,0,0,24461,93,17060,15534,9745,4316
2021-06-11 00:00:00+00,4855,0,5776,9603,45,1873,1518,141,0,0,23811,98,16942,15424,9648,4855
2021-06-11 00:30:00+00,4776,0,5652,9351,43,1775,1523,141,0,0,23261,98,16569,15046,9394,4776
2021-06-11 01:00:00+00,5100,0,5574,9151,43,1498,1526,144,0,0,23036,103,16294,14768,9194,5100
2021-06-11 01:30:00+00,4958,0,5575,9342,43,1338,1515,141,0,0,22912,99,16475,14960,9385,4958
2021-06-11 02:00:00+00,4742,0,5572,9279,43,1474,1524,143,0,0,22777,97,16418,14894,9322,4742
2021-06-11 02:30:00+00,4776,0,5566,9293,43,1514,1528,144,0,0,22864,98,16430,14902,9336,4776
2021-06-11 03:00:00+00,4434,0,5574,9197,43,1466,1513,142,0,0,22369,94,16327,14814,9240,4434
2021-06-11 03:30:00+00,4409,0,5702,9190,43,1428,1514,142,0,0,22428,93,16449,14935,9233,4409
2021-06-11 04:00:00+00,4509,0,5788,8961,42,1942,1513,140,31,0,22926,97,16335,14822,9034,4509
2021-06-11 04:30:00+00,4850,0,5792,8803,50,2018,1638,143,154,0,23448,102,16437,14799,9007,4850
2021-06-11 05:00:00+00,5349,0,5788,8871,105,2224,1909,143,341,0,24730,106,17014,15105,9317,5349
2021-06-11 05:30:00+00,6268,0,5790,9251,132,2324,2221,142,603,0,26731,114,17997,15776,9986,6268
2021-06-11 06:00:00+00,7034,0,5790,9917,189,3026,2399,141,875,0,29371,114,19170,16771,10981,7034
2021-06-11 06:30:00+00,7489,0,5786,10369,190,3006,2594,144,1262,276,31116,114,20201,17607,11821,7489
2021-06-11 07:00:00+00,7733,0,5788,10564,161,3782,2691,149,1416,96,32380,119,20620,17929,12141,7733
2021-06-11 07:30:00+00,7177,0,5800,11255,137,3914,2670,150,1882,174,33159,110,21744,19074,13274,7177
2021-06-11 08:00:00+00,7153,0,5796,11597,136,3914,2689,150,2698,0,34133,107,22916,20227,14431,7153
2021-06-11 08:30:00+00,7123,0,5795,11687,121,3914,2718,149,3232,0,34739,105,23553,20835,15040,7123
2021-06-11 09:00:00+00,6948,0,5797,11690,123,3916,2686,149,3362,0,34671,103,23658,20972,15175,6948
2021-06-11 09:30:00+00,6686,0,5803,12010,139,3916,2684,149,3535,0,34922,99,24171,21487,15684,6686
2021-06-11 10:00:00+00,6482,0,5730,12123,108,3914,2711,144,4669,0,35881,94,25341,22630,16900,6482
2021-06-11 10:30:00+00,6352,0,5593,12147,108,3914,2577,145,5451,0,36287,91,25876,23299,17706,6352
2021-06-11 11:00:00+00,6541,0,5578,11896,125,3718,2582,146,5518,28,36132,93,25699,23117,17539,6541
2021-06-11 11:30:00+00,6356,0,5582,11750,126,3724,2560,146,6058,0,36302,91,26076,23516,17934,6356
2021-06-11 12:00:00+00,6161,0,5588,11581,109,3910,2493,149,6126,0,36117,89,25897,23404,17816,6161
2021-06-11 12:30:00+00,6298,0,5576,11076,107,3914,2471,151,5659,0,35252,93,24889,22418,16842,6298
2021-06-11 13:00:00+00,6259,0,5571,10989,108,4010,2494,159,4849,0,34439,95,24011,21517,15946,6259
2021-06-11 13:30:00+00,6313,0,5573,10563,99,4010,2588,131,5083,0,34360,96,23906,21318,15745,6313
2021-06-11 14:00:00+00,6517,0,5595,10089,107,4012,2752,131,4944,0,34147,100,23487,20735,15140,6517
2021-06-11 14:30:00+00,7372,0,5690,9859,116,4010,2793,122,4067,0,34029,111,22525,19732,14042,7372
2021-06-11 15:00:00+00,7887,0,5698,9281,252,4034,2802,200,3765,168,34087,117,21798,18996,13298,7887
2021-06-11 15:30:00+00,8212,0,5704,9247,311,4034,2795,285,3056,424,34068,122,21113,18318,12614,8212
2021-06-11 16:00:00+00,8823,0,5704,9043,366,4108,2793,290,2556,694,34377,128,20462,17669,11965,8823
2021-06-11 16:30:00+00,8964,0,5703,9141,404,4110,2790,338,2281,714,34445,130,20319,17529,11826,8964
2021-06-11 17:00:00+00,8955,0,5697,8798,313,4230,2793,331,1853,996,33966,131,19454,16661,10964,8955
2021-06-11 17:30:00+00,9065,0,5698,8896,301,4232,2588,265,1417,1218,33680,132,18900,16312,10614,9065
2021-06-11 18:00:00+00,9107,0,5697,8724,274,4516,2591,246,1037,888,33080,137,18323,15732,10035,9107
2021-06-11 18:30:00+00,9349,0,5696,8258,273,4522,2651,221,711,666,32347,143,17589,14938,9242,9349
2021-06-11 19:00:00+00,9328,0,5693,7959,237,4258,2697,156,317,694,31339,146,16903,14206,8513,9328
2021-06-11 19:30:00+00,9830,0,5634,7255,223,4256,2708,146,113,568,30733,155,15933,13225,7591,9830
2021-06-11 20:00:00+00,10129,0,5557,6319,204,4304,2736,142,9,576,29976,163,14825,12089,6532,10129
2021-06-11 20:30:00+00,10068,0,5550,5828,314,4306,2393,197,0,482,29138,166,14085,11692,6142,10068
2021-06-11 21:00:00+00,9658,0,5542,5829,262,4306,2386,216,0,322,28521,164,14019,11633,6091,9658
2021-06-11 21:30:00+00,8925,0,5550,5683,133,4280,2327,257,0,490,27645,159,13693,11366,5816,8925
2021-06-11 22:00:00+00,8795,0,5548,5812,269,3160,2354,222,0,98,26258,156,13983,11629,6081,8795
2021-06-11 22:30:00+00,7866,0,5586,5861,156,3132,2322,143,0,0,25066,147,13925,11603,6017,7866
2021-06-11 23:00:00+00,6601,0,5747,6110,55,2928,2255,160,0,0,23856,133,14167,11912,6165,6601
2021-06-11 23:30:00+00,5593,0,5848,6292,51,2928,2173,161,0,0,23046,120,14364,12191,6343,5593
2021-06-12 00:00:00+00,5280,0,5852,6312,51,2928,2220,145,0,0,22788,114,14435,12215,6363,5280
2021-06-12 00:30:00+00,5200,0,5856,6249,51,2930,2172,140,0,0,22598,113,14328,12156,6300,5200
2021-06-12 01:00:00+00,4954,0,5814,6396,51,2922,2109,139,0,0,22385,109,14370,12261,6447,4954
2021-06-12 01:30:00+00,4991,0,5785,6000,51,2924,2101,141,0,0,21993,112,13937,11836,6051,4991
2021-06-12 02:00:00+00,5519,0,5788,5520,51,2924,2110,119,0,0,22031,121,13469,11359,5571,5519
2021-06-12 02:30:00+00,5393,0,5792,5503,51,2926,2149,100,0,0,21914,119,13495,11346,5554,5393
2021-06-12 03:00:00+00,4928,0,5793,5713,50,2922,2109,99,0,0,21614,112,13665,11556,5763,4928
2021-06-12 03:30:00+00,4584,0,5785,5524,50,2922,2193,100,0,0,21158,109,13552,11359,5574,4584
2021-06-12 04:00:00+00,4412,0,5790,5677,50,2864,2135,99,71,0,21098,105,13723,11588,5798,4412
2021-06-12 04:30:00+00,4554,0,5787,5745,51,2864,2111,100,305,0,21517,106,13999,11888,6101,4554
2021-06-12 05:00:00+00,4858,0,5790,5862,86,2854,2182,100,688,0,22420,107,14608,12426,6636,4858
2021-06-12 05:30:00+00,5188,0,5784,5751,99,2858,2249,100,1163,0,23192,109,15046,12797,7013,5188
2021-06-12 06:00:00+00,5882,0,5789,5882,114,2918,2282,101,1734,0,24702,113,15801,13519,7730,5882
2021-06-12 06:30:00+00,6372,0,5789,6090,114,2918,2332,102,2532,0,26249,114,16857,14525,8736,6372
2021-06-12 07:00:00+00,6238,0,5790,6455,182,3472,2349,121,3169,0,27776,112,17945,15596,9806,6238
2021-06-12 07:30:00+00,6197,0,5774,7048,202,3480,2253,106,3908,8,28976,106,19185,16932,11158,6197
2021-06-12 08:00:00+00,6279,0,5612,7354,202,3524,2244,103,4650,0,29968,104,20062,17818,12206,6279
2021-06-12 08:30:00+00,6377,0,5555,7357,199,3524,2267,104,5246,0,30629,103,20624,18357,12802,6377
2021-06-12 09:00:00+00,6582,0,5550,7228,199,3526,2282,150,5822,0,31339,104,21081,18799,13249,6582
2021-06-12 09:30:00+00,6656,0,5554,7038,199,3526,2315,155,6347,0,31790,104,21453,19138,13584,6656
2021-06-12 10:00:00+00,6418,0,5574,7063,166,3340,2335,129,7014,0,32039,99,22152,19817,14243,6418
2021-06-12 10:30:00+00,6105,0,5657,6942,164,3338,2312,104,7343,94,32059,95,22418,20106,14449,6105
2021-06-12 11:00:00+00,5657,0,5702,6998,149,3520,2281,101,7967,144,32519,88,23097,20816,15114,5657
2021-06-12 11:30:00+00,5393,0,5692,7043,148,3524,2241,101,8373,42,32557,85,23497,21256,15564,5393
2021-06-12 12:00:00+00,5056,0,5646,7162,132,3480,2121,99,8458,0,32154,81,23519,21398,15752,5056
2021-06-12 12:30:00+00,5220,0,5559,6954,132,3478,2111,140,8736,0,32330,83,23492,21381,15822,5220
2021-06-12 13:00:00+00,5065,0,5554,6758,132,3428,2078,153,8815,0,31983,82,23337,21259,15705,5065
2021-06-12 13:30:00+00,5186,0,5549,6207,144,3428,2015,136,8535,0,31200,85,22450,20435,14886,5186
2021-06-12 14:00:00+00,5066,0,5557,5969,162,3430,2262,102,7867,0,30415,86,21817,19555,13998,5066
2021-06-12 14:30:00+00,5409,0,5558,5751,164,3426,2167,101,7246,0,29822,92,20886,18719,13161,5409
2021-06-12 15:00:00+00,5784,0,5554,5355,164,3904,2174,102,6634,0,29671,99,19881,17707,12153,5784
2021-06-12 15:30:00+00,7071,0,5551,4910,169,3914,2320,106,5821,0,29862,116,18771,16451,10900,7071
2021-06-12 16:00:00+00,8866,0,5555,4680,267,3412,2384,262,4848,50,30324,133,17734,15350,9795,8866
2021-06-12 16:30:00+00,9886,0,5555,4527,274,3410,2368,337,3963,46,30366,147,16687,14319,8764,9886
2021-06-12 17:00:00+00,10283,0,5558,4381,320,3348,2387,393,3164,528,30362,151,15810,13423,7865,10283
2021-06-12 17:30:00+00,10551,0,5632,4147,351,3350,2387,416,2382,886,30102,156,14899,12512,6880,10551
2021-06-12 18:00:00+00,10566,0,5694,3707,418,3422,2394,426,1673,1182,29482,159,13886,11492,5798,10566
2021-06-12 18:30:00+00,10857,0,5695,3320,428,3424,2397,438,1062,1378,28999,166,12902,10505,4810,10857
2021-06-12 19:00:00+00,11079,0,5697,2970,417,3424,2396,523,549,1160,28215,175,12029,9633,3936,11079
2021-06-12 19:30:00+00,11118,0,5695,2825,397,3424,2393,502,167,1000,27521,179,11477,9084,3389,11118
2021-06-12 20:00:00+00,11116,0,5693,2848,371,3422,2403,397,12,672,26934,182,11327,8924,3231,11116
2021-06-12 20:30:00+00,11168,0,5725,2782,352,3418,2405,307,0,514,26671,184,11264,8859,3134,11168
2021-06-12 21:00:00+00,11003,0,5690,2904,348,3206,2393,209,0,618,26371,182,11335,8942,3252,11003
2021-06-12 21:30:00+00,10563,0,5692,3145,293,3198,2395,144,0,106,25536,180,11525,9130,3438,10563
2021-06-12 22:00:00+00,9311,0,5694,3324,212,3314,2261,108,0,0,24224,173,11491,9230,3536,9311
2021-06-12 22:30:00+00,8229,0,5694,3537,179,3326,2218,105,0,0,23288,162,11628,9410,3716,8229
2021-06-12 23:00:00+00,7774,0,5687,3501,117,3182,2208,100,0,0,22569,159,11513,9305,3618,7774
2021-06-12 23:30:00+00,7311,0,5685,3593,113,3180,2214,100,0,0,22196,153,11605,9391,3706,7311
2021-06-13 00:00:00+00,7084,0,5688,3709,91,3112,2228,99,0,0,22011,150,11716,9488,3800,7084
2021-06-13 00:30:00+00,6644,0,5739,3721,89,3110,2272,99,0,0,21674,145,11821,9549,3810,6644
2021-06-13 01:00:00+00,6243,0,5788,3812,71,2974,2264,100,0,0,21252,140,11935,9671,3883,6243
2021-06-13 01:30:00+00,5699,0,5782,3939,71,2972,2317,99,0,0,20879,133,12109,9792,4010,5699
2021-06-13 02:00:00+00,5302,0,5785,4176,71,2970,2330,99,0,0,20733,126,12362,10032,4247,5302
2021-06-13 02:30:00+00,5291,0,5783,4232,70,2970,2316,99,0,0,20761,126,12401,10085,4302,5291
2021-06-13 03:00:00+00,5416,0,5789,4206,70,3002,2266,99,0,0,20848,128,12331,10065,4276,5416
2021-06-13 03:30:00+00,5243,0,5791,3901,69,2972,2276,99,0,0,20351,127,12037,9761,3970,5243
2021-06-13 04:00:00+00,5435,0,5787,3794,69,2974,2300,99,47,0,20505,130,11997,9697,3910,5435
2021-06-13 04:30:00+00,5456,0,5787,3758,72,2974,2286,99,278,0,20710,129,12181,9895,4108,5456
2021-06-13 05:00:00+00,5617,0,5789,3661,114,2980,2284,99,658,0,21202,129,12506,10222,4433,5617
2021-06-13 05:30:00+00,5641,0,5790,3647,117,2980,2273,143,1128,0,21719,127,12955,10682,4892,5641
2021-06-13 06:00:00+00,5698,0,5793,3681,132,2982,2302,234,1735,0,22557,125,13643,11341,5548,5698
2021-06-13 06:30:00+00,5840,0,5793,3827,130,2980,2336,198,2406,0,23510,122,14492,12156,6363,5840
2021-06-13 07:00:00+00,6488,0,5791,3899,173,2978,2220,154,3044,0,24747,125,15127,12907,7116,6488
2021-06-13 07:30:00+00,6656,0,5792,4157,164,2978,2216,153,3792,0,25908,122,16121,13905,8113,6656
2021-06-13 08:00:00+00,6798,0,5794,4531,189,2976,2212,153,4518,0,27171,118,17244,15032,9238,6798
2021-06-13 08:30:00+00,6760,0,5795,4589,184,2976,2258,152,5320,0,28034,114,18146,15888,10093,6760
2021-06-13 09:00:00+00,6451,0,5802,4905,184,3320,2226,153,6128,0,29169,109,19245,17019,11217,6451
2021-06-13 09:30:00+00,5882,0,5798,5378,183,3566,2210,153,6751,0,29921,99,20320,18110,12312,5882
2021-06-13 10:00:00+00,5940,0,5796,5590,133,3328,2267,152,7301,0,30507,98,21087,18820,13024,5940
2021-06-13 10:30:00+00,5825,0,5796,5955,133,3330,2216,152,7697,0,31104,94,21797,19581,13785,5825
2021-06-13 11:00:00+00,5766,0,5793,6189,117,3332,2239,152,7988,0,31576,92,22326,20087,14294,5766
2021-06-13 11:30:00+00,5542,0,5790,6341,114,3330,2263,179,8098,0,31657,89,22606,20343,14553,5542
2021-06-13 12:00:00+00,5037,0,5786,6452,99,3522,2313,190,8016,0,31415,85,22666,20353,14567,5037
2021-06-13 12:30:00+00,4762,0,5782,6638,98,3526,2306,182,7732,0,31026,82,22556,20250,14468,4762
2021-06-13 13:00:00+00,4650,0,5792,6771,98,3528,2270,151,7440,0,30700,81,22371,20101,14309,4650
2021-06-13 13:30:00+00,4586,0,5863,6846,98,3528,2230,145,7206,0,30502,81,22243,20013,14150,4586
2021-06-13 14:00:00+00,4779,0,5871,6937,98,3530,2225,145,6791,0,30376,84,21922,19697,13826,4779
2021-06-13 14:30:00+00,5092,0,5882,6884,98,3528,2236,188,6260,0,30168,89,21360,19124,13242,5092
2021-06-13 15:00:00+00,5607,0,5886,7007,98,3716,2239,189,5682,0,30424,95,20912,18673,12787,5607
2021-06-13 15:30:00+00,6718,0,5890,7061,100,3720,2233,167,5013,0,30902,108,20297,18064,12174,6718
2021-06-13 16:00:00+00,7547,0,5892,6900,132,3900,2266,152,4215,0,31004,119,19405,17139,11247,7547
2021-06-13 16:30:00+00,8172,0,5894,6577,150,3902,2396,199,3488,218,30996,127,18505,16109,10215,8172
2021-06-13 17:00:00+00,8662,0,5900,6545,283,3826,2416,296,2824,292,31044,134,17968,15552,9652,8662
2021-06-13 17:30:00+00,8888,0,5899,6355,335,3828,2418,305,2119,744,30891,138,17126,14708,8809,8888
2021-06-13 18:00:00+00,9014,0,5899,6145,327,3866,2416,295,1501,1134,30597,141,16288,13872,7973,9014
2021-06-13 18:30:00+00,9197,0,5898,6201,333,3864,2417,260,963,1174,30307,144,15812,13395,7497,9197
2021-06-13 19:00:00+00,9346,0,5900,5865,351,3768,2419,253,512,1202,29616,149,15047,12628,6728,9346
2021-06-13 19:30:00+00,9315,0,5898,5594,348,3762,2414,239,175,1162,28907,152,14429,12015,6117,9315
2021-06-13 20:00:00+00,9501,0,5901,5521,323,3350,2414,228,2,1170,28410,153,14161,11747,5846,9501
2021-06-13 20:30:00+00,9562,0,5899,5313,301,3346,2404,234,0,970,28029,156,13917,11513,5614,9562
2021-06-13 21:00:00+00,9399,0,5901,5384,283,3752,2382,226,0,658,27985,157,13950,11568,5667,9399
2021-06-13 21:30:00+00,9008,0,5904,5578,280,3760,2329,198,0,46,27103,156,14091,11762,5858,9008
2021-06-13 22:00:00+00,8030,0,5903,5768,189,3064,2274,151,0,0,25379,147,14134,11860,5957,8030
2021-06-13 22:30:00+00,6630,0,5905,5749,178,3134,2272,151,0,0,24019,134,14104,11832,5927,6630
2021-06-13 23:00:00+00,5668,0,5909,5947,125,3000,2239,109,0,0,22997,120,14220,11981,6072,5668
2021-06-13 23:30:00+00,5261,0,5905,6245,124,2978,2219,101,0,0,22833,113,14493,12274,6369,5261
2021-06-14 00:00:00+00,4548,0,5900,6635,109,2976,2214,100,0,0,22482,104,14858,12644,6744,4548
2021-06-14 00:30:00+00,4061,0,5898,7039,109,2976,2210,99,0,0,22392,96,15256,13046,7148,4061
2021-06-14 01:00:00+00,3841,0,5894,7512,109,2944,2089,99,0,0,22488,91,15604,13515,7621,3841
2021-06-14 01:30:00+00,3688,0,5898,8019,108,2932,1752,99,0,0,22496,86,15777,14025,8127,3688
2021-06-14 02:00:00+00,3831,0,5897,8239,106,2458,1853,100,0,0,22484,85,16095,14242,8345,3831
2021-06-14 02:30:00+00,3508,0,5901,8718,105,2436,1875,100,0,0,22643,79,16599,14724,8823,3508
2021-06-14 03:00:00+00,3589,0,5895,8752,104,1802,1960,100,0,0,22202,80,16711,14751,8856,3589
2021-06-14 03:30:00+00,3542,0,5898,8797,103,1758,2149,98,0,0,22345,79,16947,14798,8900,3542
2021-06-14 04:00:00+00,4333,0,5896,8756,102,1014,2271,99,57,0,22528,95,17082,14811,8915,4333
2021-06-14 04:30:00+00,4625,0,5913,8691,104,1030,2241,98,265,0,22967,100,17214,14973,9060,4625
2021-06-14 05:00:00+00,4965,0,5904,9103,137,2008,2216,97,648,0,25078,94,18008,15792,9888,4965
2021-06-14 05:30:00+00,6491,0,5899,9297,156,2058,2375,99,1147,0,27522,108,18874,16499,10600,6491
2021-06-14 06:00:00+00,6819,0,5903,9309,182,3320,2407,99,1690,0,29729,111,19491,17084,11181,6819
2021-06-14 06:30:00+00,7361,0,5903,9642,195,3460,2394,100,2305,0,31360,114,20439,18045,12142,7361
2021-06-14 07:00:00+00,7637,0,5902,9181,198,4000,2400,100,2952,126,32496,116,20633,18233,12331,7637
2021-06-14 07:30:00+00,7771,0,5899,8997,207,4012,2419,103,3665,348,33421,115,21187,18768,12869,7771
2021-06-14 08:00:00+00,7889,0,5902,9107,190,4012,2424,104,4396,0,34024,114,22019,19595,13693,7889
2021-06-14 08:30:00+00,7804,0,5904,8862,169,4012,2428,102,5146,18,34445,112,22509,20081,14177,7804
2021-06-14 09:00:00+00,7836,0,5909,8674,117,4012,2420,102,5815,6,34891,111,22935,20515,14606,7836
2021-06-14 09:30:00+00,7710,0,5906,8662,96,4012,2421,102,6360,10,35279,108,23445,21024,15118,7710
2021-06-14 10:00:00+00,7405,0,5902,8722,96,4008,2426,108,6807,220,35694,104,23953,21527,15625,7405
2021-06-14 10:30:00+00,7391,0,5903,8844,96,4008,2404,159,7182,40,36027,103,24429,22025,16122,7391
2021-06-14 11:00:00+00,7583,0,5903,8607,96,4008,2415,138,7901,112,36763,103,24922,22507,16604,7583
2021-06-14 11:30:00+00,7417,0,5902,8570,96,4010,2434,157,7967,152,36705,101,24969,22535,16633,7417
2021-06-14 12:00:00+00,7259,0,5906,8575,96,4204,2429,220,7676,26,36391,102,24682,22253,16347,7259
2021-06-14 12:30:00+00,7501,0,5892,8458,97,4206,2432,155,7439,114,36294,104,24318,21886,15994,7501
2021-06-14 13:00:00+00,7492,0,5889,8345,137,4306,2432,210,6932,220,35963,106,23735,21303,15414,7492
2021-06-14 13:30:00+00,8021,0,5885,8247,136,4306,2434,187,6151,22,35389,113,22853,20419,14534,8021
2021-06-14 14:00:00+00,8447,0,5884,8095,136,4108,2437,396,5148,0,34651,120,21700,19263,13379,8447
2021-06-14 14:30:00+00,9166,0,5882,7966,146,4106,2426,464,4494,62,34712,129,20914,18488,12606,9166
2021-06-14 15:00:00+00,9839,0,5885,7938,136,4314,2434,422,4072,36,35076,136,20465,18031,12146,9839
2021-06-14 15:30:00+00,11067,0,5886,7802,148,4308,2309,366,3873,106,35865,146,20018,17709,11823,11067
2021-06-14 16:00:00+00,11942,0,5888,7510,215,3828,2337,382,3179,1006,36287,149,19129,16792,10904,11942
2021-06-14 16:30:00+00,11977,0,5890,7061,359,3820,2338,378,2510,1380,35713,151,18158,15820,9930,11977
2021-06-14 17:00:00+00,11855,0,5894,7183,400,4144,2381,371,1979,1188,35395,156,17837,15456,9562,11855
2021-06-14 17:30:00+00,11887,0,5896,6939,390,4158,2402,322,1394,1404,34792,159,17021,14619,8723,11887
2021-06-14 18:00:00+00,11697,0,5901,6747,393,4290,2408,231,980,1578,34225,160,16429,14021,8120,11697
2021-06-14 18:30:00+00,11745,0,5899,6338,280,4292,2402,219,705,1540,33420,164,15624,13222,7323,11745
2021-06-14 19:00:00+00,11616,0,5899,5999,252,4448,2393,310,450,1408,32775,167,14993,12600,6701,11616
2021-06-14 19:30:00+00,11727,0,5897,5757,227,4422,2417,216,174,1174,32011,172,14472,12055,6158,11727
2021-06-14 20:00:00+00,12234,0,5895,5314,168,3732,2427,264,21,1054,31109,175,13825,11398,5503,12234
2021-06-14 20:30:00+00,12039,0,5893,4923,230,3704,2419,280,0,814,30302,176,13465,11046,5153,12039
2021-06-14 21:00:00+00,11939,0,5886,4654,204,4000,2135,175,0,816,29809,181,12879,10744,4858,11939
2021-06-14 21:30:00+00,11613,0,5892,4359,106,3996,2167,129,0,58,28320,186,12524,10357,4465,11613
2021-06-14 22:00:00+00,10697,0,5890,3882,105,3410,2383,114,0,128,26609,181,12260,9877,3987,10697
2021-06-14 22:30:00+00,9985,0,5893,3662,92,3398,2274,113,0,0,25417,178,11921,9647,3754,9985
2021-06-14 23:00:00+00,9935,0,5894,3436,41,3202,2395,113,0,0,25016,180,11766,9371,3477,9935
2021-06-14 23:30:00+00,9499,0,5893,3065,40,3198,2456,113,0,0,24264,179,11454,8998,3105,9499
2021-06-15 00:00:00+00,9070,0,5894,2718,39,3254,2463,113,0,0,23551,178,11114,8651,2757,9070
2021-06-15 00:30:00+00,9118,0,5891,2444,37,3256,2461,105,0,0,23312,181,10832,8372,2480,9118
2021-06-15 01:00:00+00,9118,0,5888,2307,47,3254,2460,93,0,0,23167,182,10702,8242,2354,9118
2021-06-15 01:30:00+00,9168,0,5889,2164,36,3254,2467,93,0,0,23071,184,10556,8089,2200,9168
2021-06-15 02:00:00+00,9063,0,5889,1956,35,3256,2471,93,0,0,22763,184,10351,7880,1991,9063
2021-06-15 02:30:00+00,9216,0,5888,1655,34,3256,2469,93,0,0,22611,188,10046,7577,1689,9216
2021-06-15 03:00:00+00,9323,0,5894,1452,34,3256,2471,93,0,0,22523,191,9851,7380,1486,9323
2021-06-15 03:30:00+00,9069,0,5894,1348,34,3256,2470,93,1,0,22165,189,9747,7277,1383,9069
2021-06-15 04:00:00+00,8827,0,5898,1247,50,3240,2462,93,94,0,21911,187,9751,7289,1391,8827
2021-06-15 04:30:00+00,9372,25,5902,1074,53,3259,2456,93,346,0,22580,192,9831,7375,1473,9397
2021-06-15 05:00:00+00,10902,63,5898,1004,88,3438,2394,99,660,0,24546,202,10044,7650,1752,10965
2021-06-15 05:30:00+00,12030,122,5899,876,221,3538,2452,245,1202,130,26715,208,10650,8198,2299,12152
2021-06-15 06:00:00+00,12551,180,5898,852,178,4410,2471,292,1929,308,29069,209,11328,8857,2959,12731
2021-06-15 06:30:00+00,12676,261,5901,863,453,4458,2411,344,2593,580,30540,204,12221,9810,3909,12937
2021-06-15 07:00:00+00,12596,274,5902,957,457,4512,2453,352,3377,844,31724,196,13146,10693,4791,12870
2021-06-15 07:30:00+00,12459,283,5899,1133,344,4496,2461,286,4256,802,32419,189,14093,11632,5733,12742
2021-06-15 08:00:00+00,12469,282,5897,1261,387,4278,2446,311,4990,784,33105,183,14981,12535,6638,12751
2021-06-15 08:30:00+00,12417,288,5895,1480,304,4228,2467,300,5839,324,33542,180,15985,13518,7623,12705
2021-06-15 09:00:00+00,12256,324,5895,1855,192,4346,2402,170,6554,122,34116,175,16898,14496,8601,12580
2021-06-15 09:30:00+00,11851,336,5884,2333,123,4260,2449,141,7039,36,34452,168,17828,15379,9495,12187
2021-06-15 10:00:00+00,11038,365,5885,2910,70,4172,2403,97,7584,0,34524,158,18852,16449,10564,11403
2021-06-15 10:30:00+00,10314,359,5881,2968,70,4128,2418,87,8174,0,34399,149,19511,17093,11212,10673
2021-06-15 11:00:00+00,10069,361,5878,4142,69,3994,2391,94,8472,4,35474,142,20952,18561,12683,10430
2021-06-15 11:30:00+00,9598,351,5886,4553,69,3918,2451,94,8971,8,35899,135,21930,19479,13593,9949
2021-06-15 12:00:00+00,9500,360,5877,5075,69,3314,2457,95,8961,0,35708,140,22439,19982,14105,9860
2021-06-15 12:30:00+00,9075,335,5877,5608,72,3172,2454,123,8797,0,35513,135,22808,20354,14477,9410
2021-06-15 13:00:00+00,9449,308,5872,5859,84,2278,2415,94,8625,0,34984,138,22855,20440,14568,9757
2021-06-15 13:30:00+00,9592,330,5865,6250,84,2164,2333,101,8230,0,34948,139,22762,20428,14564,9922
2021-06-15 14:00:00+00,9700,325,5856,6513,84,1674,2366,211,7771,0,34500,138,22590,20224,14368,10025
2021-06-15 14:30:00+00,9542,315,5859,6733,84,1874,2362,292,7048,0,34109,141,22086,19724,13865,9857
2021-06-15 15:00:00+00,9592,310,5846,7151,130,2518,2377,381,6116,0,34421,145,21620,19243,13397,9902
2021-06-15 15:30:00+00,10117,350,5792,7297,136,2618,2457,445,5433,0,34645,153,21115,18658,12866,10467
2021-06-15 16:00:00+00,9829,320,5486,7279,208,4408,2328,387,4470,26,34741,152,19771,17443,11957,10149
2021-06-15 16:30:00+00,10251,304,5483,7440,251,4618,2434,354,3468,76,34679,159,19076,16642,11159,10555
2021-06-15 17:00:00+00,10353,234,5486,7497,298,4498,2460,376,2852,422,34476,159,18593,16133,10647,10587
2021-06-15 17:30:00+00,10332,282,5489,7773,336,4536,2468,345,2221,444,34226,162,18287,15819,10330,10614
2021-06-15 18:00:00+00,10596,287,5491,8131,250,4156,2469,324,1640,438,33782,165,17981,15512,10021,10883
2021-06-15 18:30:00+00,10808,299,5491,8300,239,4032,2425,345,1077,394,33410,169,17532,15107,9616,11107
2021-06-15 19:00:00+00,11150,268,5491,8417,208,3082,2463,426,601,394,32500,171,17180,14717,9226,11418
2021-06-15 19:30:00+00,11261,1,5484,8718,185,2956,2474,388,190,0,31657,167,17051,14577,9093,11262
2021-06-15 20:00:00+00,11236,0,5486,8843,169,2068,2467,385,18,10,30682,165,16983,14516,9030,11236
2021-06-15 20:30:00+00,10959,0,5484,8901,152,2004,2464,196,0,0,30160,161,17001,14537,9053,10959
2021-06-15 21:00:00+00,10252,0,5482,8878,118,2038,2470,127,0,32,29397,155,16948,14478,8996,10252
2021-06-15 21:30:00+00,9021,0,5489,8933,100,2054,2469,130,0,0,28196,144,16991,14522,9033,9021
2021-06-15 22:00:00+00,6832,0,5491,8870,96,3088,2469,100,0,0,26946,125,16926,14457,8966,6832
2021-06-15 22:30:00+00,5705,0,5485,8645,73,3126,2464,99,0,0,25597,114,16667,14203,8718,5705
2021-06-15 23:00:00+00,5782,0,5490,8386,36,2800,2419,99,0,0,25012,116,16331,13912,8422,5782
2021-06-15 23:30:00+00,5569,0,5487,8293,34,2776,2268,99,0,0,24526,113,16082,13814,8327,5569
2021-06-16 00:00:00+00,4809,0,5499,8594,35,2872,2399,100,0,0,24308,103,16527,14128,8629,4809
2021-06-16 00:30:00+00,4522,0,5520,8581,39,2870,2448,99,0,0,24079,99,16588,14140,8620,4522
2021-06-16 01:00:00+00,4218,0,5520,8488,39,2858,2453,99,0,0,23675,94,16500,14047,8527,4218
2021-06-16 01:30:00+00,4154,0,5516,8465,38,2856,2287,99,0,0,23415,94,16306,14019,8503,4154
2021-06-16 02:00:00+00,4103,0,5517,8457,33,2798,2284,100,0,0,23292,95,16291,14007,8490,4103
2021-06-16 02:30:00+00,3929,0,5518,8560,33,2794,2354,99,0,0,23287,92,16465,14111,8593,3929
2021-06-16 03:00:00+00,3695,0,5521,8502,33,2826,2328,101,0,0,23006,89,16384,14056,8535,3695
2021-06-16 03:30:00+00,3673,0,5525,8254,33,2826,2257,101,0,0,22669,90,16069,13812,8287,3673
2021-06-16 04:00:00+00,3733,0,5524,8076,95,2426,2118,100,71,0,22143,92,15884,13766,8242,3733
2021-06-16 04:30:00+00,4502,0,5531,7674,112,2603,2151,100,313,0,22986,107,15781,13630,8099,4502
2021-06-16 05:00:00+00,6556,0,5532,7454,133,2410,2378,100,657,0,25220,132,16154,13776,8244,6556
2021-06-16 05:30:00+00,8565,0,5533,7128,136,2354,2273,101,1271,0,27361,150,16341,14068,8535,8565
2021-06-16 06:00:00+00,10475,0,5529,6645,183,2874,2150,104,1943,216,30119,160,16450,14300,8771,10475
2021-06-16 06:30:00+00,11539,0,5533,6183,207,2870,2357,192,2600,258,31739,166,16880,14523,8990,11539
2021-06-16 07:00:00+00,11634,0,5534,5911,219,3826,2394,204,3473,20,33215,164,17531,15137,9603,11634
2021-06-16 07:30:00+00,11767,0,5533,5501,199,3848,2420,204,4359,0,33831,163,18012,15592,10059,11767
2021-06-16 08:00:00+00,11769,0,5534,5164,178,4064,2479,205,5233,88,34714,160,18588,16109,10575,11769
2021-06-16 08:30:00+00,11706,0,5535,4740,233,4080,2426,272,6048,196,35236,157,18982,16556,11021,11706
2021-06-16 09:00:00+00,11747,0,5540,4311,226,4144,2414,282,6779,6,35449,157,19270,16856,11316,11747
2021-06-16 09:30:00+00,11863,0,5537,3940,186,4138,2387,282,7395,314,36042,156,19445,17058,11521,11863
2021-06-16 10:00:00+00,11736,0,5555,3938,182,4492,2340,186,7906,150,36485,152,19921,17581,12026,11736
2021-06-16 10:30:00+00,11717,0,5573,4063,158,4504,2316,207,8260,44,36842,151,20370,18054,12481,11717
2021-06-16 11:00:00+00,11881,0,5583,4130,227,4524,2200,245,8455,186,37431,150,20595,18395,12812,11881
2021-06-16 11:30:00+00,11857,0,5603,4217,238,4524,2198,272,8457,0,37366,150,20713,18515,12912,11857
2021-06-16 12:00:00+00,11979,0,5611,4408,156,4442,2205,238,8199,0,37238,151,20579,18374,12763,11979
2021-06-16 12:30:00+00,11749,0,5628,4632,149,4442,2145,231,8089,0,37065,149,20643,18498,12870,11749
2021-06-16 13:00:00+00,11849,0,5650,4859,148,3830,2172,234,7891,8,36641,151,20720,18548,12898,11849
2021-06-16 13:30:00+00,11966,0,5656,5106,128,3818,2140,186,7380,38,36418,153,20410,18270,12614,11966
2021-06-16 14:00:00+00,12443,0,5664,5247,91,3460,1980,145,6576,4,35610,161,19558,17578,11914,12443
2021-06-16 14:30:00+00,12845,0,5675,5347,94,3464,2127,198,5700,182,35632,167,18943,16816,11141,12845
2021-06-16 15:00:00+00,13049,0,5689,5397,114,4342,2176,177,5429,116,36489,166,18805,16629,10940,13049
2021-06-16 15:30:00+00,13726,0,5685,5282,183,4374,2239,265,4724,266,36744,173,18113,15874,10189,13726
2021-06-16 16:00:00+00,13940,0,5690,5129,264,4548,2259,355,3918,582,36685,176,17260,15001,9311,13940
2021-06-16 16:30:00+00,14049,0,5692,5043,293,4554,2280,391,3179,958,36439,180,16487,14207,8515,14049
2021-06-16 17:00:00+00,14086,0,5696,4685,306,4558,2277,398,2322,1216,35544,185,15286,13009,7313,14086
2021-06-16 17:30:00+00,14117,0,5699,4385,307,4562,2212,399,1714,1210,34605,190,14317,12105,6406,14117
2021-06-16 18:00:00+00,14298,0,5698,4090,308,4564,2209,400,1299,1636,34502,192,13604,11395,5697,14298
2021-06-16 18:30:00+00,14342,0,5704,3836,304,4564,2228,399,672,1358,33407,199,12744,10516,4812,14342
2021-06-16 19:00:00+00,14316,0,5707,3735,268,4564,2224,397,365,1086,32662,203,12299,10075,4368,14316
2021-06-16 19:30:00+00,14413,0,5703,3149,230,4560,2241,395,135,980,31806,210,11458,9217,3514,14413
2021-06-16 20:00:00+00,14350,0,5702,2786,205,4273,2255,346,12,1238,31167,210,10960,8705,3003,14350
2021-06-16 20:30:00+00,14503,0,5709,2571,199,4270,2317,295,0,576,30440,217,10796,8479,2770,14503
2021-06-16 21:00:00+00,14571,0,5709,2321,224,3938,2315,214,0,456,29748,218,10569,8254,2545,14571
2021-06-16 21:30:00+00,14039,0,5706,2143,235,3927,2319,154,0,122,28645,218,10403,8084,2378,14039
2021-06-16 22:00:00+00,12880,0,5704,2257,233,3502,2315,151,0,76,27118,212,10509,8194,2490,12880
2021-06-16 22:30:00+00,11788,0,5698,2033,178,3486,2318,142,0,0,25643,206,10227,7909,2211,11788
2021-06-16 23:00:00+00,11073,0,5701,2301,72,3478,2315,139,0,0,25079,199,10389,8074,2373,11073
2021-06-16 23:30:00+00,10235,0,5700,2394,57,3474,2320,139,0,0,24319,192,10471,8151,2451,10235
2021-06-17 00:00:00+00,10029,0,5701,2292,53,3328,2321,139,0,0,23863,192,10367,8046,2345,10029
2021-06-17 00:30:00+00,10108,0,5701,2370,55,3328,2320,139,0,0,24022,192,10446,8126,2425,10108
2021-06-17 01:00:00+00,10026,0,5702,2184,56,3328,2324,139,0,0,23759,192,10266,7942,2240,10026
2021-06-17 01:30:00+00,9812,0,5699,1825,56,3328,2312,139,0,0,23171,194,9892,7580,1881,9812
2021-06-17 02:00:00+00,9719,0,5700,1838,55,3326,2363,139,0,0,23140,193,9956,7593,1893,9719
2021-06-17 02:30:00+00,9661,0,5700,1693,55,3326,2334,139,0,0,22908,193,9782,7448,1748,9661
2021-06-17 03:00:00+00,9623,0,5698,1799,55,3326,2328,139,0,0,22968,192,9880,7552,1854,9623
2021-06-17 03:30:00+00,9490,45,5701,1890,55,3326,2330,139,0,0,22976,192,9976,7646,1945,9535
2021-06-17 04:00:00+00,9617,90,5710,1792,55,3420,2334,139,11,0,23168,194,9902,7568,1858,9707
2021-06-17 04:30:00+00,9790,285,5714,1603,73,3418,2329,139,81,0,23432,203,9800,7471,1757,10075
2021-06-17 05:00:00+00,10489,408,5715,1613,179,3176,2335,140,245,0,24300,212,10087,7752,2037,10897
2021-06-17 05:30:00+00,11281,493,5711,1483,201,3168,2296,147,401,98,25279,219,10092,7796,2085,11774
2021-06-17 06:00:00+00,12487,693,5713,1380,401,4466,2263,277,590,382,28651,226,10347,8084,2371,13180
2021-06-17 06:30:00+00,13533,767,5713,1624,551,4502,2251,444,865,638,30888,227,11004,8753,3040,14300
2021-06-17 07:00:00+00,14457,791,5718,1677,669,4502,2249,479,1232,1374,33148,224,11545,9296,3578,15248
2021-06-17 07:30:00+00,14938,822,5716,1693,664,4500,2247,476,1630,1246,33932,225,11950,9703,3987,15760
2021-06-17 08:00:00+00,15234,834,5718,1663,650,4546,2283,521,2080,1028,34557,226,12394,10111,4393,16068
2021-06-17 08:30:00+00,15384,756,5714,1744,628,4550,2287,512,2695,684,34954,223,13068,10781,5067,16140
2021-06-17 09:00:00+00,15463,722,5711,1760,632,4548,2276,486,3265,524,35387,220,13644,11368,5657,16185
2021-06-17 09:30:00+00,15391,700,5709,1723,571,4546,2258,481,3992,442,35813,215,14253,11995,6286,16091
2021-06-17 10:00:00+00,15339,721,5724,2064,423,4558,2283,390,4423,30,35955,214,14917,12634,6910,16060
2021-06-17 10:30:00+00,15195,544,5722,2351,142,4558,2311,277,4612,0,35711,209,15138,12827,7105,15739
2021-06-17 11:00:00+00,15096,499,5718,2937,106,4560,2313,250,5062,0,36541,201,16136,13823,8105,15595
2021-06-17 11:30:00+00,15138,473,5706,2971,105,4550,2289,208,4863,186,36489,201,15934,13645,7939,15611
2021-06-17 12:00:00+00,15319,441,5714,2700,90,4300,2285,184,4631,124,35788,205,15420,13135,7421,15760
2021-06-17 12:30:00+00,15320,476,5706,2593,90,4286,2310,147,4567,0,35495,207,15266,12956,7250,15796
2021-06-17 13:00:00+00,15339,492,5707,2393,91,3594,2283,137,4810,126,34972,210,15284,13001,7294,15831
2021-06-17 13:30:00+00,15268,418,5721,2458,90,3572,2289,143,4082,128,34169,212,14640,12351,6630,15686
2021-06-17 14:00:00+00,15194,286,5758,2606,89,4040,2262,142,3702,160,34239,208,14417,12155,6397,15480
2021-06-17 14:30:00+00,15382,465,5758,2770,88,4058,2264,143,3377,0,34305,214,14257,11993,6235,15847
2021-06-17 15:00:00+00,15468,498,5752,3011,87,4502,2230,231,2942,0,34721,215,14022,11792,6040,15966
2021-06-17 15:30:00+00,15617,497,5741,3125,94,4592,2291,285,2682,0,34924,217,13933,11642,5901,16114
2021-06-17 16:00:00+00,15570,495,5739,3141,264,4650,2298,292,2283,212,34944,217,13725,11427,5688,16065
2021-06-17 16:30:00+00,15561,496,5743,3152,519,4606,2261,362,1693,464,34857,217,13368,11107,5364,16057
2021-06-17 17:00:00+00,15762,494,5750,3146,556,4322,2259,377,1483,664,34813,218,13194,10935,5185,16256
2021-06-17 17:30:00+00,15566,494,5746,3145,369,4410,2367,371,1284,550,34302,221,12911,10544,4798,16060
2021-06-17 18:00:00+00,15604,494,5751,3125,303,4240,2379,343,918,508,33665,222,12476,10097,4346,16098
2021-06-17 18:30:00+00,15552,495,5757,3141,315,4250,2381,332,577,238,33038,225,12171,9790,4033,16047
2021-06-17 19:00:00+00,15357,495,5757,3279,245,4008,2384,328,318,52,32223,229,11983,9599,3842,15852
2021-06-17 19:30:00+00,14957,493,5756,3502,208,3916,2336,327,118,100,31713,226,11920,9584,3828,15450
2021-06-17 20:00:00+00,14999,496,5761,3581,420,3036,2386,322,17,16,31034,228,12165,9779,4018,15495
2021-06-17 20:30:00+00,14813,400,5764,3813,200,3016,2388,248,0,0,30642,225,12165,9777,4013,15213
2021-06-17 21:00:00+00,14286,49,5781,4170,288,2588,2385,186,0,8,29741,215,12624,10239,4458,14335
2021-06-17 21:30:00+00,13228,0,5786,4385,132,2520,2388,139,0,0,28578,206,12691,10303,4517,13228
2021-06-17 22:00:00+00,10292,0,5785,4623,90,3388,2386,140,0,0,26704,175,12884,10498,4713,10292
2021-06-17 22:30:00+00,8300,0,5783,4985,81,3476,2426,139,0,0,25190,156,13275,10849,5066,8300
2021-06-17 23:00:00+00,7891,0,5783,5272,52,3028,2447,140,0,0,24613,151,13554,11107,5324,7891
2021-06-17 23:30:00+00,7477,0,5775,5110,52,3120,2453,139,0,0,24126,150,13390,10937,5162,7477
2021-06-18 00:00:00+00,7404,0,5775,4893,52,3020,2458,139,0,0,23741,148,13178,10720,4945,7404
2021-06-18 00:30:00+00,7464,0,5785,4632,52,3010,2458,139,0,0,23540,150,12927,10469,4684,7464
2021-06-18 01:00:00+00,7417,0,5791,4540,52,2982,2458,139,0,0,23379,150,12841,10383,4592,7417
2021-06-18 01:30:00+00,7306,0,5784,4206,52,2982,2463,140,0,0,22933,151,12505,10042,4258,7306
2021-06-18 02:00:00+00,7370,0,5783,4110,51,2954,2464,139,0,0,22871,153,12408,9944,4161,7370
2021-06-18 02:30:00+00,7461,0,5784,3982,51,2952,2461,139,0,0,22830,154,12278,9817,4033,7461
2021-06-18 03:00:00+00,7465,0,5779,3901,51,2846,2449,139,0,0,22630,156,12180,9731,3952,7465
2021-06-18 03:30:00+00,7311,69,5776,4164,49,2832,2423,139,0,0,22763,155,12412,9989,4213,7380
2021-06-18 04:00:00+00,7169,138,5786,4434,48,2506,2298,139,28,0,22546,155,12594,10296,4510,7307
2021-06-18 04:30:00+00,7734,290,5781,4644,67,2434,2101,139,152,0,23342,163,12745,10644,4863,8024
2021-06-18 05:00:00+00,9823,420,5778,4884,187,1176,2304,140,324,0,25036,185,13477,11173,5395,10243
2021-06-18 05:30:00+00,11143,613,5775,5110,217,1188,2447,141,536,0,27170,197,14085,11638,5863,11756
2021-06-18 06:00:00+00,11567,763,5780,5523,267,3062,2427,148,830,0,30367,195,14827,12400,6620,12330
2021-06-18 06:30:00+00,12271,754,5782,6136,289,3158,2463,173,1262,54,32342,192,15932,13469,7687,13025
2021-06-18 07:00:00+00,12414,743,5776,6287,305,4464,2259,175,1546,428,34397,187,16173,13914,8138,13157
2021-06-18 07:30:00+00,12655,781,5783,6451,305,4500,2323,252,1788,30,34868,189,16650,14327,8544,13436
2021-06-18 08:00:00+00,12629,725,5777,6507,305,4558,2462,207,2213,342,35725,184,17264,14802,9025,13354
2021-06-18 08:30:00+00,12852,771,5779,6441,292,4558,2465,149,2698,272,36277,184,17675,15210,9431,13623
2021-06-18 09:00:00+00,13026,773,5783,6377,179,4544,2463,144,2890,340,36519,185,17692,15229,9446,13799
2021-06-18 09:30:00+00,12944,698,5787,6492,150,4544,2461,142,3106,206,36530,182,17996,15535,9748,13642
2021-06-18 10:00:00+00,13046,725,5801,6549,110,4540,2395,141,3267,120,36694,183,18122,15727,9926,13771
2021-06-18 10:30:00+00,13261,759,5801,6374,108,4356,2468,146,3294,104,36671,184,18045,15577,9776,14020
2021-06-18 11:00:00+00,13597,726,5784,6452,97,3562,2469,318,3389,508,36902,184,18191,15722,9938,14323
2021-06-18 11:30:00+00,13619,726,5785,6244,95,3486,2469,299,3509,582,36814,184,18102,15633,9848,14345
2021-06-18 12:00:00+00,13610,771,5791,6131,90,3486,2462,313,3166,404,36224,188,17640,15178,9387,14381
2021-06-18 12:30:00+00,13372,758,5792,6367,77,3486,2447,351,2973,158,35781,187,17656,15209,9417,14130
2021-06-18 13:00:00+00,13178,772,5789,6534,77,3463,2310,340,2877,156,35496,186,17587,15277,9488,13950
2021-06-18 13:30:00+00,13249,753,5790,6674,79,3448,2278,199,2642,0,35112,187,17463,15185,9395,14002
2021-06-18 14:00:00+00,13166,726,5787,6848,90,3417,2221,167,2372,0,34794,187,17318,15097,9310,13892
2021-06-18 14:30:00+00,13247,679,5783,6998,133,3418,2288,168,2115,0,34829,186,17317,15029,9246,13926
2021-06-18 15:00:00+00,12943,572,5784,6839,135,4272,2376,174,2005,58,35158,179,17139,14763,8979,13515
2021-06-18 15:30:00+00,13461,650,5778,6547,157,4353,2379,174,1725,0,35223,187,16586,14207,8429,14111
2021-06-18 16:00:00+00,13684,749,5777,6342,283,4472,2372,160,1480,0,35319,192,16254,13882,8105,14433
2021-06-18 16:30:00+00,13475,740,5776,6262,316,4476,2390,210,1245,86,34976,191,15989,13599,7823,14215
2021-06-18 17:00:00+00,13445,655,5778,6124,341,4505,2380,202,1034,368,34831,190,15656,13276,7498,14100
2021-06-18 17:30:00+00,13306,558,5780,6054,334,4511,2413,215,699,408,34278,189,15280,12867,7087,13864
2021-06-18 18:00:00+00,13182,468,5782,5985,339,4509,2468,209,439,460,33840,188,15013,12545,6763,13650
2021-06-18 18:30:00+00,12704,438,5778,5796,340,4510,2466,209,280,278,32798,187,14660,12194,6416,13142
2021-06-18 19:00:00+00,11943,353,5774,5612,270,4445,2464,213,181,130,31386,183,14301,11837,6063,12296
2021-06-18 19:30:00+00,11679,405,5781,5410,232,4430,2460,209,80,172,30858,184,13963,11503,5722,12084
2021-06-18 20:00:00+00,11465,355,5782,5282,163,4333,2462,154,12,54,30062,184,13701,11239,5457,11820
2021-06-18 20:30:00+00,10984,39,5784,5278,141,4314,2452,139,0,28,29160,173,13655,11203,5419,11023
2021-06-18 21:00:00+00,11175,20,5787,5274,90,3862,2436,141,0,0,28784,176,13587,11151,5364,11194
2021-06-18 21:30:00+00,10525,0,5789,5080,96,3830,2100,141,0,0,27561,172,13065,10965,5176,10525
2021-06-18 22:00:00+00,10386,0,5797,5142,91,3141,1773,140,0,54,26524,174,12803,11030,5233,10386
2021-06-18 22:30:00+00,8846,0,5798,5245,90,3120,1768,139,0,0,25006,160,12901,11133,5335,8846
2021-06-18 23:00:00+00,7571,0,5794,5442,90,3095,1767,141,0,0,23900,146,13093,11326,5532,7571
2021-06-18 23:30:00+00,6723,0,5795,5503,90,3100,1770,141,0,0,23122,136,13158,11388,5593,6723
2021-06-19 00:00:00+00,6760,0,5796,5269,89,3102,1768,139,0,0,22923,138,12922,11154,5358,6760
2021-06-19 00:30:00+00,6616,0,5799,5042,88,3102,1757,140,0,0,22544,138,12686,10929,5130,6616
2021-06-19 01:00:00+00,6519,0,5796,4800,87,3102,1764,139,0,0,22207,138,12447,10683,4887,6519
2021-06-19 01:30:00+00,6484,0,5797,4587,86,3102,1770,141,0,0,21967,139,12240,10470,4673,6484
2021-06-19 02:00:00+00,6425,0,5801,4257,85,3106,1773,142,0,0,21589,140,11916,10143,4342,6425
2021-06-19 02:30:00+00,6551,0,5805,4065,85,3106,1773,140,0,0,21525,143,11728,9955,4150,6551
2021-06-19 03:00:00+00,6568,0,5802,3809,85,3106,1775,140,0,0,21285,145,11471,9696,3894,6568
2021-06-19 03:30:00+00,6741,0,5803,3373,86,3108,1774,140,0,0,21025,150,11036,9262,3459,6741
2021-06-19 04:00:00+00,6954,0,5809,2995,97,3106,1690,147,23,0,20821,155,10614,8924,3115,6954
2021-06-19 04:30:00+00,7381,0,5806,2591,96,3106,1688,202,150,0,21020,163,10331,8643,2837,7381
2021-06-19 05:00:00+00,8014,133,5808,2391,97,3106,1769,178,437,0,21933,173,10502,8733,2925,8147
2021-06-19 05:30:00+00,8672,336,5805,2109,101,3132,1773,169,819,20,22936,185,10607,8834,3029,9008
2021-06-19 06:00:00+00,9253,323,5809,2051,156,3878,1765,218,1231,0,24684,186,11012,9247,3438,9576
2021-06-19 06:30:00+00,10331,238,5806,2188,154,3892,1705,167,1566,132,26178,188,11418,9714,3908,10569
2021-06-19 07:00:00+00,11372,369,5807,2077,221,4112,1678,193,1893,270,27992,195,11676,9998,4191,11741
2021-06-19 07:30:00+00,12178,491,5803,2062,226,4120,1692,223,2246,306,29347,201,12029,10337,4534,12669
2021-06-19 08:00:00+00,12484,495,5807,1976,280,4310,1709,233,2643,414,30351,200,12415,10706,4899,12979
2021-06-19 08:30:00+00,12501,495,5806,2049,291,4312,1770,248,2832,282,30586,199,12748,10978,5172,12996
2021-06-19 09:00:00+00,12261,493,5809,2153,294,4542,1771,250,3128,256,30957,195,13155,11384,5575,12754
2021-06-19 09:30:00+00,12319,491,5805,2139,295,4546,1775,235,3259,274,31138,194,13273,11498,5693,12810
2021-06-19 10:00:00+00,12189,489,5806,2082,294,4750,1771,237,3459,150,31227,194,13412,11641,5835,12678
2021-06-19 10:30:00+00,12017,492,5806,2150,263,4748,1768,214,3733,94,31285,191,13720,11952,6146,12509
2021-06-19 11:00:00+00,12238,491,5805,2259,153,4463,1770,197,4252,0,31628,190,14239,12469,6664,12729
2021-06-19 11:30:00+00,12274,490,5801,2377,152,4462,1768,222,4213,0,31759,190,14311,12543,6742,12764
2021-06-19 12:00:00+00,12121,344,5806,2503,94,4365,1771,186,4294,44,31528,183,14468,12697,6891,12465
2021-06-19 12:30:00+00,11807,332,5806,2630,90,4366,1758,164,4168,0,31121,181,14452,12694,6888,12139
2021-06-19 13:00:00+00,11315,334,5806,2871,98,4279,1741,168,4036,0,30648,178,14552,12811,7005,11649
2021-06-19 13:30:00+00,10954,334,5804,2976,104,4284,1717,153,3689,0,30015,177,14290,12573,6769,11288
2021-06-19 14:00:00+00,10831,332,5805,3112,104,4543,1620,142,3742,0,30231,174,14383,12763,6958,11163
2021-06-19 14:30:00+00,10758,296,5806,3299,96,4550,1604,142,3560,0,30111,172,14365,12761,6955,11054
2021-06-19 15:00:00+00,10743,283,5805,3521,158,4773,1613,143,3010,0,30049,175,14107,12494,6689,11026
2021-06-19 15:30:00+00,11008,395,5800,3729,176,4790,1630,143,2529,26,30226,181,13864,12234,6434,11403
2021-06-19 16:00:00+00,11237,429,5797,3879,280,4770,1698,178,2202,502,30971,181,13856,12158,6361,11666
2021-06-19 16:30:00+00,11372,441,5797,4115,303,4765,1706,219,1882,644,31244,182,13803,12097,6300,11813
2021-06-19 17:00:00+00,11456,434,5798,4246,308,4765,1706,229,1472,596,31010,184,13530,11824,6026,11890
2021-06-19 17:30:00+00,11520,446,5791,4217,315,4759,1661,261,1100,556,30626,187,13084,11423,5632,11966
2021-06-19 18:00:00+00,11819,458,5794,4093,300,4463,1768,229,703,562,30189,193,12658,10890,5096,12277
2021-06-19 18:30:00+00,11516,488,5795,4499,283,4450,1794,205,433,448,29912,192,12804,11010,5215,12004
2021-06-19 19:00:00+00,11326,464,5798,4968,216,4444,1800,212,283,22,29533,191,13065,11265,5467,11790
2021-06-19 19:30:00+00,11145,452,5804,4854,127,4444,1794,149,99,0,28868,192,12678,10884,5080,11597
2021-06-19 20:00:00+00,10814,436,5815,5114,81,4406,1798,141,20,0,28625,188,12828,11030,5215,11250
2021-06-19 20:30:00+00,10075,341,5801,5740,75,4406,1757,140,0,4,28339,176,13373,11616,5815,10416
2021-06-19 21:00:00+00,9922,31,5809,5569,31,4166,1740,171,0,122,27561,168,13149,11409,5600,9953
2021-06-19 21:30:00+00,8928,0,5819,5744,41,4040,1510,192,0,0,26274,159,13114,11604,5785,8928
2021-06-19 22:00:00+00,8194,0,5813,5955,27,3210,1460,141,0,0,24800,150,13255,11795,5982,8194
2021-06-19 22:30:00+00,7249,0,5816,5813,27,3252,1475,142,0,0,23774,142,13131,11656,5840,7249
2021-06-19 23:00:00+00,6539,0,5817,6002,27,3156,1460,139,0,0,23140,132,13306,11846,6028,6539
2021-06-19 23:30:00+00,5901,0,5814,6152,27,3138,1469,140,0,0,22641,123,13462,11993,6179,5901
2021-06-20 00:00:00+00,5730,0,5815,6077,27,3204,1467,140,0,0,22460,121,13386,11919,6104,5730
2021-06-20 00:30:00+00,5961,0,5809,5354,26,3188,1476,142,0,0,21956,127,12665,11189,5380,5961
2021-06-20 01:00:00+00,6230,0,5811,4818,26,3218,1465,140,0,0,21708,134,12120,10655,4844,6230
2021-06-20 01:30:00+00,6098,0,5808,4665,26,3226,1461,139,0,0,21423,134,11960,10499,4691,6098
2021-06-20 02:00:00+00,5779,0,5806,4732,25,3134,1465,140,0,0,21081,128,12028,10563,4757,5779
2021-06-20 02:30:00+00,5214,0,5811,5304,25,3127,1465,142,0,0,21088,117,12605,11140,5329,5214
2021-06-20 03:00:00+00,5145,0,5807,5045,25,3120,1472,142,0,0,20756,118,12349,10877,5070,5145
2021-06-20 03:30:00+00,5436,0,5812,4503,25,3120,1473,142,0,0,20511,125,11813,10340,4528,5436
2021-06-20 04:00:00+00,5551,0,5822,4417,25,3120,1465,142,4,0,20546,127,11733,10268,4446,5551
2021-06-20 04:30:00+00,5926,0,5817,3854,28,3120,1477,143,68,0,20433,135,11244,9767,3950,5926
2021-06-20 05:00:00+00,6388,0,5805,3116,72,3122,1471,141,197,0,20312,144,10661,9190,3385,6388
2021-06-20 05:30:00+00,7150,0,5794,2635,77,3138,1470,140,299,0,20703,156,10275,8805,3011,7150
2021-06-20 06:00:00+00,7763,0,5785,2696,121,3140,1476,142,487,0,21610,161,10565,9089,3304,7763
2021-06-20 06:30:00+00,8720,0,5781,2403,140,3132,1676,141,700,48,22741,171,10700,9024,3243,8720
2021-06-20 07:00:00+00,9511,0,5778,2245,218,3780,1734,141,1025,220,24652,176,11000,9266,3488,9511
2021-06-20 07:30:00+00,10610,71,5768,2223,219,3792,1753,149,1473,418,26476,183,11436,9683,3915,10680
2021-06-20 08:00:00+00,11426,141,5762,2300,235,4274,1639,280,1696,122,27875,190,11632,9993,4231,11567
2021-06-20 08:30:00+00,12113,375,5750,2336,235,4288,1508,281,1780,20,28686,202,11609,10101,4351,12488
2021-06-20 09:00:00+00,12070,477,5746,2396,229,4756,1606,193,2064,0,29537,199,12041,10435,4689,12547
2021-06-20 09:30:00+00,12556,494,5734,2272,216,4774,1698,182,2623,0,30549,199,12543,10845,5111,13050
2021-06-20 10:00:00+00,12827,493,5730,1974,110,4772,1799,209,3166,128,31208,199,12779,10980,5250,13320
2021-06-20 10:30:00+00,12902,493,5724,1764,96,4772,1804,252,3684,36,31527,199,13072,11268,5544,13395
2021-06-20 11:00:00+00,13063,493,5715,1621,58,4772,1802,252,3883,378,32037,198,13079,11277,5562,13556
2021-06-20 11:30:00+00,13095,494,5704,1497,56,4774,1806,263,4143,552,32384,196,13206,11400,5696,13589
2021-06-20 12:00:00+00,12982,495,5700,1509,43,4870,1804,246,4167,188,32004,198,13223,11419,5719,13477
2021-06-20 12:30:00+00,12622,491,5687,1634,40,4870,1769,188,3747,0,31048,197,12877,11108,5421,13113
2021-06-20 13:00:00+00,12604,416,5680,1748,40,4870,1684,149,3517,0,30708,196,12669,10985,5305,13020
2021-06-20 13:30:00+00,12596,404,5672,1841,41,4870,1704,135,3494,0,30757,196,12752,11048,5376,13000
2021-06-20 14:00:00+00,12456,396,5664,1969,51,4870,1692,134,3289,0,30521,195,12665,10973,5309,12852
2021-06-20 14:30:00+00,12594,370,5651,2163,59,4870,1707,136,3215,0,30765,194,12795,11088,5437,12964
2021-06-20 15:00:00+00,12999,344,5647,2545,79,4882,1698,135,2909,0,31238,196,12878,11180,5533,13343
2021-06-20 15:30:00+00,13287,350,5636,2814,97,4980,1719,136,2609,0,31628,198,12875,11156,5520,13637
2021-06-20 16:00:00+00,13572,348,5629,2850,165,5168,1735,141,2320,310,32238,200,12699,10964,5335,13920
2021-06-20 16:30:00+00,13654,344,5615,2822,184,5218,1809,182,1802,348,31978,204,12232,10423,4808,13998
2021-06-20 17:00:00+00,13614,349,5603,3005,313,5176,1839,162,1423,340,31824,205,12183,10344,4741,13963
2021-06-20 17:30:00+00,13217,353,5593,3165,316,5262,1834,160,974,398,31272,205,11882,10048,4455,13570
2021-06-20 18:00:00+00,13025,357,5582,3436,317,5462,1836,159,697,368,31239,206,11868,10032,4450,13382
2021-06-20 18:30:00+00,12821,414,5571,3590,316,5392,1825,142,487,76,30634,207,11789,9964,4393,13235
2021-06-20 19:00:00+00,12454,435,5564,3761,306,5442,1709,163,271,0,30105,206,11611,9902,4338,12889
2021-06-20 19:30:00+00,11920,349,5547,3974,291,5426,1688,130,110,0,29435,200,11610,9922,4375,12269
2021-06-20 20:00:00+00,11842,230,5365,4316,224,4830,1672,130,22,16,28647,201,11599,9927,4562,12072
2021-06-20 20:30:00+00,11143,230,5194,4659,191,4830,1651,129,0,0,28027,195,11695,10044,4850,11373
2021-06-20 21:00:00+00,10231,234,4921,4914,110,5120,1629,133,0,14,27306,189,11574,9945,5024,10465
2021-06-20 21:30:00+00,8959,234,4911,5078,138,5008,1569,131,0,4,26032,177,11696,10127,5216,9193
2021-06-20 22:00:00+00,8396,101,4903,5053,122,4140,1658,130,0,10,24513,167,11736,10078,5175,8497
2021-06-20 22:30:00+00,7094,0,4896,5068,108,4174,1720,132,0,0,23192,152,11792,10072,5176,7094
2021-06-20 23:00:00+00,6769,0,4754,5104,108,3784,1752,130,0,0,22401,148,11718,9966,5212,6769
2021-06-20 23:30:00+00,6172,0,4697,5255,104,3682,1803,131,0,0,21844,140,11859,10056,5359,6172
2021-06-21 00:00:00+00,5863,0,4700,5408,103,3730,1776,133,0,0,21713,138,11987,10211,5511,5863
2021-06-21 00:30:00+00,5762,0,4701,5516,90,3702,1770,124,0,0,21665,136,12077,10307,5606,5762
2021-06-21 01:00:00+00,6085,0,4700,5455,78,3634,1800,115,0,0,21867,139,12033,10233,5533,6085
2021-06-21 01:30:00+00,5923,0,4700,5496,78,3646,1797,113,0,0,21753,137,12071,10274,5574,5923
2021-06-21 02:00:00+00,5837,0,4701,5652,78,3612,1822,112,0,0,21814,134,12253,10431,5730,5837
2021-06-21 02:30:00+00,5756,0,4699,5633,78,3596,1866,115,0,0,21743,133,12276,10410,5711,5756
2021-06-21 03:00:00+00,5532,0,4705,6046,78,3576,1889,112,0,0,21938,130,12718,10829,6124,5532
2021-06-21 03:30:00+00,5027,0,4703,6424,45,3612,1851,115,0,0,21777,122,13023,11172,6469,5027
2021-06-21 04:00:00+00,5437,0,4705,6663,39,3252,2027,114,60,0,22297,125,13494,11467,6762,5437
2021-06-21 04:30:00+00,5873,0,4704,6674,45,3270,2081,114,209,0,22970,130,13713,11632,6928,5873
2021-06-21 05:00:00+00,7389,2,4703,6682,90,2772,2259,114,403,0,24413,149,14137,11878,7175,7390
2021-06-21 05:30:00+00,9028,3,4705,6702,102,2930,2290,114,671,0,26545,163,14470,12180,7475,9031
2021-06-21 06:00:00+00,10429,138,4708,6700,138,4034,2165,115,993,0,29420,173,14704,12539,7831,10567
2021-06-21 06:30:00+00,11642,384,4701,6836,148,4182,2085,117,1343,0,31438,186,15113,13028,8327,12026
2021-06-21 07:00:00+00,11867,453,4704,6830,161,5278,1930,120,1532,0,32875,184,15157,13227,8523,12320
2021-06-21 07:30:00+00,12277,272,4705,6883,162,5228,1901,127,1977,0,33532,180,15628,13727,9022,12549
2021-06-21 08:00:00+00,12328,296,4703,6813,143,5480,1924,123,2416,124,34350,178,15999,14075,9372,12624
2021-06-21 08:30:00+00,12311,291,4702,6903,142,5584,1910,120,2737,186,34886,175,16394,14484,9782,12602
2021-06-21 09:00:00+00,12506,335,4702,6803,123,5484,1962,122,2769,32,34838,178,16359,14397,9695,12841
2021-06-21 09:30:00+00,12499,300,4705,6783,107,5480,1944,125,2863,80,34886,177,16402,14458,9753,12799
2021-06-21 10:00:00+00,12852,337,4703,6624,68,5310,1986,121,3026,114,35141,179,16407,14421,9718,13189
2021-06-21 10:30:00+00,12690,456,4705,6724,55,5336,2010,116,3279,80,35451,179,16773,14763,10058,13146
2021-06-21 11:00:00+00,12887,462,4706,6776,25,5140,2131,122,3508,92,35849,178,17146,15015,10309,13349
2021-06-21 11:30:00+00,12905,386,4714,6645,25,5138,2206,124,3402,0,35545,178,16992,14786,10072,13291
2021-06-21 12:00:00+00,12793,445,4712,6458,25,5196,2202,119,3498,0,35448,179,16895,14693,9981,13238
2021-06-21 12:30:00+00,12611,312,4715,6619,25,5026,2257,115,3389,0,35069,174,17005,14748,10033,12923
2021-06-21 13:00:00+00,12311,260,4713,7071,25,5046,2111,115,3175,0,34827,170,17095,14984,10271,12571
2021-06-21 13:30:00+00,11918,241,4719,7403,34,4948,2106,118,2873,50,34410,166,17135,15029,10310,12159
2021-06-21 14:00:00+00,11718,230,4723,7726,41,5116,2206,115,2735,2,34612,163,17431,15225,10502,11948
2021-06-21 14:30:00+00,12046,231,4724,8018,43,5252,2311,116,2450,0,35191,166,17546,15235,10511,12277
2021-06-21 15:00:00+00,12322,231,4725,8119,94,5012,2442,131,2183,64,35323,168,17563,15121,10396,12553
2021-06-21 15:30:00+00,12642,284,4722,8244,151,5220,2395,145,1986,90,35879,173,17498,15103,10381,12926
2021-06-21 16:00:00+00,12685,361,4720,8416,259,5426,2398,147,1618,360,36390,174,17411,15013,10293,13046
2021-06-21 16:30:00+00,12624,298,4721,8479,285,5532,2368,153,1356,588,36404,172,17209,14841,10120,12922
2021-06-21 17:00:00+00,12798,235,4719,8475,291,5520,2371,157,1086,412,36064,174,16942,14571,9852,13033
2021-06-21 17:30:00+00,12546,344,4715,8341,293,5436,2381,143,799,494,35492,176,16529,14148,9433,12890
2021-06-21 18:00:00+00,12696,379,4714,8043,293,5322,2385,139,587,400,34958,179,16022,13637,8923,13075
2021-06-21 18:30:00+00,12541,351,4714,7884,289,5146,2367,141,406,290,34129,179,15660,13293,8579,12892
2021-06-21 19:00:00+00,12482,352,4709,7534,262,4984,2385,142,213,124,33187,182,15103,12718,8009,12834
2021-06-21 19:30:00+00,12174,286,4709,7307,245,4974,2376,141,71,30,32313,181,14708,12332,7623,12460
2021-06-21 20:00:00+00,11762,238,4707,7037,175,4868,2400,141,8,64,31400,179,14327,11927,7220,12000
2021-06-21 20:30:00+00,11461,233,4683,6736,141,4872,2388,140,0,0,30654,179,13948,11560,6877,11694
2021-06-21 21:00:00+00,11191,231,4568,6588,96,4484,2362,140,0,0,29660,180,13614,11252,6684,11422
2021-06-21 21:30:00+00,9756,232,4574,6477,92,4456,2381,146,0,0,28114,170,13524,11143,6569,9988
2021-06-21 22:00:00+00,8537,334,4576,6382,80,3686,2471,144,0,70,26280,163,13509,11038,6462,8871
2021-06-21 22:30:00+00,7406,355,4575,6334,68,3606,2466,141,0,0,24951,153,13443,10977,6402,7761
2021-06-21 23:00:00+00,6878,329,4584,6362,56,3364,2392,143,0,0,24108,148,13394,11002,6418,7207
2021-06-21 23:30:00+00,6647,238,4579,6086,41,3298,2461,143,0,0,23493,145,13167,10706,6127,6885
2021-06-22 00:00:00+00,6970,249,4582,5783,41,3298,2459,143,0,0,23525,151,12865,10406,5824,7219
2021-06-22 00:30:00+00,7079,311,4582,5539,41,3298,2483,148,0,0,23481,156,12645,10162,5580,7390
2021-06-22 01:00:00+00,6920,373,4577,5501,41,3300,2483,142,0,0,23337,157,12602,10119,5542,7293
2021-06-22 01:30:00+00,6408,326,4583,5872,41,3300,2478,140,0,0,23148,147,12974,10496,5913,6734
2021-06-22 02:00:00+00,6039,241,4582,6079,41,3300,2440,144,0,0,22866,139,13142,10702,6120,6280
2021-06-22 02:30:00+00,6046,243,4578,6031,41,3302,2414,144,0,0,22799,140,13064,10650,6072,6289
2021-06-22 03:00:00+00,6088,321,4580,5996,41,3296,2479,140,0,0,22941,143,13096,10617,6037,6409
2021-06-22 03:30:00+00,6136,342,4581,5690,41,3294,2491,143,0,0,22718,146,12804,10312,5732,6478
2021-06-22 04:00:00+00,6491,238,4584,5458,41,3164,2487,143,51,0,22657,147,12621,10134,5550,6729
2021-06-22 04:30:00+00,7106,245,4582,5438,42,3164,2483,141,250,0,23451,152,12795,10312,5730,7351
2021-06-22 05:00:00+00,8206,249,4579,5679,89,3378,2295,141,546,0,25162,159,13188,10893,6314,8455
2021-06-22 05:30:00+00,10155,274,4557,5678,95,3464,2225,144,916,0,27508,174,13471,11246,6689,10429
2021-06-22 06:00:00+00,11384,370,4545,5553,123,4670,2331,147,1488,70,30681,183,14040,11709,7164,11754
2021-06-22 06:30:00+00,12750,569,4540,5437,128,4706,2396,142,2273,0,32941,193,14774,12378,7838,13319
2021-06-22 07:00:00+00,13800,691,4522,5455,206,4270,2312,155,3149,0,34560,199,15644,13332,8810,14491
2021-06-22 07:30:00+00,13619,693,4496,5374,213,4254,2293,163,3916,0,35021,194,16292,13999,9503,14312
2021-06-22 08:00:00+00,13046,755,4479,5146,201,4830,2471,147,4391,66,35532,188,16688,14217,9738,13801
2021-06-22 08:30:00+00,12748,838,4465,5122,205,4856,2454,142,4864,64,35758,186,17110,14656,10191,13586
2021-06-22 09:00:00+00,13284,875,4447,5195,118,4054,2472,142,5163,64,35814,192,17395,14923,10476,14159
2021-06-22 09:30:00+00,13021,779,4435,5467,100,3984,2478,142,5387,68,35861,186,17867,15389,10954,13800
2021-06-22 10:00:00+00,12951,707,4423,5632,70,4098,2443,144,5976,68,36512,179,18544,16101,11678,13658
2021-06-22 10:30:00+00,13000,725,4420,5641,69,4114,2349,144,5917,0,36379,181,18396,16047,11627,13725
2021-06-22 11:00:00+00,13096,832,4328,5610,53,4232,2472,146,5907,0,36676,184,18370,15898,11570,13928
2021-06-22 11:30:00+00,13237,822,4195,5472,52,4232,2481,144,5643,0,36278,187,17843,15362,11167,14059
2021-06-22 12:00:00+00,13014,599,4191,5590,52,4458,2475,146,5804,0,36329,179,18112,15637,11446,13613
2021-06-22 12:30:00+00,12724,532,4172,5750,51,4476,2473,147,5591,0,35916,176,18037,15564,11392,13256
2021-06-22 13:00:00+00,12464,566,4165,5712,51,4472,2472,146,5338,0,35386,177,17738,15266,11101,13030
2021-06-22 13:30:00+00,12186,586,4165,5507,52,4458,2467,142,5690,0,35253,175,17881,15414,11249,12772
2021-06-22 14:00:00+00,12078,499,4164,5492,75,4606,2472,142,5147,0,34675,175,17350,14878,10714,12577
2021-06-22 14:30:00+00,12186,673,4187,5550,101,4602,2477,146,4939,64,34925,180,17254,14777,10590,12859
2021-06-22 15:00:00+00,12214,794,4359,5732,194,4626,2465,165,4819,64,35432,178,17569,15104,10745,13008
2021-06-22 15:30:00+00,12823,757,4432,6058,203,4662,2475,174,4429,64,36077,181,17597,15122,10690,13580
2021-06-22 16:00:00+00,13439,744,4429,6204,244,4698,2479,172,4000,64,36473,187,17356,14877,10448,14183
2021-06-22 16:30:00+00,13872,841,4426,6036,262,4700,2481,179,3096,100,35993,197,16301,13820,9394,14713
2021-06-22 17:00:00+00,13795,986,4431,5883,287,4484,2477,228,2543,524,35638,201,15621,13144,8713,14781
2021-06-22 17:30:00+00,13863,992,4429,5843,295,4484,2480,228,2023,446,35083,205,15070,12590,8161,14855
2021-06-22 18:00:00+00,13797,990,4429,5773,310,4520,2480,203,1577,488,34567,208,14569,12089,7660,14787
2021-06-22 18:30:00+00,13674,991,4429,5320,310,4512,2479,187,1031,654,33587,212,13569,11090,6661,14665
2021-06-22 19:00:00+00,13528,925,4431,4995,279,4758,2440,151,596,424,32527,215,12741,10301,5870,14453
2021-06-22 19:30:00+00,13451,819,4414,4587,267,4764,2384,146,207,346,31385,218,11859,9475,5061,14270
2021-06-22 20:00:00+00,13328,822,4397,4325,178,4776,2472,141,16,26,30481,225,11388,8916,4519,14150
2021-06-22 20:30:00+00,13230,854,4393,3844,173,4774,2478,140,0,0,29886,229,10888,8410,4017,14084
2021-06-22 21:00:00+00,12725,969,4399,3533,116,4750,2478,149,0,408,29527,228,10526,8048,3649,13694
2021-06-22 21:30:00+00,11656,988,4399,3337,73,4700,2472,150,0,168,27943,226,10281,7809,3410,12644
2021-06-22 22:00:00+00,10729,933,4400,3357,54,3856,2474,223,0,242,26268,219,10285,7811,3411,11662
2021-06-22 22:30:00+00,9780,856,4398,3087,49,3848,2490,203,0,0,24711,214,10024,7534,3136,10636
2021-06-22 23:00:00+00,9270,669,4398,2905,49,3834,2487,140,0,0,23752,206,9839,7352,2954,9939
2021-06-22 23:30:00+00,8665,616,4377,2883,50,3821,2491,141,0,0,23044,200,9801,7310,2933,9281
2021-06-23 00:00:00+00,8504,809,4299,2762,50,3808,2488,141,0,0,22862,208,9599,7111,2812,9313
2021-06-23 00:30:00+00,8569,761,4277,2622,50,3796,2488,141,0,0,22704,209,9437,6949,2672,9330
2021-06-23 01:00:00+00,8416,807,4271,2531,49,3798,2487,140,0,0,22499,210,9338,6851,2580,9223
2021-06-23 01:30:00+00,8118,870,4261,2419,49,3794,2484,140,0,0,22135,210,9213,6729,2468,8988
2021-06-23 02:00:00+00,8156,923,4242,2305,49,3784,2486,140,0,0,22085,214,9082,6596,2354,9079
2021-06-23 02:30:00+00,8294,905,4244,2204,50,3782,2484,139,0,0,22102,215,8982,6498,2254,9199
2021-06-23 03:00:00+00,8518,673,4243,2277,50,3784,2478,139,0,0,22162,209,9048,6570,2327,9191
2021-06-23 03:30:00+00,8462,620,4242,2330,49,3784,2490,139,0,0,22116,206,9111,6621,2379,9082
2021-06-23 04:00:00+00,8698,478,4242,2122,66,3466,2492,139,94,0,21797,204,9016,6524,2282,9176
2021-06-23 04:30:00+00,9296,520,4249,2049,88,3460,2489,140,407,0,22698,208,9282,6793,2544,9816
2021-06-23 05:00:00+00,10891,874,4253,2004,135,3308,2491,140,879,0,24975,226,9762,7271,3018,11765
2021-06-23 05:30:00+00,12504,988,4259,1882,166,3320,2496,158,1462,68,27303,233,10265,7769,3510,13492
2021-06-23 06:00:00+00,13533,967,4258,1782,235,4266,2495,221,2142,256,30155,231,10912,8417,4159,14500
2021-06-23 06:30:00+00,14430,980,4262,1756,236,4284,2491,336,2849,334,31958,230,11594,9103,4841,15410
2021-06-23 07:00:00+00,15076,990,4261,1704,251,4708,2499,291,3706,124,33610,231,12421,9922,5661,16066
2021-06-23 07:30:00+00,15238,992,4266,1583,230,4716,2493,197,4585,106,34406,227,13157,10664,6398,16230
2021-06-23 08:00:00+00,15269,993,4263,1541,137,4532,2464,170,5351,230,34950,221,13756,11292,7029,16262
2021-06-23 08:30:00+00,15003,986,4262,1505,134,4530,2439,169,5984,136,35148,216,14324,11885,7623,15989
2021-06-23 09:00:00+00,15200,985,4258,1526,64,3486,2438,259,6693,420,35329,215,14979,12541,8283,16185
2021-06-23 09:30:00+00,15226,986,4260,1469,66,3410,2443,193,7265,304,35622,213,15503,13060,8800,16212
2021-06-23 10:00:00+00,14782,991,4266,1465,66,3996,2443,143,7504,18,35674,208,15744,13301,9035,15773
2021-06-23 10:30:00+00,14722,991,4262,1412,66,4016,2441,141,7603,206,35860,206,15784,13344,9082,15713
2021-06-23 11:00:00+00,14862,992,4264,1362,66,4068,2417,232,7551,402,36216,211,15660,13243,8979,15854
2021-06-23 11:30:00+00,14811,990,4262,1386,65,4040,2380,273,7597,206,36010,212,15690,13310,9048,15801
2021-06-23 12:00:00+00,14758,973,4262,1433,64,3418,2455,272,7586,358,35579,207,15800,13345,9083,15731
2021-06-23 12:30:00+00,14691,993,4274,1496,49,3430,2447,260,7487,74,35201,209,15753,13306,9032,15684
2021-06-23 13:00:00+00,14488,990,4277,1571,49,3766,2400,153,7211,126,35031,207,15508,13108,8831,15478
2021-06-23 13:30:00+00,14452,993,4281,1642,49,3750,2388,143,6944,58,34700,209,15304,12916,8635,15445
2021-06-23 14:00:00+00,14254,820,4287,1627,49,4230,2407,141,6494,162,34471,209,14864,12457,8170,15074
2021-06-23 14:30:00+00,14726,846,4300,1564,49,4244,2438,183,6038,200,34588,215,14389,11951,7651,15572
2021-06-23 15:00:00+00,14928,833,4399,1536,153,4786,2395,274,5413,68,34785,217,13896,11501,7102,15761
2021-06-23 15:30:00+00,15264,855,4399,1555,168,4836,2428,378,4623,288,34794,222,13173,10745,6346,16119
2021-06-23 16:00:00+00,15345,889,4397,1544,371,4980,2452,490,3861,1224,35553,222,12625,10173,5776,16234
2021-06-23 16:30:00+00,15568,967,4401,1586,522,4982,2462,540,3164,1176,35368,228,12135,9673,5272,16535
2021-06-23 17:00:00+00,15850,975,4419,1544,551,5044,2477,611,2496,952,34919,236,11487,9010,4591,16825
2021-06-23 17:30:00+00,15932,985,4435,1484,549,5046,2483,563,1864,896,34237,242,10815,8332,3897,16917
2021-06-23 18:00:00+00,15927,987,4441,1500,429,5068,2486,565,1253,1160,33816,245,10109,7623,3182,16914
2021-06-23 18:30:00+00,15938,986,4440,1385,431,4896,2444,561,764,1074,32919,251,9464,7020,2580,16924
2021-06-23 19:00:00+00,15708,986,4438,1328,369,5066,2472,455,371,1028,32221,253,8978,6506,2068,16694
2021-06-23 19:30:00+00,15436,985,4445,1279,297,5066,2482,433,103,832,31358,256,8606,6124,1679,16421
2021-06-23 20:00:00+00,15236,954,4453,1244,265,5046,2479,414,5,490,30586,259,8446,5967,1514,16190
2021-06-23 20:30:00+00,15399,846,4469,1127,227,5046,2474,256,0,62,29906,262,8297,5823,1354,16245
2021-06-23 21:00:00+00,15023,841,4476,1123,96,4984,2476,184,0,276,29479,260,8171,5695,1219,15864
2021-06-23 21:30:00+00,13701,799,4474,1122,144,4976,2476,140,0,162,27994,253,8216,5740,1266,14500
2021-06-23 22:00:00+00,12765,719,4484,1119,138,4325,2469,150,0,298,26467,243,8210,5741,1257,13484
2021-06-23 22:30:00+00,11919,469,4496,1123,130,4307,2467,143,0,0,25054,234,8216,5749,1253,12388
2021-06-23 23:00:00+00,11575,99,4510,1114,124,4115,2473,142,0,0,24152,220,8221,5748,1238,11674
2021-06-23 23:30:00+00,11132,0,4517,1190,105,4131,2473,142,0,0,23690,213,8285,5812,1295,11132
2021-06-24 00:00:00+00,10578,0,4532,1295,105,4092,2463,142,0,0,23207,208,8395,5932,1400,10578
2021-06-24 00:30:00+00,10357,0,4547,1345,104,4066,2471,141,0,0,23031,206,8467,5996,1449,10357
2021-06-24 01:00:00+00,10445,0,4551,1354,103,4077,2464,141,0,0,23135,207,8472,6008,1457,10445
2021-06-24 01:30:00+00,10331,0,4566,1388,103,4086,2472,141,0,0,23087,205,8529,6057,1491,10331
2021-06-24 02:00:00+00,10359,0,4566,1417,103,3258,2472,140,0,0,22316,208,8558,6086,1520,10359
2021-06-24 02:30:00+00,10458,0,4566,1502,103,4108,2466,140,0,0,23343,205,8637,6171,1605,10458
2021-06-24 03:00:00+00,10438,0,4583,1603,103,4069,2468,141,0,0,23405,204,8757,6289,1706,10438
2021-06-24 03:30:00+00,10205,0,4591,1786,118,4071,2445,139,0,0,23354,201,8940,6495,1904,10205
2021-06-24 04:00:00+00,10151,10,4605,1846,122,3560,2270,139,50,0,22753,197,8893,6623,2018,10161
2021-06-24 04:30:00+00,10630,20,4618,1862,121,3576,2366,139,208,0,23540,200,9175,6809,2191,10650
2021-06-24 05:00:00+00,12178,276,4636,1860,121,3562,2325,139,462,0,25560,218,9404,7079,2443,12454
2021-06-24 05:30:00+00,13595,551,4641,1857,154,3539,2408,140,828,14,27726,230,9888,7480,2839,14146
2021-06-24 06:00:00+00,13696,754,4646,1930,402,4127,2387,152,1260,0,29355,232,10625,8238,3592,14450
2021-06-24 06:30:00+00,14298,795,4648,1927,402,4217,2356,362,1773,462,31241,230,11106,8750,4102,15093
2021-06-24 07:00:00+00,14465,793,4647,1936,277,5039,2351,401,2307,640,32856,227,11518,9167,4520,15258
2021-06-24 07:30:00+00,14497,783,4655,2102,424,5094,2346,383,2814,518,33616,222,12341,9995,5340,15280
2021-06-24 08:00:00+00,14630,709,4655,2088,407,5128,2398,357,3204,694,34270,217,12752,10354,5699,15339
2021-06-24 08:30:00+00,14655,726,4661,2213,398,5068,2393,409,3693,512,34728,216,13358,10965,6304,15381
2021-06-24 09:00:00+00,14649,679,4662,2363,342,5082,2378,395,4104,302,34956,212,13849,11471,6809,15328
2021-06-24 09:30:00+00,14668,711,4665,2363,338,5094,2374,377,4366,220,35176,212,14106,11732,7067,15379
2021-06-24 10:00:00+00,14601,717,4659,2473,309,4882,2360,423,4781,352,35557,207,14582,12222,7563,15318
2021-06-24 10:30:00+00,14531,710,4662,2692,295,4882,2344,396,4782,86,35380,207,14775,12431,7769,15241
2021-06-24 11:00:00+00,14522,664,4655,2934,171,5056,2334,298,5098,64,35796,204,15192,12858,8203,15186
2021-06-24 11:30:00+00,14418,708,4654,3230,96,5054,2358,214,5025,66,35823,203,15363,13005,8351,15126
2021-06-24 12:00:00+00,14175,749,4653,3355,181,4796,2389,216,4767,116,35397,201,15345,12956,8303,14924
2021-06-24 12:30:00+00,13895,750,4651,3537,193,4778,2433,218,4843,64,35362,199,15657,13224,8573,14645
2021-06-24 13:00:00+00,13928,768,4619,3979,176,4384,2433,202,4665,64,35218,196,15872,13439,8820,14696
2021-06-24 13:30:00+00,13904,754,4600,4269,66,4378,2434,158,3958,64,34585,199,15327,12893,8293,14658
2021-06-24 14:00:00+00,13882,789,4563,4335,71,4632,2393,146,3544,64,34419,204,14906,12513,7950,14671
2021-06-24 14:30:00+00,13976,789,4556,4525,79,4634,2384,146,3618,58,34765,203,15162,12778,8222,14765
2021-06-24 15:00:00+00,13885,732,4557,5045,126,4648,2422,154,3790,0,35359,196,15940,13518,8961,14617
2021-06-24 15:30:00+00,14078,758,4556,5222,132,4654,2411,163,3318,0,35292,199,15639,13228,8672,14836
2021-06-24 16:00:00+00,14164,791,4557,5348,254,5048,2357,173,2935,166,35793,203,15451,13094,8537,14955
2021-06-24 16:30:00+00,14165,906,4556,5470,271,5054,2366,244,2220,220,35472,208,14883,12517,7961,15071
2021-06-24 17:00:00+00,14083,982,4557,5647,287,4432,2400,306,1471,528,34693,208,14362,11962,7405,15065
2021-06-24 17:30:00+00,13887,986,4551,5880,286,4512,2409,336,1210,518,34575,208,14336,11927,7376,14873
2021-06-24 18:00:00+00,13941,983,4547,5816,273,4556,2393,170,775,464,33918,212,13804,11411,6864,14924
2021-06-24 18:30:00+00,13865,980,4553,5861,260,4666,2353,188,511,160,33397,216,13538,11185,6632,14845
2021-06-24 19:00:00+00,14071,981,4553,5987,167,3970,2367,183,236,152,32667,218,13310,10943,6390,15052
2021-06-24 19:30:00+00,13656,981,4548,6017,159,3830,2400,145,60,170,31966,215,13184,10784,6236,14637
2021-06-24 20:00:00+00,13088,982,4556,6343,244,3204,2409,282,0,146,31254,216,13552,11143,6587,14070
2021-06-24 20:30:00+00,12430,985,4554,6349,100,3152,2411,266,0,162,30409,213,13414,11003,6449,13415
2021-06-24 21:00:00+00,11141,986,4563,6249,72,3748,2395,202,0,0,29356,211,13279,10884,6321,12127
2021-06-24 21:30:00+00,10006,822,4557,6862,126,3778,2304,152,0,0,28607,195,13849,11545,6988,10828
2021-06-24 22:00:00+00,8229,912,4559,6625,87,3600,2342,141,0,0,26495,186,13613,11271,6712,9141
2021-06-24 22:30:00+00,6891,839,4561,6758,81,3734,2342,139,0,0,25345,173,13742,11400,6839,7730
2021-06-24 23:00:00+00,6017,682,4556,6726,73,3658,2339,140,0,0,24191,159,13694,11355,6799,6699
2021-06-24 23:30:00+00,5707,539,4559,6817,68,3598,2340,140,0,0,23768,150,13784,11444,6885,6246
2021-06-25 00:00:00+00,5429,573,4559,6666,68,3694,2422,141,0,0,23552,150,13715,11293,6734,6002
2021-06-25 00:30:00+00,5138,664,4562,6599,68,3648,2414,140,0,0,23233,150,13643,11229,6667,5802
2021-06-25 01:00:00+00,5263,712,4552,6445,68,3600,2391,141,0,0,23172,153,13456,11065,6513,5975
2021-06-25 01:30:00+00,5127,730,4516,6517,67,3570,2394,141,0,0,23062,152,13494,11100,6584,5857
2021-06-25 02:00:00+00,4940,741,4515,6284,67,3740,2360,141,0,0,22788,154,13226,10866,6351,5681
2021-06-25 02:30:00+00,4848,664,4519,6279,67,3784,2442,141,0,0,22744,151,13307,10865,6346,5512
2021-06-25 03:00:00+00,4958,586,4518,6162,67,3750,2434,141,0,0,22616,150,13181,10747,6229,5544
2021-06-25 03:30:00+00,5132,615,4515,5762,66,3738,2369,141,0,0,22338,156,12712,10343,5828,5747
2021-06-25 04:00:00+00,5226,706,4500,5787,66,3426,2225,140,13,0,22089,160,12591,10366,5866,5932
2021-06-25 04:30:00+00,5778,758,4337,5801,66,3504,2180,139,83,0,22646,169,12467,10287,5950,6536
2021-06-25 05:00:00+00,7214,837,4289,5986,64,3528,2250,142,256,0,24566,181,12845,10595,6306,8051
2021-06-25 05:30:00+00,8704,893,4288,6265,80,3416,2306,140,491,0,26583,189,13430,11124,6836,9597
2021-06-25 06:00:00+00,10053,762,4296,6457,188,4332,2337,141,835,0,29401,187,14113,11776,7480,10815
2021-06-25 06:30:00+00,11102,658,4462,6568,201,4482,2376,185,1166,28,31228,188,14773,12397,7935,11760
2021-06-25 07:00:00+00,11628,726,4560,6339,190,5018,2317,184,1644,0,32606,193,15050,12733,8173,12354
2021-06-25 07:30:00+00,11675,872,4560,6202,178,4992,2322,276,1928,36,33041,196,15190,12868,8308,12547
2021-06-25 08:00:00+00,11598,913,4561,6359,177,5426,2323,275,2487,116,34235,191,15907,13584,9023,12511
2021-06-25 08:30:00+00,11810,918,4567,6616,167,5334,2323,247,2742,116,34840,189,16415,14092,9525,12728
2021-06-25 09:00:00+00,11696,949,4569,6882,106,5320,2339,177,3036,24,35098,186,16932,14593,10024,12645
2021-06-25 09:30:00+00,11174,901,4568,7163,81,5180,2374,144,3151,0,34736,179,17337,14963,10395,12075
2021-06-25 10:00:00+00,11227,923,4563,7492,56,4184,2374,196,3470,178,34663,178,17955,15581,11018,12150
2021-06-25 10:30:00+00,11287,980,4565,7418,62,4104,2377,174,3701,20,34688,179,18123,15746,11181,12267
2021-06-25 11:00:00+00,11191,980,4563,7427,71,4102,2379,142,4002,104,34961,176,18442,16063,11500,12171
2021-06-25 11:30:00+00,11187,982,4559,7258,77,4098,2378,142,4286,92,35059,175,18558,16180,11621,12169
2021-06-25 12:00:00+00,10799,987,4556,7311,75,3990,2373,143,4529,0,34763,172,18844,16471,11915,11786
2021-06-25 12:30:00+00,10099,915,4550,7331,76,3956,2369,143,4739,122,34300,164,19065,16696,12146,11014
2021-06-25 13:00:00+00,9437,808,4545,7396,72,4840,2184,142,4687,0,34111,156,18884,16700,12155,10245
2021-06-25 13:30:00+00,9484,726,4380,7288,68,4888,1937,144,4553,30,33498,156,18226,16289,11909,10210
2021-06-25 14:00:00+00,9264,685,4288,7410,70,4874,2196,146,4322,0,33255,154,18286,16090,11802,9949
2021-06-25 14:30:00+00,9504,506,4290,7549,68,4872,2261,146,4176,0,33372,152,18344,16083,11793,10010
2021-06-25 15:00:00+00,10127,513,4295,7480,68,4758,2277,156,3752,40,33466,159,17872,15595,11300,10640
2021-06-25 15:30:00+00,10377,770,4392,7380,148,4774,2336,152,3309,152,33790,168,17565,15229,10837,11147
2021-06-25 16:00:00+00,10602,932,4564,7124,444,4998,2066,198,2437,356,33721,176,16635,14569,10005,11534
2021-06-25 16:30:00+00,10789,994,4573,7142,445,5130,2162,193,1866,270,33564,182,16188,14026,9453,11783
2021-06-25 17:00:00+00,10606,994,4571,6862,444,5132,2249,160,1618,720,33356,182,15744,13495,8924,11600
2021-06-25 17:30:00+00,10602,992,4578,6742,441,5194,2371,165,1186,742,33013,185,15318,12947,8369,11594
2021-06-25 18:00:00+00,10729,993,4571,6366,316,4996,2380,153,842,738,32084,190,14475,12095,7524,11722
2021-06-25 18:30:00+00,10779,991,4575,5907,268,4940,2354,355,590,570,31329,196,13694,11340,6765,11770
2021-06-25 19:00:00+00,11014,974,4574,5552,207,4756,2338,477,314,190,30396,205,12985,10647,6073,11988
2021-06-25 19:30:00+00,11033,895,4576,5113,193,4726,2291,521,120,260,29728,207,12293,10002,5426,11928
2021-06-25 20:00:00+00,11016,879,4556,4951,103,4554,2264,475,7,48,28853,209,11881,9617,5061,11895
2021-06-25 20:30:00+00,10880,899,4376,4939,93,4548,2310,443,0,0,28488,211,11718,9408,5032,11779
2021-06-25 21:00:00+00,10731,972,4299,4846,54,4606,2255,313,0,0,28076,214,11454,9199,4900,11703
2021-06-25 21:30:00+00,10624,799,4301,4665,66,4578,1963,145,0,0,27141,210,10995,9032,4731,11423
2021-06-25 22:00:00+00,10599,575,4298,4534,66,3628,1601,207,0,0,25508,206,10499,8898,4600,11174
2021-06-25 22:30:00+00,9777,254,4311,4485,66,3642,1598,168,0,0,24301,191,10460,8862,4551,10031
2021-06-25 23:00:00+00,9372,0,4475,4269,66,3330,1541,141,0,0,23194,181,10351,8810,4335,9372
2021-06-25 23:30:00+00,8960,0,4568,3826,66,3312,1528,142,0,0,22402,180,9988,8460,3892,8960
2021-06-26 00:00:00+00,8877,0,4566,3461,66,3312,1552,141,0,0,21975,183,9645,8093,3527,8877
2021-06-26 00:30:00+00,8744,0,4570,3325,66,3310,1596,142,0,0,21753,183,9557,7961,3391,8744
2021-06-26 01:00:00+00,8729,0,4571,3355,66,3136,1603,143,0,0,21603,183,9595,7992,3421,8729
2021-06-26 01:30:00+00,8405,0,4571,3268,66,3138,1604,143,0,0,21195,181,9509,7905,3334,8405
2021-06-26 02:00:00+00,8366,0,4572,3165,66,3134,1606,144,0,0,21053,181,9409,7803,3231,8366
2021-06-26 02:30:00+00,8428,0,4577,3107,66,3134,1605,143,0,0,21060,182,9355,7750,3173,8428
2021-06-26 03:00:00+00,8441,0,4579,3116,66,3136,1607,141,0,0,21086,182,9368,7761,3182,8441
2021-06-26 03:30:00+00,8388,32,4539,3099,66,3136,1607,141,0,0,21008,184,9311,7704,3165,8420
2021-06-26 04:00:00+00,8636,64,4362,2958,66,3150,1607,143,22,0,21009,190,9015,7408,3046,8700
2021-06-26 04:30:00+00,8574,97,4306,2836,66,3136,1602,223,142,0,20982,191,8952,7350,3044,8671
2021-06-26 05:00:00+00,8535,129,4304,2748,66,3308,1603,237,333,150,21413,189,9054,7451,3147,8664
2021-06-26 05:30:00+00,8625,262,4318,2659,85,3314,1605,269,583,372,22092,191,9250,7645,3327,8887
2021-06-26 06:00:00+00,8725,418,4510,2584,85,4008,1603,277,955,466,23631,194,9737,8134,3624,9143
2021-06-26 06:30:00+00,10017,422,4579,2565,86,4024,1603,361,1405,28,25090,205,10238,8635,4056,10439
2021-06-26 07:00:00+00,10680,426,4578,2605,131,4262,1605,359,1925,146,26717,203,10844,9239,4661,11106
2021-06-26 07:30:00+00,10907,499,4577,2478,206,4266,1608,466,2450,598,28055,200,11319,9711,5134,11406
2021-06-26 08:00:00+00,10776,640,4580,2501,521,4508,1602,535,2863,410,28936,199,12067,10465,5885,11416
2021-06-26 08:30:00+00,10768,844,4578,2519,536,4510,1609,488,3481,362,29695,199,12723,11114,6536,11612
2021-06-26 09:00:00+00,10821,970,4583,2502,543,4536,1609,480,3893,98,30035,202,13130,11521,6938,11791
2021-06-26 09:30:00+00,10787,985,4584,2355,438,4510,1608,461,4522,206,30456,199,13507,11899,7315,11772
2021-06-26 10:00:00+00,10719,990,4588,2340,256,4654,1602,438,4795,138,30520,200,13581,11979,7391,11709
2021-06-26 10:30:00+00,10841,932,4581,2144,233,4764,1606,293,5122,242,30758,198,13686,12080,7499,11773
2021-06-26 11:00:00+00,10796,943,4578,2072,201,4540,1606,309,5595,478,31118,195,14052,12446,7868,11739
2021-06-26 11:30:00+00,10720,946,4578,2059,172,4388,1605,307,6246,242,31263,191,14660,13055,8477,11666
2021-06-26 12:00:00+00,10540,991,4577,2010,102,4406,1601,143,6364,256,30990,190,14654,13053,8476,11531
2021-06-26 12:30:00+00,10604,994,4573,1965,99,4294,1604,144,6332,162,30771,191,14573,12969,8396,11598
2021-06-26 13:00:00+00,10610,923,4573,1997,99,4266,1604,142,6257,152,30623,189,14530,12926,8353,11533
2021-06-26 13:30:00+00,10329,776,4570,2060,99,4268,1603,144,5813,108,29770,186,14145,12542,7972,11105
2021-06-26 14:00:00+00,10410,692,4575,2061,99,4270,1602,143,5601,32,29485,187,13938,12336,7761,11102
2021-06-26 14:30:00+00,10536,675,4576,2051,99,4264,1605,143,5186,0,29135,190,13517,11912,7336,11211
2021-06-26 15:00:00+00,10784,889,4575,2019,135,4284,1662,157,5097,0,29602,198,13488,11826,7251,11673
2021-06-26 15:30:00+00,11342,947,4478,2129,167,4424,1668,413,4486,38,30092,208,12928,11260,6782,12289
2021-06-26 16:00:00+00,11537,904,4318,2196,257,5168,1666,415,3867,208,30536,211,12304,10638,6320,12441
2021-06-26 16:30:00+00,11849,897,4307,2201,279,5194,1667,325,3203,460,30382,215,11657,9990,5683,12746
2021-06-26 17:00:00+00,11969,915,4309,2202,299,5162,1667,319,2565,730,30137,219,11042,9375,5066,12884
2021-06-26 17:30:00+00,11804,858,4313,2265,299,5212,1599,323,1990,988,29651,219,10466,8867,4554,12662
2021-06-26 18:00:00+00,12038,818,4321,2264,314,5222,1665,320,1418,1006,29386,223,9982,8317,3996,12856
2021-06-26 18:30:00+00,11970,681,4511,2326,317,5266,1665,234,915,1014,28899,221,9734,8069,3558,12651
2021-06-26 19:00:00+00,11770,681,4587,2500,262,5336,1631,174,512,732,28185,224,9492,7861,3274,12451
2021-06-26 19:30:00+00,11648,699,4582,2618,240,5236,1603,142,187,676,27631,226,9230,7627,3045,12347
2021-06-26 20:00:00+00,11879,696,4586,2637,194,5160,1657,141,16,248,27214,233,9090,7433,2847,12575
2021-06-26 20:30:00+00,11729,676,4588,2555,164,5154,1654,141,0,106,26767,234,8961,7307,2719,12405
2021-06-26 21:00:00+00,11783,695,4583,2655,148,4916,1616,141,0,0,26537,236,9002,7386,2803,12478
2021-06-26 21:30:00+00,11104,648,4585,2655,147,4822,1551,139,0,0,25651,230,8938,7387,2802,11752
2021-06-26 22:00:00+00,10631,471,4584,2674,133,3976,1658,138,0,0,24265,219,9049,7391,2807,11102
2021-06-26 22:30:00+00,9311,460,4586,2646,94,3924,1661,137,0,0,22819,209,8987,7326,2740,9771
2021-06-26 23:00:00+00,8870,479,4556,2806,73,3400,1620,138,0,0,21942,206,9055,7435,2879,9349
2021-06-26 23:30:00+00,8303,461,4375,3146,71,3326,1658,137,0,0,21477,198,9250,7592,3217,8764
2021-06-27 00:00:00+00,7762,487,4300,3371,71,3328,1665,137,0,0,21121,189,9407,7742,3442,8249
2021-06-27 00:30:00+00,7726,467,4302,3357,71,3327,1665,137,0,0,21052,188,9395,7730,3428,8193
2021-06-27 01:00:00+00,7896,238,4305,3214,71,3328,1658,137,0,0,20847,183,9248,7590,3285,8134
2021-06-27 01:30:00+00,7496,14,4408,3242,71,3316,1621,138,0,0,20306,169,9342,7721,3313,7510
2021-06-27 02:00:00+00,7517,0,4484,3260,71,3314,1537,138,0,0,20321,168,9352,7815,3331,7517
2021-06-27 02:30:00+00,7698,0,4481,3139,71,3314,1530,138,0,0,20371,171,9221,7691,3210,7698
2021-06-27 03:00:00+00,7651,0,4477,3143,71,3312,1629,137,0,0,20420,170,9320,7691,3214,7651
2021-06-27 03:30:00+00,7790,0,4484,3115,71,3312,1518,136,0,0,20426,172,9188,7670,3186,7790
2021-06-27 04:00:00+00,7792,0,4486,3143,71,3312,1617,137,9,0,20567,172,9326,7709,3223,7792
2021-06-27 04:30:00+00,7696,0,4490,3244,71,3312,1634,136,86,0,20670,169,9526,7892,3402,7696
2021-06-27 05:00:00+00,7667,0,4488,3437,71,3314,1634,137,229,0,20977,166,9859,8225,3737,7667
2021-06-27 05:30:00+00,7886,0,4490,3642,73,3342,1599,136,431,0,21599,165,10235,8636,4146,7886
2021-06-27 06:00:00+00,8012,0,4459,3822,92,4060,1620,137,667,0,22869,166,10660,9040,4581,8012
2021-06-27 06:30:00+00,8661,0,4273,3938,107,4068,1605,139,860,0,23651,171,10783,9178,4905,8661
2021-06-27 07:00:00+00,9457,0,4215,3993,160,4024,1595,158,1116,148,24866,175,11079,9484,5269,9457
2021-06-27 07:30:00+00,10063,123,4215,4161,167,4022,1633,219,1470,122,26195,180,11646,10013,5798,10186
2021-06-27 08:00:00+00,10426,465,4215,4101,258,4262,1632,385,1699,388,27831,189,11905,10273,6058,10891
2021-06-27 08:30:00+00,11025,827,4266,4140,260,4268,1638,399,1980,62,28865,202,12284,10646,6380,11852
2021-06-27 09:00:00+00,11008,947,4454,4258,259,4508,1608,400,2297,54,29793,200,12876,11268,6814,11955
2021-06-27 09:30:00+00,11112,982,4495,4494,236,4512,1616,376,2783,158,30764,196,13624,12008,7513,12094
2021-06-27 10:00:00+00,11041,918,4501,4747,187,4512,1641,328,2894,352,31121,191,13970,12329,7828,11959
2021-06-27 10:30:00+00,11086,921,4499,4975,182,4512,1640,271,2889,466,31441,189,14185,12545,8046,12007
2021-06-27 11:00:00+00,11020,978,4503,5105,127,4512,1639,278,2906,598,31666,188,14280,12641,8138,11998
2021-06-27 11:30:00+00,11040,986,4494,5272,122,4512,1641,296,3018,262,31643,189,14547,12906,8412,12026
2021-06-27 12:00:00+00,10961,938,4491,5356,52,4750,1635,142,3134,174,31633,186,14668,13033,8542,11899
2021-06-27 12:30:00+00,11009,746,4495,5324,47,4756,1633,141,3667,142,31960,179,15166,13533,9038,11755
2021-06-27 13:00:00+00,10924,613,4417,5316,48,4754,1602,122,3600,128,31524,176,14983,13381,8964,11537
2021-06-27 13:30:00+00,11116,528,4162,5365,48,4754,1610,117,3542,0,31242,178,14727,13117,8955,11644
2021-06-27 14:00:00+00,11236,625,4088,5350,48,4754,1612,115,3564,118,31510,181,14662,13050,8962,11861
2021-06-27 14:30:00+00,11409,818,4090,5294,53,4752,1612,117,3210,0,31355,189,14259,12647,8557,12227
2021-06-27 15:00:00+00,11679,931,4158,5278,103,4754,1616,122,2812,142,31595,195,13967,12351,8193,12610
2021-06-27 15:30:00+00,11580,978,4368,5614,145,4752,1620,214,2623,2,31896,194,14370,12750,8382,12558
2021-06-27 16:00:00+00,11607,982,4483,5807,322,4756,1580,229,2063,556,32385,192,14255,12675,8192,12589
2021-06-27 16:30:00+00,11684,981,4497,5764,336,4756,1563,233,1699,860,32373,192,13859,12296,7799,12665
2021-06-27 17:00:00+00,11820,970,4499,5584,362,4874,1634,235,1329,700,32007,197,13408,11774,7275,12790
2021-06-27 17:30:00+00,11808,959,4490,5357,366,4876,1638,238,1138,744,31614,199,12989,11351,6861,12767
2021-06-27 18:00:00+00,11746,987,4492,4968,354,4876,1635,293,653,798,30802,204,12102,10467,5975,12733
2021-06-27 18:30:00+00,11698,988,4491,4538,348,4876,1632,292,421,720,30004,209,11430,9798,5307,12686
2021-06-27 19:00:00+00,11769,986,4490,4562,308,4876,1636,287,216,466,29596,213,11212,9576,5086,12755
2021-06-27 19:30:00+00,11718,959,4489,4494,289,4876,1639,289,78,332,29163,215,10989,9350,4861,12677
2021-06-27 20:00:00+00,11591,931,4490,4778,241,4754,1639,290,9,52,28775,215,11157,9518,5028,12522
2021-06-27 20:30:00+00,11324,845,4493,4842,202,4750,1631,187,0,0,28274,211,11168,9537,5044,12169
2021-06-27 21:00:00+00,11262,601,4495,4942,114,4508,1572,141,0,0,27635,205,11123,9551,5056,11863
2021-06-27 21:30:00+00,10522,459,4492,4785,137,4504,1556,141,0,0,26596,197,10970,9414,4922,10981
2021-06-27 22:00:00+00,9345,618,4490,4873,104,3632,1612,159,0,0,24833,191,11079,9467,4977,9963
2021-06-27 22:30:00+00,8199,624,4451,4854,87,3694,1574,161,0,0,23644,183,10966,9392,4941,8823
2021-06-27 23:00:00+00,7878,494,4332,4580,81,3214,1640,150,0,0,22369,180,10633,8993,4661,8372
2021-06-27 23:30:00+00,7573,544,4324,4357,78,3206,1610,144,0,0,21836,181,10369,8759,4435,8117
2021-06-28 00:00:00+00,7429,660,4317,4187,78,3206,1606,144,0,0,21627,189,10188,8582,4265,8089
2021-06-28 00:30:00+00,7556,702,4316,4097,78,3090,1583,143,0,0,21566,193,10074,8491,4175,8258
2021-06-28 01:00:00+00,7640,649,4345,4142,77,3209,1594,145,0,0,21801,191,10158,8564,4219,8289
2021-06-28 01:30:00+00,7594,626,4433,4129,76,3209,1589,146,0,0,21802,189,10227,8638,4205,8220
2021-06-28 02:00:00+00,7668,535,4441,4298,67,3402,1562,146,0,0,22119,184,10368,8806,4365,8203
2021-06-28 02:30:00+00,7783,512,4494,4292,53,3404,1593,144,0,0,22274,184,10432,8839,4345,8295
2021-06-28 03:00:00+00,7922,502,4512,4111,53,3356,1635,147,0,0,22239,186,10311,8676,4164,8424
2021-06-28 03:30:00+00,7981,516,4461,3592,53,3353,1704,142,0,0,21802,192,9810,8106,3645,8497
2021-06-28 04:00:00+00,8316,515,4381,3266,53,3333,1739,141,15,0,21760,197,9454,7715,3334,8831
2021-06-28 04:30:00+00,8704,722,4375,2806,57,3406,1781,168,82,0,22101,212,9101,7320,2945,9426
2021-06-28 05:00:00+00,9546,844,4375,2708,86,3988,1960,231,201,90,24029,216,9330,7370,2995,10390
2021-06-28 05:30:00+00,10547,836,4374,2482,103,3773,2164,275,352,238,25144,222,9475,7311,2937,11383
2021-06-28 06:00:00+00,11963,828,4375,2301,103,4061,2239,314,509,0,26693,232,9527,7288,2913,12791
2021-06-28 06:30:00+00,13219,918,4370,2248,111,4026,2261,352,765,334,28604,237,9755,7494,3124,14137
2021-06-28 07:00:00+00,14350,987,4368,2120,263,4896,2206,375,1047,728,31340,240,10004,7798,3430,15337
2021-06-28 07:30:00+00,15038,991,4380,2018,264,4934,2200,374,1291,930,32420,240,10153,7953,3573,16029
2021-06-28 08:00:00+00,15537,988,4497,1952,259,5014,2176,366,1763,966,33518,239,10647,8471,3974,16525
2021-06-28 08:30:00+00,15890,986,4554,1932,253,5010,2147,374,2064,954,34164,239,10950,8803,4249,16876
2021-06-28 09:00:00+00,16176,988,4558,1802,217,4624,2208,367,2258,1082,34280,240,11043,8835,4277,17164
2021-06-28 09:30:00+00,16382,984,4562,1723,208,4620,2216,380,2451,1166,34693,240,11160,8944,4382,17366
2021-06-28 10:00:00+00,16595,964,4562,1838,174,4796,2199,466,2577,552,34723,244,11350,9151,4589,17559
2021-06-28 10:30:00+00,16718,980,4562,1992,169,4798,2175,382,2630,182,34588,246,11528,9353,4791,17698
2021-06-28 11:00:00+00,16894,988,4560,1943,113,5054,2136,354,2803,192,35037,246,11555,9419,4859,17882
2021-06-28 11:30:00+00,16943,983,4545,1828,112,5056,2213,292,3196,138,35306,244,11894,9681,5136,17926
2021-06-28 12:00:00+00,16727,992,4414,1763,97,5000,2218,264,3118,62,34655,245,11610,9392,4978,17719
2021-06-28 12:30:00+00,16617,991,4389,1692,100,4998,2215,284,3178,0,34464,245,11574,9359,4970,17608
2021-06-28 13:00:00+00,16597,990,4382,1609,112,4816,2149,367,3250,0,34272,245,11502,9353,4971,17587
2021-06-28 13:30:00+00,16426,980,4407,1558,127,4816,2133,579,3500,0,34526,242,11725,9592,5185,17406
2021-06-28 14:00:00+00,16206,934,4523,1583,131,4974,2128,581,3157,88,34305,242,11522,9394,4871,17140
2021-06-28 14:30:00+00,16375,988,4557,1546,147,4976,2146,570,2929,88,34322,245,11325,9179,4622,17363
2021-06-28 15:00:00+00,16816,990,4548,1511,263,5018,2170,584,2680,184,34764,248,11172,9002,4454,17806
2021-06-28 15:30:00+00,17314,994,4494,1547,268,5018,2209,592,2308,462,35206,251,10826,8617,4123,18308
2021-06-28 16:00:00+00,17558,986,4494,1607,303,5076,2199,631,1942,780,35576,252,10545,8346,3852,18544
2021-06-28 16:30:00+00,17812,985,4509,1688,305,5078,2212,621,1510,842,35562,255,10224,8012,3503,18797
2021-06-28 17:00:00+00,17879,964,4515,1753,314,5076,2211,640,1103,762,35217,258,9896,7685,3170,18843
2021-06-28 17:30:00+00,17384,925,4516,1954,314,5076,2209,684,850,592,34504,257,9843,7634,3118,18309
2021-06-28 18:00:00+00,17301,929,4515,1948,300,4918,2215,616,590,720,34052,256,9568,7353,2838,18230
2021-06-28 18:30:00+00,17085,916,4529,2075,295,4916,2200,507,347,384,33254,258,9446,7246,2717,18001
2021-06-28 19:00:00+00,16693,926,4533,2202,259,4708,2114,282,161,340,32218,257,9269,7155,2622,17619
2021-06-28 19:30:00+00,16228,921,4530,2419,239,4706,2137,158,48,394,31780,253,9373,7236,2706,17149
2021-06-28 20:00:00+00,15989,901,4527,2470,160,4711,2136,145,3,32,31074,255,9296,7160,2633,16890
2021-06-28 20:30:00+00,15539,785,4525,2454,149,4720,2140,144,0,20,30475,251,9268,7128,2603,16324
2021-06-28 21:00:00+00,15050,407,4525,2348,134,4556,2145,156,0,44,29365,242,9152,7007,2482,15457
2021-06-28 21:30:00+00,14090,56,4525,2463,133,4567,2133,141,0,70,28178,228,9254,7121,2596,14146
2021-06-28 22:00:00+00,13037,0,4524,2428,115,3860,2216,142,0,0,26322,220,9283,7067,2543,13037
2021-06-28 22:30:00+00,12045,0,4525,2213,96,3804,2188,142,0,0,25013,215,9022,6834,2309,12045
2021-06-28 23:00:00+00,11579,0,4529,2245,75,3808,2053,142,0,0,24431,212,8902,6849,2320,11579
2021-06-28 23:30:00+00,11175,0,4465,2240,72,3804,1861,144,0,0,23762,211,8638,6777,2312,11175
2021-06-29 00:00:00+00,10912,0,4444,2242,70,3801,1915,145,0,0,23529,209,8671,6756,2312,10912
2021-06-29 00:30:00+00,10533,0,4456,2360,70,3798,2038,142,0,0,23397,204,8924,6886,2430,10533
2021-06-29 01:00:00+00,10271,0,4458,2406,70,3794,2119,142,0,0,23260,201,9053,6934,2476,10271
2021-06-29 01:30:00+00,10137,0,4506,2387,70,3794,2122,142,0,0,23158,200,9085,6963,2457,10137
2021-06-29 02:00:00+00,9923,0,4587,2457,70,3746,2134,141,0,0,23058,196,9248,7114,2527,9923
2021-06-29 02:30:00+00,9833,0,4579,2331,70,3746,2128,158,0,0,22845,197,9108,6980,2401,9833
2021-06-29 03:00:00+00,9932,2,4579,2185,70,3622,2212,142,0,0,22743,198,9046,6834,2255,9934
2021-06-29 03:30:00+00,9842,3,4580,2223,70,3622,2219,141,0,0,22700,196,9092,6873,2293,9845
2021-06-29 04:00:00+00,9783,189,4585,2319,69,3224,2213,140,30,0,22552,199,9216,7003,2418,9972
2021-06-29 04:30:00+00,10045,290,4587,2560,71,3288,2015,144,122,0,23122,203,9355,7340,2753,10335
2021-06-29 05:00:00+00,11816,532,4590,2614,97,3022,2118,142,235,0,25166,223,9654,7536,2946,12348
2021-06-29 05:30:00+00,13720,786,4590,2455,126,3006,2189,142,399,0,27413,240,9759,7570,2980,14506
2021-06-29 06:00:00+00,15125,851,4588,2401,176,3582,2192,195,690,0,29800,244,10047,7855,3267,15976
2021-06-29 06:30:00+00,16032,829,4584,2535,181,3598,2144,290,1190,262,31645,241,10634,8490,3906,16861
2021-06-29 07:00:00+00,16360,847,4582,2405,216,4148,2134,393,1848,400,33333,239,11185,9051,4469,17207
2021-06-29 07:30:00+00,16574,962,4582,2236,225,4186,2034,419,2165,758,34141,240,11242,9208,4626,17536
2021-06-29 08:00:00+00,17042,987,4580,2135,229,4326,2150,414,2466,568,34897,242,11560,9410,4830,18029
2021-06-29 08:30:00+00,17102,979,4488,2294,232,4326,2106,414,2929,560,35430,239,12049,9943,5455,18081
2021-06-29 09:00:00+00,16474,987,4467,2649,216,4554,2087,307,3284,434,35459,232,12703,10616,6149,17461
2021-06-29 09:30:00+00,16463,980,4471,2906,216,4556,2096,264,3657,244,35853,229,13346,11250,6779,17443
2021-06-29 10:00:00+00,16628,895,4467,3070,179,4534,2004,256,4188,684,36905,221,13908,11904,7437,17523
2021-06-29 10:30:00+00,16805,828,4468,3150,169,4536,2084,261,4626,184,37112,220,14498,12414,7946,17633
2021-06-29 11:00:00+00,16838,824,4467,3352,115,4600,2110,236,4691,0,37233,220,14735,12625,8158,17662
2021-06-29 11:30:00+00,16817,829,4468,3442,112,4598,2108,216,4917,0,37507,218,15047,12939,8471,17646
2021-06-29 12:00:00+00,16732,820,4480,3717,96,4416,2091,180,4755,0,37287,217,15139,13048,8568,17552
2021-06-29 12:30:00+00,16337,734,4607,3833,98,4408,2042,149,4725,0,36933,212,15305,13263,8656,17071
2021-06-29 13:00:00+00,16242,820,4654,3835,108,3818,2143,148,4575,0,36343,216,15315,13172,8518,17062
2021-06-29 13:30:00+00,15869,801,4652,3725,125,3806,2119,148,4249,0,35494,216,14870,12751,8099,16670
2021-06-29 14:00:00+00,15292,832,4649,3636,135,4036,2036,148,4180,0,34944,211,14636,12600,7951,16124
2021-06-29 14:30:00+00,15336,984,4646,3771,125,4038,2121,223,4220,70,35534,213,14883,12762,8116,16320
2021-06-29 15:00:00+00,15406,989,4647,3706,188,4202,2172,335,3996,34,35675,216,14709,12537,7890,16395
2021-06-29 15:30:00+00,15658,987,4644,3753,191,4208,2138,482,3191,206,35458,222,13917,11779,7135,16645
2021-06-29 16:00:00+00,14995,742,4648,3951,329,4612,2051,502,2653,706,35189,213,13632,11581,6933,15737
2021-06-29 16:30:00+00,14959,730,4642,4147,307,4610,2091,503,2294,1178,35461,211,13481,11390,6748,15689
2021-06-29 17:00:00+00,14933,726,4647,4192,296,4342,2070,518,2001,988,34713,212,13206,11136,6489,15659
2021-06-29 17:30:00+00,14317,727,4647,4113,296,4336,1947,494,1554,1110,33541,211,12557,10610,5963,15044
2021-06-29 18:00:00+00,15186,829,4652,4255,291,4164,2010,460,1118,1102,34067,219,12326,10316,5664,16015
2021-06-29 18:30:00+00,15435,901,4650,4508,273,4142,2022,373,778,768,33850,225,12231,10209,5559,16336
2021-06-29 19:00:00+00,15402,989,4652,4494,223,3626,2035,373,423,840,33057,228,11827,9792,5140,16391
2021-06-29 19:30:00+00,14998,981,4653,4522,203,3626,2128,411,141,426,32089,230,11647,9519,4866,15979
2021-06-29 20:00:00+00,14733,807,4607,4459,132,4146,2131,215,13,28,31271,232,11342,9211,4604,15540
2021-06-29 20:30:00+00,14519,589,4492,4331,115,4196,2060,147,0,16,30465,229,10998,8938,4446,15108
2021-06-29 21:00:00+00,14114,266,4485,4221,117,4252,1997,145,0,16,29613,221,10820,8823,4338,14380
2021-06-29 21:30:00+00,12713,234,4484,4209,118,4246,1975,146,0,10,28135,212,10786,8811,4327,12947
2021-06-29 22:00:00+00,11469,235,4507,4232,117,3610,1987,146,0,22,26325,203,10843,8856,4349,11704
2021-06-29 22:30:00+00,9964,236,4623,4084,98,3604,1972,143,0,0,24724,192,10777,8805,4182,10200
2021-06-29 23:00:00+00,9538,232,4650,4215,73,3616,2011,144,0,0,24479,188,10949,8938,4288,9770
2021-06-29 23:30:00+00,9090,178,4652,4384,64,3616,2012,145,0,0,24141,181,11112,9100,4448,9268
2021-06-30 00:00:00+00,8764,0,4649,4366,51,3618,2017,146,0,0,23611,171,11083,9066,4417,8764
2021-06-30 00:30:00+00,8515,0,4650,4345,51,3618,2017,145,0,0,23341,169,11063,9046,4396,8515
2021-06-30 01:00:00+00,8238,0,4656,4577,50,3620,1996,144,0,0,23281,165,11279,9283,4627,8238
2021-06-30 01:30:00+00,7969,0,4701,4561,50,3616,2012,143,0,0,23052,162,11324,9312,4611,7969
2021-06-30 02:00:00+00,8038,0,4742,4233,48,3526,2019,146,0,0,22752,164,11042,9023,4281,8038
2021-06-30 02:30:00+00,8183,0,4749,4060,48,3524,2011,143,0,0,22718,167,10868,8857,4108,8183
2021-06-30 03:00:00+00,8461,0,4743,3972,48,3226,1986,141,0,0,22577,171,10749,8763,4020,8461
2021-06-30 03:30:00+00,8670,0,4747,3642,50,3220,1969,141,0,0,22439,175,10408,8439,3692,8670
2021-06-30 04:00:00+00,8809,13,4751,3921,81,3018,1966,141,10,0,22710,172,10729,8763,4012,8822
2021-06-30 04:30:00+00,9005,188,4753,4377,92,3015,1837,142,123,0,23532,175,11182,9345,4592,9193
2021-06-30 05:00:00+00,9658,229,4756,4686,109,3094,1740,143,351,0,24767,178,11642,9902,5146,9887
2021-06-30 05:30:00+00,10483,234,4760,4734,109,3088,1859,145,632,0,26043,183,12094,10235,5475,10717
2021-06-30 06:00:00+00,11727,582,4755,4441,109,3843,1917,146,1146,192,28857,195,12368,10451,5696,12309
2021-06-30 06:30:00+00,12828,891,4759,4285,110,3872,1967,275,1518,78,30583,209,12639,10672,5913,13719
2021-06-30 07:00:00+00,13797,987,4755,3957,191,3774,1967,448,1867,62,31804,217,12737,10770,6015,14784
2021-06-30 07:30:00+00,14314,994,4754,3694,194,3774,1968,454,2465,344,32955,216,13075,11107,6353,15308
2021-06-30 08:00:00+00,14652,960,4754,3555,194,4288,1968,452,2915,320,34058,216,13386,11418,6664,15612
2021-06-30 08:30:00+00,14846,959,4750,3475,191,4310,1969,455,3239,280,34474,216,13624,11655,6905,15805
2021-06-30 09:00:00+00,15050,1174,4531,3956,194,4466,2098,654,3685,416,36224,217,14464,12366,7835,16224
2021-06-30 09:30:00+00,15008,955,4748,3687,155,4468,2009,456,4099,394,35978,210,14698,12689,7941,15963
2021-06-30 10:00:00+00,15035,986,4749,3618,94,4728,2047,375,4309,254,36195,214,14817,12770,8021,16021
2021-06-30 10:30:00+00,15032,860,4748,3489,91,4742,2094,392,4478,124,36050,212,14900,12806,8058,15892
2021-06-30 11:00:00+00,15078,721,4727,3568,91,4722,2088,407,4974,0,36375,205,15448,13360,8633,15799
2021-06-30 11:30:00+00,15024,704,4710,3625,91,4718,2019,409,4914,0,36214,205,15359,13340,8630,15728
2021-06-30 12:00:00+00,14991,700,4711,3829,92,4446,2085,402,4780,0,36036,206,15497,13412,8701,15691
2021-06-30 12:30:00+00,14830,697,4709,3997,101,4432,2069,324,4798,0,35958,203,15674,13605,8896,15527
2021-06-30 13:00:00+00,14765,526,4716,3852,125,4546,2021,270,4639,66,35526,201,15353,13332,8616,15291
2021-06-30 13:30:00+00,14692,541,4728,3665,116,4544,2039,204,4721,0,35250,202,15269,13230,8502,15233
2021-06-30 14:00:00+00,14735,510,4722,3741,114,4370,2013,186,4453,84,34928,201,15043,13030,8308,15245
2021-06-30 14:30:00+00,14900,693,4712,3874,105,4370,2062,177,3938,74,34905,208,14691,12629,7917,15593
2021-06-30 15:00:00+00,14364,963,4721,4130,169,4846,2091,181,3811,0,35276,209,14922,12831,8110,15327
2021-06-30 15:30:00+00,14618,989,4716,4094,174,4850,2098,227,3577,264,35607,211,14659,12561,7845,15607
2021-06-30 16:00:00+00,14579,990,4715,4213,299,5074,2092,224,3062,760,36008,210,14381,12289,7574,15569
2021-06-30 16:30:00+00,14724,992,4713,4416,303,5078,2061,245,2593,806,35931,213,14086,12025,7312,15716
2021-06-30 17:00:00+00,14917,991,4712,4253,308,5076,2032,244,2333,846,35712,216,13638,11606,6894,15908
2021-06-30 17:30:00+00,14993,992,4714,4169,308,5078,2100,228,1782,802,35166,220,13073,10973,6259,15985
2021-06-30 18:00:00+00,14790,992,4717,4161,322,5076,2100,264,1228,548,34198,224,12528,10428,5711,15782
2021-06-30 18:30:00+00,14776,994,4716,4101,305,5064,2097,269,691,332,33345,230,11910,9813,5097,15770
2021-06-30 19:00:00+00,14793,991,4715,3832,268,4668,2101,266,377,434,32445,235,11293,9192,4477,15784
2021-06-30 19:30:00+00,14725,990,4712,3682,244,4664,2102,233,125,166,31643,239,10865,8763,4051,15715
2021-06-30 20:00:00+00,14292,869,4717,3621,117,4896,2101,153,10,348,31124,235,10566,8465,3748,15161
2021-06-30 20:30:00+00,14158,648,4723,3472,117,4902,2104,140,0,130,30394,232,10416,8312,3589,14806
2021-06-30 21:00:00+00,13863,488,4729,3411,117,4896,2103,140,0,148,29895,226,10360,8257,3528,14351
2021-06-30 21:30:00+00,12883,347,4730,3300,115,4876,2103,140,0,52,28546,218,10248,8145,3415,13230
2021-06-30 22:00:00+00,11989,114,4746,3156,89,3818,2102,140,0,150,26304,207,10093,7991,3245,12103
2021-06-30 22:30:00+00,10790,0,4771,3191,63,3796,2102,140,0,0,24853,195,10127,8025,3254,10790
2021-06-30 23:00:00+00,9665,0,4769,3140,55,3606,2103,142,0,230,23710,186,10067,7964,3195,9665
2021-06-30 23:30:00+00,9001,0,4771,3030,55,3602,2101,142,0,178,22880,181,9957,7856,3085,9001
2021-07-01 00:00:00+00,8734,0,4774,2964,55,3600,2098,142,0,0,22367,181,9891,7793,3019,8734
2021-07-01 00:30:00+00,8958,0,4772,2881,55,3600,2113,143,0,0,22522,183,9821,7708,2936,8958
2021-07-01 01:00:00+00,8991,0,4782,2858,74,3604,2129,142,0,0,22580,184,9843,7714,2932,8991
2021-07-01 01:30:00+00,8943,0,4781,3001,74,3604,2123,142,0,0,22668,182,9979,7856,3075,8943
2021-07-01 02:00:00+00,8980,0,4731,2976,74,3604,2131,142,0,0,22638,183,9912,7781,3050,8980
2021-07-01 02:30:00+00,8750,0,4683,3023,72,3604,2133,141,0,0,22406,181,9911,7778,3095,8750
2021-07-01 03:00:00+00,8698,0,4679,3038,55,3602,2137,140,0,0,22349,180,9909,7772,3093,8698
2021-07-01 03:30:00+00,8476,0,4678,3052,54,3602,2138,139,0,0,22139,178,9922,7784,3106,8476
2021-07-01 04:00:00+00,8479,2,4677,3007,53,3594,2141,151,55,0,22159,178,9933,7792,3115,8481
2021-07-01 04:30:00+00,8850,194,4677,3000,55,3596,2130,159,268,0,22929,186,10130,8000,3323,9044
2021-07-01 05:00:00+00,10273,230,4678,3044,81,3792,2135,159,609,0,25001,195,10547,8412,3734,10503
2021-07-01 05:30:00+00,11859,235,4681,3010,85,3794,2134,160,1074,0,27032,204,10984,8850,4169,12094
2021-07-01 06:00:00+00,13449,381,4684,2989,139,4698,2133,171,1676,0,30320,215,11621,9488,4804,13830
2021-07-01 06:30:00+00,14614,498,4691,2896,152,4718,2119,397,2099,2,32186,223,11956,9838,5146,15112
2021-07-01 07:00:00+00,15190,500,4693,2880,241,5090,2081,424,2676,46,33821,219,12571,10490,5797,15690
2021-07-01 07:30:00+00,15084,492,4699,2928,236,5332,2130,461,3523,0,34885,212,13516,11386,6687,15576
2021-07-01 08:00:00+00,15234,495,4695,2920,209,4856,2128,490,4133,192,35352,210,14085,11957,7262,15729
2021-07-01 08:30:00+00,15223,480,4698,2780,204,4890,2127,515,4672,0,35589,208,14481,12354,7656,15703
2021-07-01 09:00:00+00,15067,468,4693,2733,121,5264,2112,426,4963,0,35847,204,14622,12510,7817,15535
2021-07-01 09:30:00+00,14888,499,4695,2674,108,5280,2125,342,5782,0,36393,198,15384,13259,8564,15387
2021-07-01 10:00:00+00,14645,502,4693,2632,100,5322,2121,333,6167,0,36515,196,15713,13592,8899,15147
2021-07-01 10:30:00+00,14539,501,4696,2664,100,5324,2119,258,6908,0,37109,191,16487,14368,9672,15040
2021-07-01 11:00:00+00,14385,459,4694,2747,101,5548,2126,144,6980,0,37184,188,16648,14522,9828,14844
2021-07-01 11:30:00+00,14181,483,4694,2745,100,5546,2110,145,7419,0,37423,186,17068,14958,10264,14664
2021-07-01 12:00:00+00,13778,487,4694,2801,100,5616,2056,141,7307,0,36980,183,16958,14902,10208,14265
2021-07-01 12:30:00+00,13502,437,4693,2824,82,5616,2065,142,7031,0,36392,181,16695,14630,9937,13939
2021-07-01 13:00:00+00,13769,498,4693,2815,82,5184,2113,144,6675,0,35973,187,16378,14265,9572,14267
2021-07-01 13:30:00+00,13505,499,4693,2810,82,5184,2121,146,6285,0,35325,187,15991,13870,9177,14004
2021-07-01 14:00:00+00,13428,500,4692,2920,82,5238,2117,145,6165,0,35287,187,15976,13859,9167,13928
2021-07-01 14:30:00+00,13557,591,4687,3028,90,5228,2124,145,5631,0,35081,192,15560,13436,8749,14148
2021-07-01 15:00:00+00,13882,799,4685,3084,148,5210,2123,150,5187,0,35268,198,15227,13104,8419,14681
2021-07-01 15:30:00+00,14499,963,4683,3083,166,5216,2120,162,4852,10,35754,207,14904,12784,8101,15462
2021-07-01 16:00:00+00,14797,989,4682,2966,302,5722,2097,164,4189,0,35908,214,14236,12139,7457,15786
2021-07-01 16:30:00+00,14921,988,4685,2899,302,5732,2120,194,3423,280,35544,218,13429,11309,6624,15909
2021-07-01 17:00:00+00,15392,987,4682,2776,314,5142,2118,317,2672,300,34700,227,12562,10444,5762,16379
2021-07-01 17:30:00+00,15544,987,4679,2546,317,5142,2141,320,2062,454,34192,232,11745,9604,4925,16531
2021-07-01 18:00:00+00,15372,986,4679,2510,317,5736,2126,207,1341,746,34020,233,10973,8847,4168,16358
2021-07-01 18:30:00+00,15347,987,4684,2265,310,5760,2183,285,816,818,33455,238,10258,8075,3391,16334
2021-07-01 19:00:00+00,15457,988,4690,1862,255,5760,2190,334,395,580,32511,247,9392,7202,2512,16445
2021-07-01 19:30:00+00,15419,989,4691,1570,243,5708,2194,380,127,432,31753,253,8825,6631,1940,16408
2021-07-01 20:00:00+00,15473,989,4693,1428,161,5092,2196,376,10,544,30962,259,8488,6292,1599,16462
2021-07-01 20:30:00+00,15474,987,4696,1246,157,4998,2190,276,0,294,30318,263,8289,6099,1403,16461
2021-07-01 21:00:00+00,15353,953,4696,1110,110,4978,2160,170,0,130,29660,265,8076,5916,1220,16306
2021-07-01 21:30:00+00,14039,971,4701,939,128,4958,2139,152,0,144,28171,260,7907,5768,1067,15010
2021-07-01 22:00:00+00,12909,986,4699,846,114,4020,2142,140,0,248,26104,254,7801,5659,960,13895
2021-07-01 22:30:00+00,11911,989,4696,817,106,3996,2104,139,0,0,24758,252,7723,5619,923,12900
2021-07-01 23:00:00+00,11578,991,4695,727,70,3996,2132,141,0,0,24330,251,7624,5492,797,12569
2021-07-01 23:30:00+00,11133,990,4694,756,70,3996,2092,141,0,0,23872,248,7612,5520,826,12123
2021-07-02 00:00:00+00,10731,990,4697,709,71,3996,2154,150,0,0,23498,246,7631,5477,780,11721
2021-07-02 00:30:00+00,10384,993,4694,591,71,3996,2196,142,0,0,23067,245,7552,5356,662,11377
2021-07-02 01:00:00+00,10349,992,4698,549,71,3996,2196,143,0,0,22994,245,7514,5318,620,11341
2021-07-02 01:30:00+00,10411,994,4693,522,71,3996,2193,143,0,0,23023,246,7479,5286,593,11405
2021-07-02 02:00:00+00,10353,993,4699,473,71,3994,2202,143,0,0,22928,246,7445,5243,544,11346
2021-07-02 02:30:00+00,10236,995,4696,423,71,3990,2202,143,0,0,22756,246,7392,5190,494,11231
2021-07-02 03:00:00+00,10241,995,4701,411,71,3802,2201,141,0,0,22563,248,7384,5183,482,11236
2021-07-02 03:30:00+00,10208,993,4699,381,71,3800,2202,140,0,0,22494,248,7353,5151,452,11201
2021-07-02 04:00:00+00,10035,955,4700,384,71,4202,2105,139,30,0,22621,249,7290,5185,485,10990
2021-07-02 04:30:00+00,10494,865,4698,397,71,4210,2063,139,190,0,23127,248,7419,5356,658,11359
2021-07-02 05:00:00+00,11775,799,4696,376,97,4294,2013,139,437,0,24626,246,7619,5606,910,12574
2021-07-02 05:30:00+00,13174,859,4697,392,121,4296,1992,139,811,86,26567,251,8013,6021,1324,14033
2021-07-02 06:00:00+00,14261,978,4698,402,176,4978,2118,294,1168,248,29320,255,8562,6444,1746,15239
2021-07-02 06:30:00+00,14768,991,4701,394,181,4998,2098,624,1679,518,30952,252,9053,6955,2254,15759
2021-07-02 07:00:00+00,15120,994,4704,371,321,4996,2135,748,2252,1066,32707,244,9783,7648,2944,16114
2021-07-02 07:30:00+00,15137,996,4708,387,324,5138,2151,819,2811,1198,33669,238,10381,8230,3522,16133
2021-07-02 08:00:00+00,14973,995,4704,399,324,5442,2199,793,3503,1268,34600,231,11129,8930,4226,15968
2021-07-02 08:30:00+00,14862,995,4707,398,317,5652,2193,808,4075,778,34785,228,11690,9497,4790,15857
2021-07-02 09:00:00+00,14800,995,4706,394,235,5738,2190,920,4774,392,35144,226,12299,10109,5403,15795
2021-07-02 09:30:00+00,14758,993,4711,418,228,5738,2193,648,5598,236,35521,221,13148,10955,6244,15751
2021-07-02 10:00:00+00,14786,991,4707,464,162,5736,2203,538,6189,88,35864,218,13725,11522,6815,15777
2021-07-02 10:30:00+00,14856,995,4708,552,141,5736,2206,536,6620,0,36350,216,14227,12021,7313,15851
2021-07-02 11:00:00+00,14833,994,4709,615,126,5736,2209,563,6785,114,36684,214,14444,12235,7526,15827
2021-07-02 11:30:00+00,14502,992,4714,656,126,5736,2199,595,6919,102,36541,211,14614,12415,7701,15494
2021-07-02 12:00:00+00,14582,992,4708,715,110,5582,2195,495,6743,0,36122,213,14471,12276,7568,15574
2021-07-02 12:30:00+00,14671,989,4707,790,110,5582,2108,151,7117,0,36225,210,14832,12724,8017,15660
2021-07-02 13:00:00+00,14187,898,4709,846,111,5676,2095,141,6903,0,35566,206,14664,12569,7860,15085
2021-07-02 13:30:00+00,13865,863,4706,929,110,5626,2126,141,6129,0,34495,208,14000,11874,7168,14728
2021-07-02 14:00:00+00,14322,896,4706,970,117,5030,2158,219,5562,0,33980,218,13513,11355,6649,15218
2021-07-02 14:30:00+00,14443,951,4704,1035,126,4938,2147,343,5471,0,34158,221,13483,11336,6632,15394
2021-07-02 15:00:00+00,14613,963,4708,1193,136,5014,2189,369,5049,0,34234,223,13275,11086,6378,15576
2021-07-02 15:30:00+00,14939,944,4702,1417,161,5018,2190,413,4168,106,34058,228,12638,10448,5746,15883
2021-07-02 16:00:00+00,15263,943,4701,1526,285,5074,2193,424,3469,280,34158,232,12174,9981,5280,16206
2021-07-02 16:30:00+00,15305,946,4698,1639,297,5074,2165,457,2595,628,33804,236,11394,9229,4531,16251
2021-07-02 17:00:00+00,15255,942,4701,1749,344,5076,2138,437,2054,710,33406,238,10986,8848,4147,16197
2021-07-02 17:30:00+00,15174,938,4698,1777,346,5074,2121,408,1543,732,32811,241,10485,8364,3666,16112
2021-07-02 18:00:00+00,15129,935,4698,1815,312,5074,2129,404,1136,558,32190,245,10090,7961,3263,16064
2021-07-02 18:30:00+00,15087,935,4698,1882,296,5072,2132,319,676,314,31411,249,9684,7552,2854,16022
2021-07-02 19:00:00+00,15051,945,4696,1876,172,5072,2137,163,314,180,30606,254,9195,7058,2362,15996
2021-07-02 19:30:00+00,14723,932,4704,2066,155,5062,2136,140,65,0,29983,254,9126,6990,2286,15655
2021-07-02 20:00:00+00,14414,936,4704,2015,122,4754,2142,148,2,272,29509,252,8985,6843,2139,15350
2021-07-02 20:30:00+00,14072,773,4710,1966,119,4754,2143,217,0,36,28790,249,8938,6795,2085,14845
2021-07-02 21:00:00+00,13313,690,4712,2067,119,4994,2143,186,0,0,28224,242,9041,6898,2186,14003
2021-07-02 21:30:00+00,12099,695,4710,2156,119,4950,2143,139,0,0,27011,234,9128,6985,2275,12794
2021-07-02 22:00:00+00,10624,697,4711,2172,99,4636,2074,206,0,80,25299,228,9056,6982,2271,11321
2021-07-02 22:30:00+00,9588,522,4713,2263,80,4756,2017,197,0,0,24136,217,9073,7056,2343,10110
2021-07-02 23:00:00+00,9366,627,4709,2411,49,3708,2035,141,0,0,23046,213,9204,7169,2460,9993
2021-07-02 23:30:00+00,8773,511,4711,2604,49,3628,2018,142,0,0,22436,203,9382,7364,2653,9284
2021-07-03 00:00:00+00,8873,491,4715,2720,49,3436,1902,142,0,0,22328,202,9386,7484,2769,9364
2021-07-03 00:30:00+00,8947,236,4710,2720,49,3434,1923,151,0,0,22170,194,9402,7479,2769,9183
2021-07-03 01:00:00+00,9121,118,4710,2673,49,3434,1941,141,0,0,22187,192,9373,7432,2722,9239
2021-07-03 01:30:00+00,8929,0,4709,2566,50,3434,1948,143,0,0,21779,187,9273,7325,2616,8929
2021-07-03 02:00:00+00,8871,0,4708,2418,50,3434,1935,179,0,0,21595,188,9111,7176,2468,8871
2021-07-03 02:30:00+00,8784,0,4706,2438,50,3434,1908,198,0,0,21518,187,9102,7194,2488,8784
2021-07-03 03:00:00+00,8585,0,4712,2484,50,3434,1906,203,0,0,21374,185,9152,7246,2534,8585
2021-07-03 03:30:00+00,8358,0,4709,2595,50,3434,1905,183,0,0,21234,181,9259,7354,2645,8358
2021-07-03 04:00:00+00,8261,0,4708,2646,50,3434,1916,141,8,0,21164,180,9328,7412,2704,8261
2021-07-03 04:30:00+00,8411,0,4705,2573,51,3434,1946,139,78,0,21337,181,9353,7407,2702,8411
2021-07-03 05:00:00+00,8677,0,4712,2529,78,3434,1921,139,244,0,21734,183,9484,7563,2851,8677
2021-07-03 05:30:00+00,9198,0,4710,2563,79,3434,1944,145,447,0,22520,185,9743,7799,3089,9198
2021-07-03 06:00:00+00,9764,0,4714,2861,79,3630,1923,266,743,0,23980,185,10320,8397,3683,9764
2021-07-03 06:30:00+00,10617,125,4714,2915,96,3642,1984,240,964,98,25395,193,10673,8689,3975,10742
2021-07-03 07:00:00+00,11028,458,4716,3108,123,4486,2011,218,1226,4,27378,204,11184,9173,4457,11486
2021-07-03 07:30:00+00,11526,836,4719,3261,129,4508,2020,173,1500,0,28672,213,11629,9609,4890,12362
2021-07-03 08:00:00+00,11448,990,4724,3446,221,4988,1950,240,1953,0,29960,210,12294,10344,5620,12438
2021-07-03 08:30:00+00,11653,989,4725,3488,230,4994,2032,218,2085,0,30414,210,12560,10528,5803,12642
2021-07-03 09:00:00+00,11950,919,4721,3479,252,4630,2002,446,2127,282,30808,210,12581,10579,5858,12869
2021-07-03 09:30:00+00,12069,897,4725,3398,251,4624,1964,594,2320,224,31066,210,12658,10694,5969,12966
2021-07-03 10:00:00+00,11890,986,4726,3708,199,4464,1934,655,2546,388,31496,206,13113,11179,6453,12876
2021-07-03 10:30:00+00,11670,987,4725,4101,187,4470,1925,655,3179,196,32095,200,14117,12192,7467,12657
2021-07-03 11:00:00+00,11423,991,4721,4638,160,4916,1941,226,3287,180,32483,192,14747,12806,8085,12414
2021-07-03 11:30:00+00,10973,985,4719,5240,159,4924,2017,151,3403,0,32571,186,15538,13521,8802,11958
2021-07-03 12:00:00+00,10798,719,4718,5313,92,4758,2163,143,3738,0,32442,177,16024,13861,9143,11517
2021-07-03 12:30:00+00,10609,504,4719,5354,84,4752,2174,141,3417,0,31754,173,15748,13574,8855,11113
2021-07-03 13:00:00+00,9985,472,4716,5598,84,4752,2171,141,3913,0,31832,163,16482,14311,9595,10457
2021-07-03 13:30:00+00,9787,493,4715,5642,84,4754,2172,141,3697,0,31485,163,16310,14138,9423,10280
2021-07-03 14:00:00+00,9703,460,4716,5638,83,4752,2176,141,3602,0,31271,163,16215,14039,9323,10163
2021-07-03 14:30:00+00,9701,458,4716,5667,82,4754,2174,141,3762,0,31455,162,16401,14227,9511,10159
2021-07-03 15:00:00+00,10006,460,4714,5840,104,4754,2174,142,3731,0,31925,163,16563,14389,9675,10466
2021-07-03 15:30:00+00,10527,557,4719,6016,123,4754,2173,142,3498,0,32509,169,16529,14356,9637,11084
2021-07-03 16:00:00+00,11030,690,4715,6047,213,4714,2170,143,3124,0,32846,177,16269,14099,9384,11720
2021-07-03 16:30:00+00,11550,775,4711,5650,218,4714,2161,167,2557,0,32503,188,15297,13136,8425,12325
2021-07-03 17:00:00+00,11626,827,4709,4887,280,4754,2172,334,2010,436,32035,195,14058,11886,7177,12453
2021-07-03 17:30:00+00,11694,778,4708,4550,286,4754,2176,408,1393,576,31323,199,13113,10937,6229,12472
2021-07-03 18:00:00+00,11762,780,4710,4363,278,4680,2181,423,897,618,30692,204,12429,10248,5538,12542
2021-07-03 18:30:00+00,11574,755,4709,4351,275,4682,2176,446,615,406,29989,205,12126,9950,5241,12329
2021-07-03 19:00:00+00,11164,784,4709,4578,189,4504,2179,452,334,28,28921,208,11989,9810,5101,11948
2021-07-03 19:30:00+00,10971,693,4709,4753,169,4500,2175,183,98,102,28353,204,11904,9729,5020,11664
2021-07-03 20:00:00+00,10429,496,4710,4695,133,4492,2176,143,4,396,27674,194,11718,9542,4832,10925
2021-07-03 20:30:00+00,10347,461,4712,4693,128,4490,2173,141,0,24,27169,195,11706,9533,4821,10808
2021-07-03 21:00:00+00,10639,429,4716,4648,100,4264,2176,140,0,58,27170,198,11640,9464,4748,11068
2021-07-03 21:30:00+00,10234,195,4716,4703,99,4260,2167,141,0,0,26515,188,11685,9518,4802,10429
2021-07-03 22:00:00+00,9328,0,4720,4717,99,4022,2032,141,0,126,25185,175,11568,9536,4816,9328
2021-07-03 22:30:00+00,8697,0,4717,4775,86,4018,1741,141,0,0,24175,171,11319,9578,4861,8697
2021-07-03 23:00:00+00,8219,0,4718,4558,55,3776,1590,149,0,2,23067,169,10921,9331,4613,8219
2021-07-03 23:30:00+00,7520,0,4718,4288,55,3770,1569,346,0,20,22286,165,10630,9061,4343,7520
2021-07-04 00:00:00+00,7402,0,4720,4232,55,3532,1567,344,0,0,21852,165,10574,9007,4287,7402
2021-07-04 00:30:00+00,7284,0,4720,4216,55,3528,1611,261,0,0,21675,163,10602,8991,4271,7284
2021-07-04 01:00:00+00,6970,0,4720,4250,55,3532,1546,141,0,0,21214,159,10571,9025,4305,6970
2021-07-04 01:30:00+00,6793,0,4717,4267,55,3532,1558,142,0,0,21064,157,10597,9039,4322,6793
2021-07-04 02:00:00+00,6976,0,4713,3884,55,3530,1540,142,0,0,20840,162,10192,8652,3939,6976
2021-07-04 02:30:00+00,7149,0,4715,3601,55,3530,1512,141,0,0,20703,166,9883,8371,3656,7149
2021-07-04 03:00:00+00,7202,0,4715,3399,55,3512,1502,140,0,0,20525,168,9671,8169,3454,7202
2021-07-04 03:30:00+00,7204,0,4711,3173,55,3510,1495,141,0,0,20289,170,9434,7939,3228,7204
2021-07-04 04:00:00+00,7198,0,4710,3095,55,3464,1498,140,51,0,20211,171,9409,7911,3201,7198
2021-07-04 04:30:00+00,7129,86,4713,3030,55,3462,1490,139,226,0,20330,172,9514,8024,3311,7214
2021-07-04 05:00:00+00,6590,171,4713,3158,82,3520,1485,140,452,0,20311,166,9890,8405,3692,6761
2021-07-04 05:30:00+00,7052,230,4709,3099,83,3536,1507,139,786,0,21141,170,10184,8677,3968,7282
2021-07-04 06:00:00+00,7450,235,4711,2963,82,3778,1776,142,1126,0,22263,172,10658,8882,4171,7685
2021-07-04 06:30:00+00,8186,232,4711,2863,77,3774,1887,140,1507,0,23377,177,11045,9158,4447,8418
2021-07-04 07:00:00+00,8905,528,4711,2807,96,4254,2008,142,1933,0,25384,187,11555,9547,4836,9433
2021-07-04 07:30:00+00,9806,765,4712,2720,95,4266,2012,141,2244,0,26761,199,11783,9771,5059,10571
2021-07-04 08:00:00+00,10269,853,4714,2709,77,4746,2063,142,2552,0,28125,201,12115,10052,5338,11122
2021-07-04 08:30:00+00,10785,927,4717,2644,77,4754,2172,142,3124,0,29342,203,12734,10562,5845,11712
2021-07-04 09:00:00+00,11552,792,4721,2561,108,4752,2104,153,3280,0,30023,204,12774,10670,5949,12344
2021-07-04 09:30:00+00,11687,803,4721,2491,112,4752,2133,146,3808,0,30653,202,13265,11132,6411,12490
2021-07-04 10:00:00+00,11499,890,4719,2581,207,4752,2110,152,4191,0,31101,199,13808,11698,6979,12389
2021-07-04 10:30:00+00,11279,911,4722,2687,210,4752,2212,151,4742,2,31668,194,14573,12361,7639,12190
2021-07-04 11:00:00+00,11397,913,4718,2815,194,4752,2230,185,5267,0,32471,191,15224,12994,8276,12310
2021-07-04 11:30:00+00,11256,962,4715,2921,195,4752,2246,164,5371,0,32582,190,15448,13202,8487,12218
2021-07-04 12:00:00+00,10910,808,4714,3100,86,4996,2254,143,4822,0,31833,186,14976,12722,8008,11718
2021-07-04 12:30:00+00,10733,807,4714,3219,81,5000,2152,141,5106,0,31953,183,15272,13120,8406,11540
2021-07-04 13:00:00+00,10893,829,4711,3269,81,4702,1913,140,4628,0,31166,187,14602,12689,7978,11722
2021-07-04 13:30:00+00,10788,642,4707,3540,81,4700,1924,140,4699,0,31221,180,14951,13027,8320,11430
2021-07-04 14:00:00+00,10916,572,4705,3465,81,4824,2028,139,4087,0,30817,183,14366,12338,7633,11488
2021-07-04 14:30:00+00,11130,684,4704,3579,80,4824,2140,147,4000,0,31288,187,14503,12363,7659,11814
2021-07-04 15:00:00+00,11452,854,4701,3847,92,4518,2196,191,3932,30,31813,189,14768,12572,7871,12306
2021-07-04 15:30:00+00,11540,966,4700,4006,100,4562,2187,356,3602,254,32273,193,14595,12408,7708,12506
2021-07-04 16:00:00+00,11631,964,4700,4346,244,4818,2161,449,2795,608,32716,194,14246,12085,7385,12595
2021-07-04 16:30:00+00,11551,893,4705,4434,253,4816,2186,488,2234,860,32420,193,13812,11626,6921,12444
2021-07-04 17:00:00+00,11538,898,4699,4389,253,4888,2168,453,1749,982,32017,196,13258,11090,6391,12436
2021-07-04 17:30:00+00,11437,891,4702,4718,253,4888,2205,395,1322,796,31607,197,13200,10995,6293,12328
2021-07-04 18:00:00+00,11137,944,4704,4932,243,4848,2247,271,1110,686,31122,196,13236,10989,6285,12081
2021-07-04 18:30:00+00,10564,968,4704,5330,235,4850,2285,256,672,622,30486,194,13226,10941,6237,11532
2021-07-04 19:00:00+00,10581,947,4703,5319,143,4996,2259,255,344,290,29837,200,12768,10509,5806,11528
2021-07-04 19:30:00+00,10542,847,4699,5375,127,4992,2277,266,94,0,29219,200,12572,10295,5596,11389
2021-07-04 20:00:00+00,10270,563,4700,5327,71,4682,2415,315,4,146,28493,192,12517,10102,5402,10833
2021-07-04 20:30:00+00,10038,199,4699,5330,71,4674,2417,304,0,14,27746,181,12517,10100,5401,10237
2021-07-04 21:00:00+00,9693,0,4700,5778,71,4510,2394,317,0,0,27463,171,12943,10549,5849,9693
2021-07-04 21:30:00+00,8890,0,4705,5952,71,4508,2232,303,0,0,26661,163,12960,10728,6023,8890
2021-07-04 22:00:00+00,7679,0,4710,6046,71,3772,2292,189,0,128,24887,152,13119,10827,6117,7679
2021-07-04 22:30:00+00,6369,0,4709,6040,65,3758,2255,190,0,74,23460,139,13069,10814,6105,6369
2021-07-04 23:00:00+00,5979,0,4713,5916,55,3528,2268,194,0,0,22653,136,12952,10684,5971,5979
2021-07-04 23:30:00+00,5397,0,4716,6171,55,3520,2214,194,0,0,22267,128,13156,10942,6226,5397
2021-07-05 00:00:00+00,5761,0,4715,6479,55,3182,2190,194,0,0,22576,127,13439,11249,6534,5761
2021-07-05 00:30:00+00,5559,0,4720,6650,55,3178,2265,194,0,0,22621,123,13690,11425,6705,5559
2021-07-05 01:00:00+00,5514,0,4714,6592,55,2830,2355,194,0,0,22254,124,13716,11361,6647,5514
2021-07-05 01:30:00+00,5653,0,4713,6116,55,2826,2420,193,0,0,21976,129,13304,10884,6171,5653
2021-07-05 02:00:00+00,5817,0,4713,5930,55,2774,2319,194,0,0,21802,132,13017,10698,5985,5817
2021-07-05 02:30:00+00,5620,0,4712,6175,55,2772,2273,193,0,0,21800,128,13215,10942,6230,5620
2021-07-05 03:00:00+00,5504,0,4710,6509,55,2620,2281,192,0,0,21871,125,13555,11274,6564,5504
2021-07-05 03:30:00+00,5243,0,4709,6549,55,2614,2276,140,0,0,21586,122,13589,11313,6604,5243
2021-07-05 04:00:00+00,5331,23,4705,6257,55,2406,2291,142,4,0,21214,123,13312,11021,6316,5354
2021-07-05 04:30:00+00,5575,53,4707,6496,56,2422,2375,141,115,0,21940,125,13748,11374,6666,5628
2021-07-05 05:00:00+00,6680,99,4705,6440,83,3298,2278,141,349,24,24097,137,13855,11577,6872,6779
2021-07-05 05:30:00+00,8694,166,4705,6313,83,3316,2346,141,678,0,26442,158,14125,11779,7074,8860
2021-07-05 06:00:00+00,11293,224,4704,5921,83,3238,2329,142,1266,110,29310,181,14303,11974,7270,11517
2021-07-05 06:30:00+00,12316,290,4701,5679,83,3232,2337,116,1896,194,30844,187,14696,12359,7658,12606
2021-07-05 07:00:00+00,12617,281,4702,5359,103,4466,2335,116,2563,166,32708,187,15062,12727,8025,12898
2021-07-05 07:30:00+00,12854,270,4703,5341,103,4492,2330,115,3402,146,33756,184,15879,13549,8846,13124
2021-07-05 08:00:00+00,12879,252,4699,5254,120,4598,2341,116,4257,260,34776,180,16671,14330,9631,13131
2021-07-05 08:30:00+00,12884,294,4699,4852,121,4600,2352,133,4865,168,34968,180,16889,14537,9838,13178
2021-07-05 09:00:00+00,12581,288,4703,4837,186,4884,2334,141,5085,78,35117,175,17145,14811,10108,12869
2021-07-05 09:30:00+00,12370,299,4705,4917,195,4892,2236,144,5477,4,35239,170,17530,15294,10589,12669
2021-07-05 10:00:00+00,12547,256,4720,4782,236,4958,2140,144,5708,18,35509,170,17586,15446,10726,12803
2021-07-05 10:30:00+00,12485,281,4711,4855,236,4954,2132,144,6031,0,35829,169,17965,15833,11122,12766
2021-07-05 11:00:00+00,12625,307,4710,5014,221,4604,2253,147,6284,0,36165,170,18482,16229,11519,12932
2021-07-05 11:30:00+00,12514,298,4711,5172,193,4594,2292,146,6235,0,36155,168,18603,16311,11600,12812
2021-07-05 12:00:00+00,12339,254,4710,4923,84,4972,2357,144,6665,108,36556,164,18739,16382,11672,12593
2021-07-05 12:30:00+00,12102,301,4707,5159,83,4978,2363,145,6255,0,36093,165,18567,16204,11497,12403
2021-07-05 13:00:00+00,12245,305,4707,5033,83,4960,2360,153,5634,168,35648,168,17817,15457,10750,12550
2021-07-05 13:30:00+00,12449,380,4705,4862,83,4962,2358,146,5052,130,35127,175,17060,14702,9997,12829
2021-07-05 14:00:00+00,12640,648,4706,4994,83,4838,2343,144,4437,0,34833,186,16563,14220,9514,13288
2021-07-05 14:30:00+00,13064,1047,4702,4964,90,4840,2361,148,3701,110,35027,200,15818,13457,8755,14111
2021-07-05 15:00:00+00,13629,1265,4705,5023,99,4850,2366,274,3056,160,35427,212,15249,12883,8178,14894
2021-07-05 15:30:00+00,14211,1285,4703,4769,127,4848,2368,319,2507,764,35901,216,14474,12106,7403,15496
2021-07-05 16:00:00+00,14367,1280,4705,4257,253,4796,2421,394,1814,1546,35833,219,13450,11029,6324,15647
2021-07-05 16:30:00+00,14961,1288,4704,3891,248,4798,2429,518,1465,1596,35898,227,12737,10308,5604,16249
2021-07-05 17:00:00+00,15161,1284,4707,3642,292,4796,2422,512,1093,1436,35345,232,12156,9734,5027,16445
2021-07-05 17:30:00+00,15124,1271,4711,3675,301,4796,2422,515,779,1408,35002,234,11888,9466,4755,16395
2021-07-05 18:00:00+00,14808,1266,4712,3895,306,4796,2418,502,469,1280,34452,234,11800,9382,4670,16074
2021-07-05 18:30:00+00,14391,1260,4712,4257,312,4798,2394,401,270,964,33759,233,11945,9551,4839,15651
2021-07-05 19:00:00+00,14427,1291,4708,4120,276,4976,2381,342,121,446,33088,238,11606,9225,4517,15718
2021-07-05 19:30:00+00,14152,1268,4705,4246,252,4974,2374,296,39,4,32310,240,11616,9242,4537,15420
2021-07-05 20:00:00+00,13940,1245,4710,4193,191,4716,2407,164,1,0,31567,238,11502,9095,4385,15185
2021-07-05 20:30:00+00,12825,1151,4712,4561,182,4710,2417,139,0,0,30697,227,11872,9455,4743,13976
2021-07-05 21:00:00+00,11301,1107,4710,4844,172,4606,2383,139,0,0,29262,217,12109,9726,5016,12408
2021-07-05 21:30:00+00,9550,993,4707,5518,168,4594,2109,139,0,0,27778,198,12502,10393,5686,10543
2021-07-05 22:00:00+00,8523,969,4705,5895,140,4024,1635,139,0,0,26030,191,12375,10740,6035,9492
2021-07-05 22:30:00+00,7083,937,4708,6225,132,4008,1440,140,0,0,24673,176,12505,11065,6357,8020
2021-07-05 23:00:00+00,6613,910,4706,6344,110,3438,1453,141,0,0,23715,172,12613,11160,6454,7523
2021-07-05 23:30:00+00,6321,818,4709,6247,98,3448,1466,142,0,0,23249,167,12520,11054,6345,7139
2021-07-06 00:00:00+00,6275,542,4711,5789,77,3458,1606,140,0,0,22598,157,12183,10577,5866,6817
2021-07-06 00:30:00+00,6355,272,4708,5809,77,3486,1664,142,0,0,22513,149,12258,10594,5886,6627
2021-07-06 01:00:00+00,5975,282,4710,6406,77,3594,1642,213,0,0,22899,144,12835,11193,6483,6257
2021-07-06 01:30:00+00,5532,270,4713,6803,78,3482,1542,258,0,0,22678,135,13136,11594,6881,5802
2021-07-06 02:00:00+00,5467,161,4710,6769,80,3528,1455,259,0,0,22429,132,13014,11559,6849,5628
2021-07-06 02:30:00+00,5560,288,4711,6906,81,3450,1441,232,0,0,22669,135,13139,11698,6987,5848
2021-07-06 03:00:00+00,5459,303,4710,6956,81,3448,1452,141,0,0,22550,132,13199,11747,7037,5762
2021-07-06 03:30:00+00,5284,304,4710,7153,81,3432,1437,141,0,0,22542,129,13381,11944,7234,5588
2021-07-06 04:00:00+00,5002,248,4713,7640,81,3436,1417,141,22,0,22700,121,13873,12456,7743,5250
2021-07-06 04:30:00+00,5180,269,4711,7957,81,3442,1426,141,160,0,23367,121,14335,12909,8198,5449
2021-07-06 05:00:00+00,5910,304,4710,8210,104,3544,1491,142,295,0,24710,129,14810,13319,8609,6214
2021-07-06 05:30:00+00,7052,300,4704,8217,107,3564,2077,142,504,0,26667,139,15609,13532,8828,7352
2021-07-06 06:00:00+00,8270,473,4704,8139,125,4497,2289,142,794,0,29433,151,16051,13762,9058,8743
2021-07-06 06:30:00+00,9164,830,4700,8132,148,4502,2306,141,1248,36,31207,165,16534,14228,9528,9994
2021-07-06 07:00:00+00,9573,1101,4705,8157,217,4748,2297,146,1674,152,32770,170,17050,14753,10048,10674
2021-07-06 07:30:00+00,9861,1274,4704,7792,220,4750,2361,150,2296,288,33696,174,17373,15012,10308,11135
2021-07-06 08:00:00+00,9910,1292,4705,7266,220,4750,2350,148,2857,622,34120,173,17398,15048,10343,11202
2021-07-06 08:30:00+00,9683,1247,4708,7213,211,4752,2349,284,3369,626,34442,169,17850,15501,10793,10930
2021-07-06 09:00:00+00,9623,1268,4707,7160,211,4802,2347,355,3993,216,34682,169,18418,16071,11364,10891
2021-07-06 09:30:00+00,9619,1262,4709,7055,209,4800,2359,300,4433,224,34970,166,18765,16406,11697,10881
2021-07-06 10:00:00+00,9729,1258,4709,7104,176,4558,2326,332,4329,450,34971,168,18644,16318,11609,10987
2021-07-06 10:30:00+00,10030,1264,4709,7054,153,4556,2322,425,5195,376,36084,167,19433,17111,12402,11294
2021-07-06 11:00:00+00,10107,1264,4710,7141,91,4266,2318,453,4608,462,35420,171,18868,16550,11840,11371
2021-07-06 11:30:00+00,10113,1252,4714,7390,90,4270,2307,439,5174,188,35937,168,19675,17368,12654,11365
2021-07-06 12:00:00+00,9975,1176,4714,7922,73,4172,2334,210,4801,94,35471,165,19844,17510,12796,11151
2021-07-06 12:30:00+00,9473,1030,4721,8590,58,4158,2333,143,5372,0,35878,152,21074,18741,14020,10503
2021-07-06 13:00:00+00,9044,983,4722,9078,59,4062,2379,142,5070,0,35539,148,21308,18929,14207,10027
2021-07-06 13:30:00+00,8628,713,4721,9751,60,4076,2171,150,5665,0,35935,134,22368,20197,15476,9341
2021-07-06 14:00:00+00,8746,586,4718,9917,60,4028,2083,142,4921,0,35201,134,21699,19616,14898,9332
2021-07-06 14:30:00+00,9123,606,4710,9928,61,4020,2176,143,4211,0,34978,140,21086,18910,14200,9729
2021-07-06 15:00:00+00,9402,700,4709,9716,73,4196,2198,188,3633,0,34815,147,20329,18131,13422,10102
2021-07-06 15:30:00+00,9764,753,4709,9602,127,4206,2349,340,3634,0,35484,152,20421,18072,13363,10517
2021-07-06 16:00:00+00,9942,746,4707,9532,267,4452,2387,401,2854,490,35778,153,19747,17360,12653,10688
2021-07-06 16:30:00+00,10418,831,4705,9205,278,4462,2382,411,2253,532,35477,162,18823,16441,11736,11249
2021-07-06 17:00:00+00,10396,764,4698,8743,260,5064,2351,422,1853,784,35335,162,17905,15554,10856,11160
2021-07-06 17:30:00+00,10475,747,4697,8358,304,5074,2368,422,1374,998,34817,165,17101,14733,10036,11222
2021-07-06 18:00:00+00,10482,707,4701,8414,473,5018,2419,409,765,474,33862,168,16772,14353,9652,11189
2021-07-06 18:30:00+00,10518,634,4701,8091,410,5016,2424,406,497,506,33203,170,16123,13699,8998,11152
2021-07-06 19:00:00+00,10366,617,4703,7709,317,5030,2424,376,228,84,31854,175,15381,12957,8254,10983
2021-07-06 19:30:00+00,9937,553,4706,7748,238,5008,2415,337,68,382,31392,169,15175,12760,8054,10490
2021-07-06 20:00:00+00,10294,485,4703,7780,179,4528,2329,252,2,120,30672,173,14993,12664,7961,10779
2021-07-06 20:30:00+00,9830,479,4703,7735,165,4516,2321,195,0,132,30076,169,14924,12603,7900,10309
2021-07-06 21:00:00+00,9688,462,4703,7825,165,3990,2297,170,0,150,29450,168,14990,12693,7990,10150
2021-07-06 21:30:00+00,9042,421,4702,7903,129,3970,2054,170,0,88,28479,162,14788,12734,8032,9463
2021-07-06 22:00:00+00,8476,229,4701,8154,62,3442,1484,170,0,0,26718,154,14401,12917,8216,8705
2021-07-06 22:30:00+00,6570,233,4696,8337,59,3430,1446,171,0,0,24942,135,14538,13092,8396,6803
2021-07-06 23:00:00+00,5382,230,4697,8397,59,3430,1442,146,0,0,23783,121,14595,13153,8456,5612
2021-07-06 23:30:00+00,4796,149,4696,8379,59,3430,1456,141,0,0,23106,111,14590,13134,8438,4945
2021-07-07 00:00:00+00,5121,0,4702,8578,58,3430,1446,142,0,0,23477,113,14784,13338,8636,5121
2021-07-07 00:30:00+00,5266,0,4697,8598,58,3430,1462,142,0,0,23653,114,14815,13353,8656,5266
2021-07-07 01:00:00+00,5189,0,4700,8532,57,3430,1447,141,0,0,23496,114,14736,13289,8589,5189
2021-07-07 01:30:00+00,5188,0,4699,8393,57,3430,1459,142,0,0,23368,114,14608,13149,8450,5188
2021-07-07 02:00:00+00,5152,0,4703,8210,57,3432,1445,140,0,0,23139,115,14415,12970,8267,5152
2021-07-07 02:30:00+00,5203,0,4703,8149,57,3430,1445,141,0,0,23128,116,14354,12909,8206,5203
2021-07-07 03:00:00+00,5239,0,4707,8097,57,3434,1424,140,0,0,23098,116,14285,12861,8154,5239
2021-07-07 03:30:00+00,5355,0,4707,7856,57,3430,1435,141,0,0,22980,119,14054,12620,7912,5355
2021-07-07 04:00:00+00,5548,0,4707,7583,57,3294,1426,139,7,0,22761,123,13780,12354,7647,5548
2021-07-07 04:30:00+00,6095,0,4711,7525,57,3292,1443,141,69,0,23333,129,13805,12362,7651,6095
2021-07-07 05:00:00+00,7260,0,4710,7411,116,3394,1851,141,235,0,25118,142,14323,12472,7762,7260
2021-07-07 05:30:00+00,8462,0,4712,7378,118,3336,2230,142,459,0,26837,152,14897,12667,7955,8462
2021-07-07 06:00:00+00,10292,166,4710,7239,118,4182,2266,141,817,0,29931,167,15150,12884,8174,10458
2021-07-07 06:30:00+00,11614,568,4709,6981,136,4222,1910,142,1225,4,31511,185,14961,13051,8342,12182
2021-07-07 07:00:00+00,11933,883,4710,6984,180,4798,2016,165,1635,146,33450,192,15526,13510,8800,12816
2021-07-07 07:30:00+00,12069,968,4714,6913,184,4802,2181,232,2127,140,34330,192,16119,13938,9224,13037
2021-07-07 08:00:00+00,12272,979,4717,6763,202,4588,2285,161,2782,292,35041,190,16749,14464,9747,13251
2021-07-07 08:30:00+00,12326,981,4713,6496,223,4054,2360,229,3207,608,35197,190,16999,14639,9926,13307
2021-07-07 09:00:00+00,12044,989,4710,6316,223,3932,2425,278,4150,376,35443,187,17824,15399,10689,13033
2021-07-07 09:30:00+00,12096,986,4708,6260,213,3932,2418,363,4478,230,35684,187,18077,15659,10951,13082
2021-07-07 10:00:00+00,12224,985,4706,6347,368,3452,2418,404,4826,280,36010,187,18665,16247,11541,13209
2021-07-07 10:30:00+00,12419,982,4699,6389,373,3448,2423,327,5270,194,36524,185,19154,16731,12032,13401
2021-07-07 11:00:00+00,12540,985,4706,6554,149,3586,2422,231,5283,178,36634,186,19114,16692,11986,13525
2021-07-07 11:30:00+00,12735,987,4703,6675,115,3586,2425,272,5622,84,37204,185,19540,17115,12412,13722
2021-07-07 12:00:00+00,12596,888,4715,6604,59,3772,2414,229,5402,0,36679,183,19194,16780,12065,13484
2021-07-07 12:30:00+00,12452,815,4718,6442,57,3774,2425,205,5517,0,36405,180,19159,16734,12016,13267
2021-07-07 13:00:00+00,12426,813,4720,6439,84,3782,2305,140,5116,0,35825,182,18664,16359,11639,13239
2021-07-07 13:30:00+00,12258,694,4720,6471,99,3778,2265,143,5178,0,35606,178,18733,16468,11748,12952
2021-07-07 14:00:00+00,12151,527,4719,6470,97,3992,2230,139,5030,0,35355,174,18546,16316,11597,12678
2021-07-07 14:30:00+00,12385,632,4715,6478,84,3994,2248,143,4565,0,35244,180,18090,15842,11127,13017
2021-07-07 15:00:00+00,12701,623,4710,6560,183,4028,2299,154,4152,0,35410,183,17904,15605,10895,13324
2021-07-07 15:30:00+00,13395,624,4703,6603,201,4028,2416,173,3282,0,35425,191,17205,14789,10086,14019
2021-07-07 16:00:00+00,13976,700,4703,6264,290,4084,2420,252,3307,206,36202,197,16984,14564,9861,14676
2021-07-07 16:30:00+00,14213,742,4702,5866,290,4086,2419,336,2911,412,35977,203,16188,13769,9067,14955
2021-07-07 17:00:00+00,14248,822,4702,5467,284,4086,2417,357,2453,572,35408,209,15323,12906,8204,15070
2021-07-07 17:30:00+00,14370,883,4700,5146,282,4086,2416,323,1739,602,34547,217,14283,11867,7167,15253
2021-07-07 18:00:00+00,14302,963,4705,4667,337,3926,2431,376,1232,592,33531,223,13372,10941,6236,15265
2021-07-07 18:30:00+00,13578,983,4703,4181,430,4702,2422,357,813,504,32673,222,12549,10127,5424,14561
2021-07-07 19:00:00+00,13442,955,4706,4120,445,4630,2393,295,412,6,31404,225,12076,9683,4977,14397
2021-07-07 19:30:00+00,13001,794,4710,4186,424,4620,2392,240,131,292,30790,218,11843,9451,4741,13795
2021-07-07 20:00:00+00,13110,812,4712,4067,244,4198,2393,210,8,62,29816,224,11424,9031,4319,13922
2021-07-07 20:30:00+00,12639,732,4712,4122,107,4196,2272,146,0,212,29138,219,11213,8941,4229,13371
2021-07-07 21:00:00+00,12342,460,4712,4079,81,4578,2294,141,0,18,28705,214,11166,8872,4160,12802
2021-07-07 21:30:00+00,12078,241,4707,4063,99,4580,1946,140,0,280,28134,206,10815,8869,4162,12319
2021-07-07 22:00:00+00,11809,232,4706,4001,96,4218,1419,145,0,160,26786,208,10222,8803,4097,12041
2021-07-07 22:30:00+00,10381,231,4710,3952,87,4216,1359,139,0,0,25075,199,10108,8749,4039,10612
2021-07-07 23:00:00+00,9931,104,4708,3986,83,4214,1389,141,0,0,24556,192,10166,8777,4069,10035
2021-07-07 23:30:00+00,9792,52,4702,3949,82,4210,1440,139,0,0,24366,190,10173,8733,4031,9844
2021-07-08 00:00:00+00,9838,0,4701,3557,74,4262,1444,141,0,0,24017,193,9776,8332,3631,9838
2021-07-08 00:30:00+00,9977,0,4708,3184,72,4264,1440,140,0,0,23785,198,9404,7964,3256,9977
2021-07-08 01:00:00+00,9692,0,4710,3082,72,4264,1444,142,0,0,23406,196,9308,7864,3154,9692
2021-07-08 01:30:00+00,9318,0,4713,3177,72,4264,1441,140,0,0,23125,192,9403,7962,3249,9318
2021-07-08 02:00:00+00,8907,0,4714,3273,72,4264,1444,141,0,0,22815,187,9503,8059,3345,8907
2021-07-08 02:30:00+00,8758,0,4714,3391,72,4264,1442,140,0,0,22781,185,9619,8177,3463,8758
2021-07-08 03:00:00+00,9023,0,4713,3162,72,4242,1426,140,0,0,22778,190,9373,7947,3234,9023
2021-07-08 03:30:00+00,9115,0,4713,3024,72,4240,1413,139,0,0,22716,192,9222,7809,3096,9115
2021-07-08 04:00:00+00,9749,0,4716,2760,72,3784,1427,143,18,0,22669,199,8993,7566,2850,9749
2021-07-08 04:30:00+00,9922,0,4720,2344,72,3766,1560,141,153,0,22679,202,8850,7290,2569,9922
2021-07-08 05:00:00+00,10547,18,4721,2132,96,3112,1864,142,418,0,23050,202,9231,7367,2646,10565
2021-07-08 05:30:00+00,11334,277,4723,2026,103,3076,2210,140,757,42,24688,213,9820,7610,2886,11611
2021-07-08 06:00:00+00,12552,462,4722,1864,141,3838,2363,182,1235,120,27479,222,10325,7962,3240,13014
2021-07-08 06:30:00+00,13688,494,4719,1886,153,3876,2377,341,1845,286,29666,224,10981,8604,3884,14182
2021-07-08 07:00:00+00,14584,495,4720,1869,215,4964,2387,360,2395,214,32204,225,11586,9199,4479,15079
2021-07-08 07:30:00+00,15094,494,4720,1869,214,5000,2391,330,3021,498,33632,222,12216,9825,5104,15588
2021-07-08 08:00:00+00,15402,493,4717,1774,231,4910,2390,273,3415,468,34072,220,12527,10137,5420,15895
2021-07-08 08:30:00+00,15621,495,4711,1687,226,4908,2390,247,4126,190,34602,220,13141,10750,6039,16116
2021-07-08 09:00:00+00,15768,493,4696,1577,154,4828,2389,282,4719,172,35078,218,13535,11146,6450,16261
2021-07-08 09:30:00+00,15745,81,4680,594,26,4844,2382,46,5371,22,33791,212,13053,10671,5991,15826
2021-07-08 10:00:00+00,15730,40,4678,429,0,4936,2382,0,5447,0,33642,212,12935,10554,5876,15771
2021-07-08 10:30:00+00,15682,0,4679,439,0,4986,2382,0,5796,0,33964,209,13297,10915,6235,15682
2021-07-08 11:00:00+00,15714,244,4688,996,65,5258,2382,101,5992,152,35592,210,14123,11741,7053,15958
2021-07-08 11:30:00+00,15656,488,4693,1558,119,5214,2378,190,5816,330,36442,212,14564,12186,7493,16144
2021-07-08 12:00:00+00,15588,489,4696,1619,74,4890,2374,179,5870,362,36141,210,14633,12259,7563,16077
2021-07-08 12:30:00+00,15363,488,4697,1694,76,4888,2368,142,6146,340,36203,207,14982,12613,7916,15851
2021-07-08 13:00:00+00,15278,490,4698,1799,76,4992,2364,142,6032,242,36114,206,14969,12605,7907,15768
2021-07-08 13:30:00+00,15162,491,4698,1891,71,5000,2360,179,5378,0,35230,211,14398,12038,7340,15653
2021-07-08 14:00:00+00,15164,489,4698,1848,59,4992,2358,199,5298,0,35105,211,14260,11902,7205,15653
2021-07-08 14:30:00+00,15321,489,4699,1689,92,4992,2357,267,4745,216,34867,215,13583,11225,6526,15810
2021-07-08 15:00:00+00,15578,487,4700,1685,174,5018,2357,361,4257,218,34835,220,13173,10816,6116,16065
2021-07-08 15:30:00+00,16063,486,4702,1653,187,5020,2360,351,3567,834,35223,222,12469,10109,5407,16549
2021-07-08 16:00:00+00,16480,487,4703,1558,277,5078,2362,408,2999,1428,35780,225,11899,9537,4834,16967
2021-07-08 16:30:00+00,16593,487,4704,1527,276,5078,2363,418,2456,1568,35470,228,11326,8963,4259,17080
2021-07-08 17:00:00+00,16590,489,4699,1451,277,5076,2363,459,1986,1594,34984,232,10776,8413,3714,17079
2021-07-08 17:30:00+00,16392,488,4694,1298,389,5076,2357,467,1642,1708,34511,233,10380,8023,3329,16880
2021-07-08 18:00:00+00,16442,489,4694,1238,467,5018,2362,462,1251,1582,34005,236,10012,7650,2956,16931
2021-07-08 18:30:00+00,16439,491,4692,1133,465,5018,2361,442,803,1446,33290,241,9454,7093,2401,16930
2021-07-08 19:00:00+00,16538,489,4691,1103,348,4976,2417,412,418,1024,32416,248,8977,6560,1869,17027
2021-07-08 19:30:00+00,16494,490,4691,1085,230,4978,2430,419,119,762,31698,253,8555,6125,1434,16984
2021-07-08 20:00:00+00,16367,490,4695,980,152,4998,2428,391,7,424,30932,258,8262,5834,1139,16857
2021-07-08 20:30:00+00,16345,458,4697,876,150,5000,2431,350,0,144,30451,260,8154,5723,1026,16803
2021-07-08 21:00:00+00,16177,401,4698,897,81,4998,2385,227,0,24,29888,260,8061,5676,978,16578
2021-07-08 21:30:00+00,15099,414,4691,959,79,4980,2110,143,0,28,28503,255,7839,5729,1038,15513
2021-07-08 22:00:00+00,13913,407,4691,972,77,4404,1778,139,0,274,26655,252,7518,5740,1049,14320
2021-07-08 22:30:00+00,12968,404,4690,997,66,4386,1591,139,0,0,25241,250,7344,5753,1063,13372
2021-07-08 23:00:00+00,12453,382,4692,918,56,4264,1443,139,0,0,24347,249,7109,5666,974,12835
2021-07-08 23:30:00+00,12199,242,4683,865,56,4266,1445,141,0,0,23897,244,7049,5604,921,12441
2021-07-09 00:00:00+00,12021,0,4689,814,56,4262,1440,140,0,0,23422,237,6999,5559,870,12021
2021-07-09 00:30:00+00,11968,0,4688,721,56,4262,1446,140,0,0,23281,237,6911,5465,777,11968
2021-07-09 01:00:00+00,12156,0,4691,664,56,4266,1440,141,0,0,23414,239,6851,5411,720,12156
2021-07-09 01:30:00+00,12063,0,4698,660,56,4262,1439,141,0,0,23319,239,6853,5414,716,12063
2021-07-09 02:00:00+00,11856,0,4697,638,56,4266,1453,141,0,0,23107,237,6844,5391,694,11856
2021-07-09 02:30:00+00,11804,0,4700,650,56,4266,1436,141,0,0,23053,237,6842,5406,706,11804
2021-07-09 03:00:00+00,11817,0,4700,625,56,4264,1436,140,0,0,23038,237,6817,5381,681,11817
2021-07-09 03:30:00+00,12035,0,4702,563,56,4234,1430,140,0,0,23160,240,6751,5321,619,12035
2021-07-09 04:00:00+00,12607,0,4701,532,56,3000,1422,142,12,0,22472,251,6723,5301,600,12607
2021-07-09 04:30:00+00,13095,10,4700,552,56,2968,1557,140,160,0,23238,252,7025,5468,768,13105
2021-07-09 05:00:00+00,13808,35,4699,557,119,3300,1921,139,470,0,25048,249,7766,5845,1146,13843
2021-07-09 05:30:00+00,14835,118,4700,536,122,3334,2295,140,857,0,26937,251,8510,6215,1515,14953
2021-07-09 06:00:00+00,15678,310,4695,473,127,4394,2432,141,1316,110,29676,251,9043,6611,1916,15988
2021-07-09 06:30:00+00,16166,566,4700,412,137,4416,2435,320,1988,212,31352,253,9672,7237,2537,16732
2021-07-09 07:00:00+00,16416,683,4701,385,236,4748,2435,559,2582,288,33033,249,10339,7904,3203,17099
2021-07-09 07:30:00+00,16718,690,4701,365,229,4754,2410,587,3052,206,33712,248,10757,8347,3646,17408
2021-07-09 08:00:00+00,16656,690,4700,399,235,4754,2418,648,3739,298,34537,242,11491,9073,4373,17346
2021-07-09 08:30:00+00,16493,690,4693,415,235,4754,2415,534,4273,378,34880,237,12031,9616,4923,17183
2021-07-09 09:00:00+00,16535,689,4693,440,219,4758,2383,277,4680,470,35144,233,12415,10032,5339,17224
2021-07-09 09:30:00+00,16477,689,4688,461,217,4756,2397,212,4964,422,35283,231,12727,10330,5642,17166
2021-07-09 10:00:00+00,16188,767,4685,539,141,4532,2398,340,5539,236,35365,230,13302,10904,6219,16955
2021-07-09 10:30:00+00,16255,892,4682,611,142,4528,2432,442,5873,0,35857,232,13740,11308,6626,17147
2021-07-09 11:00:00+00,16576,913,4680,677,119,4346,2438,400,5980,46,36175,231,13894,11456,6776,17489
2021-07-09 11:30:00+00,16472,928,4684,728,154,4340,2436,357,5667,120,35886,232,13669,11233,6549,17400
2021-07-09 12:00:00+00,16519,930,4680,769,246,4208,2436,317,5608,36,35749,231,13739,11303,6623,17449
2021-07-09 12:30:00+00,16341,929,4687,806,245,4208,2429,321,5507,0,35473,231,13674,11245,6558,17270
2021-07-09 13:00:00+00,16389,930,4685,854,204,4314,2350,334,5133,0,35193,235,13226,10876,6191,17319
2021-07-09 13:30:00+00,16159,928,4693,973,100,4316,2432,297,4384,0,34282,239,12582,10150,5457,17087
2021-07-09 14:00:00+00,16300,930,4695,1015,100,4242,2424,234,4162,0,34102,240,12396,9972,5277,17230
2021-07-09 14:30:00+00,16552,928,4698,1074,101,4240,2385,263,3983,46,34270,241,12241,9856,5158,17480
2021-07-09 15:00:00+00,16434,924,4701,1134,120,4170,2355,323,3784,136,34081,240,12094,9739,5038,17358
2021-07-09 15:30:00+00,16664,926,4701,1149,134,4168,2416,334,2984,540,34016,243,11384,8968,4267,17590
2021-07-09 16:00:00+00,16797,924,4701,1167,345,4418,2426,357,2251,756,34142,246,10890,8464,3763,17721
2021-07-09 16:30:00+00,17034,939,4694,1050,385,4420,2380,430,1917,874,34123,250,10426,8046,3352,17973
2021-07-09 17:00:00+00,16972,968,4693,1017,397,4556,2380,430,1499,816,33728,255,9986,7606,2913,17940
2021-07-09 17:30:00+00,16941,989,4687,957,389,4558,2405,359,1116,916,33317,258,9554,7149,2462,17930
2021-07-09 18:00:00+00,16737,978,4693,977,387,4636,2407,331,755,840,32741,260,9219,6812,2119,17715
2021-07-09 18:30:00+00,16832,990,4686,927,262,4638,2403,272,481,700,32191,266,8759,6356,1670,17822
2021-07-09 19:00:00+00,16611,990,4687,907,187,4594,2427,275,249,366,31293,270,8457,6030,1343,17601
2021-07-09 19:30:00+00,16350,988,4690,897,179,4592,2431,260,85,198,30670,272,8282,5851,1161,17338
2021-07-09 20:00:00+00,16034,986,4689,853,167,4570,2426,287,3,178,30193,272,8138,5712,1023,17020
2021-07-09 20:30:00+00,15818,960,4689,857,295,4570,2425,285,0,148,30047,270,8266,5841,1152,16778
2021-07-09 21:00:00+00,15434,811,4692,892,266,4702,2374,169,0,142,29482,266,8224,5850,1158,16245
2021-07-09 21:30:00+00,14564,783,4692,839,149,4712,2106,140,0,70,28055,265,7786,5680,988,15347
2021-07-09 22:00:00+00,13274,886,4692,798,81,4742,1762,147,0,28,26410,263,7333,5571,879,14160
2021-07-09 22:30:00+00,12154,765,4689,811,67,4744,1651,141,0,0,25022,255,7218,5567,878,12919
2021-07-09 23:00:00+00,11578,830,4687,834,58,4198,1640,145,0,0,23970,255,7219,5579,892,12408
2021-07-09 23:30:00+00,10691,810,4675,779,59,4192,1641,155,0,0,23002,250,7154,5513,838,11501
2021-07-10 00:00:00+00,10339,823,4673,799,59,4218,1678,150,0,0,22739,247,7209,5531,858,11162
2021-07-10 00:30:00+00,10096,841,4671,834,59,4220,1775,147,0,0,22643,245,7339,5564,893,10937
2021-07-10 01:00:00+00,10041,869,4675,859,59,4260,1783,146,0,0,22692,246,7376,5593,918,10910
2021-07-10 01:30:00+00,9904,905,4679,821,59,4260,1782,147,0,0,22557,246,7341,5559,880,10809
2021-07-10 02:00:00+00,9562,877,4684,814,59,4260,1784,147,0,0,22187,243,7341,5557,873,10439
2021-07-10 02:30:00+00,9521,890,4693,773,59,4260,1786,147,0,0,22129,244,7311,5525,832,10411
2021-07-10 03:00:00+00,9667,902,4692,749,59,4266,1790,141,0,0,22266,245,7290,5500,808,10569
2021-07-10 03:30:00+00,9485,906,4693,748,59,4266,1781,141,0,0,22079,244,7281,5500,807,10391
2021-07-10 04:00:00+00,9495,912,4693,764,73,4128,1789,140,12,0,22006,245,7331,5542,849,10407
2021-07-10 04:30:00+00,9703,902,4689,714,96,4122,1790,139,85,0,22240,246,7374,5584,895,10605
2021-07-10 05:00:00+00,9916,912,4689,695,98,4122,1786,139,167,0,22524,247,7435,5649,960,10828
2021-07-10 05:30:00+00,10716,876,4688,684,98,4124,1788,139,316,0,23429,250,7574,5786,1098,11592
2021-07-10 06:00:00+00,11351,786,4687,681,107,4316,1786,150,509,0,24373,248,7770,5984,1297,12137
2021-07-10 06:30:00+00,12212,831,4687,624,136,4318,1734,221,850,2,25615,252,8031,6297,1610,13043
2021-07-10 07:00:00+00,13660,855,4685,557,178,4508,1749,259,1200,98,27749,256,8369,6620,1935,14515
2021-07-10 07:30:00+00,14310,954,4689,544,180,4510,1783,282,1507,56,28815,259,8703,6920,2231,15264
2021-07-10 08:00:00+00,14685,986,4689,540,223,4688,1788,319,1899,116,29933,256,9139,7351,2662,15671
2021-07-10 08:30:00+00,14807,987,4690,533,221,4692,1788,334,2423,268,30743,251,9655,7867,3177,15794
2021-07-10 09:00:00+00,14833,985,4682,521,227,4446,1789,436,3088,516,31523,246,10307,8518,3836,15818
2021-07-10 09:30:00+00,14792,981,4680,536,235,4442,1783,550,3467,286,31752,245,10701,8918,4238,15773
2021-07-10 10:00:00+00,14747,994,4677,549,206,4498,1752,552,3396,76,31447,248,10580,8828,4151,15741
2021-07-10 10:30:00+00,14625,991,4667,564,206,4500,1753,588,3574,274,31742,244,10764,9011,4344,15616
2021-07-10 11:00:00+00,14669,992,4669,557,188,4548,1783,555,4026,42,32029,242,11223,9440,4771,15661
2021-07-10 11:30:00+00,14593,991,4668,564,178,4550,1786,430,4000,90,31850,241,11196,9410,4742,15584
2021-07-10 12:00:00+00,14458,912,4676,580,101,4688,1729,424,3946,0,31514,239,11032,9303,4627,15370
2021-07-10 12:30:00+00,14262,813,4670,591,100,4690,1662,316,3765,66,30935,236,10788,9126,4456,15075
2021-07-10 13:00:00+00,14038,959,4679,610,62,4592,1689,293,3766,0,30688,238,10806,9117,4438,14997
2021-07-10 13:30:00+00,13849,986,4680,642,58,4588,1752,286,3618,0,30459,239,10750,8998,4318,14835
2021-07-10 14:00:00+00,13994,990,4682,668,58,4396,1798,250,3550,0,30386,241,10756,8958,4276,14984
2021-07-10 14:30:00+00,13993,985,4688,672,65,4392,1813,241,3488,0,30337,241,10726,8913,4225,14978
2021-07-10 15:00:00+00,14099,989,4685,658,107,4558,1814,218,3204,0,30332,244,10468,8654,3969,15088
2021-07-10 15:30:00+00,14331,990,4687,632,111,4562,1817,271,2844,254,30499,246,10091,8274,3587,15321
2021-07-10 16:00:00+00,14667,990,4689,638,227,4696,1817,379,2527,594,31224,246,9898,8081,3392,15657
2021-07-10 16:30:00+00,14751,990,4695,634,259,4700,1816,365,2292,760,31262,247,9696,7880,3185,15741
2021-07-10 17:00:00+00,14861,990,4687,606,258,4594,1824,405,1826,1056,31107,248,9201,7377,2690,15851
2021-07-10 17:30:00+00,14835,990,4686,617,271,4592,1818,407,1519,1156,30891,250,8911,7093,2407,15825
2021-07-10 18:00:00+00,14973,991,4680,621,295,4630,1822,377,1061,874,30324,256,8479,6657,1977,15964
2021-07-10 18:30:00+00,14910,989,4677,617,255,4630,1817,353,663,1018,29929,259,8029,6212,1535,15899
2021-07-10 19:00:00+00,14661,898,4674,606,203,4710,1818,415,341,664,28990,262,7642,5824,1150,15559
2021-07-10 19:30:00+00,14527,924,4676,588,195,4720,1822,339,111,590,28492,265,7392,5570,894,15451
2021-07-10 20:00:00+00,14414,989,4678,588,121,4694,1825,315,8,536,28168,268,7220,5395,717,15403
2021-07-10 20:30:00+00,14371,988,4682,597,120,4692,1824,296,0,448,28018,269,7223,5399,717,15359
2021-07-10 21:00:00+00,14387,987,4680,601,127,4690,1779,195,0,372,27818,270,7187,5408,728,15374
2021-07-10 21:30:00+00,14023,989,4680,635,119,4686,1486,142,0,0,26760,273,6920,5434,754,15012
2021-07-10 22:00:00+00,13191,989,4678,652,123,4124,1171,144,0,184,25256,271,6624,5453,775,14180
2021-07-10 22:30:00+00,12246,875,4677,623,100,4116,1222,143,0,0,24002,266,6622,5400,723,13121
2021-07-10 23:00:00+00,11489,813,4672,627,77,3728,1239,154,0,170,22969,260,6615,5376,704,12302
2021-07-10 23:30:00+00,10623,835,4674,667,80,3724,1269,141,0,158,22171,255,6690,5421,747,11458
2021-07-11 00:00:00+00,10015,758,4676,758,81,3726,1394,140,0,0,21548,248,6910,5516,840,10773
2021-07-11 00:30:00+00,9535,878,4679,802,81,3726,1516,141,0,0,21358,247,7078,5562,883,10413
2021-07-11 01:00:00+00,9406,916,4680,802,81,3726,1561,142,0,0,21314,247,7124,5563,883,10322
2021-07-11 01:30:00+00,9259,916,4676,786,81,3726,1544,142,0,0,21130,247,7087,5543,867,10175
2021-07-11 02:00:00+00,9095,920,4676,791,68,3726,1454,144,0,0,20874,246,6989,5535,859,10015
2021-07-11 02:30:00+00,9089,915,4682,766,68,3724,1532,141,0,0,20917,246,7048,5516,834,10004
2021-07-11 03:00:00+00,9000,910,4685,741,67,3724,1523,141,0,0,20791,245,7016,5493,808,9910
2021-07-11 03:30:00+00,8826,905,4688,751,66,3724,1495,141,0,0,20596,244,7000,5505,817,9731
2021-07-11 04:00:00+00,8759,871,4689,741,64,3726,1467,141,12,0,20470,242,6973,5506,817,9630
2021-07-11 04:30:00+00,8825,858,4685,762,63,3726,1455,142,142,0,20658,241,7107,5652,967,9683
2021-07-11 05:00:00+00,8984,861,4684,815,89,3724,1571,141,468,0,21337,237,7627,6056,1372,9845
2021-07-11 05:30:00+00,9295,863,4683,819,88,3724,1696,139,909,0,22216,234,8195,6499,1816,10158
2021-07-11 06:00:00+00,9724,880,4682,787,87,3924,1608,140,1506,0,23338,231,8670,7062,2380,10604
2021-07-11 06:30:00+00,9973,917,4683,813,90,3920,1618,175,1891,0,24080,230,9095,7477,2794,10890
2021-07-11 07:00:00+00,10357,917,4683,852,116,3920,1726,339,2350,0,25260,228,9727,8001,3318,11274
2021-07-11 07:30:00+00,10663,918,4683,959,122,3918,1798,503,2924,0,26488,225,10486,8688,4005,11581
2021-07-11 08:00:00+00,11520,901,4688,1106,199,3918,1792,521,3415,0,28060,224,11200,9408,4720,12421
2021-07-11 08:30:00+00,11964,925,4683,1194,201,3920,1797,500,3848,0,29032,223,11723,9926,5243,12889
2021-07-11 09:00:00+00,11663,983,4686,1258,215,4308,1916,400,4151,196,29776,216,12226,10310,5624,12646
2021-07-11 09:30:00+00,11726,986,4680,1399,200,4312,2150,336,4112,44,29945,216,12541,10391,5711,12712
2021-07-11 10:00:00+00,11705,987,4676,1418,201,4316,2387,353,4086,178,30308,214,12768,10382,5706,12692
2021-07-11 10:30:00+00,11916,987,4673,1458,201,4314,2436,372,4254,180,30791,214,13022,10586,5913,12903
2021-07-11 11:00:00+00,12302,988,4670,1522,201,4314,2437,389,3603,404,30830,219,12433,9996,5326,13290
2021-07-11 11:30:00+00,12549,987,4671,1535,194,4320,2436,445,3329,306,30772,223,12165,9729,5058,13536
2021-07-11 12:00:00+00,12582,987,4671,1584,116,4496,2441,423,3616,224,31140,222,12428,9987,5316,13569
2021-07-11 12:30:00+00,12465,988,4678,1655,91,4500,2397,423,3445,50,30692,223,12266,9869,5191,13453
2021-07-11 13:00:00+00,12426,970,4679,1729,60,4478,2392,425,3373,116,30648,223,12233,9841,5162,13396
2021-07-11 13:30:00+00,12352,979,4680,1765,58,4478,2396,407,3271,152,30538,223,12170,9774,5094,13331
2021-07-11 14:00:00+00,12526,990,4685,1827,59,4478,2398,376,2951,60,30350,226,11920,9522,4837,13516
2021-07-11 14:30:00+00,12987,987,4684,1865,68,4476,2357,369,2696,0,30489,231,11670,9313,4629,13974
2021-07-11 15:00:00+00,13519,989,4690,1915,108,4482,2396,352,2187,0,30638,237,11296,8900,4210,14508
2021-07-11 15:30:00+00,13747,986,4689,1891,145,4474,2321,355,1849,474,30931,237,10895,8574,3885,14733
2021-07-11 16:00:00+00,14114,989,4692,1904,298,4804,2386,374,1523,554,31638,238,10803,8417,3725,15103
2021-07-11 16:30:00+00,14149,988,4693,1940,325,4806,2381,247,1185,644,31358,240,10524,8143,3450,15137
2021-07-11 17:00:00+00,14303,989,4692,2112,298,4804,2394,248,1057,630,31527,240,10553,8159,3467,15292
2021-07-11 17:30:00+00,14082,989,4690,1994,304,4804,2399,277,728,464,30731,244,10115,7716,3026,15071
2021-07-11 18:00:00+00,13896,961,4686,2123,273,4748,2399,273,474,498,30331,243,9955,7556,2870,14857
2021-07-11 18:30:00+00,13673,816,4679,2032,280,4748,2359,200,341,566,29694,240,9691,7332,2653,14489
2021-07-11 19:00:00+00,12781,817,4675,1954,247,4750,2371,147,182,194,28118,240,9429,7058,2383,13598
2021-07-11 19:30:00+00,12645,826,4673,1819,260,4744,2304,139,41,370,27821,241,9097,6793,2120,13471
2021-07-11 20:00:00+00,12990,840,4672,1677,150,4560,2226,143,1,318,27577,246,8726,6500,1828,13830
2021-07-11 20:30:00+00,12676,677,4677,1523,138,4554,2225,141,0,74,26685,244,8563,6338,1661,13353
2021-07-11 21:00:00+00,12391,681,4684,1392,114,4346,2306,142,0,442,26498,240,8496,6190,1506,13072
2021-07-11 21:30:00+00,11733,777,4681,1337,126,4348,2247,141,0,306,25696,241,8391,6144,1463,12510
2021-07-11 22:00:00+00,10406,972,4678,1269,123,4308,2267,141,0,854,25018,235,8337,6070,1392,11378
2021-07-11 22:30:00+00,9489,980,4681,1263,114,4308,2307,140,0,344,23626,234,8365,6058,1377,10469
2021-07-11 23:00:00+00,9698,899,4658,1194,85,3924,2437,143,0,0,23038,239,8374,5937,1279,10597
2021-07-11 23:30:00+00,9644,865,4654,1084,80,3922,2442,141,0,0,22832,239,8260,5818,1164,10509
2021-07-12 00:00:00+00,9402,858,4658,1031,80,3920,2440,141,0,0,22530,239,8209,5769,1111,10260
2021-07-12 00:30:00+00,9312,846,4659,880,80,3920,2439,142,0,0,22278,239,8058,5619,960,10158
2021-07-12 01:00:00+00,9112,822,4663,805,80,3920,2439,141,0,0,21982,238,7987,5548,885,9934
2021-07-12 01:30:00+00,9054,815,4672,738,79,3920,2438,140,0,0,21856,238,7927,5489,817,9869
2021-07-12 02:00:00+00,8699,803,4675,724,79,3920,2438,142,0,0,21480,235,7916,5478,803,9502
2021-07-12 02:30:00+00,8679,812,4674,667,79,3920,2440,142,0,0,21413,236,7860,5420,746,9491
2021-07-12 03:00:00+00,8717,834,4675,647,79,3922,2443,142,0,0,21459,237,7844,5401,726,9551
2021-07-12 03:30:00+00,8837,963,4681,593,79,3922,2434,143,0,0,21652,243,7787,5353,672,9800
2021-07-12 04:00:00+00,9067,936,4682,569,78,3902,2278,142,0,0,21654,245,7607,5329,647,10003
2021-07-12 04:30:00+00,9495,915,4685,612,78,3902,2272,142,32,0,22133,246,7679,5407,722,10410
2021-07-12 05:00:00+00,10266,852,4686,666,77,4228,2234,145,129,0,23283,245,7792,5558,872,11118
2021-07-12 05:30:00+00,11893,933,4685,723,82,4222,2212,140,331,50,25271,254,8033,5821,1136,12826
2021-07-12 06:00:00+00,13461,918,4683,689,106,4713,2273,146,588,0,27576,259,8339,6066,1383,14379
2021-07-12 06:30:00+00,14669,961,4684,832,122,4713,2390,149,866,150,29537,260,8894,6504,1820,15630
2021-07-12 07:00:00+00,15950,990,4690,810,196,4708,2290,191,1308,168,31301,262,9294,7004,2314,16940
2021-07-12 07:30:00+00,16376,938,4703,722,198,4708,2280,223,1685,290,32123,259,9588,7308,2605,17314
2021-07-12 08:00:00+00,16781,830,4738,653,245,4708,2237,363,2309,484,33348,253,10182,7945,3207,17611
2021-07-12 08:30:00+00,16873,778,4750,670,311,4712,2213,326,2800,466,33899,249,10744,8531,3781,17651
2021-07-12 09:00:00+00,16844,740,4749,677,319,4708,2198,302,3158,382,34077,246,11101,8903,4154,17584
2021-07-12 09:30:00+00,16714,734,4746,721,277,4702,2242,325,3337,324,34122,244,11323,9081,4335,17448
2021-07-12 10:00:00+00,16820,807,4763,819,208,4344,2314,410,3735,390,34610,244,11839,9525,4762,17627
2021-07-12 10:30:00+00,16896,853,4773,1009,123,4344,2275,496,3988,270,35027,244,12168,9893,5120,17749
2021-07-12 11:00:00+00,16768,828,4786,1104,105,4756,2183,369,4130,290,35319,240,12308,10125,5339,17596
2021-07-12 11:30:00+00,16874,887,4779,1213,108,4768,2226,247,4436,236,35774,239,12762,10536,5757,17761
2021-07-12 12:00:00+00,16789,914,4780,1236,168,4548,2245,264,4357,90,35391,239,12786,10541,5761,17703
2021-07-12 12:30:00+00,16520,917,4800,1359,180,4546,2171,275,4265,0,35033,239,12775,10604,5804,17437
2021-07-12 13:00:00+00,16359,773,4809,1489,75,4708,2187,192,4298,0,34890,234,12858,10671,5862,17132
2021-07-12 13:30:00+00,16292,716,4812,1496,75,4708,2165,158,3963,98,34483,234,12511,10346,5534,17008
2021-07-12 14:00:00+00,16576,862,4814,1593,76,4708,2154,141,3606,0,34530,240,12243,10089,5275,17438
2021-07-12 14:30:00+00,16883,908,4822,1664,107,4708,2221,147,3310,0,34770,244,12124,9903,5081,17791
2021-07-12 15:00:00+00,17220,959,4843,1591,203,4730,2283,248,3164,0,35241,247,12084,9801,4958,18179
2021-07-12 15:30:00+00,17316,982,4860,1565,296,4730,2367,292,2864,320,35592,247,11952,9585,4725,18298
2021-07-12 16:00:00+00,17315,986,4870,1519,339,4786,2395,326,2310,876,35722,247,11433,9038,4168,18301
2021-07-12 16:30:00+00,17280,984,4875,1509,353,4788,2269,339,1776,1048,35221,250,10782,8513,3638,18264
2021-07-12 17:00:00+00,17284,980,4874,1403,380,4708,2328,416,1471,994,34838,253,10456,8128,3254,18264
2021-07-12 17:30:00+00,17273,979,4874,1330,591,4706,2192,380,1143,798,34266,256,10130,7938,3064,18252
2021-07-12 18:00:00+00,17263,983,4876,1295,577,4552,2208,357,889,726,33726,258,9845,7637,2761,18246
2021-07-12 18:30:00+00,17178,980,4873,1274,374,4550,2291,210,535,492,32757,263,9347,7056,2183,18158
2021-07-12 19:00:00+00,16995,982,4867,1204,358,4612,2331,151,313,298,32111,266,9073,6742,1875,17977
2021-07-12 19:30:00+00,16857,903,4866,1159,307,4610,2248,142,103,0,31195,270,8683,6435,1569,17760
2021-07-12 20:00:00+00,16283,917,4864,1187,248,4482,2239,140,3,232,30595,266,8541,6302,1438,17200
2021-07-12 20:30:00+00,15811,987,4864,1151,171,4482,2310,141,0,66,29983,268,8496,6186,1322,16798
2021-07-12 21:00:00+00,15213,872,4870,986,105,4204,2319,141,0,104,28814,263,8280,5961,1091,16085
2021-07-12 21:30:00+00,14575,441,4875,946,167,4202,2305,141,0,0,27652,250,8293,5988,1113,15016
2021-07-12 22:00:00+00,13015,31,4870,904,87,4406,2339,142,0,14,25808,237,8200,5861,991,13046
2021-07-12 22:30:00+00,11602,0,4867,870,93,4410,2403,141,0,0,24386,227,8233,5830,963,11602
2021-07-12 23:00:00+00,10980,0,4867,862,91,4120,2426,142,0,72,23560,222,8246,5820,953,10980
2021-07-12 23:30:00+00,10671,0,4869,896,91,4118,2418,144,0,0,23207,220,8274,5856,987,10671
2021-07-13 00:00:00+00,10816,0,4865,903,89,4118,2428,142,0,0,23361,220,8285,5857,992,10816
2021-07-13 00:30:00+00,10598,0,4869,926,89,4118,2427,142,0,0,23169,218,8311,5884,1015,10598
2021-07-13 01:00:00+00,10291,0,4884,1061,88,4118,2426,141,0,0,23009,214,8459,6033,1149,10291
2021-07-13 01:30:00+00,9992,0,4900,1093,86,4118,2441,145,0,0,22775,211,8520,6079,1179,9992
2021-07-13 02:00:00+00,9913,0,4913,1143,65,4118,2407,143,0,0,22702,210,8528,6121,1208,9913
2021-07-13 02:30:00+00,9714,0,4949,1281,65,4118,2378,147,0,0,22652,207,8673,6295,1346,9714
2021-07-13 03:00:00+00,9817,0,4942,1346,64,3996,2406,144,0,0,22715,208,8758,6352,1410,9817
2021-07-13 03:30:00+00,9739,0,4959,1330,63,3992,2389,144,0,0,22616,208,8741,6352,1393,9739
2021-07-13 04:00:00+00,10056,118,4968,1454,63,3306,2387,154,5,0,22511,208,8877,6490,1522,10174
2021-07-13 04:30:00+00,9999,230,4972,1735,63,3290,2420,141,93,0,22943,207,9283,6863,1891,10229
2021-07-13 05:00:00+00,10938,490,4974,1754,74,3222,2264,141,333,0,24190,220,9399,7135,2161,11428
2021-07-13 05:30:00+00,12051,852,4978,1696,78,3220,2378,140,656,60,26109,234,9786,7408,2430,12903
2021-07-13 06:00:00+00,13765,927,4981,1688,125,3804,2434,158,999,162,29043,239,10227,7793,2812,14692
2021-07-13 06:30:00+00,14852,988,4983,1765,145,3812,2429,315,1417,298,31004,242,10739,8310,3327,15840
2021-07-13 07:00:00+00,15099,991,4978,1850,197,4546,2423,340,1780,424,32628,241,11228,8805,3827,16090
2021-07-13 07:30:00+00,15084,900,4979,1975,199,4562,2410,344,2488,500,33441,232,12051,9641,4662,15984
2021-07-13 08:00:00+00,15128,867,4977,2179,171,4526,2300,343,3184,722,34397,225,12811,10511,5534,15995
2021-07-13 08:30:00+00,15010,829,4968,2455,245,4524,2292,338,3867,366,34894,219,13827,11535,6567,15839
2021-07-13 09:00:00+00,14816,948,4949,2638,245,3994,2357,322,4548,358,35175,212,14737,12380,7431,15764
2021-07-13 09:30:00+00,14832,990,4870,2736,230,3978,2377,297,4314,150,34774,215,14527,12150,7280,15822
2021-07-13 10:00:00+00,14620,990,4786,2812,230,4316,2333,343,4666,98,35194,215,14827,12494,7708,15610
2021-07-13 10:30:00+00,14561,988,4793,2815,230,4322,2315,341,4700,98,35163,214,14853,12538,7745,15549
2021-07-13 11:00:00+00,14839,990,4795,3038,230,4172,2354,313,4998,42,35771,211,15415,13061,8266,15829
2021-07-13 11:30:00+00,14622,971,4816,3250,212,4172,2350,310,4926,0,35629,209,15554,13204,8388,15593
2021-07-13 12:00:00+00,14153,880,4832,3566,77,4334,2354,250,5169,0,35615,203,15998,13644,8812,15033
2021-07-13 12:30:00+00,14053,819,4837,3687,82,4336,2306,160,5325,0,35605,199,16237,13931,9094,14872
2021-07-13 13:00:00+00,14112,801,4844,3657,76,4054,2211,142,5979,0,35876,196,16767,14556,9712,14913
2021-07-13 13:30:00+00,14079,714,4858,3627,74,4052,2209,140,5659,0,35412,196,16427,14218,9360,14793
2021-07-13 14:00:00+00,13413,638,4866,3824,63,4434,2167,139,5474,0,35018,191,16394,14227,9361,14051
2021-07-13 14:30:00+00,13449,647,4868,4221,65,4436,2121,143,5113,0,35063,192,16388,14267,9399,14096
2021-07-13 15:00:00+00,13388,658,4875,4568,104,4710,2259,151,4481,0,35194,194,16287,14028,9153,14046
2021-07-13 15:30:00+00,13708,711,4964,4444,123,4712,2423,164,4173,72,35494,198,16127,13704,8740,14419
2021-07-13 16:00:00+00,14100,799,5034,4425,325,4788,2354,167,3842,8,35842,204,15980,13626,8592,14899
2021-07-13 16:30:00+00,14109,898,5043,4556,334,4790,2398,166,3204,32,35530,208,15535,13137,8094,15007
2021-07-13 17:00:00+00,13795,897,4978,4999,321,4790,2314,173,2668,114,35049,207,15280,12966,7988,14692
2021-07-13 17:30:00+00,13814,844,4976,5153,320,4788,2383,167,1968,2,34415,210,14800,12417,7441,14658
2021-07-13 18:00:00+00,13823,727,4977,5099,320,4730,2397,157,1395,278,33903,209,14188,11791,6814,14550
2021-07-13 18:30:00+00,13336,823,4976,5151,317,4728,2459,144,863,292,33089,211,13766,11307,6331,14159
2021-07-13 19:00:00+00,13102,834,4972,4885,176,4730,2434,142,401,384,32060,216,12868,10434,5462,13936
2021-07-13 19:30:00+00,13089,720,4968,4671,161,4730,2382,142,94,294,31251,217,12276,9894,4926,13809
2021-07-13 20:00:00+00,13080,718,4970,4712,105,4710,2392,141,2,52,30882,220,12181,9789,4819,13798
2021-07-13 20:30:00+00,12646,653,4974,4337,81,4714,2400,142,0,250,30197,217,11792,9392,4418,13299
2021-07-13 21:00:00+00,11957,678,4986,4154,68,4802,2378,143,0,100,29266,216,11586,9208,4222,12635
2021-07-13 21:30:00+00,11000,477,4991,4291,92,4790,2105,142,0,0,27888,205,11479,9374,4383,11477
2021-07-13 22:00:00+00,10673,560,4995,4270,92,3938,1571,145,0,0,26244,209,10928,9357,4362,11233
2021-07-13 22:30:00+00,9861,482,5017,4162,91,3920,1484,143,0,0,25160,201,10754,9270,4253,10343
2021-07-13 23:00:00+00,8827,236,5027,4195,90,3724,1483,143,0,0,23725,186,10795,9312,4285,9063
2021-07-13 23:30:00+00,8212,341,5027,4236,90,3726,1485,142,0,0,23259,183,10838,9353,4326,8553
2021-07-14 00:00:00+00,7876,342,5024,4079,89,3726,1484,142,0,0,22762,179,10676,9192,4168,8218
2021-07-14 00:30:00+00,7687,306,5029,4167,89,3726,1486,143,0,0,22633,175,10771,9285,4256,7993
2021-07-14 01:00:00+00,7726,288,5034,4089,89,3798,1482,155,0,0,22661,176,10694,9212,4178,8014
2021-07-14 01:30:00+00,7738,300,5033,3785,89,3800,1478,141,0,0,22364,179,10385,8907,3874,8038
2021-07-14 02:00:00+00,7583,268,5045,4057,89,3822,1482,141,0,0,22487,174,10673,9191,4146,7851
2021-07-14 02:30:00+00,7480,231,5050,4215,88,3822,1483,141,0,0,22510,171,10836,9353,4303,7711
2021-07-14 03:00:00+00,7423,233,5052,4111,88,3842,1490,142,0,0,22381,171,10741,9251,4199,7656
2021-07-14 03:30:00+00,7385,230,5060,4173,88,3844,1476,141,0,0,22397,170,10797,9321,4261,7615
2021-07-14 04:00:00+00,7496,230,5058,4401,88,3776,1480,142,10,0,22681,168,11037,9557,4499,7726
2021-07-14 04:30:00+00,7634,232,5061,4664,104,3774,1564,143,165,0,23341,166,11558,9994,4933,7866
2021-07-14 05:00:00+00,8122,230,5063,5048,121,3770,1912,143,444,0,24853,165,12588,10676,5613,8352
2021-07-14 05:30:00+00,9297,256,5064,4981,121,3770,2306,143,875,0,26813,173,13347,11041,5977,9553
2021-07-14 06:00:00+00,10671,352,5063,4918,121,4528,2292,188,1446,48,29627,180,13840,11548,6485,11023
2021-07-14 06:30:00+00,11131,350,5066,5241,117,4540,2200,304,1973,396,31318,177,14597,12397,7331,11481
2021-07-14 07:00:00+00,11717,334,5063,5408,175,4554,2303,279,2517,590,32940,176,15466,13163,8100,12051
2021-07-14 07:30:00+00,11992,326,5065,5443,177,4542,2326,236,3110,548,33765,174,16121,13795,8730,12318
2021-07-14 08:00:00+00,11917,333,5061,5643,173,4362,2372,184,3633,352,34030,171,16882,14510,9449,12250
2021-07-14 08:30:00+00,11785,324,5064,5860,172,4362,2194,171,4335,434,34701,165,17625,15431,10367,12109
2021-07-14 09:00:00+00,11757,358,5064,6165,172,3930,2267,165,4726,274,34878,162,18394,16127,11063,12115
2021-07-14 09:30:00+00,11566,330,5073,6440,171,3922,2249,163,5321,48,35283,157,19254,17005,11932,11896
2021-07-14 10:00:00+00,11910,340,5070,6451,119,3272,2330,164,6247,0,35903,151,20217,17887,12817,12250
2021-07-14 10:30:00+00,11723,310,5067,6494,103,3272,2362,147,6716,0,36194,147,20742,18380,13313,12033
2021-07-14 11:00:00+00,10751,281,5063,6771,86,4234,2414,144,6991,0,36735,141,21325,18911,13848,11032
2021-07-14 11:30:00+00,10407,238,5065,6992,86,4332,2302,143,7297,20,36882,137,21742,19440,14375,10645
2021-07-14 12:00:00+00,9752,233,5065,7243,88,4534,2289,142,7514,0,36860,132,22199,19910,14845,9985
2021-07-14 12:30:00+00,9161,233,5062,7388,90,4538,2229,142,7412,0,36255,128,22181,19952,14890,9394
2021-07-14 13:00:00+00,8813,230,5050,7585,74,4570,2252,141,7298,0,36013,126,22259,20007,14957,9043
2021-07-14 13:30:00+00,8579,231,5048,7791,67,4572,2242,150,6956,0,35636,125,22104,19862,14814,8810
2021-07-14 14:00:00+00,8784,232,5053,7948,68,4706,2425,151,6678,0,36045,127,22172,19747,14694,9016
2021-07-14 14:30:00+00,9159,251,5056,7979,80,4706,2425,140,6057,0,35853,132,21597,19172,14116,9410
2021-07-14 15:00:00+00,9504,389,5055,8133,115,4568,2391,148,5311,0,35614,140,21005,18614,13559,9893
2021-07-14 15:30:00+00,10079,469,5062,8238,124,4568,2276,149,4901,0,35866,147,20601,18325,13263,10548
2021-07-14 16:00:00+00,10841,465,5064,8126,219,4786,2178,153,4386,0,36218,154,19973,17795,12731,11306
2021-07-14 16:30:00+00,11192,463,5071,8022,221,4790,2228,153,3663,0,35803,160,19205,16977,11906,11655
2021-07-14 17:00:00+00,11223,467,5076,7998,221,4788,2387,158,3065,100,35483,163,18747,16360,11284,11690
2021-07-14 17:30:00+00,11419,474,5077,7970,223,4786,2388,157,2230,162,34886,168,17888,15500,10423,11893
2021-07-14 18:00:00+00,11245,488,5082,8000,223,4730,2346,153,1538,440,34245,169,17189,14843,9761,11733
2021-07-14 18:30:00+00,11279,486,5082,8199,213,4730,2122,150,1010,344,33615,171,16626,14504,9422,11765
2021-07-14 19:00:00+00,11285,465,5079,8465,104,4730,2145,147,449,0,32869,175,16242,14097,9018,11750
2021-07-14 19:30:00+00,10979,459,5084,8254,79,4726,2124,144,127,0,31976,175,15668,13544,8460,11438
2021-07-14 20:00:00+00,10628,463,5077,8293,61,4448,2118,144,3,0,31235,174,15552,13434,8357,11091
2021-07-14 20:30:00+00,9978,461,5072,8509,57,4440,2135,145,0,0,30797,168,15773,13638,8566,10439
2021-07-14 21:00:00+00,9711,466,5070,8535,56,4030,2174,145,0,0,30187,165,15835,13661,8591,10177
2021-07-14 21:30:00+00,8465,462,5068,8772,60,4024,1831,145,0,0,28827,154,15731,13900,8832,8927
2021-07-14 22:00:00+00,7181,592,5071,8815,60,3778,1432,167,0,0,27096,149,15378,13946,8875,7773
2021-07-14 22:30:00+00,5969,750,5073,8793,60,3772,1133,153,0,0,25703,142,15059,13926,8853,6719
2021-07-14 23:00:00+00,5296,623,5073,8843,60,3436,1161,149,0,0,24641,131,15137,13976,8903,5919
2021-07-14 23:30:00+00,5070,291,5078,8696,59,3430,1173,147,0,0,23944,119,15006,13833,8755,5361
2021-07-15 00:00:00+00,4906,244,5081,8606,59,3434,1170,144,0,0,23644,115,14916,13746,8665,5150
2021-07-15 00:30:00+00,5264,247,5078,8398,59,3434,1176,150,0,0,23806,120,14711,13535,8457,5511
2021-07-15 01:00:00+00,5267,216,5076,8238,59,3432,1173,146,0,0,23607,120,14546,13373,8297,5483
2021-07-15 01:30:00+00,5201,0,5072,8282,59,3432,1170,144,0,0,23360,111,14583,13413,8341,5201
2021-07-15 02:00:00+00,4950,0,5074,8391,59,3430,1175,147,0,0,23226,108,14699,13524,8450,4950
2021-07-15 02:30:00+00,5061,0,5075,8235,59,3430,1162,144,0,0,23166,110,14531,13369,8294,5061
2021-07-15 03:00:00+00,4932,0,5075,8261,59,3430,1155,144,0,0,23056,108,14550,13395,8320,4932
2021-07-15 03:30:00+00,5085,0,5072,8060,59,3430,1155,145,0,0,23006,111,14346,13191,8119,5085
2021-07-15 04:00:00+00,5530,0,5076,7493,58,3382,1148,153,8,0,22848,119,13783,12635,7559,5530
2021-07-15 04:30:00+00,6127,0,5081,7118,78,3380,1190,146,144,0,23264,127,13611,12421,7340,6127
2021-07-15 05:00:00+00,6562,0,5092,7170,86,3482,1673,257,484,102,24908,129,14505,12832,7740,6562
2021-07-15 05:30:00+00,7761,0,5095,6973,86,3488,2201,186,932,304,27026,138,15287,13086,7991,7761
2021-07-15 06:00:00+00,9423,0,5101,6668,86,4256,2363,151,1571,146,29765,151,15789,13426,8325,9423
2021-07-15 06:30:00+00,10654,0,5104,6724,86,4270,2362,148,2202,256,31806,157,16478,14116,9012,10654
2021-07-15 07:00:00+00,11475,0,5100,6531,156,4514,2366,147,2880,262,33431,160,17033,14667,9567,11475
2021-07-15 07:30:00+00,11756,0,5100,6341,156,4518,2375,147,3411,268,34072,161,17383,15008,9908,11756
2021-07-15 08:00:00+00,11822,0,5104,6338,168,4668,2373,181,3808,360,34822,158,17791,15418,10314,11822
2021-07-15 08:30:00+00,12037,0,5106,5957,170,4672,2376,243,4071,492,35124,160,17680,15304,10198,12037
2021-07-15 09:00:00+00,12512,0,5110,5576,147,3560,2380,465,3998,734,34482,168,17211,14831,9721,12512
2021-07-15 09:30:00+00,12498,0,5107,5627,128,3504,2383,502,4496,596,34841,166,17741,15358,10251,12498
2021-07-15 10:00:00+00,12542,72,5107,5814,88,3896,2376,469,4820,172,35356,165,18205,15829,10722,12614
2021-07-15 10:30:00+00,12516,145,5108,5794,117,3986,2367,269,5111,208,35621,164,18497,16130,11022,12661
2021-07-15 11:00:00+00,12345,230,5047,6001,102,4560,2313,194,5538,142,36472,164,19001,16688,11641,12575
2021-07-15 11:30:00+00,12096,229,4925,6112,102,4572,2306,169,5899,144,36554,160,19344,17038,12113,12325
2021-07-15 12:00:00+00,11900,233,4919,6259,90,4118,2312,170,5929,148,36078,159,19509,17197,12278,12133
2021-07-15 12:30:00+00,11320,230,4923,6457,80,4072,2354,167,5744,0,35347,156,19558,17204,12281,11550
2021-07-15 13:00:00+00,11758,231,4932,6301,76,3558,2357,151,5895,0,35259,157,19561,17204,12272,11989
2021-07-15 13:30:00+00,11604,231,4928,6105,96,3550,2328,164,5965,0,34971,157,19422,17094,12166,11835
2021-07-15 14:00:00+00,11780,231,4921,6072,92,3446,2291,164,5634,0,34631,156,19010,16719,11798,12011
2021-07-15 14:30:00+00,11919,268,4920,6165,93,3442,2358,149,5369,0,34683,158,18905,16547,11627,12187
2021-07-15 15:00:00+00,11825,507,4921,6085,116,3882,2326,157,4849,2,34670,166,18297,15971,11050,12332
2021-07-15 15:30:00+00,12385,773,4926,5897,116,3880,2334,163,4174,8,34656,180,17447,15113,10187,13158
2021-07-15 16:00:00+00,12740,906,4932,5711,165,4004,2355,254,3731,232,35030,188,16894,14539,9607,13646
2021-07-15 16:30:00+00,13118,855,4928,5686,189,4002,2270,287,3264,520,35119,190,16337,14067,9139,13973
2021-07-15 17:00:00+00,13145,783,4930,5711,212,4082,2352,284,2637,594,34730,192,15842,13490,8560,13928
2021-07-15 17:30:00+00,13393,519,4932,5668,220,4080,2447,279,1969,844,34351,190,15236,12789,7857,13912
2021-07-15 18:00:00+00,13316,363,4929,5411,227,4714,2412,164,1392,1018,33946,191,14371,11959,7030,13679
2021-07-15 18:30:00+00,13339,441,4938,5404,210,4730,2465,156,851,824,33358,197,13868,11403,6465,13780
2021-07-15 19:00:00+00,13489,499,4934,5245,172,4728,2473,150,385,372,32447,205,13209,10736,5802,13988
2021-07-15 19:30:00+00,13211,500,4898,5137,141,4728,2467,149,97,298,31626,207,12740,10273,5375,13711
2021-07-15 20:00:00+00,13010,500,4792,5033,101,4710,2427,158,1,210,30942,209,12354,9927,5135,13510
2021-07-15 20:30:00+00,12806,427,4794,4847,101,4702,2288,261,0,360,30586,207,12030,9742,4948,13233
2021-07-15 21:00:00+00,12898,395,4790,4581,99,4466,2288,269,0,188,29974,211,11758,9470,4680,13293
2021-07-15 21:30:00+00,12439,250,4813,4387,99,4462,1981,166,0,0,28597,207,11280,9299,4486,12689
2021-07-15 22:00:00+00,11425,275,4911,4186,99,4116,1731,148,0,0,26891,203,10927,9196,4285,11700
2021-07-15 22:30:00+00,10363,289,4919,3970,97,4114,1777,148,0,0,25677,197,10763,8986,4067,10652
2021-07-15 23:00:00+00,9579,372,4922,4046,91,3724,1813,149,0,0,24696,194,10872,9059,4137,9951
2021-07-15 23:30:00+00,8901,339,4922,4121,89,3724,1729,148,0,0,23973,187,10861,9132,4210,9240
2021-07-16 00:00:00+00,8529,268,4924,4020,83,3726,1727,149,0,0,23426,185,10754,9027,4103,8797
2021-07-16 00:30:00+00,8389,267,4830,3937,81,3726,1745,148,0,0,23123,185,10593,8848,4018,8656
2021-07-16 01:00:00+00,8076,278,4809,3874,80,3726,1775,147,0,0,22765,183,10538,8763,3954,8354
2021-07-16 01:30:00+00,7889,230,4804,3900,80,3726,1763,147,0,0,22539,180,10547,8784,3980,8119
2021-07-16 02:00:00+00,7552,230,4803,3978,80,3718,1768,147,0,0,22276,176,10629,8861,4058,7782
2021-07-16 02:30:00+00,7437,231,4803,3997,80,3718,1763,147,0,0,22176,175,10643,8880,4077,7668
2021-07-16 03:00:00+00,7245,230,4810,4316,80,3700,1706,146,0,0,22233,170,10912,9206,4396,7475
2021-07-16 03:30:00+00,7036,231,4833,4421,80,3698,1736,148,0,0,22183,167,11070,9334,4501,7267
2021-07-16 04:00:00+00,7046,252,4954,4389,80,3488,1739,149,8,0,22105,164,11170,9431,4477,7298
2021-07-16 04:30:00+00,7353,319,5027,4304,80,3486,1926,147,168,0,22810,168,11505,9579,4552,7672
2021-07-16 05:00:00+00,8285,400,5030,4203,90,3748,2323,149,546,2,24776,177,12192,9869,4839,8685
2021-07-16 05:30:00+00,9671,399,5031,4040,105,3750,2369,250,1093,0,26708,186,12638,10269,5238,10070
2021-07-16 06:00:00+00,11177,254,5029,3880,117,4064,2339,303,1747,296,29206,186,13112,10773,5744,11431
2021-07-16 06:30:00+00,11670,280,5027,3834,117,4064,2454,286,2464,778,30974,182,13896,11442,6415,11950
2021-07-16 07:00:00+00,11520,235,5025,3746,230,4786,2416,251,3291,740,32240,178,14708,12292,7267,11755
2021-07-16 07:30:00+00,11475,245,5028,3557,230,4802,2417,158,4238,774,32924,173,15470,13053,8025,11720
2021-07-16 08:00:00+00,11427,312,5029,3574,225,4802,2357,165,5230,592,33713,170,16415,14058,9029,11739
2021-07-16 08:30:00+00,11311,456,5034,3646,231,4802,2303,171,6154,164,34272,170,17368,15065,10031,11767
2021-07-16 09:00:00+00,11291,449,5031,3747,185,4236,2383,203,6977,22,34524,167,18323,15940,10909,11740
2021-07-16 09:30:00+00,11277,418,5028,3755,176,4216,2375,194,7692,2,35133,163,19026,16651,11623,11695
2021-07-16 10:00:00+00,11281,419,5025,3972,111,3822,2379,285,8260,0,35554,161,19747,17368,12343,11700
2021-07-16 10:30:00+00,11184,394,5021,4102,89,3822,2389,289,8647,0,35937,158,20248,17859,12838,11578
2021-07-16 11:00:00+00,11169,472,4953,4440,73,3824,2387,303,8792,0,36413,159,20645,18258,13305,11641
2021-07-16 11:30:00+00,11005,424,4862,4756,72,3824,2389,293,8824,2,36451,155,20903,18514,13652,11429
2021-07-16 12:00:00+00,9878,316,4865,4980,72,4682,2217,149,8762,0,35921,142,20896,18679,13814,10194
2021-07-16 12:30:00+00,9584,264,4857,5169,72,4764,2060,159,8579,0,35508,139,20737,18677,13820,9848
2021-07-16 13:00:00+00,9516,350,4857,5484,75,4336,2109,141,8254,0,35122,141,20778,18670,13812,9866
2021-07-16 13:30:00+00,9210,379,4845,5740,76,4326,2133,141,8044,0,34894,139,20838,18705,13860,9589
2021-07-16 14:00:00+00,9040,359,4712,5702,76,4584,2120,142,7404,0,34139,140,20014,17894,13182,9399
2021-07-16 14:30:00+00,9644,368,4611,5480,76,4580,2269,142,6861,0,34031,149,19297,17028,12417,10012
2021-07-16 15:00:00+00,10460,370,4616,5362,90,4524,2381,150,6127,0,34080,158,18576,16195,11579,10830
2021-07-16 15:30:00+00,10718,466,4661,5619,99,4524,2428,304,5504,20,34343,165,18311,15883,11222,11184
2021-07-16 16:00:00+00,11141,597,4683,5469,141,4706,2463,348,4677,170,34395,174,17433,14970,10287,11738
2021-07-16 16:30:00+00,11486,733,4814,5269,145,4710,2464,377,3816,188,34002,184,16508,14044,9230,12219
2021-07-16 17:00:00+00,11698,903,4861,4961,210,4534,2466,374,3042,614,33663,190,15540,13074,8213,12601
2021-07-16 17:30:00+00,12008,967,4867,4574,211,4532,2473,344,2229,910,33115,199,14354,11881,7014,12975
2021-07-16 18:00:00+00,12372,975,4865,4241,210,4710,2471,381,1520,802,32547,210,13307,10836,5971,13347
2021-07-16 18:30:00+00,12508,977,4873,4057,208,4712,2470,430,927,706,31868,217,12535,10065,5192,13485
2021-07-16 19:00:00+00,12440,834,4873,4088,190,4706,2467,423,436,268,30725,220,12054,9587,4714,13274
2021-07-16 19:30:00+00,12307,797,4875,4314,186,4708,2394,400,106,262,30349,219,11875,9481,4606,13104
2021-07-16 20:00:00+00,12112,854,4871,4246,155,4708,2406,246,1,390,29990,218,11680,9274,4402,12966
2021-07-16 20:30:00+00,12059,956,4868,3941,129,4700,2401,213,0,464,29731,222,11339,8938,4070,13015
2021-07-16 21:00:00+00,12122,959,4874,3597,82,4346,2374,212,0,504,29070,227,10927,8553,3679,13081
2021-07-16 21:30:00+00,12010,884,4854,3528,94,4336,2378,190,0,6,28280,229,10854,8476,3622,12894
2021-07-16 22:00:00+00,11147,843,4819,3311,94,3810,2434,162,0,66,26686,219,10658,8224,3405,11990
2021-07-16 22:30:00+00,10012,820,4802,3403,94,3804,2480,147,0,0,25562,210,10779,8299,3497,10832
2021-07-16 23:00:00+00,9044,840,4739,3477,95,3610,2484,146,0,0,24435,204,10795,8311,3572,9884
2021-07-16 23:30:00+00,8279,829,4737,3425,95,3604,2486,146,0,0,23601,199,10743,8257,3520,9108
2021-07-17 00:00:00+00,7959,824,4735,3431,86,3410,2480,147,0,0,23072,196,10732,8252,3517,8783
2021-07-17 00:30:00+00,7669,706,4744,3555,85,3408,2480,148,0,0,22795,188,10864,8384,3640,8375
2021-07-17 01:00:00+00,7631,415,4821,3696,85,3312,2333,146,0,0,22439,178,10935,8602,3781,8046
2021-07-17 01:30:00+00,7250,292,4840,3817,86,3310,2273,146,0,0,22014,169,11016,8743,3903,7542
2021-07-17 02:00:00+00,7505,0,4932,3868,85,3310,2330,147,0,0,22177,160,11215,8885,3953,7505
2021-07-17 02:30:00+00,7453,0,4976,3826,86,3310,2195,146,0,0,21992,160,11083,8888,3912,7453
2021-07-17 03:00:00+00,7653,0,4978,3868,86,3290,2133,147,0,0,22155,161,11065,8932,3954,7653
2021-07-17 03:30:00+00,7488,0,4978,3851,85,3290,2058,145,0,0,21895,160,10972,8914,3936,7488
2021-07-17 04:00:00+00,7603,0,4982,3840,85,3272,1947,146,7,0,21882,161,10861,8914,3932,7603
2021-07-17 04:30:00+00,7593,0,4988,3961,85,3272,1924,145,161,0,22129,159,11119,9195,4207,7593
2021-07-17 05:00:00+00,7764,0,4987,3888,86,3130,2265,148,537,0,22805,157,11763,9498,4511,7764
2021-07-17 05:30:00+00,7818,0,4988,3924,85,3130,2342,212,1076,0,23575,154,12415,10073,5085,7818
2021-07-17 06:00:00+00,7808,0,4988,3929,94,3906,2323,245,1762,0,25055,155,13096,10773,5785,7808
2021-07-17 06:30:00+00,8343,0,4991,3959,94,3920,2341,262,2541,0,26451,155,13926,11585,6594,8343
2021-07-17 07:00:00+00,9001,0,4981,4081,94,4016,2432,253,3382,40,28280,155,14970,12538,7557,9001
2021-07-17 07:30:00+00,9175,0,4981,4278,97,4018,2436,254,4284,0,29523,151,16076,13640,8659,9175
2021-07-17 08:00:00+00,9083,0,4981,4450,170,4116,2161,257,5212,112,30542,144,16974,14813,9832,9083
2021-07-17 08:30:00+00,9171,0,4985,4452,180,4112,1818,284,6097,0,31099,142,17532,15714,10729,9171
2021-07-17 09:00:00+00,8994,163,4982,4516,205,4210,1800,253,6894,0,32017,140,18397,16597,11615,9157
2021-07-17 09:30:00+00,8988,273,4976,4610,209,4212,1320,241,7599,0,32428,140,18714,17394,12418,9261
2021-07-17 10:00:00+00,9012,324,4974,4774,141,4118,1122,203,8180,0,32848,138,19191,18069,13095,9336
2021-07-17 10:30:00+00,8986,261,4974,4897,137,4114,528,180,8624,0,32701,134,19160,18632,13658,9247
2021-07-17 11:00:00+00,8764,281,4974,4898,112,4022,527,180,8901,0,32659,132,19412,18885,13911,9045
2021-07-17 11:30:00+00,8381,312,4977,4989,112,4020,525,180,9063,0,32559,129,19666,19141,14164,8693
2021-07-17 12:00:00+00,7984,293,4978,5174,70,3926,547,162,9082,0,32216,125,19851,19304,14326,8277
2021-07-17 12:30:00+00,7427,490,4977,5246,70,3920,830,150,8997,0,32107,125,20120,19290,14313,7917
2021-07-17 13:00:00+00,7123,571,4972,5178,70,3764,1129,148,8799,0,31754,125,20148,19019,14047,7694
2021-07-17 13:30:00+00,6836,480,4966,5136,71,3770,1433,146,8440,0,31278,122,20046,18613,13647,7316
2021-07-17 14:00:00+00,6813,491,4966,5029,88,3778,1676,166,7927,0,30934,125,19686,18010,13044,7304
2021-07-17 14:30:00+00,7107,611,4968,5043,88,3770,1806,168,7276,0,30837,133,19181,17375,12407,7718
2021-07-17 15:00:00+00,7528,703,4965,4999,97,3876,1806,179,6546,36,30735,143,18413,16607,11642,8231
2021-07-17 15:30:00+00,8453,634,4963,5012,97,3870,1872,237,5708,8,30854,153,17652,15780,10817,9087
2021-07-17 16:00:00+00,9049,523,4957,5018,113,4356,2043,208,4827,210,31304,157,16958,14915,9958,9572
2021-07-17 16:30:00+00,10070,762,4960,5076,108,4366,2086,190,3906,130,31654,175,16136,14050,9090,10832
2021-07-17 17:00:00+00,10641,871,4965,4818,193,4454,2238,222,3044,138,31584,187,15258,13020,8055,11512
2021-07-17 17:30:00+00,11045,908,4968,4540,233,4462,2351,224,2236,444,31411,194,14328,11977,7009,11953
2021-07-17 18:00:00+00,11099,973,4966,4336,233,4704,2368,222,1536,464,30901,201,13439,11071,6105,12072
2021-07-17 18:30:00+00,11206,974,4968,3943,230,4710,2386,218,934,586,30155,207,12461,10075,5107,12180
2021-07-17 19:00:00+00,11075,971,4972,3809,183,4710,2416,217,427,586,29366,212,11807,9391,4419,12046
2021-07-17 19:30:00+00,10959,971,4979,3837,180,4712,2446,215,96,540,28935,213,11538,9092,4113,11930
2021-07-17 20:00:00+00,10929,974,4910,3783,138,4708,2433,249,0,118,28242,219,11264,8831,3921,11903
2021-07-17 20:30:00+00,11205,973,4776,3648,127,4700,2456,227,0,168,28280,222,11007,8551,3775,12178
2021-07-17 21:00:00+00,11111,973,4758,3533,81,4074,2432,201,0,526,27689,219,10804,8372,3614,12084
2021-07-17 21:30:00+00,11315,905,4760,3418,79,4074,2131,199,0,106,26987,224,10388,8257,3497,12220
2021-07-17 22:00:00+00,10377,836,4762,3469,78,4256,1815,149,0,78,25820,218,10124,8309,3547,11213
2021-07-17 22:30:00+00,9585,815,4758,3535,70,4258,1486,146,0,0,24653,213,9849,8363,3605,10400
2021-07-17 23:00:00+00,9027,656,4804,3471,70,3782,1501,147,0,0,23458,206,9846,8345,3541,9683
2021-07-17 23:30:00+00,8549,402,4880,3236,70,3774,1493,148,0,42,22594,195,9679,8186,3306,8951
2021-07-18 00:00:00+00,8387,329,4877,3066,70,3778,1492,147,0,0,22146,193,9505,8013,3136,8716
2021-07-18 00:30:00+00,8232,235,4881,3006,70,3776,1492,148,0,0,21840,189,9449,7957,3076,8467
2021-07-18 01:00:00+00,8216,242,4882,2971,70,3534,1495,148,0,0,21558,190,9418,7923,3041,8458
2021-07-18 01:30:00+00,7911,214,4886,2932,70,3532,1493,148,0,0,21186,186,9380,7888,3002,8125
2021-07-18 02:00:00+00,7941,107,4882,2743,70,3532,1500,148,0,0,20923,185,9195,7695,2813,8048
2021-07-18 02:30:00+00,7789,0,4890,2613,70,3530,1495,148,0,0,20535,180,9068,7573,2683,7789
2021-07-18 03:00:00+00,7774,0,4836,2586,70,3532,1499,149,0,0,20446,181,8991,7492,2656,7774
2021-07-18 03:30:00+00,7629,0,4753,2541,70,3530,1507,149,0,0,20179,180,8871,7364,2611,7629
2021-07-18 04:00:00+00,7407,0,4747,2516,71,3530,1504,147,4,0,19926,178,8842,7338,2591,7407
2021-07-18 04:30:00+00,7507,0,4751,2456,71,3528,1494,147,139,0,20093,179,8911,7417,2666,7507
2021-07-18 05:00:00+00,8006,0,4779,2259,71,3532,1504,147,501,0,20799,182,9114,7610,2831,8006
2021-07-18 05:30:00+00,8305,186,4882,2043,71,3548,1506,148,1029,0,21718,188,9531,8025,3143,8491
2021-07-18 06:00:00+00,8579,229,4888,1984,71,3780,1442,146,1663,0,22782,186,10048,8606,3718,8808
2021-07-18 06:30:00+00,9380,335,4884,1815,72,3778,1193,150,2404,0,24011,193,10368,9175,4291,9715
2021-07-18 07:00:00+00,9618,399,4884,1701,89,4014,1204,149,3234,30,25322,190,11112,9908,5024,10017
2021-07-18 07:30:00+00,9889,413,4937,1611,96,4020,1204,159,4116,220,26665,185,11964,10760,5823,10302
2021-07-18 08:00:00+00,9890,589,4968,1473,163,4334,1200,199,4995,420,28231,183,12799,11599,6631,10479
2021-07-18 08:30:00+00,9962,726,4970,1349,169,4338,1195,187,5855,394,29145,183,13538,12343,7373,10688
2021-07-18 09:00:00+00,10002,786,4968,1315,232,4410,1196,179,6627,488,30203,179,14338,13142,8174,10788
2021-07-18 09:30:00+00,10140,778,4970,1292,277,4412,1196,336,7267,252,30920,178,15002,13806,8836,10918
2021-07-18 10:00:00+00,10434,677,4967,1262,230,4594,1199,332,7805,74,31574,176,15463,14264,9297,11111
2021-07-18 10:30:00+00,10353,686,4969,1162,161,4600,1199,179,8224,0,31533,173,15715,14516,9547,11039
2021-07-18 11:00:00+00,10513,765,4962,1122,72,4742,1194,182,8482,4,32038,175,15832,14638,9676,11278
2021-07-18 11:30:00+00,10356,683,4964,1183,73,4750,1176,181,8573,0,31939,171,15969,14793,9829,11039
2021-07-18 12:00:00+00,10355,629,4939,1284,57,4662,1181,146,8721,6,31980,169,16182,15001,10062,10984
2021-07-18 12:30:00+00,10267,646,4814,1346,57,4656,1177,145,8564,20,31692,170,15958,14781,9967,10913
2021-07-18 13:00:00+00,10220,572,4743,1350,57,4656,1179,147,8252,48,31224,169,15581,14402,9659,10792
2021-07-18 13:30:00+00,10245,656,4743,1358,71,4658,1366,146,8000,20,31263,173,15538,14172,9429,10901
2021-07-18 14:00:00+00,10369,515,4741,1347,70,4658,1826,155,7441,0,31122,173,15425,13599,8858,10884
2021-07-18 14:30:00+00,10576,462,4737,1316,57,4656,2064,147,6804,0,30819,176,14978,12914,8177,11038
2021-07-18 15:00:00+00,11151,625,4747,1254,85,4874,2090,163,6034,12,31035,189,14210,12120,7373,11776
2021-07-18 15:30:00+00,11802,761,4842,1317,88,4874,2140,148,5280,0,31252,200,13667,11527,6685,12563
2021-07-18 16:00:00+00,12273,953,4956,1418,121,4748,2204,195,4415,176,31459,211,13114,10910,5954,13226
2021-07-18 16:30:00+00,12619,977,4954,1347,250,4736,2357,313,3608,238,31399,219,12516,10159,5205,13596
2021-07-18 17:00:00+00,12956,979,4952,1342,329,4644,2476,316,2839,446,31279,225,11938,9462,4510,13935
2021-07-18 17:30:00+00,13319,945,4954,1283,341,4640,2475,302,2139,770,31168,229,11192,8717,3763,14264
2021-07-18 18:00:00+00,13505,903,4956,1204,431,4584,2482,315,1436,1056,30872,231,10509,8027,3071,14408
2021-07-18 18:30:00+00,13563,969,4955,1062,351,4584,2475,381,876,1098,30314,239,9719,7244,2289,14532
2021-07-18 19:00:00+00,13514,976,4956,923,313,4586,2472,377,385,1122,29624,244,9049,6577,1621,14490
2021-07-18 19:30:00+00,13611,977,4958,786,312,4586,2470,386,81,1214,29381,247,8607,6137,1179,14588
2021-07-18 20:00:00+00,13795,975,4960,720,286,4566,2480,428,0,892,29102,252,8446,5966,1006,14770
2021-07-18 20:30:00+00,13765,976,4965,659,259,4566,2477,374,0,768,28809,254,8360,5883,918,14741
2021-07-18 21:00:00+00,13763,975,4968,581,193,4566,2471,390,0,474,28381,258,8213,5742,774,14738
2021-07-18 21:30:00+00,13393,977,4974,507,182,4568,2455,343,0,0,27399,261,8118,5663,689,14370
2021-07-18 22:00:00+00,12637,976,4970,463,144,4168,2473,155,0,96,26082,256,8050,5577,607,13613
2021-07-18 22:30:00+00,11559,926,4972,463,144,4172,2475,140,0,0,24851,250,8054,5579,607,12485
2021-07-18 23:00:00+00,10935,800,4966,439,113,4118,2465,139,0,0,23975,245,7983,5518,552,11735
2021-07-18 23:30:00+00,10670,486,4967,442,110,4120,2465,139,0,0,23399,234,7984,5519,552,11156
2021-07-19 00:00:00+00,10575,412,4962,422,110,4166,2479,139,0,0,23265,234,7973,5494,532,10987
2021-07-19 00:30:00+00,10637,416,4940,388,110,4166,2486,175,0,0,23318,235,7924,5438,498,11053
2021-07-19 01:00:00+00,10726,421,4804,371,110,4166,2484,199,0,0,23281,237,7769,5285,481,11147
2021-07-19 01:30:00+00,10688,403,4746,388,110,4166,2446,185,0,0,23132,237,7690,5244,498,11091
2021-07-19 02:00:00+00,10658,401,4746,414,110,4166,2411,179,0,0,23085,237,7681,5270,524,11059
2021-07-19 02:30:00+00,10494,391,4750,459,109,4166,2403,174,0,0,22946,235,7721,5318,568,10885
2021-07-19 03:00:00+00,10600,352,4746,488,110,4166,2349,138,0,0,22949,234,7693,5344,598,10952
2021-07-19 03:30:00+00,10521,347,4752,535,110,4166,2348,137,0,0,22916,233,7745,5397,645,10868
2021-07-19 04:00:00+00,10349,342,4757,567,110,4154,2404,136,3,0,22822,231,7841,5437,680,10691
2021-07-19 04:30:00+00,10641,405,4864,661,110,4152,2369,137,143,0,23482,232,8147,5778,914,11046
2021-07-19 05:00:00+00,11597,394,4959,755,110,4228,2407,137,513,0,25100,231,8744,6337,1378,11991
2021-07-19 05:30:00+00,13133,413,4958,805,110,4228,2402,171,1029,0,27249,236,9304,6902,1944,13546
2021-07-19 06:00:00+00,14383,687,4960,785,110,4686,2355,174,1652,0,29792,244,9862,7507,2547,15070
2021-07-19 06:30:00+00,15302,948,4960,774,112,4692,2354,166,2378,154,31840,248,10578,8224,3264,16250
2021-07-19 07:00:00+00,15620,990,4956,794,204,4690,2396,157,3159,522,33488,240,11509,9113,4157,16610
2021-07-19 07:30:00+00,15908,990,4956,787,214,4692,2421,278,3957,106,34309,239,12335,9914,4958,16898
2021-07-19 08:00:00+00,15821,989,4958,785,202,4692,2424,269,4767,158,35065,233,13136,10712,5754,16810
2021-07-19 08:30:00+00,15608,982,4960,805,200,4692,2419,257,5718,64,35705,226,14102,11683,6723,16590
2021-07-19 09:00:00+00,15599,985,4958,850,129,4300,2426,287,6550,0,36084,222,14913,12487,7529,16584
2021-07-19 09:30:00+00,15237,985,4954,850,127,4296,2424,307,7281,50,36511,215,15636,13212,8258,16222
2021-07-19 10:00:00+00,14644,984,4954,878,112,4742,2421,289,7860,56,36940,209,16225,13804,8850,15628
2021-07-19 10:30:00+00,14611,983,4954,1067,110,4750,2419,287,8083,104,37368,206,16633,14214,9260,15594
2021-07-19 11:00:00+00,14720,982,4953,1186,93,4750,2420,237,8187,172,37700,205,16839,14419,9466,15702
2021-07-19 11:30:00+00,14788,979,4949,1240,93,4750,2414,240,8243,210,37906,205,16939,14525,9576,15767
2021-07-19 12:00:00+00,14727,982,4818,1243,93,4710,2406,244,8318,0,37541,206,16878,14472,9654,15709
2021-07-19 12:30:00+00,14447,982,4740,1271,93,4710,2379,239,7957,0,36818,207,16440,14061,9321,15429
2021-07-19 13:00:00+00,14245,982,4738,1320,93,4710,2398,244,7931,130,36791,205,16480,14082,9344,15227
2021-07-19 13:30:00+00,14312,890,4736,1410,104,4710,2399,224,7772,166,36723,203,16421,14022,9286,15202
2021-07-19 14:00:00+00,14394,723,4743,1430,94,4710,2403,234,7310,442,36483,201,15980,13577,8834,15117
2021-07-19 14:30:00+00,14327,680,4863,1487,110,4712,2380,207,6823,534,36123,201,15663,13283,8420,15007
2021-07-19 15:00:00+00,14660,697,4945,1734,108,4730,2383,223,6192,474,36146,206,15362,12979,8034,15357
2021-07-19 15:30:00+00,14897,706,4939,2075,138,4732,2363,257,5429,942,36478,207,14944,12581,7642,15603
2021-07-19 16:00:00+00,15198,850,4934,2279,483,4786,2395,255,4460,986,36626,214,14551,12156,7222,16048
2021-07-19 16:30:00+00,15692,939,4937,2312,532,4788,2403,301,3609,870,36383,224,13793,11390,6453,16631
2021-07-19 17:00:00+00,15964,967,4938,2349,494,4788,2376,331,2856,848,35911,231,13013,10637,5699,16931
2021-07-19 17:30:00+00,16284,920,4942,2402,493,4788,2406,328,2110,856,35529,235,12353,9947,5005,17204
2021-07-19 18:00:00+00,16338,917,4984,2374,396,4704,2405,307,1442,896,34763,239,11601,9196,4212,17255
2021-07-19 18:30:00+00,16272,957,5037,2281,384,4704,2382,327,858,822,34024,245,10942,8560,3523,17229
2021-07-19 19:00:00+00,16243,929,5051,2220,246,4722,2390,251,392,854,33298,249,10299,7909,2858,17172
2021-07-19 19:30:00+00,15788,971,5052,2180,234,4720,2395,224,84,792,32440,251,9945,7550,2498,16759
2021-07-19 20:00:00+00,15527,976,5040,2081,175,4710,2421,351,0,510,31791,254,9717,7296,2256,16503
2021-07-19 20:30:00+00,15802,977,4912,1910,142,4710,2426,380,0,250,31509,260,9390,6964,2052,16779
2021-07-19 21:00:00+00,15625,977,4857,1733,90,4616,2418,298,0,120,30734,262,9098,6680,1823,16602
2021-07-19 21:30:00+00,14731,978,4864,1589,88,4614,2421,199,0,0,29484,261,8962,6541,1677,15709
2021-07-19 22:00:00+00,13549,898,4865,1485,118,4542,2424,189,0,0,28070,254,8892,6468,1603,14447
2021-07-19 22:30:00+00,12187,859,4944,1417,123,4542,2478,190,0,0,26740,246,8962,6484,1540,13046
2021-07-19 23:00:00+00,12171,873,5054,1390,104,4318,2488,155,0,0,26553,246,9036,6548,1494,13044
2021-07-19 23:30:00+00,11864,818,5070,1355,90,4318,2432,140,0,0,26087,243,8947,6515,1445,12682
2021-07-20 00:00:00+00,11581,704,5077,1340,90,4318,2355,144,0,0,25609,239,8862,6507,1430,12285
2021-07-20 00:30:00+00,11443,703,5041,1269,90,4316,2381,139,0,0,25382,239,8781,6400,1359,12146
2021-07-20 01:00:00+00,11067,660,5053,1248,90,4316,2381,139,0,0,24954,236,8772,6391,1338,11727
2021-07-20 01:30:00+00,10952,628,5062,1157,90,4316,2383,139,0,0,24727,235,8692,6309,1247,11580
2021-07-20 02:00:00+00,10864,620,5058,1121,90,4324,2359,139,0,0,24575,235,8628,6269,1211,11484
2021-07-20 02:30:00+00,10853,533,5059,1209,90,4324,2295,139,0,0,24502,231,8653,6358,1299,11386
2021-07-20 03:00:00+00,10784,504,5054,1190,90,4312,2410,140,0,0,24484,230,8744,6334,1280,11288
2021-07-20 03:30:00+00,10651,503,5052,1188,90,4312,2482,141,0,0,24419,228,8812,6330,1278,11154
2021-07-20 04:00:00+00,10704,671,5053,1180,90,4122,2277,141,2,0,24240,236,8602,6325,1272,11375
2021-07-20 04:30:00+00,11002,770,5057,1174,90,4124,2258,140,140,0,24755,239,8719,6461,1404,11772
2021-07-20 05:00:00+00,12131,884,5059,1081,90,3590,2364,282,490,0,25971,239,9084,6720,1661,13015
2021-07-20 05:30:00+00,13339,981,5058,1100,90,3572,2304,394,985,0,27823,245,9537,7233,2175,14320
2021-07-20 06:00:00+00,14944,924,5055,1133,90,3878,2368,371,1636,104,30503,247,10282,7914,2859,15868
2021-07-20 06:30:00+00,15457,980,5055,1089,103,3896,2489,375,2290,172,31906,245,11026,8537,3482,16437
2021-07-20 07:00:00+00,15644,931,5052,1070,184,4690,2482,359,3167,72,33651,241,11955,9473,4421,16575
2021-07-20 07:30:00+00,15819,980,5057,1053,224,4710,2482,364,4049,70,34808,236,12865,10383,5326,16799
2021-07-20 08:00:00+00,15746,979,5070,1066,227,4710,2486,301,4927,124,35636,229,13776,11290,6220,16725
2021-07-20 08:30:00+00,15423,981,5079,1006,227,4710,2492,168,5689,30,35805,223,14493,12001,6922,16404
2021-07-20 09:00:00+00,15248,980,5077,962,132,4712,2489,145,6341,94,36180,218,15001,12512,7435,16228
2021-07-20 09:30:00+00,15218,919,5079,980,128,4710,2485,141,7098,46,36804,213,15770,13285,8206,16137
2021-07-20 10:00:00+00,15334,651,5093,983,111,4758,2480,146,7727,0,37283,205,16394,13914,8821,15985
2021-07-20 10:30:00+00,15299,461,5105,994,109,4758,2478,141,8047,48,37440,199,16733,14255,9150,15760
2021-07-20 11:00:00+00,15345,613,5106,1001,109,4770,2479,141,8409,104,38077,200,17104,14625,9519,15958
2021-07-20 11:30:00+00,15424,745,5111,1035,109,4770,2453,140,8438,34,38259,203,17146,14693,9582,16169
2021-07-20 12:00:00+00,15188,731,5111,1088,109,4728,2403,140,8211,0,37709,202,16922,14519,9408,15919
2021-07-20 12:30:00+00,15018,714,5162,1165,109,4730,2397,158,8004,0,37457,202,16837,14440,9278,15732
2021-07-20 13:00:00+00,14740,756,5207,1297,109,4758,2394,150,7917,36,37364,200,16924,14530,9323,15496
2021-07-20 13:30:00+00,14800,820,5242,1517,109,4708,2349,197,7522,0,37264,203,16739,14390,9148,15620
2021-07-20 14:00:00+00,14803,841,5240,1759,109,4758,2370,160,6852,220,37112,205,16330,13960,8720,15644
2021-07-20 14:30:00+00,14798,837,5230,1758,113,4758,2262,250,6227,890,37123,205,15590,13328,8098,15635
2021-07-20 15:00:00+00,15266,855,5183,1679,145,4780,2215,382,5639,586,36730,214,14861,12646,7463,16121
2021-07-20 15:30:00+00,15787,906,5142,1636,155,4780,2370,340,4695,644,36455,222,13998,11628,6486,16693
2021-07-20 16:00:00+00,15645,965,5144,1602,401,4810,2395,387,4075,1282,36706,222,13617,11222,6078,16610
2021-07-20 16:30:00+00,16103,974,5135,1618,416,4818,2332,447,3193,1428,36464,229,12694,10362,5227,17077
2021-07-20 17:00:00+00,16233,971,5132,1545,439,4816,2314,527,2382,1594,35953,234,11812,9498,4366,17204
2021-07-20 17:30:00+00,16399,972,5136,1360,521,4808,2310,527,1797,1462,35292,240,11124,8814,3678,17371
2021-07-20 18:00:00+00,16718,906,5137,1104,527,4778,2383,503,1257,1282,34595,246,10408,8025,2888,17624
2021-07-20 18:30:00+00,16925,972,5132,1000,327,4780,2390,497,771,1086,33880,256,9620,7230,2098,17897
2021-07-20 19:00:00+00,16979,976,5128,922,273,4778,2397,497,364,760,33074,263,9084,6687,1559,17955
2021-07-20 19:30:00+00,16883,977,5128,815,362,4780,2401,434,71,402,32253,268,8777,6376,1248,17860
2021-07-20 20:00:00+00,16768,977,5134,777,397,4760,2389,403,0,180,31785,270,8697,6308,1174,17745
2021-07-20 20:30:00+00,16769,977,5129,850,232,4756,2400,405,0,268,31786,270,8611,6211,1082,17746
2021-07-20 21:00:00+00,16697,977,4877,877,106,4688,2421,293,0,252,31188,272,8281,5860,983,17674
2021-07-20 21:30:00+00,15899,848,4873,907,84,4688,2420,199,0,0,29918,269,8284,5864,991,16747
2021-07-20 22:00:00+00,14696,742,4878,894,170,4560,2398,140,0,0,28478,261,8340,5942,1064,15438
2021-07-20 22:30:00+00,13594,506,4889,851,212,4560,2423,140,0,0,27175,249,8375,5952,1063,14100
2021-07-20 23:00:00+00,13227,503,4858,828,212,4558,2434,140,0,0,26760,247,8332,5898,1040,13730
2021-07-20 23:30:00+00,12953,236,4736,799,102,4556,2434,140,0,0,25956,241,8071,5637,901,13189
2021-07-21 00:00:00+00,13016,6,4712,805,51,4560,2437,140,0,0,25727,238,8005,5568,856,13022
2021-07-21 00:30:00+00,12892,0,4706,816,51,4562,2418,140,0,0,25585,237,7991,5573,867,12892
2021-07-21 01:00:00+00,12758,0,4708,779,51,4560,2415,142,0,0,25413,237,7953,5538,830,12758
2021-07-21 01:30:00+00,12530,0,4710,743,51,4558,2433,139,0,0,25164,236,7937,5504,794,12530
2021-07-21 02:00:00+00,12348,0,4707,739,51,4560,2434,139,0,0,24978,235,7931,5497,790,12348
2021-07-21 02:30:00+00,12249,0,4702,711,51,4558,2439,139,0,0,24849,234,7903,5464,762,12249
2021-07-21 03:00:00+00,12253,0,4699,686,51,4558,2492,142,0,0,24881,234,7928,5436,737,12253
2021-07-21 03:30:00+00,12234,0,4715,666,51,4548,2499,143,0,0,24856,234,7931,5432,717,12234
2021-07-21 04:00:00+00,12515,0,4699,655,51,4016,2506,140,1,0,24583,231,7912,5406,707,12515
2021-07-21 04:30:00+00,13056,0,4702,594,51,4006,2503,140,114,0,25167,233,7965,5462,759,13056
2021-07-21 05:00:00+00,13853,1,4703,550,51,4204,2497,141,406,0,26406,238,8207,5710,1007,13854
2021-07-21 05:30:00+00,14692,144,4705,526,51,4208,2493,142,840,0,27800,243,8614,6121,1417,14836
2021-07-21 06:00:00+00,15746,569,4703,490,51,4686,2488,218,1436,0,30386,257,9167,6679,1977,16315
2021-07-21 06:30:00+00,16103,909,4700,437,61,4692,2494,259,2141,186,31982,259,9833,7339,2639,17012
2021-07-21 07:00:00+00,16239,976,4700,410,137,4756,2491,482,2914,516,33621,252,10652,8161,3461,17215
2021-07-21 07:30:00+00,16130,979,4701,392,142,4756,2473,502,3684,652,34411,245,11392,8919,4218,17109
2021-07-21 08:00:00+00,16184,981,4697,377,142,4760,2458,485,4485,574,35143,240,12159,9701,5004,17165
2021-07-21 08:30:00+00,16072,979,4690,385,141,4760,2459,450,5282,302,35520,236,12957,10498,5808,17051
2021-07-21 09:00:00+00,16044,975,4675,390,133,4758,2459,418,6025,244,36121,231,13682,11223,6548,17019
2021-07-21 09:30:00+00,15344,1039,4661,1090,246,4760,2548,706,6694,154,37243,222,15240,12692,8030,16383
2021-07-21 10:00:00+00,15976,972,4661,419,118,4800,2455,376,7243,266,37286,224,14896,12441,7780,16948
2021-07-21 10:30:00+00,16020,974,4665,453,83,4800,2441,327,7784,48,37595,222,15426,12985,8320,16994
2021-07-21 11:00:00+00,16115,972,4676,485,59,4798,2439,319,8234,48,38146,220,15894,13455,8778,17087
2021-07-21 11:30:00+00,16016,969,4685,536,60,4802,2438,308,8406,0,38220,218,16125,13687,9002,16985
2021-07-21 12:00:00+00,15751,969,4694,573,60,4872,2439,268,8463,160,38249,214,16229,13790,9096,16720
2021-07-21 12:30:00+00,15527,970,4701,681,58,4874,2428,300,8261,0,37800,214,16129,13701,9000,16497
2021-07-21 13:00:00+00,15539,974,4708,773,59,4786,2429,318,8018,0,37604,216,15987,13558,8850,16513
2021-07-21 13:30:00+00,15485,971,4715,870,51,4782,2424,291,7732,0,37321,217,15792,13368,8653,16456
2021-07-21 14:00:00+00,15692,976,4721,945,66,4756,2449,309,7319,0,37233,220,15500,13051,8330,16668
2021-07-21 14:30:00+00,16142,975,4729,1022,67,4758,2454,235,6512,32,36925,226,14783,12329,7601,17117
2021-07-21 15:00:00+00,16183,973,4736,1111,124,4800,2441,229,5792,176,36565,229,14204,11763,7027,17156
2021-07-21 15:30:00+00,16648,977,4727,1152,178,4800,2425,289,4880,222,36298,236,13362,10937,6210,17625
2021-07-21 16:00:00+00,17113,973,4722,1198,249,4814,2367,311,4218,742,36707,239,12754,10387,5665,18086
2021-07-21 16:30:00+00,17317,972,4721,1204,250,4814,2381,320,3411,778,36168,245,11967,9586,4865,18289
2021-07-21 17:00:00+00,17463,973,4723,1148,243,4812,2417,344,2685,814,35622,250,11216,8799,4076,18436
2021-07-21 17:30:00+00,17498,971,4719,1117,247,4812,2450,340,1951,1022,35127,254,10484,8034,3315,18469
2021-07-21 18:00:00+00,17497,971,4717,1082,237,4780,2454,321,1356,1016,34431,259,9846,7392,2675,18468
2021-07-21 18:30:00+00,17426,970,4722,984,268,4778,2453,325,837,1030,33793,263,9264,6811,2089,18396
2021-07-21 19:00:00+00,17348,970,4722,902,257,4778,2449,282,376,934,33018,268,8706,6257,1535,18318
2021-07-21 19:30:00+00,17185,972,4722,795,260,4780,2448,262,78,686,32188,272,8303,5855,1133,18157
2021-07-21 20:00:00+00,17253,975,4714,698,186,4760,2438,273,0,514,31811,276,8036,5598,884,18228
2021-07-21 20:30:00+00,17185,973,4619,620,190,4758,2436,253,0,402,31436,278,7865,5429,810,18158
2021-07-21 21:00:00+00,16832,970,4581,576,143,4758,2441,266,0,338,30905,278,7741,5300,719,17802
2021-07-21 21:30:00+00,16124,807,4587,558,121,4756,2442,224,0,330,29949,273,7708,5266,679,16931
2021-07-21 22:00:00+00,15327,642,4584,532,122,4510,2426,163,0,0,28306,270,7664,5238,654,15969
2021-07-21 22:30:00+00,14416,461,4592,500,124,4510,2287,162,0,0,27052,262,7503,5216,624,14877
2021-07-21 23:00:00+00,13934,547,4586,474,124,4508,2281,162,0,0,26616,262,7465,5184,598,14481
2021-07-21 23:30:00+00,13434,471,4588,460,124,4508,2344,162,0,0,26091,258,7516,5172,584,13905
2021-07-22 00:00:00+00,13228,502,4594,375,124,4508,2265,163,0,0,25759,258,7358,5093,499,13730
2021-07-22 00:30:00+00,12954,459,4601,355,124,4510,2111,163,0,0,25277,257,7191,5080,479,13413
2021-07-22 01:00:00+00,12523,463,4604,338,124,4512,2196,143,0,0,24903,254,7262,5066,462,12986
2021-07-22 01:30:00+00,12167,570,4609,342,124,4514,2205,144,0,0,24675,255,7280,5075,466,12737
2021-07-22 02:00:00+00,11846,608,4607,341,124,4510,2194,144,0,0,24374,254,7266,5072,465,12454
2021-07-22 02:30:00+00,11991,459,4606,345,124,4510,2194,144,0,0,24373,251,7269,5075,469,12450
2021-07-22 03:00:00+00,12009,458,4605,349,124,4510,2159,139,0,0,24353,251,7237,5078,473,12467
2021-07-22 03:30:00+00,11982,457,4601,355,124,4498,2145,139,0,0,24301,251,7225,5080,479,12439
2021-07-22 04:00:00+00,12207,626,4609,366,124,3656,2337,139,0,0,24064,254,7436,5099,490,12833
2021-07-22 04:30:00+00,12280,936,4649,378,65,3640,2398,139,98,0,24583,262,7588,5190,541,13216
2021-07-22 05:00:00+00,13686,972,4652,398,59,3116,2431,141,404,0,25859,270,7944,5513,861,14658
2021-07-22 05:30:00+00,14896,975,4656,380,60,3102,2380,240,896,0,27585,272,8372,5992,1336,15871
2021-07-22 06:00:00+00,15391,948,4661,374,77,4338,2375,261,1484,70,29979,264,8971,6596,1935,16339
2021-07-22 06:30:00+00,16176,981,4660,357,78,4358,2377,328,2181,28,31524,264,9653,7276,2616,17157
2021-07-22 07:00:00+00,16602,979,4661,334,175,4704,2373,320,3009,142,33299,257,10552,8179,3518,17581
2021-07-22 07:30:00+00,16572,978,4660,346,180,4710,2393,344,3853,252,34288,249,11432,9039,4379,17550
2021-07-22 08:00:00+00,16566,976,4653,357,181,4708,2376,347,4687,302,35153,243,12254,9878,5225,17542
2021-07-22 08:30:00+00,16450,966,4648,391,180,4710,2366,356,5541,86,35694,238,13126,10760,6112,17416
2021-07-22 09:00:00+00,16331,972,4588,400,162,4710,2351,333,6305,0,36152,233,13806,11455,6867,17303
2021-07-22 09:30:00+00,16180,980,4527,408,149,4710,2362,185,6979,42,36522,228,14425,12063,7536,17160
2021-07-22 10:00:00+00,16163,980,4480,386,122,4708,2361,140,7538,0,36878,225,14887,12526,8046,17143
2021-07-22 10:30:00+00,16084,981,4437,384,89,4710,2369,140,7876,0,37070,223,15155,12786,8349,17065
2021-07-22 11:00:00+00,16142,978,4400,397,68,4708,2281,140,8028,48,37191,223,15175,12894,8493,17120
2021-07-22 11:30:00+00,16026,977,4360,434,66,4708,2283,141,8089,22,37106,222,15232,12949,8589,17003
2021-07-22 12:00:00+00,15686,979,4319,511,70,4710,2259,153,8114,142,36943,219,15273,13014,8695,16665
2021-07-22 12:30:00+00,15682,977,4275,547,67,4708,2258,199,7919,0,36633,221,15067,12809,8533,16659
2021-07-22 13:00:00+00,15822,977,4231,581,88,4708,2267,200,7537,0,36411,225,14704,12437,8206,16799
2021-07-22 13:30:00+00,15853,977,4187,667,103,4708,2244,203,7060,0,36002,227,14261,12017,7830,16830
2021-07-22 14:00:00+00,16151,974,4141,739,178,4710,2254,336,6719,378,36580,228,14031,11777,7636,17125
2021-07-22 14:30:00+00,16328,968,4099,800,304,4712,2266,425,6253,20,36175,233,13722,11456,7357,17296
2021-07-22 15:00:00+00,16694,972,4056,858,355,4776,2240,442,5520,16,35929,239,13029,10789,6733,17666
2021-07-22 15:30:00+00,17063,972,4014,965,375,4778,2252,488,4832,280,36019,243,12438,10186,6172,18035
2021-07-22 16:00:00+00,17764,970,3970,1015,406,4780,2265,526,4057,512,36265,250,11713,9448,5478,18734
2021-07-22 16:30:00+00,18102,975,3927,1085,403,4778,2251,503,3240,874,36138,255,10906,8655,4728,19077
2021-07-22 17:00:00+00,18304,973,3883,1148,415,4778,2270,505,2532,948,35756,260,10248,7978,4095,19277
2021-07-22 17:30:00+00,18282,975,3839,1199,432,4778,2274,508,1830,1112,35229,264,9574,7300,3461,19257
2021-07-22 18:00:00+00,18077,977,3795,1206,429,4780,2293,504,1197,1234,34492,267,8920,6627,2832,19054
2021-07-22 18:30:00+00,17845,977,3751,1215,350,4780,2291,506,679,1186,33580,271,8286,5995,2244,18822
2021-07-22 19:00:00+00,17615,978,3706,1221,291,4778,2303,481,272,894,32539,277,7793,5490,1784,18593
2021-07-22 19:30:00+00,17406,978,3659,1252,275,4780,2303,388,48,764,31854,279,7538,5235,1575,18384
2021-07-22 20:00:00+00,17365,978,3612,1338,268,4758,2306,341,0,488,31454,280,7524,5218,1606,18343
2021-07-22 20:30:00+00,17355,923,3613,1331,223,4758,2297,342,0,706,31548,278,7464,5167,1554,18278
2021-07-22 21:00:00+00,17106,973,3607,1268,98,4758,2301,272,0,420,30803,283,7274,4973,1366,18079
2021-07-22 21:30:00+00,16428,863,3600,1238,80,4754,2305,209,0,288,29765,279,7223,4918,1318,17291
2021-07-22 22:00:00+00,15918,767,3598,1209,97,4178,2310,140,0,0,28217,280,7214,4904,1306,16685
2021-07-22 22:30:00+00,14457,583,3601,1138,105,4166,2309,135,0,0,26494,270,7153,4844,1243,15040
2021-07-22 23:00:00+00,13168,654,3601,1139,79,4166,2317,134,0,0,25258,265,7136,4819,1218,13822
2021-07-22 23:30:00+00,12170,789,3603,1121,78,4166,2312,135,0,0,24374,264,7114,4802,1199,12959
2021-07-23 00:00:00+00,11963,759,3607,1126,77,4166,2272,135,0,0,24105,261,7082,4810,1203,12722
2021-07-23 00:30:00+00,12047,654,3614,1147,77,4164,2277,139,0,0,24119,258,7115,4838,1224,12701
2021-07-23 01:00:00+00,12092,624,3615,1212,69,4166,2314,137,0,0,24229,257,7210,4896,1281,12716
2021-07-23 01:30:00+00,11904,465,3618,1285,63,4166,2313,137,0,0,23951,251,7279,4966,1348,12369
2021-07-23 02:00:00+00,11753,462,3643,1351,62,4166,2303,136,0,0,23876,249,7359,5056,1413,12215
2021-07-23 02:30:00+00,11499,462,3661,1391,62,4166,2311,136,0,0,23688,247,7425,5114,1453,11961
2021-07-23 03:00:00+00,11488,464,3663,1453,62,4164,2278,134,0,0,23706,246,7456,5178,1515,11952
2021-07-23 03:30:00+00,11729,464,3661,1494,62,4164,2234,133,0,0,23941,247,7451,5217,1556,12193
2021-07-23 04:00:00+00,11913,475,3659,1561,61,3970,2239,134,0,0,24012,247,7520,5281,1622,12388
2021-07-23 04:30:00+00,11958,480,3660,1564,61,3968,2302,133,107,0,24233,246,7694,5392,1732,12438
2021-07-23 05:00:00+00,12404,680,3659,1561,61,4006,2306,134,403,0,25214,251,7990,5684,2025,13084
2021-07-23 05:30:00+00,13435,811,3658,1624,67,4006,2315,135,799,0,26850,255,8463,6148,2490,14246
2021-07-23 06:00:00+00,14677,915,3658,1666,122,4738,2127,136,1267,0,29306,259,8840,6713,3055,15592
2021-07-23 06:30:00+00,15146,979,3659,1683,125,4754,2175,140,1789,0,30450,257,9431,7256,3597,16125
2021-07-23 07:00:00+00,15382,980,3661,1645,181,4822,2233,274,2350,854,32382,247,10070,7837,4176,16362
2021-07-23 07:30:00+00,15542,981,3661,1666,180,4821,2262,452,3086,798,33449,243,10855,8593,4932,16523
2021-07-23 08:00:00+00,15696,973,3658,1635,180,4878,2309,461,3809,720,34320,240,11591,9282,5624,16669
2021-07-23 08:30:00+00,15649,981,3653,1609,216,4878,2217,450,4375,676,34704,236,12070,9853,6200,16630
2021-07-23 09:00:00+00,15690,981,3648,1634,202,4904,2215,384,5045,272,34975,235,12744,10529,6881,16671
2021-07-23 09:30:00+00,15370,981,3643,1851,193,4902,2238,324,5529,0,35032,230,13454,11216,7573,16351
2021-07-23 10:00:00+00,15290,980,3639,1981,162,4912,2306,243,5846,82,35441,226,13934,11628,7989,16270
2021-07-23 10:30:00+00,14955,979,3636,2030,168,4900,2305,270,6115,154,35512,222,14254,11949,8313,15934
2021-07-23 11:00:00+00,14924,979,3631,2067,166,4852,2213,275,6447,306,35860,220,14524,12311,8680,15903
2021-07-23 11:30:00+00,15079,980,3633,2097,146,4837,2220,240,6369,134,35735,222,14465,12245,8612,16059
2021-07-23 12:00:00+00,15116,979,3631,2123,315,4812,2293,198,6474,352,36293,219,14836,12543,8912,16095
2021-07-23 12:30:00+00,15300,979,3634,2113,136,4800,2314,195,6400,140,36011,222,14597,12283,8649,16279
2021-07-23 13:00:00+00,15195,975,3637,2170,100,4814,2323,196,6169,136,35715,222,14399,12076,8439,16170
2021-07-23 13:30:00+00,15383,901,3637,2276,101,4803,2323,196,6035,144,35799,222,14372,12049,8412,16284
2021-07-23 14:00:00+00,15539,861,3647,2417,88,4768,2318,196,5643,0,35477,224,14113,11795,8148,16400
2021-07-23 14:30:00+00,15758,840,3651,2523,89,4753,2336,171,4969,60,35150,228,13568,11232,7581,16598
2021-07-23 15:00:00+00,15619,734,3651,2523,85,4747,2290,173,4317,32,34171,229,12866,10576,6925,16353
2021-07-23 15:30:00+00,15691,725,3650,2997,101,4735,2277,159,3700,0,34035,230,12725,10448,6798,16416
2021-07-23 16:00:00+00,15655,715,3650,3212,191,4773,2302,169,3134,420,34221,228,12489,10187,6537,16370
2021-07-23 16:30:00+00,15495,745,3651,3522,206,4768,2344,211,2544,546,34032,229,12267,9923,6272,16240
2021-07-23 17:00:00+00,15232,883,3664,3775,232,4784,2304,326,2151,590,33941,232,12126,9822,6158,16115
2021-07-23 17:30:00+00,15202,886,3661,3969,237,4776,2340,292,1670,466,33499,234,11877,9537,5876,16088
2021-07-23 18:00:00+00,15248,901,3659,4123,248,4778,2527,171,1088,62,32805,240,11645,9118,5459,16149
2021-07-23 18:30:00+00,14966,864,3660,4377,246,4776,2491,140,595,12,32127,240,11369,8878,5218,15830
2021-07-23 19:00:00+00,14855,669,3663,4545,185,4582,2482,137,235,102,31455,234,11110,8628,4965,15524
2021-07-23 19:30:00+00,14614,410,3664,4825,157,4582,2456,135,31,0,30874,228,11133,8677,5013,15024
2021-07-23 20:00:00+00,13658,417,3665,5152,101,4756,2586,137,0,18,30490,222,11504,8918,5253,14075
2021-07-23 20:30:00+00,13154,398,3664,5383,79,4756,2655,136,0,0,30225,217,11781,9126,5462,13552
2021-07-23 21:00:00+00,12449,328,3663,5381,78,4756,2413,136,0,0,29204,212,11535,9122,5459,12777
2021-07-23 21:30:00+00,11537,231,3659,5342,78,4728,2308,134,0,0,28017,204,11387,9079,5420,11768
2021-07-23 22:00:00+00,11359,239,3651,5295,78,3658,2122,135,0,98,26635,200,11146,9024,5373,11598
2021-07-23 22:30:00+00,10485,233,3648,4986,67,3632,1970,134,0,0,25155,196,10671,8701,5053,10718
2021-07-23 23:00:00+00,10012,262,3662,4956,60,3338,1680,134,0,0,24104,196,10358,8678,5016,10274
2021-07-23 23:30:00+00,9216,229,3674,5071,60,3334,1624,135,0,0,23343,188,10429,8805,5131,9445
2021-07-24 00:00:00+00,8914,183,3671,5264,60,3334,1576,135,0,0,23137,180,10571,8995,5324,9097
2021-07-24 00:30:00+00,8769,0,3670,5291,60,3334,1669,135,0,0,22928,172,10690,9021,5351,8769
2021-07-24 01:00:00+00,8687,0,3675,5232,60,3336,1674,136,0,0,22800,172,10641,8967,5292,8687
2021-07-24 01:30:00+00,7967,0,3682,5499,60,3336,1674,135,0,0,22353,162,10915,9241,5559,7967
2021-07-24 02:00:00+00,7984,0,3686,5687,60,3190,1680,138,0,0,22425,162,11113,9433,5747,7984
2021-07-24 02:30:00+00,7868,0,3691,5900,60,3190,1559,135,0,0,22403,160,11210,9651,5960,7868
2021-07-24 03:00:00+00,7891,0,3693,5989,60,3186,1475,139,0,0,22433,159,11217,9742,6049,7891
2021-07-24 03:30:00+00,7857,0,3698,5863,60,3186,1466,137,0,0,22267,160,11087,9621,5923,7857
2021-07-24 04:00:00+00,8167,53,3699,5730,60,2836,1465,136,0,0,22146,168,10954,9489,5790,8220
2021-07-24 04:30:00+00,8271,106,3699,5753,60,2810,1459,136,46,0,22340,171,11017,9558,5859,8377
2021-07-24 05:00:00+00,8044,159,3701,5798,60,3322,1608,137,171,0,23000,165,11338,9730,6029,8203
2021-07-24 05:30:00+00,8649,229,3700,5738,60,3334,1566,138,294,0,23708,173,11358,9792,6092,8878
2021-07-24 06:00:00+00,9677,230,3697,5292,59,3728,1413,139,410,0,24645,189,10871,9458,5761,9907
2021-07-24 06:30:00+00,10849,230,3696,4900,59,3724,1418,140,636,0,25652,200,10709,9291,5595,11079
2021-07-24 07:00:00+00,12374,297,3699,4363,59,4114,1432,145,961,4,27448,213,10514,9082,5383,12671
2021-07-24 07:30:00+00,12719,403,3704,4210,63,4118,1582,139,1359,18,28315,216,10918,9336,5632,13122
2021-07-24 08:00:00+00,12822,553,3708,4052,185,4462,1581,169,1505,160,29197,218,11031,9450,5742,13375
2021-07-24 08:30:00+00,13026,765,3706,4444,188,4464,1567,281,1875,0,30316,220,11780,10213,6507,13791
2021-07-24 09:00:00+00,13198,899,3698,4480,188,4420,1576,276,2344,0,31079,221,12286,10710,7012,14097
2021-07-24 09:30:00+00,13211,981,3692,4494,177,4416,1577,184,2810,0,31542,219,12750,11173,7481,14192
2021-07-24 10:00:00+00,13101,983,3688,4595,137,4304,1565,142,3213,0,31728,216,13198,11633,7945,14084
2021-07-24 10:30:00+00,12782,988,3686,4648,121,4312,1421,136,3543,0,31637,212,13419,11998,8312,13770
2021-07-24 11:00:00+00,12513,900,3689,4721,112,4460,1395,136,3957,0,31883,205,13874,12479,8790,13413
2021-07-24 11:30:00+00,12694,638,3685,4323,112,4462,1508,141,4484,76,32123,198,14112,12604,8919,13332
2021-07-24 12:00:00+00,13510,474,3684,3927,61,3962,1583,137,4366,0,31704,204,13621,12038,8354,13984
2021-07-24 12:30:00+00,13374,483,3682,3665,61,3950,1589,140,4550,0,31494,204,13547,11958,8276,13857
2021-07-24 13:00:00+00,13264,474,3684,3334,61,3938,1586,136,4858,0,31335,203,13523,11937,8253,13738
2021-07-24 13:30:00+00,13042,460,3688,3356,60,3928,1612,136,4798,0,31080,202,13514,11902,8214,13502
2021-07-24 14:00:00+00,13212,557,3686,3179,60,3416,1693,136,4376,0,30315,204,12994,11301,7615,13769
2021-07-24 14:30:00+00,13107,692,3689,2969,59,3396,1757,136,4356,0,30161,208,12830,11073,7384,13799
2021-07-24 15:00:00+00,13231,846,3692,2831,74,3586,1908,141,3871,80,30260,215,12376,10468,6776,14077
2021-07-24 15:30:00+00,13649,975,3696,2703,111,3608,2019,143,3601,36,30541,223,12130,10111,6415,14624
2021-07-24 16:00:00+00,13581,958,3698,2571,258,4380,1946,230,3239,14,30875,229,11712,9766,6068,14539
2021-07-24 16:30:00+00,14014,981,3701,2445,280,4410,1965,279,2520,316,30911,236,10911,8946,5245,14995
2021-07-24 17:00:00+00,13913,984,3703,2384,291,4722,1962,311,1862,624,30756,237,10202,8240,4537,14897
2021-07-24 17:30:00+00,14013,985,3702,2283,291,4728,1977,318,1353,618,30268,243,9606,7629,3927,14998
2021-07-24 18:00:00+00,14111,986,3699,2301,288,4548,1996,276,932,678,29815,246,9216,7220,3521,15097
2021-07-24 18:30:00+00,14035,985,3698,2448,253,4548,1981,262,557,558,29325,249,8937,6956,3258,15020
2021-07-24 19:00:00+00,13891,988,3698,2492,209,4726,1992,227,260,548,29031,250,8651,6659,2961,14879
2021-07-24 19:30:00+00,13748,992,3700,2468,180,4734,2054,259,52,194,28381,255,8454,6400,2700,14740
2021-07-24 20:00:00+00,13610,924,3703,2663,102,4704,2086,295,0,0,28087,252,8554,6468,2765,14534
2021-07-24 20:30:00+00,13416,850,3706,2815,95,4696,2088,267,0,0,27933,247,8704,6616,2910,14266
2021-07-24 21:00:00+00,13517,836,3710,2836,86,4186,2110,210,0,0,27491,244,8742,6632,2922,14353
2021-07-24 21:30:00+00,13225,608,3710,2816,82,4170,1877,136,0,0,26624,237,8485,6608,2898,13833
2021-07-24 22:00:00+00,12749,289,3706,2852,91,3936,1567,138,0,20,25348,229,8216,6649,2943,13038
2021-07-24 22:30:00+00,11777,230,3704,2927,90,3928,1534,137,0,0,24327,220,8255,6721,3017,12007
2021-07-24 23:00:00+00,11236,237,3698,2802,76,3770,1569,136,0,0,23524,219,8145,6576,2878,11473
2021-07-24 23:30:00+00,10716,247,3697,2574,76,3770,1580,136,0,2,22798,217,7927,6347,2650,10963
2021-07-25 00:00:00+00,10351,265,3697,2458,76,3636,1562,134,0,6,22185,217,7793,6231,2534,10616
2021-07-25 00:30:00+00,10153,234,3693,2477,75,3634,1518,135,0,0,21919,214,7763,6245,2552,10387
2021-07-25 01:00:00+00,9935,230,3689,2511,75,3630,1396,136,0,0,21602,213,7671,6275,2586,10165
2021-07-25 01:30:00+00,9832,230,3691,2487,76,3630,1405,135,0,0,21486,212,7659,6254,2563,10062
2021-07-25 02:00:00+00,9846,240,3695,2473,76,3634,1486,137,0,0,21587,212,7730,6244,2549,10086
2021-07-25 02:30:00+00,9818,235,3695,2394,75,3632,1492,136,0,0,21477,213,7656,6164,2469,10053
2021-07-25 03:00:00+00,9800,240,3699,2227,75,3630,1499,135,0,0,21305,214,7500,6001,2302,10040
2021-07-25 03:30:00+00,9905,245,3702,2184,75,3630,1508,135,0,0,21384,216,7469,5961,2259,10150
2021-07-25 04:00:00+00,9833,237,3703,2045,75,3630,1496,136,0,0,21155,216,7319,5823,2120,10070
2021-07-25 04:30:00+00,9804,234,3706,1903,76,3630,1492,134,33,0,21012,217,7210,5718,2012,10038
2021-07-25 05:00:00+00,10279,240,3706,1787,76,3630,1635,134,162,0,21649,220,7366,5731,2025,10519
2021-07-25 05:30:00+00,10411,391,3705,1663,76,3630,1680,134,349,0,22039,225,7473,5793,2088,10802
2021-07-25 06:00:00+00,10619,465,3706,1706,76,3638,1615,134,566,0,22525,227,7669,6054,2348,11084
2021-07-25 06:30:00+00,11581,471,3705,1568,76,3642,1565,137,836,0,23581,233,7750,6185,2480,12052
2021-07-25 07:00:00+00,12373,470,3704,1423,76,4108,1582,140,1139,0,25015,241,7924,6342,2638,12843
2021-07-25 07:30:00+00,13287,459,3706,1410,79,4120,1630,153,1519,0,26363,242,8344,6714,3008,13746
2021-07-25 08:00:00+00,13523,590,3707,1431,169,4502,1672,138,1805,0,27537,242,8784,7112,3405,14113
2021-07-25 08:30:00+00,13828,805,3706,1416,172,4512,1681,139,2152,72,28483,245,9127,7446,3740,14633
2021-07-25 09:00:00+00,14007,911,3710,1422,172,4512,1680,191,2645,150,29400,244,9629,7949,4239,14918
2021-07-25 09:30:00+00,13975,942,3712,1394,172,4512,1681,194,2986,152,29720,242,9945,8264,4552,14917
2021-07-25 10:00:00+00,14005,944,3709,1375,126,4466,1680,215,3294,314,30128,239,10184,8504,4795,14949
2021-07-25 10:30:00+00,13917,935,3706,1356,116,4460,1673,250,3379,466,30258,237,10230,8557,4851,14852
2021-07-25 11:00:00+00,13970,923,3699,1417,94,4368,1676,423,3981,352,30903,235,10867,9191,5492,14893
2021-07-25 11:30:00+00,13655,941,3693,1464,94,4362,1674,462,4456,444,31245,229,11381,9707,6014,14596
2021-07-25 12:00:00+00,13581,981,3695,1434,78,4602,1668,422,4696,10,31168,230,11572,9904,6208,14562
2021-07-25 12:30:00+00,13363,985,3690,1463,75,4608,1646,374,5067,0,31271,226,11941,10295,6605,14348
2021-07-25 13:00:00+00,13484,980,3686,1537,75,4610,1524,174,5146,0,31216,225,11968,10444,6758,14464
2021-07-25 13:30:00+00,13293,982,3690,1698,75,4610,1496,141,4917,0,30902,225,11876,10380,6690,14275
2021-07-25 14:00:00+00,13316,985,3687,1899,75,4610,1502,157,4351,0,30582,227,11514,10012,6325,14301
2021-07-25 14:30:00+00,13319,985,3688,2039,75,4610,1713,141,3976,0,30546,228,11491,9778,6090,14304
2021-07-25 15:00:00+00,13618,985,3687,2055,75,4730,1783,141,3708,0,30782,231,11308,9525,5838,14603
2021-07-25 15:30:00+00,14057,982,3692,2024,98,4728,1997,232,3188,96,31094,236,11000,9002,5310,15039
2021-07-25 16:00:00+00,14306,987,3696,1963,336,4730,2128,315,2508,272,31241,239,10631,8503,4807,15293
2021-07-25 16:30:00+00,14511,983,3698,1940,341,4732,2071,347,2085,664,31372,241,10135,8064,4366,15494
2021-07-25 17:00:00+00,14589,982,3701,1794,347,4730,2098,393,1721,806,31161,244,9661,7563,3862,15571
2021-07-25 17:30:00+00,14564,984,3702,1615,329,4730,2096,397,1261,998,30676,248,9003,6907,3205,15548
2021-07-25 18:00:00+00,14479,985,3702,1359,320,4728,2142,399,870,708,29692,255,8393,6251,2549,15464
2021-07-25 18:30:00+00,14553,982,3701,1178,315,4730,2139,408,500,630,29136,261,7833,5694,1993,15535
2021-07-25 19:00:00+00,14528,982,3699,999,271,4728,2154,387,218,586,28552,265,7341,5187,1488,15510
2021-07-25 19:30:00+00,14427,981,3699,880,242,4732,2180,380,37,286,27844,271,7038,4858,1159,15408
2021-07-25 20:00:00+00,14335,984,3697,809,110,4712,2176,387,0,406,27616,272,6792,4616,919,15319
2021-07-25 20:30:00+00,14407,985,3700,767,110,4712,2208,325,0,242,27456,274,6785,4577,877,15392
2021-07-25 21:00:00+00,14347,988,3705,765,110,4712,2249,329,0,12,27217,276,6829,4580,875,15335
2021-07-25 21:30:00+00,13902,884,3710,741,107,4692,2269,240,0,32,26577,271,6827,4558,848,14786
2021-07-25 22:00:00+00,13130,908,3710,716,94,3742,2278,140,0,166,24884,266,6798,4520,810,14038
2021-07-25 22:30:00+00,11802,906,3709,771,91,3734,2293,137,0,0,23443,259,6864,4571,862,12708
2021-07-25 23:00:00+00,11063,808,3703,796,76,3738,2255,134,0,0,22573,252,6830,4575,872,11871
2021-07-25 23:30:00+00,10822,700,3698,735,76,3738,2218,133,0,0,22120,248,6727,4509,811,11522
2021-07-26 00:00:00+00,10902,755,3693,684,76,3732,2295,134,0,0,22271,253,6748,4453,760,11657
2021-07-26 00:30:00+00,10899,698,3696,654,76,3732,2299,133,0,0,22187,251,6725,4426,730,11597
2021-07-26 01:00:00+00,10950,654,3697,664,76,3812,2223,135,0,0,22211,250,6660,4437,740,11604
2021-07-26 01:30:00+00,10640,544,3698,701,75,3812,2200,136,0,0,21806,244,6674,4474,776,11184
2021-07-26 02:00:00+00,10603,467,3698,717,76,3812,2281,135,0,0,21789,241,6772,4491,793,11070
2021-07-26 02:30:00+00,10504,495,3698,725,76,3812,2285,135,0,0,21730,241,6784,4499,801,10999
2021-07-26 03:00:00+00,10619,582,3697,713,76,3812,2218,136,0,0,21853,245,6704,4486,789,11201
2021-07-26 03:30:00+00,10675,588,3697,717,75,3810,2213,136,0,0,21911,245,6702,4489,792,11263
2021-07-26 04:00:00+00,10625,469,3702,759,76,3810,2241,135,0,0,21817,240,6778,4537,835,11094
2021-07-26 04:30:00+00,11087,464,3706,739,75,3810,2310,134,46,0,22371,243,6876,4566,860,11551
2021-07-26 05:00:00+00,11250,458,3706,708,75,4650,2494,133,286,0,23760,244,7269,4775,1069,11708
2021-07-26 05:30:00+00,12437,460,3707,708,75,4666,2647,133,634,0,25467,247,7771,5124,1417,12897
2021-07-26 06:00:00+00,14295,655,3705,648,75,4468,2862,136,1136,0,27980,258,8426,5564,1859,14950
2021-07-26 06:30:00+00,15053,858,3704,639,80,4464,2944,137,1465,20,29364,263,8832,5888,2184,15911
2021-07-26 07:00:00+00,15322,983,3705,601,246,4706,2926,297,2133,292,31211,257,9611,6685,2980,16305
2021-07-26 07:30:00+00,15502,910,3700,577,256,4712,2934,318,2731,540,32180,250,10198,7264,3564,16412
2021-07-26 08:00:00+00,15374,936,3700,631,253,4714,2920,337,3495,890,33250,241,10999,8079,4379,16310
2021-07-26 08:30:00+00,15417,901,3699,649,221,4714,2938,339,4062,738,33678,237,11569,8631,4932,16318
2021-07-26 09:00:00+00,15405,896,3704,668,160,4714,2943,279,4871,424,34064,234,12346,9403,5699,16301
2021-07-26 09:30:00+00,15357,904,3705,686,150,4714,2939,276,5767,130,34628,230,13247,10308,6603,16261
2021-07-26 10:00:00+00,15545,907,3707,723,124,4714,2961,279,6588,0,35548,226,14103,11142,7435,16452
2021-07-26 10:30:00+00,15678,978,3708,694,123,4716,2963,288,6693,0,35841,228,14181,11218,7510,16656
2021-07-26 11:00:00+00,15808,945,3706,742,110,4714,2958,274,6372,0,35629,229,13888,10930,7224,16753
2021-07-26 11:30:00+00,15618,966,3700,904,111,4712,2837,173,6489,166,35676,226,14041,11204,7504,16584
2021-07-26 12:00:00+00,15465,986,3697,1096,93,4714,2815,140,6513,140,35659,225,14214,11399,7702,16451
2021-07-26 12:30:00+00,15241,980,3693,1216,91,4712,2701,183,6731,90,35638,223,14432,11731,8038,16221
2021-07-26 13:00:00+00,15091,912,3691,1419,76,4716,2703,214,6788,0,35610,220,14677,11974,8283,16003
2021-07-26 13:30:00+00,14738,915,3688,1577,76,4712,2766,215,6732,12,35431,217,14839,12073,8385,15653
2021-07-26 14:00:00+00,14575,979,3686,1643,76,4714,2745,252,6389,0,35059,220,14539,11794,8108,15554
2021-07-26 14:30:00+00,14685,979,3687,1706,82,4710,2734,322,6011,84,35000,222,14220,11486,7799,15664
2021-07-26 15:00:00+00,14728,977,3691,1886,101,4778,2794,458,5122,40,34575,227,13594,10800,7109,15705
2021-07-26 15:30:00+00,14885,978,3691,1925,99,4778,2800,508,4603,632,34899,227,13118,10318,6627,15863
2021-07-26 16:00:00+00,15251,982,3696,1870,312,4780,2862,520,3805,1222,35300,229,12545,9683,5987,16233
2021-07-26 16:30:00+00,15483,979,3697,1885,434,4778,2942,531,2949,1240,34918,234,11907,8965,5268,16462
2021-07-26 17:00:00+00,15857,979,3698,1902,379,4780,2921,536,2223,1260,34535,241,11123,8202,4504,16836
2021-07-26 17:30:00+00,16118,983,3696,2019,376,4780,2902,533,1544,1052,34003,248,10537,7635,3939,17101
2021-07-26 18:00:00+00,16084,979,3699,1967,357,4780,2948,520,908,844,33086,254,9879,6931,3232,17063
2021-07-26 18:30:00+00,15885,977,3701,2070,312,4780,2947,492,504,720,32388,257,9534,6587,2886,16862
2021-07-26 19:00:00+00,15933,979,3703,2116,138,4778,2943,453,190,450,31683,262,9090,6147,2444,16912
2021-07-26 19:30:00+00,15667,982,3700,2214,138,4778,2860,401,19,358,31117,263,8931,6071,2371,16649
2021-07-26 20:00:00+00,15410,981,3702,2426,123,4758,2916,232,0,82,30630,262,9167,6251,2549,16391
2021-07-26 20:30:00+00,14794,973,3712,2684,121,4758,2923,206,0,0,30171,258,9440,6517,2805,15767
2021-07-26 21:00:00+00,14175,842,3704,2776,88,4756,2801,153,0,0,29295,252,9369,6568,2864,15017
2021-07-26 21:30:00+00,13172,885,3702,2614,70,4754,2740,158,0,0,28095,250,9126,6386,2684,14057
2021-07-26 22:00:00+00,12236,899,3705,2498,83,4322,2584,142,0,0,26469,248,8870,6286,2581,13135
2021-07-26 22:30:00+00,10859,915,3707,2508,86,4310,2547,142,0,0,25074,241,8848,6301,2594,11774
2021-07-26 23:00:00+00,9752,918,3706,2440,77,4120,2939,142,0,0,24094,234,9162,6223,2517,10670
2021-07-26 23:30:00+00,9162,859,3703,2428,74,4118,2949,141,0,0,23434,228,9154,6205,2502,10021
2021-07-27 00:00:00+00,9155,600,3703,2415,75,4120,2991,141,0,0,23200,219,9184,6193,2490,9755
2021-07-27 00:30:00+00,8954,465,3698,2485,74,4118,2950,140,0,0,22884,213,9207,6257,2559,9419
2021-07-27 01:00:00+00,8992,488,3697,2362,74,4114,2852,146,0,0,22725,215,8985,6133,2436,9480
2021-07-27 01:30:00+00,8899,467,3697,2290,74,4114,2864,147,0,0,22552,214,8925,6061,2364,9366
2021-07-27 02:00:00+00,8951,487,3696,2124,75,4114,2870,147,0,0,22464,217,8765,5895,2199,9438
2021-07-27 02:30:00+00,8997,491,3696,1893,74,4114,2901,148,0,0,22314,220,8564,5663,1967,9488
2021-07-27 03:00:00+00,9136,480,3657,1668,74,4118,3034,142,0,0,22309,222,8433,5399,1742,9616
2021-07-27 03:30:00+00,9302,480,3540,1469,75,4116,3042,142,0,0,22166,227,8126,5084,1544,9782
2021-07-27 04:00:00+00,9704,467,3539,1452,74,4112,3042,140,0,0,22530,230,8107,5065,1526,10171
2021-07-27 04:30:00+00,10083,665,3546,1366,74,4114,2969,141,36,0,22994,239,7991,5022,1476,10748
2021-07-27 05:00:00+00,10298,859,3546,1587,75,4512,2671,141,201,0,23890,242,8080,5409,1863,11157
2021-07-27 05:30:00+00,11668,947,3550,1794,96,4518,2603,143,477,0,25796,248,8520,5917,2367,12615
2021-07-27 06:00:00+00,13640,988,3548,1545,122,4708,2687,141,906,0,28285,256,8808,6121,2573,14628
2021-07-27 06:30:00+00,14803,990,3546,1413,131,4710,3036,143,1338,0,30110,258,9464,6428,2882,15793
2021-07-27 07:00:00+00,15948,991,3543,1462,339,4710,3037,219,1739,216,32204,256,10120,7083,3540,16939
2021-07-27 07:30:00+00,16231,990,3547,1481,340,4710,3036,393,2489,388,33605,250,10893,7857,4310,17221
2021-07-27 08:00:00+00,16182,981,3545,1864,336,4712,3029,424,2920,276,34269,245,11694,8665,5120,17163
2021-07-27 08:30:00+00,16611,983,3543,1632,300,4710,3014,234,3180,210,34417,247,11669,8655,5112,17594
2021-07-27 09:00:00+00,16718,981,3542,1494,157,4708,3004,228,3543,284,34659,246,11740,8736,5194,17699
2021-07-27 09:30:00+00,16886,986,3540,1490,130,4710,2987,220,3844,276,35069,245,11991,9004,5464,17872
2021-07-27 10:00:00+00,16917,985,3543,1602,112,4710,2951,208,4326,100,35454,243,12534,9583,6040,17902
2021-07-27 10:30:00+00,16924,984,3543,1396,87,4706,2998,309,4570,228,35745,242,12594,9596,6053,17908
2021-07-27 11:00:00+00,16904,982,3544,1337,56,4710,3016,398,4860,496,36303,239,12813,9797,6253,17886
2021-07-27 11:30:00+00,16872,987,3539,1377,55,4710,2870,402,4450,380,35642,243,12291,9421,5882,17859
2021-07-27 12:00:00+00,16962,964,3446,1357,55,4710,2904,408,4417,246,35469,244,12179,9275,5829,17926
2021-07-27 12:30:00+00,16805,904,3321,1419,55,4712,2952,374,4284,138,34964,245,12031,9079,5758,17709
2021-07-27 13:00:00+00,16671,909,3302,1475,55,4712,2969,176,4481,248,34998,241,12282,9313,6011,17580
2021-07-27 13:30:00+00,16714,955,3305,1510,55,4712,2987,180,3997,12,34427,247,11854,8867,5562,17669
2021-07-27 14:00:00+00,16727,985,3304,1819,56,4712,2996,178,3566,100,34443,248,11741,8745,5441,17712
2021-07-27 14:30:00+00,16830,985,3306,2153,56,4712,2992,253,3557,82,34926,246,12064,9072,5766,17815
2021-07-27 15:00:00+00,16871,980,3306,2353,82,4730,3042,287,3526,20,35197,245,12309,9267,5961,17851
2021-07-27 15:30:00+00,16859,923,3306,2477,133,4732,3057,328,3045,134,34994,245,12018,8961,5655,17782
2021-07-27 16:00:00+00,16439,850,3311,2627,360,4732,3063,314,2400,886,34982,238,11761,8698,5387,17289
2021-07-27 16:30:00+00,16393,859,3313,2462,390,4730,3066,386,2272,1210,35081,238,11503,8437,5124,17252
2021-07-27 17:00:00+00,16598,813,3312,2199,396,4732,3074,430,1950,1278,34782,242,10931,7857,4545,17411
2021-07-27 17:30:00+00,16582,775,3316,2279,394,4730,3077,325,1082,1180,33740,247,10148,7071,3755,17357
2021-07-27 18:00:00+00,16457,768,3317,2344,386,4730,3077,392,671,888,33030,251,9795,6718,3401,17225
2021-07-27 18:30:00+00,16332,830,3317,2612,333,4732,3091,291,380,706,32624,253,9733,6642,3325,17162
2021-07-27 19:00:00+00,16197,874,3317,2729,155,4732,3078,149,122,744,32097,256,9401,6323,3006,17071
2021-07-27 19:30:00+00,15941,975,3320,2870,152,4732,3068,141,11,290,31500,260,9421,6353,3033,16916
2021-07-27 20:00:00+00,15692,988,3320,3172,136,4710,3077,140,0,114,31349,259,9705,6628,3308,16680
2021-07-27 20:30:00+00,14935,872,3319,3476,115,4712,3066,141,0,66,30702,251,9976,6910,3591,15807
2021-07-27 21:00:00+00,14078,641,3320,3640,66,4712,2870,142,0,16,29485,242,9896,7026,3706,14719
2021-07-27 21:30:00+00,12685,509,3319,3536,63,4690,2933,142,0,164,28041,230,9851,6918,3599,13194
2021-07-27 22:00:00+00,11745,522,3320,3458,72,3730,2985,142,0,224,26198,222,9835,6850,3530,12267
2021-07-27 22:30:00+00,10448,495,3321,3552,78,3702,2967,142,0,66,24771,212,9918,6951,3630,10943
2021-07-27 23:00:00+00,9428,559,3323,3573,78,3274,3002,142,0,80,23459,209,9976,6974,3651,9987
2021-07-27 23:30:00+00,8816,650,3320,3456,78,3268,3054,142,0,0,22784,209,9908,6854,3534,9466
2021-07-28 00:00:00+00,7941,473,3441,3514,79,3266,3071,141,0,14,21940,191,10105,7034,3593,8414
2021-07-28 00:30:00+00,7288,635,3581,3593,95,3268,3063,141,0,0,21664,188,10332,7269,3688,7923
2021-07-28 01:00:00+00,7056,633,3589,3787,95,3266,3024,140,0,0,21590,184,10495,7471,3882,7689
2021-07-28 01:30:00+00,6920,459,3587,4012,95,3266,2967,140,0,0,21446,175,10661,7694,4107,7379
2021-07-28 02:00:00+00,6931,567,3588,4358,77,3266,2975,140,0,0,21902,176,10998,8023,4435,7498
2021-07-28 02:30:00+00,6923,459,3590,4694,75,3264,2847,140,0,0,21992,170,11206,8359,4769,7382
2021-07-28 03:00:00+00,6955,462,3589,4764,75,3266,2708,141,0,0,21960,170,11136,8428,4839,7417
2021-07-28 03:30:00+00,7032,459,3591,4730,59,3266,2690,140,0,0,21967,171,11070,8380,4789,7491
2021-07-28 04:00:00+00,7062,462,3590,4883,77,3258,2629,141,0,0,22102,170,11179,8550,4960,7524
2021-07-28 04:30:00+00,7185,459,3591,5098,78,3258,2694,141,17,0,22521,170,11478,8784,5193,7644
2021-07-28 05:00:00+00,7548,459,3596,5137,75,3414,3021,142,210,0,23602,170,12039,9018,5422,8007
2021-07-28 05:30:00+00,8634,626,3596,5250,75,3414,3055,143,423,0,25216,182,12399,9344,5748,9260
2021-07-28 06:00:00+00,10044,640,3595,5450,68,4204,2922,143,771,0,27837,192,12806,9884,6289,10684
2021-07-28 06:30:00+00,10800,861,3597,5621,75,4218,3022,144,1087,0,29425,199,13402,10380,6783,11661
2021-07-28 07:00:00+00,11725,954,3598,5773,231,4224,3074,150,1461,102,31292,203,14137,11063,7465,12679
2021-07-28 07:30:00+00,12007,832,3594,5955,232,4222,3072,152,2124,266,32456,195,14977,11905,8311,12839
2021-07-28 08:00:00+00,12288,908,3595,5923,230,4020,3023,187,2758,290,33222,196,15529,12506,8911,13196
2021-07-28 08:30:00+00,12159,944,3597,5941,219,4024,3084,240,3431,298,33937,192,16272,13188,9591,13103
2021-07-28 09:00:00+00,12067,816,3591,5979,154,4312,3087,161,3768,160,34095,186,16579,13492,9901,12883
2021-07-28 09:30:00+00,11769,922,3588,6398,183,4316,3048,144,3763,80,34211,185,16980,13932,10344,12691
2021-07-28 10:00:00+00,11368,933,3589,6692,179,4126,3002,145,4772,0,34806,177,18234,15232,11643,12301
2021-07-28 10:30:00+00,11155,939,3591,6547,158,4126,3039,143,4852,0,34550,176,18187,15148,11557,12094
2021-07-28 11:00:00+00,10891,840,3588,6544,113,4314,3021,145,4820,112,34388,172,18086,15065,11477,11731
2021-07-28 11:30:00+00,10658,877,3587,6528,113,4318,3086,144,5053,112,34476,170,18367,15281,11694,11535
2021-07-28 12:00:00+00,9581,809,3590,7027,104,4706,3003,144,5513,0,34477,156,19237,16234,12644,10390
2021-07-28 12:30:00+00,8930,526,3587,7682,113,4712,3010,142,5685,0,34387,141,20077,17067,13480,9456
2021-07-28 13:00:00+00,8632,465,3582,7861,126,4710,2982,142,6216,0,34716,135,20767,17785,14203,9097
2021-07-28 13:30:00+00,8283,459,3584,8244,135,4710,2871,146,5309,0,33741,134,20143,17272,13688,8742
2021-07-28 14:00:00+00,8273,470,3595,8040,143,4706,2895,141,4831,0,33094,137,19504,16608,13014,8743
2021-07-28 14:30:00+00,8676,501,3581,7855,114,4704,3077,151,4238,0,32897,144,18865,15788,12207,9177
2021-07-28 15:00:00+00,9081,672,3580,7518,173,4344,3051,378,4327,134,33258,151,18649,15598,12018,9753
2021-07-28 15:30:00+00,9305,828,3498,8278,185,4336,3016,420,4185,114,34165,154,19162,16146,12648,10133
2021-07-28 16:00:00+00,10117,805,3323,8613,230,4232,3035,389,3476,232,34452,165,18677,15642,12319,10922
2021-07-28 16:30:00+00,10273,598,3311,8912,243,4222,3035,386,2836,238,34054,163,18337,15302,11991,10871
2021-07-28 17:00:00+00,10337,495,3313,9042,252,4014,2988,364,1990,464,33259,164,17585,14597,11284,10832
2021-07-28 17:30:00+00,10526,569,3316,8854,252,4036,2947,394,1459,508,32861,171,16828,13881,10565,11095
2021-07-28 18:00:00+00,10221,504,3477,9289,253,3958,2978,328,948,246,32202,169,16945,13967,10490,10725
2021-07-28 18:30:00+00,10259,472,3592,8906,245,3940,2992,256,610,118,31390,172,16345,13353,9761,10731
2021-07-28 19:00:00+00,9816,463,3592,8764,164,4446,2965,195,223,84,30712,170,15708,12743,9151,10279
2021-07-28 19:30:00+00,9731,489,3589,8570,159,4358,2904,144,24,140,30108,171,15246,12342,8753,10220
2021-07-28 20:00:00+00,9526,526,3593,8624,143,4208,2959,143,0,24,29746,170,15318,12360,8766,10052
2021-07-28 20:30:00+00,8823,460,3593,9056,141,4122,2795,141,0,0,29131,160,15585,12790,9197,9283
2021-07-28 21:00:00+00,7328,474,3591,9607,111,4010,2571,141,0,64,27897,146,15880,13309,9718,7802
2021-07-28 21:30:00+00,5877,467,3593,10288,111,3948,2108,141,0,202,26735,127,16100,13992,10399,6344
2021-07-28 22:00:00+00,5033,467,3596,10768,110,3230,1675,142,0,44,25065,115,16149,14474,10878,5500
2021-07-28 22:30:00+00,4144,460,3593,11186,94,3380,1384,142,0,0,24383,105,16257,14873,11280,4604
2021-07-28 23:00:00+00,3630,461,3596,11460,95,3474,1426,142,0,0,24284,99,16577,15151,11555,4091
2021-07-28 23:30:00+00,3602,424,3519,11540,95,3418,1254,142,0,0,23994,97,16408,15154,11635,4026
2021-07-29 00:00:00+00,4081,253,3343,11309,80,2468,1368,143,0,0,23045,98,16100,14732,11389,4334
2021-07-29 00:30:00+00,3903,229,3324,11492,96,2401,1391,141,0,0,22977,94,16303,14912,11588,4132
2021-07-29 01:00:00+00,3775,137,3322,11462,92,2210,1299,140,0,0,22437,89,16175,14876,11554,3912
2021-07-29 01:30:00+00,3786,91,3317,11577,107,2198,1210,140,0,0,22427,86,16211,15001,11684,3877
2021-07-29 02:00:00+00,3861,46,3316,11609,105,2183,1242,146,0,0,22507,85,16272,15030,11714,3907
2021-07-29 02:30:00+00,3880,0,3317,11578,105,2212,1247,146,0,0,22485,84,16247,15000,11683,3880
2021-07-29 03:00:00+00,3896,0,3312,11561,100,2210,1253,142,0,0,22474,83,16226,14973,11661,3896
2021-07-29 03:30:00+00,3864,0,3354,11582,105,2233,1252,152,0,0,22542,83,16293,15041,11687,3864
2021-07-29 04:00:00+00,3807,0,3538,11428,129,2148,1227,143,0,0,22419,83,16322,15095,11557,3807
2021-07-29 04:30:00+00,3934,0,3594,11453,129,2176,1218,141,41,0,22686,84,16435,15217,11623,3934
2021-07-29 05:00:00+00,4236,0,3588,11615,137,2384,1523,146,304,0,23933,87,17167,15644,12056,4236
2021-07-29 05:30:00+00,4799,0,3591,11700,157,2380,1953,144,792,0,25516,92,18193,16240,12649,4799
2021-07-29 06:00:00+00,4839,0,3593,11481,196,3220,2003,143,1322,0,26798,93,18595,16592,12999,4839
2021-07-29 06:30:00+00,5634,0,3594,11803,208,3284,2132,143,2088,0,28886,98,19825,17693,14099,5634
2021-07-29 07:00:00+00,6436,0,3597,11959,285,3399,2166,143,2754,0,30739,102,20761,18595,14998,6436
2021-07-29 07:30:00+00,6584,0,3595,12054,276,3439,2219,149,3490,0,31806,101,21634,19415,15820,6584
2021-07-29 08:00:00+00,6342,0,3593,12188,265,3558,2078,144,4204,0,32372,96,22328,20250,16657,6342
2021-07-29 08:30:00+00,5873,0,3596,12564,265,3604,2044,143,5101,0,33190,88,23570,21526,17930,5873
2021-07-29 09:00:00+00,5987,0,3583,12733,209,3531,2182,144,5745,0,34114,87,24452,22270,18687,5987
2021-07-29 09:30:00+00,5947,0,3575,12714,205,3567,2168,147,6269,0,34592,85,24931,22763,19188,5947
2021-07-29 10:00:00+00,6232,0,3402,12647,186,3651,2206,171,6536,0,35031,88,24977,22771,19369,6232
2021-07-29 10:30:00+00,6148,0,3322,12710,192,3693,2284,384,6359,0,35092,89,24867,22583,19261,6148
2021-07-29 11:00:00+00,6098,0,3318,12751,160,3784,2182,410,6256,0,34959,89,24667,22485,19167,6098
2021-07-29 11:30:00+00,5878,0,3333,12638,132,3834,2164,387,6180,0,34546,87,24447,22283,18950,5878
2021-07-29 12:00:00+00,5506,0,3364,12462,93,4256,2271,255,6050,162,34419,83,24240,21969,18605,5506
2021-07-29 12:30:00+00,5467,0,3537,12512,91,4262,2277,143,6031,284,34604,81,24448,22171,18634,5467
2021-07-29 13:00:00+00,5690,0,3588,12215,90,4264,2220,144,5967,172,34350,84,24080,21860,18272,5690
2021-07-29 13:30:00+00,5924,82,3588,11960,107,4268,2253,141,5538,308,34169,89,23446,21193,17605,6006
2021-07-29 14:00:00+00,6387,374,3584,11620,121,4270,2212,141,5408,222,34339,102,22945,20733,17149,6761
2021-07-29 14:30:00+00,7111,700,3580,11094,138,4272,2248,141,4688,14,33986,121,21748,19500,15920,7811
2021-07-29 15:00:00+00,7717,807,3570,10648,175,4550,2169,145,4009,0,33790,132,20571,18402,14832,8524
2021-07-29 15:30:00+00,8757,838,3549,10070,215,4556,2210,148,3457,84,33884,145,19501,17291,13742,9595
2021-07-29 16:00:00+00,9793,861,3545,9569,272,4668,2237,152,3036,44,34177,158,18659,16422,12877,10654
2021-07-29 16:30:00+00,10641,910,3543,9385,285,4670,2259,161,2559,116,34529,167,18031,15772,12229,11551
2021-07-29 17:00:00+00,10963,873,3474,8779,309,4682,2278,259,1947,440,34004,173,16787,14509,11035,11836
2021-07-29 17:30:00+00,11309,908,3328,8057,311,4680,2301,364,1428,634,33320,183,15425,13124,9796,12217
2021-07-29 18:00:00+00,11310,917,3313,7852,311,4628,2393,375,880,736,32715,187,14749,12356,9043,12227
2021-07-29 18:30:00+00,11523,974,3314,7326,286,4620,2401,358,391,718,31911,195,13718,11317,8003,12497
2021-07-29 19:00:00+00,11792,989,3350,6763,234,4622,2400,251,143,744,31288,202,12890,10490,7140,12781
2021-07-29 19:30:00+00,11825,988,3541,6132,233,4624,2385,199,11,856,30794,205,12302,9917,6376,12813
2021-07-29 20:00:00+00,11883,983,3591,5696,213,4800,2380,197,0,650,30393,208,11880,9500,5909,12866
2021-07-29 20:30:00+00,11811,987,3589,5389,194,4800,2379,196,0,574,29919,211,11551,9172,5583,12798
2021-07-29 21:00:00+00,11952,861,3591,5063,156,4654,2380,180,0,168,29005,215,11190,8810,5219,12813
2021-07-29 21:30:00+00,11608,609,3593,4702,157,4634,2282,148,0,0,27733,210,10734,8452,4859,12217
2021-07-29 22:00:00+00,11071,465,3593,4317,138,3800,2219,156,0,204,25963,204,10267,8048,4455,11536
2021-07-29 22:30:00+00,10335,227,3590,3855,125,3778,2192,141,0,134,24377,196,9762,7570,3980,10562
2021-07-29 23:00:00+00,9932,5,3594,3552,86,3600,2214,143,0,0,23126,191,9446,7232,3638,9937
2021-07-29 23:30:00+00,9824,3,3596,3108,71,3584,2196,142,0,0,22524,194,8971,6775,3179,9826
2021-07-30 00:00:00+00,9728,0,3507,2896,70,3488,2117,141,0,0,21947,198,8590,6473,2966,9728
2021-07-30 00:30:00+00,9445,0,3339,2785,62,3486,2214,142,0,0,21473,198,8400,6186,2847,9445
2021-07-30 01:00:00+00,9234,0,3322,2522,60,3482,2209,231,0,0,21060,199,8113,5904,2582,9234
2021-07-30 01:30:00+00,9212,0,3320,2581,60,3486,2223,164,0,0,21046,198,8184,5961,2641,9212
2021-07-30 02:00:00+00,9360,0,3317,2535,59,3486,2207,143,0,0,21107,200,8118,5911,2594,9360
2021-07-30 02:30:00+00,9356,0,3321,2570,60,3486,2214,144,0,0,21151,199,8165,5951,2630,9356
2021-07-30 03:00:00+00,9269,0,3510,2722,60,3486,2147,139,0,0,21333,196,8439,6292,2782,9269
2021-07-30 03:30:00+00,9146,0,3588,2915,65,3486,2091,139,0,0,21430,192,8659,6568,2980,9146
2021-07-30 04:00:00+00,8948,0,3585,2972,80,3430,2095,141,0,0,21251,189,8732,6637,3052,8948
2021-07-30 04:30:00+00,8991,0,3584,3058,86,3436,2115,140,3,50,21463,188,8846,6731,3147,8991
2021-07-30 05:00:00+00,9677,125,3587,3309,139,3854,2184,141,52,0,23068,192,9271,7087,3500,9802
2021-07-30 05:30:00+00,10577,336,3588,3428,139,3864,2362,141,173,0,24608,203,9690,7328,3740,10913
2021-07-30 06:00:00+00,12328,596,3588,3794,141,4154,2251,142,375,0,27369,217,10149,7898,4310,12924
2021-07-30 06:30:00+00,13092,865,3589,4298,167,4138,2339,145,725,38,29396,222,11118,8779,5190,13957
2021-07-30 07:00:00+00,14244,989,3591,4760,255,4004,2365,190,1089,0,31487,234,12060,9695,6104,15233
2021-07-30 07:30:00+00,14620,993,3590,5116,255,3988,2373,150,1700,14,32799,229,13034,10661,7071,15613
2021-07-30 08:00:00+00,15027,994,3529,5244,255,3858,2335,178,2293,128,33841,227,13656,11321,7792,16021
2021-07-30 08:30:00+00,14989,992,3347,5651,252,3858,2247,192,2265,62,33855,226,13762,11515,8168,15981
2021-07-30 09:00:00+00,15015,995,3316,5868,234,3810,2317,152,2285,0,33992,226,14020,11703,8387,16010
2021-07-30 09:30:00+00,15105,987,3321,5894,233,3810,2326,146,2670,0,34492,223,14444,12118,8797,16092
2021-07-30 10:00:00+00,15126,989,3350,5509,164,3768,2320,201,2605,170,34202,226,13948,11628,8278,16115
2021-07-30 10:30:00+00,14825,993,3558,5700,149,3768,2318,242,3345,0,34898,219,15070,12752,9194,15818
2021-07-30 11:00:00+00,15026,994,3593,5997,126,3768,2156,213,3542,0,35415,217,15414,13258,9665,16020
2021-07-30 11:30:00+00,14972,983,3590,6311,117,3768,2085,145,3259,0,35230,217,15362,13277,9687,15955
2021-07-30 12:00:00+00,14757,984,3590,6676,81,3132,2139,142,3356,0,34857,216,15842,13703,10113,15741
2021-07-30 12:30:00+00,14419,990,3590,6814,81,3012,2074,145,3697,0,34822,212,16256,14182,10592,15409
2021-07-30 13:00:00+00,14208,989,3593,6995,81,2884,2135,142,3543,0,34570,210,16347,14212,10619,15197
2021-07-30 13:30:00+00,14139,892,3588,7171,81,2882,2043,142,3153,0,34091,209,16036,13993,10405,15031
2021-07-30 14:00:00+00,14251,737,3588,7206,81,2872,1934,140,2931,0,33740,208,15740,13806,10218,14988
2021-07-30 14:30:00+00,14049,952,3588,7244,78,2870,1918,150,2641,0,33490,213,15469,13551,9963,15001
2021-07-30 15:00:00+00,14193,974,3589,7102,133,3022,1928,145,2635,0,33721,213,15387,13459,9870,15167
2021-07-30 15:30:00+00,14581,971,3576,6680,165,3022,2084,145,2374,68,33666,218,14879,12795,9219,15552
2021-07-30 16:00:00+00,15015,947,3389,6354,223,3386,2321,174,1931,56,33796,225,14218,11897,8508,15962
2021-07-30 16:30:00+00,15266,930,3313,6155,235,3390,2321,223,1921,108,33862,228,13945,11624,8311,16196
2021-07-30 17:00:00+00,14582,881,3313,5950,271,4526,2162,174,1624,362,33845,218,13320,11158,7845,15463
2021-07-30 17:30:00+00,14712,817,3323,6024,271,4570,2143,158,1003,174,33195,221,12764,10621,7298,15529
2021-07-30 18:00:00+00,14609,817,3483,6213,272,4256,2142,144,554,86,32576,219,12664,10522,7039,15426
2021-07-30 18:30:00+00,13979,822,3589,6424,252,4254,2166,140,305,0,31931,216,12736,10570,6981,14801
2021-07-30 19:00:00+00,12767,808,3590,6723,180,4664,2169,140,92,0,31133,211,12754,10585,6995,13575
2021-07-30 19:30:00+00,12093,768,3591,6954,170,4672,2195,140,6,0,30589,205,12916,10721,7130,12861
2021-07-30 20:00:00+00,11822,717,3593,6916,156,4624,2195,140,0,10,30173,203,12860,10665,7072,12539
2021-07-30 20:30:00+00,11092,683,3600,7077,131,4622,2158,139,0,0,29502,197,12966,10808,7208,11775
2021-07-30 21:00:00+00,10492,557,3597,7183,96,4512,1869,139,0,0,28445,189,12745,10876,7279,11049
2021-07-30 21:30:00+00,9720,469,3599,7193,87,4496,1505,139,0,0,27208,182,12384,10879,7280,10189
2021-07-30 22:00:00+00,8868,516,3599,7514,66,3598,1426,139,0,0,25726,172,12605,11179,7580,9384
2021-07-30 22:30:00+00,7330,488,3600,7735,58,3568,1430,141,0,0,24350,155,12823,11393,7793,7818
2021-07-30 23:00:00+00,6689,462,3504,7802,56,3112,1445,139,0,0,23209,151,12807,11362,7858,7151
2021-07-30 23:30:00+00,5958,458,3338,7955,55,3104,1443,142,0,0,22453,143,12791,11348,8010,6416
2021-07-31 00:00:00+00,5435,533,3326,7698,55,3102,1450,141,0,0,21740,139,12529,11079,7753,5968
2021-07-31 00:30:00+00,5285,549,3326,7709,55,3102,1440,140,0,0,21606,138,12530,11090,7764,5834
2021-07-31 01:00:00+00,5079,537,3325,7776,55,3102,1452,143,0,0,21469,135,12608,11156,7831,5616
2021-07-31 01:30:00+00,4612,491,3416,7972,55,3102,1452,141,0,0,21241,126,12895,11443,8027,5103
2021-07-31 02:00:00+00,4610,512,3549,7973,55,3104,1454,142,0,0,21399,126,13031,11577,8028,5122
2021-07-31 02:30:00+00,4536,519,3544,8043,55,3104,1489,141,0,0,21431,125,13131,11642,8098,5055
2021-07-31 03:00:00+00,4541,520,3539,7997,55,3104,1458,139,0,0,21353,125,13049,11591,8052,5061
2021-07-31 03:30:00+00,4533,521,3548,7937,55,3104,1455,139,0,0,21292,125,12995,11540,7992,5054
2021-07-31 04:00:00+00,4588,525,3561,7900,55,3104,1467,140,0,0,21340,126,12983,11516,7955,5113
2021-07-31 04:30:00+00,4645,525,3559,7678,55,3104,1460,139,17,0,21182,128,12769,11309,7750,5170
2021-07-31 05:00:00+00,5398,563,3559,7238,85,3100,1487,140,165,0,21735,140,12534,11047,7488,5961
2021-07-31 05:30:00+00,6337,647,3558,6712,86,3128,1649,219,471,0,22807,155,12476,10827,7269,6984
2021-07-31 06:00:00+00,7353,661,3560,6208,86,3858,1701,261,763,0,24451,168,12318,10617,7057,8014
2021-07-31 06:30:00+00,8612,736,3564,5674,90,3874,1758,269,1118,0,25694,182,12204,10446,6882,9348
2021-07-31 07:00:00+00,9560,684,3565,5431,102,4254,1755,479,1589,0,27419,186,12442,10687,7122,10244
2021-07-31 07:30:00+00,10089,750,3565,5243,102,4258,1738,321,2129,0,28195,189,12777,11039,7474,10839
2021-07-31 08:00:00+00,10667,817,3570,5206,139,4550,1738,190,2666,4,29547,189,13319,11581,8011,11484
2021-07-31 08:30:00+00,10999,956,3570,5175,131,4555,1734,198,3102,0,30420,193,13712,11978,8408,11955
2021-07-31 09:00:00+00,11326,984,3570,4790,168,4508,1738,202,3463,182,30931,194,13729,11991,8421,12310
2021-07-31 09:30:00+00,11701,989,3567,4429,167,4509,1738,173,3699,0,30972,199,13600,11862,8295,12690
2021-07-31 10:00:00+00,11660,989,3569,4311,141,4512,1769,165,4179,82,31378,196,13969,12200,8631,12649
2021-07-31 10:30:00+00,11442,988,3571,4307,139,4514,1773,165,4438,200,31536,192,14228,12455,8884,12430
2021-07-31 11:00:00+00,11407,991,3571,4308,93,4515,1779,165,4769,208,31805,190,14520,12741,9170,12398
2021-07-31 11:30:00+00,11415,976,3570,4232,91,4516,1764,166,4675,200,31604,191,14332,12568,8998,12391
2021-07-31 12:00:00+00,11357,975,3576,4122,69,4519,1763,166,4288,146,30980,194,13818,12055,8479,12332
2021-07-31 12:30:00+00,11271,964,3599,4139,69,4518,1640,167,4248,116,30731,194,13695,12055,8456,12235
2021-07-31 13:00:00+00,11270,953,3593,4024,56,4515,1688,168,4045,90,30402,196,13406,11718,8125,12223
2021-07-31 13:30:00+00,11078,974,3598,3949,53,4516,1760,166,4150,0,30244,195,13510,11750,8152,12052
2021-07-31 14:00:00+00,11235,982,3595,3954,53,4523,1738,175,3924,0,30180,198,13264,11526,7932,12217
2021-07-31 14:30:00+00,11272,965,3595,3989,54,4522,1742,141,3536,0,29816,200,12916,11174,7579,12237
2021-07-31 15:00:00+00,11427,883,3592,3855,72,5005,1739,143,3243,62,30021,199,12501,10762,7170,12310
2021-07-31 15:30:00+00,11900,919,3589,3725,89,5012,1779,154,2904,164,30235,206,12086,10307,6718,12819
2021-07-31 16:00:00+00,12424,983,3586,3666,189,5018,1787,291,2646,138,30728,212,11874,10087,6501,13407
2021-07-31 16:30:00+00,12833,988,3590,3541,222,5019,1786,330,2214,242,30764,218,11353,9567,5977,13821
2021-07-31 17:00:00+00,13011,990,3593,3623,222,5020,1782,467,1617,348,30672,222,10837,9055,5462,14001
2021-07-31 17:30:00+00,12657,941,3588,3516,222,5019,1781,565,1132,614,30035,222,10239,8458,4870,13598
2021-07-31 18:00:00+00,12489,984,3608,3384,248,5040,1781,563,729,438,29264,228,9750,7969,4361,13473
2021-07-31 18:30:00+00,12519,846,3615,3219,259,5049,1785,377,379,464,28512,227,9257,7472,3857,13365
2021-07-31 19:00:00+00,12892,775,3614,3067,237,5054,1783,183,118,448,28171,230,8819,7036,3422,13667
2021-07-31 19:30:00+00,13035,767,3614,3009,181,5053,1776,180,7,302,27924,234,8587,6811,3197,13802
2021-07-31 20:00:00+00,13267,894,3617,2935,139,4722,1776,154,0,56,27560,244,8467,6691,3074,14161
2021-07-31 20:30:00+00,13047,944,3617,3056,133,4706,1769,142,0,0,27414,243,8575,6806,3189,13991
2021-07-31 21:00:00+00,12192,745,3616,3128,100,4777,1721,140,0,0,26419,232,8565,6844,3228,12937
2021-07-31 21:30:00+00,11704,625,3618,3025,89,4746,1483,141,0,0,25432,228,8215,6732,3114,12329
2021-07-31 22:00:00+00,11458,723,3615,2946,49,3798,1436,142,0,2,24169,232,8046,6610,2995,12181
2021-07-31 22:30:00+00,10801,611,3618,2770,49,3772,1433,139,0,0,23193,226,7870,6437,2819,11412
2021-07-31 23:00:00+00,10496,479,3621,2666,48,3394,1433,141,0,0,22278,224,7768,6335,2714,10975
2021-07-31 23:30:00+00,9792,462,3630,2772,48,3388,1433,141,0,0,21666,216,7883,6450,2820,10254
2021-08-01 00:00:00+00,8880,466,3644,3006,48,3386,1442,141,0,0,21013,209,8140,6698,3054,9346
2021-08-01 00:30:00+00,8377,473,3644,3050,48,3382,1471,140,0,0,20585,204,8213,6742,3098,8850
2021-08-01 01:00:00+00,8211,466,3642,3163,48,3190,1494,142,0,0,20356,203,8347,6853,3211,8677
2021-08-01 01:30:00+00,8116,479,3641,3023,48,3188,1502,143,0,0,20140,204,8214,6712,3071,8595
2021-08-01 02:00:00+00,8365,479,3638,2887,48,3188,1522,142,0,0,20269,208,8095,6573,2935,8844
2021-08-01 02:30:00+00,8411,548,3637,2708,48,3190,1544,148,0,0,20234,212,7937,6393,2756,8959
2021-08-01 03:00:00+00,8281,476,3664,2607,48,3382,1562,147,0,0,20167,208,7881,6319,2655,8757
2021-08-01 03:30:00+00,8261,462,3665,2645,48,3386,1584,140,0,0,20191,206,7942,6358,2693,8723
2021-08-01 04:00:00+00,8135,471,3664,2596,48,3386,1613,140,0,0,20053,206,7921,6308,2644,8606
2021-08-01 04:30:00+00,8088,465,3685,2555,49,3388,1665,139,9,0,20043,205,7963,6298,2613,8553
2021-08-01 05:00:00+00,8170,464,3687,2537,62,3386,1877,139,101,0,20423,204,8264,6387,2700,8634
2021-08-01 05:30:00+00,8571,476,3687,2410,62,3386,2088,140,289,0,21109,207,8536,6448,2761,9047
2021-08-01 06:00:00+00,8924,470,3687,2661,77,3386,2100,141,558,0,22004,204,9083,6983,3296,9394
2021-08-01 06:30:00+00,9579,517,3686,2407,84,3402,2059,141,938,4,22817,210,9174,7115,3429,10096
2021-08-01 07:00:00+00,9682,474,3689,2374,123,4244,2055,142,1311,0,24094,208,9552,7497,3808,10156
2021-08-01 07:30:00+00,10329,600,3690,2550,137,4262,2158,236,1594,60,25616,212,10129,7971,4281,10929
2021-08-01 08:00:00+00,10582,659,3691,2505,167,4504,2350,310,2181,82,27031,209,10894,8544,4853,11241
2021-08-01 08:30:00+00,11183,775,3697,2318,166,4510,2403,353,2810,0,28215,213,11394,8991,5294,11958
2021-08-01 09:00:00+00,11621,849,3708,2448,141,4508,2386,355,3291,0,29307,214,11974,9588,5880,12470
2021-08-01 09:30:00+00,11860,903,3726,2177,123,4508,2381,360,3666,84,29788,216,12073,9692,5966,12763
2021-08-01 10:00:00+00,12157,898,3733,2022,116,4364,2397,367,3843,184,30081,218,12111,9714,5981,13055
2021-08-01 10:30:00+00,12304,889,3753,1887,116,4360,2409,368,3910,252,30248,219,12075,9666,5913,13193
2021-08-01 11:00:00+00,12767,898,3756,1911,100,4164,2435,368,4063,138,30600,223,12265,9830,6074,13665
2021-08-01 11:30:00+00,12607,856,3789,2164,97,4160,2404,369,4244,0,30690,218,12698,10294,6505,13463
2021-08-01 12:00:00+00,12140,754,3793,2183,56,4976,2282,212,4500,0,30896,206,12814,10532,6739,12894
2021-08-01 12:30:00+00,11819,731,3795,2368,58,4998,2267,143,4512,0,30692,202,13000,10734,6938,12550
2021-08-01 13:00:00+00,11632,626,3806,2550,57,4998,2249,141,4529,0,30588,197,13191,10942,7136,12258
2021-08-01 13:30:00+00,11906,512,3818,2612,52,5000,2074,141,4011,0,30126,199,12567,10493,6675,12418
2021-08-01 14:00:00+00,11843,554,3819,2906,52,5000,2039,141,3912,0,30266,199,12728,10689,6870,12397
2021-08-01 14:30:00+00,11904,561,3844,3070,52,5000,2065,141,3965,0,30602,198,12996,10931,7087,12465
2021-08-01 15:00:00+00,12574,569,3922,2908,83,5020,2085,152,3658,0,30971,204,12656,10571,6649,13143
2021-08-01 15:30:00+00,13513,590,3920,2681,101,5020,2225,152,3358,0,31560,213,12285,10060,6140,14103
2021-08-01 16:00:00+00,13686,672,3924,2676,189,5018,2461,141,2843,32,31642,218,12093,9632,5708,14358
2021-08-01 16:30:00+00,14062,598,3923,2710,189,5020,2391,141,2264,46,31344,223,11477,9086,5163,14660
2021-08-01 17:00:00+00,13897,467,3925,2892,289,5020,2353,148,1825,386,31202,218,11284,8931,5006,14364
2021-08-01 17:30:00+00,13759,470,4013,2797,290,5020,2319,148,1387,428,30631,220,10806,8487,4474,14229
2021-08-01 18:00:00+00,13339,618,4017,2777,291,5018,2312,148,901,432,29853,225,10298,7986,3969,13957
2021-08-01 18:30:00+00,13242,741,4020,2589,288,5018,2307,146,489,460,29300,231,9693,7386,3366,13983
2021-08-01 19:00:00+00,13500,742,4026,2328,181,5018,2300,141,158,302,28696,240,8993,6693,2667,14242
2021-08-01 19:30:00+00,13141,812,4025,2246,154,5016,2290,191,9,446,28330,241,8724,6434,2409,13953
2021-08-01 20:00:00+00,13550,977,4025,2127,115,4794,2279,238,0,242,28347,249,8546,6267,2242,14527
2021-08-01 20:30:00+00,13102,982,4027,2064,113,4790,2223,253,0,8,27562,250,8427,6204,2177,14084
2021-08-01 21:00:00+00,12804,859,4032,2068,54,4602,2213,224,0,0,26856,247,8367,6154,2122,13663
2021-08-01 21:30:00+00,12237,734,4032,1934,47,4592,1948,142,0,0,25666,243,7961,6013,1981,12971
2021-08-01 22:00:00+00,11480,739,4033,1755,47,4268,1735,140,0,0,24197,245,7570,5835,1802,12219
2021-08-01 22:30:00+00,10744,724,4035,1651,47,4262,1456,140,0,0,23059,243,7189,5733,1698,11468
2021-08-01 23:00:00+00,10199,503,4037,1590,47,4018,1450,139,0,0,21983,234,7124,5674,1637,10702
2021-08-01 23:30:00+00,9490,502,4079,1561,47,4016,1463,140,0,0,21298,228,7150,5687,1608,9992
2021-08-02 00:00:00+00,9269,499,4118,1457,47,4018,1448,139,0,0,20995,230,7070,5622,1504,9768
2021-08-02 00:30:00+00,9355,437,4152,1405,47,4018,1471,140,0,0,21025,228,7075,5604,1452,9792
2021-08-02 01:00:00+00,9356,413,4151,1320,47,4014,1473,141,0,0,20915,229,6991,5518,1367,9769
2021-08-02 01:30:00+00,9211,263,4152,1300,47,4014,1454,139,0,0,20580,223,6953,5499,1347,9474
2021-08-02 02:00:00+00,8934,231,4152,1315,47,4016,1454,140,0,0,20289,219,6968,5514,1362,9165
2021-08-02 02:30:00+00,8698,233,4175,1424,47,4014,1485,140,0,0,20216,215,7131,5646,1471,8931
2021-08-02 03:00:00+00,8892,230,4239,1522,47,3778,1517,140,0,0,20365,216,7325,5808,1569,9122
2021-08-02 03:30:00+00,8863,233,4232,1587,47,3774,1544,140,0,0,20420,215,7410,5866,1634,9096
2021-08-02 04:00:00+00,9202,233,4233,1602,65,3774,1585,144,0,0,20838,218,7485,5900,1667,9435
2021-08-02 04:30:00+00,9433,235,4233,1523,65,3774,1753,145,19,0,21180,220,7593,5840,1607,9668
2021-08-02 05:00:00+00,10463,333,4233,1418,108,4204,1976,140,216,0,23091,226,7951,5975,1742,10796
2021-08-02 05:30:00+00,11627,457,4235,1374,108,4212,2275,171,541,0,25000,233,8533,6258,2023,12084
2021-08-02 06:00:00+00,12766,497,4235,1304,112,4682,2557,181,1043,0,27377,233,9251,6694,2459,13263
2021-08-02 06:30:00+00,13799,499,4238,1126,123,4688,2740,173,1619,0,29005,235,9846,7106,2868,14298
2021-08-02 07:00:00+00,14217,499,4235,1024,256,4986,2900,180,2325,96,30718,230,10740,7840,3605,14716
2021-08-02 07:30:00+00,15074,499,4236,875,271,4996,2891,162,2998,0,32002,232,11271,8380,4144,15573
2021-08-02 08:00:00+00,15456,500,4240,776,265,4998,2899,146,3719,20,33019,229,11899,9000,4760,15956
2021-08-02 08:30:00+00,15496,499,4270,677,252,5000,2894,145,4334,0,33567,226,12427,9533,5263,15995
2021-08-02 09:00:00+00,15514,500,4293,642,200,5002,2892,146,4773,0,33962,223,12800,9908,5615,16014
2021-08-02 09:30:00+00,15513,500,4312,595,185,5000,2846,167,4805,0,33923,223,12743,9897,5585,16013
2021-08-02 10:00:00+00,15612,498,4311,541,173,4926,2863,221,5264,0,34409,221,13152,10289,5978,16110
2021-08-02 10:30:00+00,15538,501,4310,510,161,4926,2899,311,5189,168,34513,221,13069,10170,5860,16039
2021-08-02 11:00:00+00,15412,499,4309,493,125,5000,2863,329,4767,354,34151,223,12557,9694,5385,15911
2021-08-02 11:30:00+00,15396,500,4309,549,106,5002,2832,338,4337,292,33661,226,12133,9301,4992,15896
2021-08-02 12:00:00+00,15459,501,4310,564,106,4998,2820,250,4235,318,33561,227,12035,9215,4905,15960
2021-08-02 12:30:00+00,15427,500,4307,612,106,4998,2816,234,4619,206,33825,224,12460,9644,5337,15927
2021-08-02 13:00:00+00,15616,574,4306,694,106,5002,2815,257,4529,28,33927,228,12450,9635,5329,16190
2021-08-02 13:30:00+00,15668,763,4307,756,106,5000,2812,170,3926,36,33544,235,11907,9095,4788,16431
2021-08-02 14:00:00+00,15785,954,4305,812,106,5000,2791,141,3272,106,33272,243,11286,8495,4190,16739
2021-08-02 14:30:00+00,16108,988,4305,856,112,4998,2636,199,3410,160,33772,245,11319,8683,4378,17096
2021-08-02 15:00:00+00,16401,986,4308,849,124,5022,2652,395,2736,6,33479,253,10669,8017,3709,17387
2021-08-02 15:30:00+00,16627,986,4305,846,190,5020,2860,594,2261,116,33805,255,10462,7602,3297,17613
2021-08-02 16:00:00+00,16614,987,4301,880,307,5020,2869,541,2069,706,34294,251,10426,7557,3256,17601
2021-08-02 16:30:00+00,16586,989,4294,893,333,5022,2892,539,1747,1066,34361,250,10159,7267,2973,17575
2021-08-02 17:00:00+00,16694,990,4286,920,330,5018,2928,527,1469,1142,34304,252,9933,7005,2719,17684
2021-08-02 17:30:00+00,16735,989,4284,921,315,5018,2929,525,1073,1050,33839,256,9522,6593,2309,17724
2021-08-02 18:00:00+00,16804,989,4286,888,317,5018,2930,442,739,620,33033,262,9160,6230,1944,17793
2021-08-02 18:30:00+00,17020,993,4285,846,295,5018,2943,386,439,404,32629,268,8808,5865,1580,18013
2021-08-02 19:00:00+00,16662,986,4283,836,234,5018,2957,304,145,548,31973,267,8455,5498,1215,17648
2021-08-02 19:30:00+00,16663,988,4292,900,200,5020,2954,203,9,166,31395,271,8355,5401,1109,17651
2021-08-02 20:00:00+00,16329,987,4295,1025,189,5000,2961,218,0,0,31004,271,8470,5509,1214,17316
2021-08-02 20:30:00+00,15722,870,4293,1066,176,5000,2956,207,0,0,30290,265,8491,5535,1242,16592
2021-08-02 21:00:00+00,14611,731,4290,1104,88,5000,2946,203,0,0,28973,258,8428,5482,1192,15342
2021-08-02 21:30:00+00,13102,717,4292,1086,85,4986,2946,170,0,0,27384,250,8409,5463,1171,13819
2021-08-02 22:00:00+00,12356,500,4299,987,86,4278,2947,143,0,12,25608,244,8319,5372,1073,12856
2021-08-02 22:30:00+00,11090,499,4300,927,83,4262,2882,143,0,58,24244,237,8192,5310,1010,11589
2021-08-02 23:00:00+00,10343,500,4307,986,53,4018,2778,141,0,0,23126,234,8124,5346,1038,10843
2021-08-02 23:30:00+00,9740,445,4308,920,53,4016,2761,139,0,0,22382,229,8042,5281,973,10185
2021-08-03 00:00:00+00,9318,442,4307,827,53,4016,2852,140,0,0,21955,229,8039,5187,880,9760
2021-08-03 00:30:00+00,9203,439,4306,801,53,4016,2863,140,0,0,21821,228,8023,5160,854,9642
2021-08-03 01:00:00+00,9023,443,4305,759,53,4018,2895,140,0,0,21636,227,8012,5117,812,9466
2021-08-03 01:30:00+00,8971,437,4304,634,53,4018,2887,139,0,0,21443,228,7878,4991,687,9408
2021-08-03 02:00:00+00,9077,438,4305,556,53,3754,2868,140,0,0,21191,226,7782,4914,609,9515
2021-08-03 02:30:00+00,9122,444,4305,565,53,3752,2901,140,0,0,21282,226,7824,4923,618,9566
2021-08-03 03:00:00+00,9121,460,4305,553,53,3880,2844,140,0,0,21356,229,7755,4911,606,9581
2021-08-03 03:30:00+00,9179,499,4304,526,53,3882,2797,140,0,0,21380,231,7680,4882,578,9678
2021-08-03 04:00:00+00,9325,500,4304,545,71,3906,2916,145,0,0,21712,232,7836,4920,616,9825
2021-08-03 04:30:00+00,9817,499,4303,534,71,3906,2926,146,20,0,22222,236,7854,4928,625,10316
2021-08-03 05:00:00+00,11116,499,4304,501,97,3816,2920,142,244,0,23639,232,8066,5146,842,11615
2021-08-03 05:30:00+00,12684,499,4304,485,97,3810,2917,140,672,0,25608,238,8475,5558,1254,13183
2021-08-03 06:00:00+00,14093,503,4304,504,119,4444,2866,142,1242,0,28217,242,9035,6169,1865,14596
2021-08-03 06:30:00+00,15278,523,4304,567,123,4458,2892,145,1884,0,30174,242,9770,6878,2574,15801
2021-08-03 07:00:00+00,15757,586,4310,587,223,4984,2891,140,2507,0,31985,245,10518,7627,3317,16343
2021-08-03 07:30:00+00,16061,692,4312,592,225,4998,2885,141,3043,12,32961,244,11057,8172,3860,16753
2021-08-03 08:00:00+00,15876,699,4313,580,211,5002,2844,152,3808,250,33735,237,11756,8912,4599,16575
2021-08-03 08:30:00+00,15551,700,4313,557,211,5000,2837,161,4572,0,33902,232,12490,9653,5340,16251
2021-08-03 09:00:00+00,15504,699,4314,527,138,4706,2847,148,5079,0,33962,231,12905,10058,5744,16203
2021-08-03 09:30:00+00,15209,700,4320,602,117,4702,2860,143,5907,0,34560,223,13806,10946,6626,15909
2021-08-03 10:00:00+00,14951,698,4326,700,117,4604,2795,142,6664,88,35085,217,14602,11807,7481,15649
2021-08-03 10:30:00+00,14812,700,4321,737,114,4598,2816,143,6836,0,35077,215,14824,12008,7687,15512
2021-08-03 11:00:00+00,15007,759,4313,768,96,4608,2824,142,6831,0,35348,218,14832,12008,7695,15766
2021-08-03 11:30:00+00,14691,949,4317,834,93,4608,2817,142,6745,0,35196,220,14806,11989,7672,15640
2021-08-03 12:00:00+00,14701,990,4310,842,85,4504,2809,141,6965,0,35347,220,15011,12202,7892,15691
2021-08-03 12:30:00+00,14563,991,4309,866,89,4500,2765,139,6617,0,34839,222,14646,11881,7572,15554
2021-08-03 13:00:00+00,14544,994,4303,983,89,4510,2719,140,6570,68,34920,221,14664,11945,7642,15538
2021-08-03 13:30:00+00,14467,996,4302,1125,89,4508,2700,139,6182,20,34528,223,14398,11698,7396,15463
2021-08-03 14:00:00+00,14537,996,4291,1238,94,4514,2818,141,5704,0,34333,225,14145,11327,7036,15533
2021-08-03 14:30:00+00,14799,993,4288,1305,111,4510,2821,142,5121,146,34236,229,13646,10825,6537,15792
2021-08-03 15:00:00+00,14965,995,4283,1361,234,4820,2818,153,4395,16,34040,232,13091,10273,5990,15960
2021-08-03 15:30:00+00,15375,996,4283,1420,339,4826,2813,281,3830,42,34205,238,12685,9872,5589,16371
2021-08-03 16:00:00+00,15451,996,4273,1500,452,5016,2897,356,3278,314,34533,237,12400,9503,5230,16447
2021-08-03 16:30:00+00,15638,998,4272,1540,456,5018,2912,439,2666,738,34677,239,11846,8934,4662,16636
2021-08-03 17:00:00+00,15844,994,4263,1589,456,4834,2917,428,2044,864,34233,244,11269,8352,4089,16838
2021-08-03 17:30:00+00,15927,978,4258,1590,456,4832,2917,473,1376,824,33631,249,10597,7680,3422,16905
2021-08-03 18:00:00+00,16142,994,4253,1619,472,4738,2916,472,812,720,33138,256,10072,7156,2903,17136
2021-08-03 18:30:00+00,16057,996,4252,1608,457,4738,2909,404,408,700,32529,259,9634,6725,2473,17053
2021-08-03 19:00:00+00,15592,996,4239,1631,400,4740,2903,333,125,634,31593,260,9298,6395,2156,16588
2021-08-03 19:30:00+00,15535,996,4239,1675,373,4738,2902,306,4,520,31288,261,9193,6291,2052,16531
2021-08-03 20:00:00+00,15828,996,4233,1621,261,4860,2899,265,0,120,31083,267,9014,6115,1882,16824
2021-08-03 20:30:00+00,15360,996,4234,1481,156,4864,2903,223,0,0,30217,268,8774,5871,1637,16356
2021-08-03 21:00:00+00,14460,997,4227,1279,93,4996,2901,146,0,14,29113,265,8500,5599,1372,15457
2021-08-03 21:30:00+00,12999,999,4227,1178,93,4986,2903,140,0,0,27525,259,8401,5498,1271,13998
2021-08-03 22:00:00+00,11894,997,4230,1172,176,4272,2807,140,0,16,25704,256,8385,5578,1348,12891
2021-08-03 22:30:00+00,10685,998,4230,1102,221,4258,2801,140,0,0,24435,250,8354,5553,1323,11683
2021-08-03 23:00:00+00,9824,996,4223,1062,183,4020,2884,140,0,0,23332,246,8352,5468,1245,10820
2021-08-03 23:30:00+00,9232,999,4225,1022,182,4020,2894,140,0,0,22714,243,8323,5429,1204,10231
2021-08-04 00:00:00+00,9001,960,4221,1019,180,4018,2829,140,0,0,22368,240,8249,5420,1199,9961
2021-08-04 00:30:00+00,8856,941,4215,973,178,4018,2869,140,0,0,22190,239,8235,5366,1151,9797
2021-08-04 01:00:00+00,8855,835,4208,977,161,4014,2811,142,0,0,22003,236,8157,5346,1138,9690
2021-08-04 01:30:00+00,8677,772,4207,994,158,4014,2774,141,0,0,21737,233,8133,5359,1152,9449
2021-08-04 02:00:00+00,8552,804,4207,975,158,4020,2753,142,0,0,21611,233,8093,5340,1133,9356
2021-08-04 02:30:00+00,8559,798,4205,992,158,4018,2746,141,0,0,21618,233,8102,5356,1150,9357
2021-08-04 03:00:00+00,8621,777,4193,1035,158,4018,2738,139,0,0,21679,233,8124,5386,1193,9398
2021-08-04 03:30:00+00,8628,792,4192,1007,158,4018,2717,140,0,0,21652,234,8074,5357,1165,9420
2021-08-04 04:00:00+00,8995,771,4182,1047,158,4018,2743,140,0,0,22054,235,8130,5387,1205,9766
2021-08-04 04:30:00+00,8976,797,4180,1031,158,4016,2872,140,19,0,22189,235,8260,5388,1208,9773
2021-08-04 05:00:00+00,10188,903,4172,1007,73,3646,2964,143,260,0,23356,236,8476,5512,1340,11091
2021-08-04 05:30:00+00,11687,963,4172,980,76,3630,2976,143,726,0,25353,242,8930,5954,1782,12650
2021-08-04 06:00:00+00,12264,964,4172,926,125,4784,2975,141,1337,100,27788,244,9535,6560,2388,13228
2021-08-04 06:30:00+00,13049,996,4171,871,128,4830,2975,174,2097,174,29465,243,10242,7267,3096,14045
2021-08-04 07:00:00+00,13706,999,4156,845,270,5014,2938,181,2983,464,31556,236,11192,8254,4098,14705
2021-08-04 07:30:00+00,13789,1000,4144,898,296,5018,2935,221,3761,558,32620,229,12034,9099,4955,14789
2021-08-04 08:00:00+00,13486,953,4143,979,302,4926,2916,252,4579,826,33362,219,12919,10003,5860,14439
2021-08-04 08:30:00+00,13334,831,4142,1090,301,4922,2908,217,5407,500,33652,212,13848,10940,6798,14165
2021-08-04 09:00:00+00,13491,875,4149,1243,269,4692,2903,187,6213,82,34104,212,14777,11874,7725,14366
2021-08-04 09:30:00+00,13289,898,4151,1402,255,4686,2731,150,6791,0,34353,208,15330,12599,8448,14187
2021-08-04 10:00:00+00,13099,959,4157,1561,253,4566,2756,142,7343,66,34902,204,16070,13314,9157,14058
2021-08-04 10:30:00+00,12902,999,4150,1644,234,4570,2737,142,7578,250,35206,201,16343,13606,9456,13901
2021-08-04 11:00:00+00,12812,998,4138,1763,200,4574,2651,141,7681,482,35440,198,16433,13782,9644,13810
2021-08-04 11:30:00+00,12736,1000,4121,1959,102,4582,2771,140,7655,378,35444,198,16608,13837,9716,13736
2021-08-04 12:00:00+00,12518,996,4118,2170,93,4820,2812,140,7475,0,35142,197,16668,13856,9738,13514
2021-08-04 12:30:00+00,12243,999,4116,2319,101,4822,2843,141,7288,0,34872,196,16667,13824,9708,13242
2021-08-04 13:00:00+00,12257,1000,4118,2476,95,4820,2811,140,7118,0,34835,196,16618,13807,9689,13257
2021-08-04 13:30:00+00,12311,999,4118,2659,98,4822,2819,140,6688,0,34654,198,16382,13563,9445,13310
2021-08-04 14:00:00+00,12386,1000,4117,2866,97,4822,2829,139,6255,42,34553,199,16164,13335,9218,13386
2021-08-04 14:30:00+00,12611,997,4117,3027,108,4820,2841,140,5840,14,34515,202,15933,13092,8975,13608
2021-08-04 15:00:00+00,12744,978,4116,3259,148,4992,2845,143,5218,0,34443,203,15586,12741,8625,13722
2021-08-04 15:30:00+00,13360,974,4112,3311,169,4992,2873,158,4550,40,34539,210,15015,12142,8030,14334
2021-08-04 16:00:00+00,13694,992,4114,3320,393,4726,2953,169,3828,678,34867,208,14608,11655,7541,14686
2021-08-04 16:30:00+00,13715,991,4113,3479,399,4726,2949,201,2989,1098,34660,210,13929,10980,6867,14706
2021-08-04 17:00:00+00,14135,993,4112,3286,401,4272,2955,348,2292,1264,34058,218,13046,10091,5979,15128
2021-08-04 17:30:00+00,14173,994,4110,3202,402,4266,2957,384,1539,1290,33317,224,12210,9253,5143,15167
2021-08-04 18:00:00+00,13970,995,4111,3193,402,4612,2948,385,924,1008,32548,230,11578,8630,4519,14965
2021-08-04 18:30:00+00,13889,998,4109,3337,381,4618,2939,302,401,690,31664,235,11167,8228,4119,14887
2021-08-04 19:00:00+00,13908,998,4107,3512,366,4954,2942,206,91,612,31696,237,11018,8076,3968,14906
2021-08-04 19:30:00+00,13767,999,4104,3508,229,4956,2945,145,1,540,31194,239,10787,7842,3738,14766
2021-08-04 20:00:00+00,13721,997,4099,3418,123,5032,2944,141,0,394,30869,241,10584,7640,3541,14718
2021-08-04 20:30:00+00,13152,995,4100,3722,110,5018,2791,139,0,0,30027,239,10723,7932,3832,14147
2021-08-04 21:00:00+00,11862,992,4101,3987,51,5018,2354,140,0,0,28505,232,10493,8139,4038,12854
2021-08-04 21:30:00+00,10880,992,4099,4018,51,4998,1823,140,0,0,27001,228,9991,8168,4069,11872
2021-08-04 22:00:00+00,10481,868,4100,3971,51,4034,1646,140,0,128,25419,226,9768,8122,4022,11349
2021-08-04 22:30:00+00,9433,533,4103,3835,49,4076,1680,140,0,0,23849,211,9667,7987,3884,9966
2021-08-04 23:00:00+00,8577,500,4104,3941,47,3674,1679,140,0,82,22744,205,9771,8092,3988,9077
2021-08-04 23:30:00+00,7605,496,4107,4217,47,3738,1681,140,0,0,22031,196,10052,8371,4264,8101
2021-08-05 00:00:00+00,6973,495,4111,4178,47,3976,1675,140,0,0,21595,193,10011,8336,4225,7468
2021-08-05 00:30:00+00,6589,496,4113,4213,47,4068,1685,140,0,0,21351,190,10058,8373,4260,7085
2021-08-05 01:00:00+00,6222,491,4118,4329,47,4062,1680,142,0,0,21091,185,10174,8494,4376,6713
2021-08-05 01:30:00+00,5941,466,4115,4274,47,4082,1682,142,0,0,20749,182,10118,8436,4321,6407
2021-08-05 02:00:00+00,5980,410,4114,4301,47,4156,1678,141,0,0,20827,182,10140,8462,4348,6390
2021-08-05 02:30:00+00,6219,426,4114,4154,47,4076,1689,142,0,0,20867,185,10004,8315,4201,6645
2021-08-05 03:00:00+00,6471,442,4114,3984,47,4068,1689,140,0,0,20955,189,9834,8145,4031,6913
2021-08-05 03:30:00+00,6451,495,4113,3862,47,4140,1670,140,0,0,20918,193,9692,8022,3909,6946
2021-08-05 04:00:00+00,6565,495,4108,3987,47,4066,1671,214,0,0,21153,193,9813,8142,4034,7060
2021-08-05 04:30:00+00,6822,493,4111,4335,49,4020,1670,267,7,0,21774,192,10172,8502,4391,7315
2021-08-05 05:00:00+00,7720,492,4110,4457,74,4268,1665,267,179,80,23312,195,10485,8820,4710,8212
2021-08-05 05:30:00+00,8523,493,4112,4858,90,4220,1846,254,536,0,24932,194,11442,9596,5484,9016
2021-08-05 06:00:00+00,9276,494,4112,5173,172,4170,2472,258,1029,4,27160,185,12958,10486,6374,9770
2021-08-05 06:30:00+00,9588,498,4115,5365,179,4258,2827,258,1664,230,28982,181,14150,11323,7208,10086
2021-08-05 07:00:00+00,9565,495,4114,5855,350,4608,2969,184,2457,410,31007,171,15745,12776,8662,10060
2021-08-05 07:30:00+00,9345,495,4116,6181,353,4662,2968,152,3089,740,32101,163,16707,13739,9623,9840
2021-08-05 08:00:00+00,9114,497,4111,6727,326,4803,2958,180,3890,480,33086,155,18012,15054,10943,9611
2021-08-05 08:30:00+00,8729,497,4113,7233,330,4750,2955,153,4639,432,33831,146,19270,16315,12202,9226
2021-08-05 09:00:00+00,8758,495,4111,7870,235,4750,2962,149,4637,0,33967,146,19815,16853,12742,9253
2021-08-05 09:30:00+00,8248,495,4116,8664,213,4750,2862,142,4708,0,34198,138,20563,17701,13585,8743
2021-08-05 10:00:00+00,7956,499,4111,9424,149,4750,2833,142,4800,16,34680,133,21317,18484,14373,8455
2021-08-05 10:30:00+00,7599,497,4114,10134,145,4752,2958,142,4728,0,35069,128,22079,19121,15007,8096
2021-08-05 11:00:00+00,7365,496,4114,10804,114,4852,2943,145,4347,126,35306,125,22322,19379,15265,7861
2021-08-05 11:30:00+00,7366,494,4116,11156,97,4850,2899,144,4270,74,35466,124,22538,19639,15523,7860
2021-08-05 12:00:00+00,7277,497,4116,11483,81,4634,2891,143,3776,0,34898,124,22347,19456,15340,7774
2021-08-05 12:30:00+00,7273,599,4115,11775,81,4630,2708,144,3206,82,34613,128,21885,19177,15062,7872
2021-08-05 13:00:00+00,7024,803,4119,12235,79,4510,2732,143,3117,0,34762,129,22282,19550,15431,7827
2021-08-05 13:30:00+00,6910,909,4119,12586,79,4510,2661,142,3033,0,34949,130,22478,19817,15698,7819
2021-08-05 14:00:00+00,7055,798,4118,12701,79,4508,2473,139,2443,0,34314,130,21814,19341,15223,7853
2021-08-05 14:30:00+00,7047,838,4117,12650,83,4506,2586,141,2025,0,33993,133,21461,18875,14758,7885
2021-08-05 15:00:00+00,7211,886,4116,12945,119,4506,2688,146,1928,0,34545,134,21796,19108,14992,8097
2021-08-05 15:30:00+00,7368,993,4114,13092,268,4508,2883,148,1496,0,34870,138,21853,18970,14856,8361
2021-08-05 16:00:00+00,7424,985,4112,13075,378,4508,2841,151,1317,432,35223,137,21723,18882,14770,8409
2021-08-05 16:30:00+00,7750,994,4112,12954,380,4506,2776,154,1242,618,35486,140,21464,18688,14576,8744
2021-08-05 17:00:00+00,7679,994,4115,13036,384,4520,2713,136,911,590,35078,139,21159,18446,14331,8673
2021-08-05 17:30:00+00,7503,995,4116,12988,409,4522,2658,88,559,604,34442,139,20730,18072,13956,8498
2021-08-05 18:00:00+00,7272,994,4119,13493,394,4512,2613,79,293,142,33911,140,20912,18299,14180,8266
2021-08-05 18:30:00+00,7245,995,4113,13282,380,4502,2482,74,104,260,33437,141,20361,17879,13766,8240
2021-08-05 19:00:00+00,7535,992,4115,12982,269,4174,2325,70,22,202,32686,144,19713,17388,13273,8527
2021-08-05 19:30:00+00,7260,997,4116,13024,260,4168,2317,69,0,0,32211,143,19717,17400,13284,8257
2021-08-05 20:00:00+00,6842,995,4110,13028,101,4044,2182,70,0,0,31372,142,19421,17239,13129,7837
2021-08-05 20:30:00+00,6070,996,4104,12887,77,4008,1827,69,0,16,30054,137,18895,17068,12964,7066
2021-08-05 21:00:00+00,5476,994,4104,12663,73,3464,1720,67,0,46,28607,132,18560,16840,12736,6470
2021-08-05 21:30:00+00,4760,858,4099,12187,61,3390,1639,70,0,62,27126,124,17986,16347,12248,5618
2021-08-05 22:00:00+00,5356,504,4103,11857,101,2000,1500,67,0,60,25548,118,17561,16061,11958,5860
2021-08-05 22:30:00+00,4855,439,4104,11806,147,1962,1146,69,0,0,24528,110,17203,16057,11953,5294
2021-08-05 23:00:00+00,4979,373,4103,11207,109,1952,1090,71,0,0,23884,113,16509,15419,11316,5352
2021-08-05 23:30:00+00,5114,358,4108,10544,48,1952,1211,68,0,0,23403,118,15911,14700,10592,5472
2021-08-06 00:00:00+00,5135,301,4111,10289,48,1952,1312,78,0,0,23226,115,15760,14448,10337,5436
2021-08-06 00:30:00+00,5062,395,4113,10013,46,1948,1441,69,0,0,23087,119,15613,14172,10059,5457
2021-08-06 01:00:00+00,4376,396,4116,9914,46,2018,1430,70,0,0,22366,106,15506,14076,9960,4772
2021-08-06 01:30:00+00,4279,389,4118,9910,45,2028,1360,75,0,0,22204,105,15433,14073,9955,4668
2021-08-06 02:00:00+00,4122,285,4118,9971,45,2028,1373,70,0,0,22012,97,15507,14134,10016,4407
2021-08-06 02:30:00+00,4269,243,4117,9605,46,2052,1414,71,0,0,21817,100,15182,13768,9651,4512
2021-08-06 03:00:00+00,4321,277,4120,9265,45,2050,1337,69,0,0,21484,107,14767,13430,9310,4598
2021-08-06 03:30:00+00,4422,300,4117,9144,46,2152,1314,69,0,0,21564,111,14621,13307,9190,4722
2021-08-06 04:00:00+00,4613,311,4119,8882,46,2340,1342,67,0,0,21720,111,14389,13047,8928,4924
2021-08-06 04:30:00+00,4742,529,4116,8686,45,2498,1393,69,5,0,22083,124,14245,12852,8736,5271
2021-08-06 05:00:00+00,5659,549,4117,8644,52,3154,1259,70,100,0,23604,132,14172,12913,8796,6208
2021-08-06 05:30:00+00,6667,652,4111,8732,65,3226,1198,70,307,0,25028,145,14413,13215,9104,7319
2021-08-06 06:00:00+00,7414,837,4110,9057,138,4370,836,69,649,0,27480,154,14790,13954,9844,8251
2021-08-06 06:30:00+00,8386,935,4111,9236,141,4534,705,72,1026,0,29146,163,15219,14514,10403,9321
2021-08-06 07:00:00+00,9141,995,4107,9317,248,4520,450,75,1476,454,30783,163,15598,15148,11041,10136
2021-08-06 07:30:00+00,9454,993,4110,9454,260,4450,450,80,1925,570,31746,161,16199,15749,11639,10447
2021-08-06 08:00:00+00,9530,989,4107,9563,359,4454,453,83,2484,478,32500,157,16966,16513,12406,10519
2021-08-06 08:30:00+00,9427,993,4104,9720,358,4450,452,81,2972,344,32901,154,17606,17154,13050,10420
2021-08-06 09:00:00+00,9388,982,4054,9941,236,4434,449,74,3652,272,33482,151,18332,17883,13829,10370
2021-08-06 09:30:00+00,9214,985,3942,10054,214,4434,450,71,4412,210,33986,146,19072,18622,14680,10199
2021-08-06 10:00:00+00,8662,983,3932,10561,171,4430,451,71,5089,0,34350,138,20204,19753,15821,9645
2021-08-06 10:30:00+00,8208,993,3928,10923,159,4426,451,72,5162,6,34328,134,20623,20172,16244,9201
2021-08-06 11:00:00+00,8324,980,3931,11191,131,4286,449,72,5245,66,34675,133,20947,20498,16567,9304
2021-08-06 11:30:00+00,7650,986,3932,11537,122,4286,450,72,5896,0,34931,124,21937,21487,17555,8636
2021-08-06 12:00:00+00,6862,910,3937,11878,97,4268,451,74,5423,0,33900,117,21786,21335,17398,7772
2021-08-06 12:30:00+00,6052,888,3937,12385,85,4262,448,71,5611,0,33739,108,22466,22018,18081,6940
2021-08-06 13:00:00+00,5608,857,3937,12970,82,4020,443,75,5655,0,33646,102,23086,22644,18706,6465
2021-08-06 13:30:00+00,5648,940,3953,12411,85,4014,446,72,5160,138,32867,107,22055,21609,17656,6588
2021-08-06 14:00:00+00,5378,968,4003,12703,81,4026,449,71,5239,0,32918,104,22475,22026,18023,6346
2021-08-06 14:30:00+00,5484,776,4016,13102,81,4018,450,71,4861,0,32859,100,22510,22060,18044,6260
2021-08-06 15:00:00+00,5978,776,4016,12792,83,4016,449,73,4499,22,32704,107,21839,21390,17374,6754
2021-08-06 15:30:00+00,6579,980,4016,12694,93,4018,450,73,3841,0,32744,120,21094,20644,16628,7559
2021-08-06 16:00:00+00,6862,996,4011,12565,228,4256,449,80,3054,16,32517,125,20307,19858,15847,7858
2021-08-06 16:30:00+00,7073,998,4022,12214,234,4258,449,80,2633,396,32357,128,19552,19103,15081,8071
2021-08-06 17:00:00+00,7057,998,4058,11274,331,4334,449,146,2026,1228,31902,131,18138,17689,13631,8055
2021-08-06 17:30:00+00,7533,997,4102,10695,335,4408,450,291,1447,1042,31301,143,17029,16579,12477,8530
2021-08-06 18:00:00+00,7656,998,4112,10587,337,4323,449,313,866,1072,30713,148,16351,15902,11790,8654
2021-08-06 18:30:00+00,7849,995,4111,10141,336,4258,450,278,377,1040,29835,154,15415,14965,10854,8844
2021-08-06 19:00:00+00,7953,992,4113,10159,307,4159,449,279,88,658,29157,158,15116,14667,10554,8945
2021-08-06 19:30:00+00,7930,997,4110,10357,301,4136,450,252,1,216,28751,160,15219,14769,10659,8927
2021-08-06 20:00:00+00,7706,994,4109,10580,236,3933,504,229,0,512,28803,156,15429,14925,10816,8700
2021-08-06 20:30:00+00,7256,940,4108,10943,165,3855,641,289,0,118,28315,150,15857,15216,11108,8196
2021-08-06 21:00:00+00,6444,773,4103,11407,112,3546,871,192,0,0,27449,136,16493,15622,11519,7217
2021-08-06 21:30:00+00,5492,400,4099,11503,92,3434,1055,149,0,0,26224,113,16749,15694,11595,5892
2021-08-06 22:00:00+00,5518,277,4101,11562,177,2401,1070,144,0,108,25358,106,16910,15840,11739,5795
2021-08-06 22:30:00+00,4602,234,4101,11681,100,2589,1075,144,0,0,24526,94,16957,15882,11781,4836
2021-08-06 23:00:00+00,4091,274,4103,11773,61,2701,1085,141,0,0,24230,88,17022,15937,11834,4365
2021-08-06 23:30:00+00,3834,259,4104,11586,78,2704,1088,141,0,0,23794,85,16856,15768,11664,4093
2021-08-07 00:00:00+00,4097,37,4102,11499,78,2633,1128,146,0,0,23720,80,16807,15679,11577,4134
2021-08-07 00:30:00+00,4210,0,4105,11316,78,2636,1105,143,0,0,23592,80,16604,15499,11394,4210
2021-08-07 01:00:00+00,4366,0,4105,11060,77,2350,1266,146,0,0,23371,85,16508,15242,11138,4366
2021-08-07 01:30:00+00,4502,0,4110,10709,59,2332,1216,148,0,0,23076,88,16094,14878,10768,4502
2021-08-07 02:00:00+00,4639,0,4113,10680,58,2251,1206,153,0,0,23100,90,16057,14851,10738,4639
2021-08-07 02:30:00+00,4715,0,4111,10466,58,2247,1218,152,0,0,22967,92,15853,14635,10524,4715
2021-08-07 03:00:00+00,4751,0,4112,10137,58,2092,1196,146,0,0,22492,94,15503,14307,10195,4751
2021-08-07 03:30:00+00,4712,0,4115,9967,87,2084,1192,182,0,0,22338,94,15361,14169,10054,4712
2021-08-07 04:00:00+00,4697,0,4114,10004,98,2014,1189,196,0,0,22312,94,15405,14216,10102,4697
2021-08-07 04:30:00+00,4833,0,4114,9509,102,2059,1223,223,5,0,22068,101,14953,13730,9616,4833
2021-08-07 05:00:00+00,5034,0,4119,9323,107,2163,1193,334,157,0,22430,107,14899,13706,9587,5034
2021-08-07 05:30:00+00,5289,0,4113,9371,121,2273,1198,324,499,180,23368,109,15302,14104,9991,5289
2021-08-07 06:00:00+00,4791,0,4115,9455,147,2586,1115,146,967,6,23328,98,15799,14684,10569,4791
2021-08-07 06:30:00+00,6010,14,4113,9029,150,2596,1090,157,1454,0,24613,113,15836,14746,10633,6024
2021-08-07 07:00:00+00,6353,247,4112,8688,200,3389,1103,145,1874,0,26111,125,15977,14874,10762,6600
2021-08-07 07:30:00+00,6955,464,4114,8458,222,3415,992,239,2268,100,27227,137,16054,15062,10948,7419
2021-08-07 08:00:00+00,7466,498,4117,8400,284,3452,893,369,2698,206,28383,141,16392,15499,11382,7964
2021-08-07 08:30:00+00,7774,622,4117,8080,304,3378,899,398,2913,438,28922,145,16313,15414,11297,8396
2021-08-07 09:00:00+00,7975,885,4115,7625,297,3405,898,483,3362,526,29571,154,16297,15399,11284,8860
2021-08-07 09:30:00+00,7969,990,4113,7485,296,3393,905,484,3883,760,30277,153,16682,15777,11664,8959
2021-08-07 10:00:00+00,7847,996,4115,7478,296,3535,880,475,4295,596,30513,153,17064,16184,12069,8843
2021-08-07 10:30:00+00,7834,997,4116,7497,295,3700,882,472,4599,502,30894,153,17389,16507,12391,8831
2021-08-07 11:00:00+00,7737,994,4118,8119,260,3773,854,410,4395,252,30911,152,17746,16892,12774,8731
2021-08-07 11:30:00+00,7445,996,4118,8454,256,3840,833,340,4474,164,30920,147,18135,17302,13184,8441
2021-08-07 12:00:00+00,6888,981,4115,8877,112,4216,776,155,4508,166,30794,140,18388,17612,13497,7869
2021-08-07 12:30:00+00,6441,976,4116,9270,98,3986,771,145,4785,160,30748,131,19040,18269,14153,7417
2021-08-07 13:00:00+00,6414,974,4117,9170,98,3846,776,144,4154,198,29891,132,18315,17539,13422,7388
2021-08-07 13:30:00+00,6103,787,4120,9592,113,3846,783,142,4320,80,29886,122,18928,18145,14025,6890
2021-08-07 14:00:00+00,5933,462,4116,9842,112,3944,791,144,3712,0,29056,114,18573,17782,13666,6395
2021-08-07 14:30:00+00,5951,523,4121,9862,97,3988,792,144,3050,0,28528,119,17922,17130,13009,6474
2021-08-07 15:00:00+00,6538,820,4117,9918,122,3744,794,145,3173,14,29385,130,18124,17330,13213,7358
2021-08-07 15:30:00+00,7146,990,4118,9676,134,3968,798,146,2708,70,29754,145,17434,16636,12518,8136
2021-08-07 16:00:00+00,7928,999,4115,9344,238,4216,817,239,2102,56,30054,157,16616,15799,11684,8927
2021-08-07 16:30:00+00,8014,986,4116,9098,303,4336,812,421,1734,508,30328,160,16063,15251,11135,9000
2021-08-07 17:00:00+00,8245,991,4111,8812,331,4322,869,427,1476,846,30430,163,15599,14730,10619,9236
2021-08-07 17:30:00+00,8407,990,4111,8749,332,4366,882,354,954,752,29897,167,15028,14146,10035,9397
2021-08-07 18:00:00+00,8335,988,4113,8807,347,4380,860,246,497,862,29435,168,14624,13764,9651,9323
2021-08-07 18:30:00+00,8248,992,4116,9074,347,4248,795,213,229,792,29054,167,14561,13766,9650,9240
2021-08-07 19:00:00+00,8464,986,4114,8775,299,4158,802,146,47,676,28467,173,14037,13235,9121,9450
2021-08-07 19:30:00+00,8417,986,4113,8683,292,4148,795,145,0,438,28017,175,13883,13088,8975,9403
2021-08-07 20:00:00+00,8371,986,4116,8608,256,4288,793,144,0,208,27770,178,13773,12980,8864,9357
2021-08-07 20:30:00+00,8203,910,4112,8276,174,4152,807,142,0,204,26980,176,13369,12562,8450,9113
2021-08-07 21:00:00+00,7810,797,4111,8105,142,3896,869,188,0,0,25918,172,13227,12358,8247,8607
2021-08-07 21:30:00+00,6782,580,4110,8191,98,3914,951,149,0,0,24775,156,13350,12399,8289,7362
2021-08-07 22:00:00+00,5384,583,4105,8693,114,3184,1093,140,0,40,23336,139,14005,12912,8807,5967
2021-08-07 22:30:00+00,4185,311,4103,9146,127,3276,1089,161,0,0,22398,115,14465,13376,9273,4496
2021-08-07 23:00:00+00,4047,302,4103,9423,126,2574,1097,146,0,0,21818,109,14749,13652,9549,4349
2021-08-07 23:30:00+00,4057,298,4105,9605,126,2430,1095,141,0,0,21857,106,14931,13836,9731,4355
2021-08-08 00:00:00+00,4231,307,4104,9856,124,1473,1104,154,0,0,21353,108,15188,14084,9980,4538
2021-08-08 00:30:00+00,4255,306,4109,10051,122,1306,1096,146,0,0,21391,105,15378,14282,10173,4561
2021-08-08 01:00:00+00,4900,265,4107,9976,88,998,1127,147,0,0,21608,111,15298,14171,10064,5165
2021-08-08 01:30:00+00,4944,243,4110,9796,82,968,1119,147,0,0,21409,111,15107,13988,9878,5187
2021-08-08 02:00:00+00,5172,216,4111,9580,82,940,1177,153,0,0,21431,114,14950,13773,9662,5388
2021-08-08 02:30:00+00,5354,0,4117,9578,82,940,1205,145,0,0,21421,108,14982,13777,9660,5354
2021-08-08 03:00:00+00,5236,0,4119,9503,81,832,1220,148,0,0,21139,108,14923,13703,9584,5236
2021-08-08 03:30:00+00,5248,0,4121,9497,82,828,1188,150,0,0,21114,108,14888,13700,9579,5248
2021-08-08 04:00:00+00,5166,0,4121,9518,100,856,1132,142,0,0,21035,106,14871,13739,9618,5166
2021-08-08 04:30:00+00,5125,1,4123,9582,100,852,1105,139,4,0,21031,105,14914,13809,9686,5126
2021-08-08 05:00:00+00,4708,1,4121,9803,101,1310,1106,139,133,0,21422,97,15264,14158,10037,4709
2021-08-08 05:30:00+00,4688,193,4121,9856,104,1360,1104,139,301,0,21866,103,15486,14382,10261,4881
2021-08-08 06:00:00+00,4816,238,4117,9946,139,1110,1101,141,561,0,22169,106,15864,14763,10646,5054
2021-08-08 06:30:00+00,4868,261,4113,10136,136,1104,1110,146,972,0,22846,105,16467,15357,11244,5129
2021-08-08 07:00:00+00,3878,251,4116,10261,184,3364,784,146,1373,0,24357,87,16718,15934,11818,4129
2021-08-08 07:30:00+00,3994,231,4117,10706,186,3528,767,144,1509,0,25182,86,17285,16518,12401,4225
2021-08-08 08:00:00+00,4414,293,4117,10933,184,3640,785,145,1811,0,26322,93,17830,17045,12928,4707
2021-08-08 08:30:00+00,4444,493,4115,10931,185,3762,853,150,1869,186,26988,100,17953,17100,12985,4937
2021-08-08 09:00:00+00,4699,584,4117,10952,186,3802,887,234,2461,274,28196,104,18603,17716,13599,5283
2021-08-08 09:30:00+00,5000,554,4117,11070,189,3852,814,232,2749,276,28853,105,18939,18125,14008,5554
2021-08-08 10:00:00+00,5253,554,4110,11084,220,3860,800,246,3067,292,29486,107,19281,18481,14371,5807
2021-08-08 10:30:00+00,5225,583,4115,11084,222,3886,786,272,3317,260,29750,107,19524,18738,14623,5808
2021-08-08 11:00:00+00,5046,690,4112,11263,223,3779,787,272,3733,242,30147,105,20118,19331,15219,5736
2021-08-08 11:30:00+00,4639,586,4111,11450,222,3808,789,271,4395,240,30510,96,20967,20178,16067,5225
2021-08-08 12:00:00+00,4312,515,4113,11593,142,3680,786,208,4968,144,30461,87,21602,20816,16703,4827
2021-08-08 12:30:00+00,4468,463,4113,11681,141,3538,568,144,5106,0,30222,84,21609,21041,16928,4931
2021-08-08 13:00:00+00,4557,519,4115,11828,125,3528,493,141,4781,0,30087,87,21342,20849,16734,5076
2021-08-08 13:30:00+00,4524,467,4114,11834,124,3528,491,143,4940,0,30165,85,21503,21012,16898,4991
2021-08-08 14:00:00+00,4523,472,4117,11878,125,3526,492,147,4538,0,29818,86,21150,20658,16541,4995
2021-08-08 14:30:00+00,4603,556,4118,11615,125,3526,493,142,4393,0,29571,90,20744,20251,16133,5159
2021-08-08 15:00:00+00,4599,479,4116,11760,167,4006,491,142,4077,0,29837,88,20611,20120,16004,5078
2021-08-08 15:30:00+00,5158,461,4118,11778,164,4058,489,144,3643,44,30057,95,20192,19703,15585,5619
2021-08-08 16:00:00+00,6181,465,4116,11839,220,4014,494,144,3034,0,30507,106,19703,19209,15093,6646
2021-08-08 16:30:00+00,6930,494,4116,11645,264,4014,496,143,2659,14,30775,116,19180,18684,14568,7424
2021-08-08 17:00:00+00,7101,566,4115,11470,282,4016,493,144,1975,108,30270,122,18335,17842,13727,7667
2021-08-08 17:30:00+00,7294,487,4112,11148,284,4014,492,145,1401,218,29595,125,17437,16945,12833,7781
2021-08-08 18:00:00+00,7433,503,4113,11000,297,4016,493,149,877,150,29031,130,16780,16287,12174,7936
2021-08-08 18:30:00+00,7493,568,4112,10860,343,4014,493,145,411,160,28599,135,16219,15726,11614,8061
2021-08-08 19:00:00+00,7944,542,4115,10594,334,3678,495,150,70,208,28130,141,15608,15113,10998,8486
2021-08-08 19:30:00+00,8191,638,4117,10217,333,3672,495,185,0,138,27986,149,15162,14667,10550,8829
2021-08-08 20:00:00+00,8229,673,4117,9871,298,3672,493,245,0,376,27974,151,14779,14286,10169,8902
2021-08-08 20:30:00+00,7792,698,4117,9738,269,3670,504,240,0,250,27278,150,14628,14124,10007,8490
2021-08-08 21:00:00+00,7465,524,4118,9781,173,3526,695,142,0,94,26518,143,14767,14072,9954,7989
2021-08-08 21:30:00+00,6350,481,4117,9679,150,3510,996,141,0,14,25438,132,14942,13946,9829,6831
2021-08-08 22:00:00+00,5405,634,4117,9442,123,2766,1102,142,0,232,23963,126,14784,13682,9565,6039
2021-08-08 22:30:00+00,4443,632,4113,9354,121,2798,1099,140,0,0,22700,117,14687,13588,9475,5075
2021-08-08 23:00:00+00,4214,600,4107,8997,115,2656,1105,139,0,0,21933,114,14324,13219,9112,4814
2021-08-08 23:30:00+00,4306,487,4104,8551,115,2652,1103,139,0,0,21457,114,13873,12770,8666,4793
2021-08-09 00:00:00+00,4596,338,4107,8275,114,2646,1113,140,0,0,21329,116,13609,12496,8389,4934
2021-08-09 00:30:00+00,4806,344,4109,7950,114,2646,1126,140,0,0,21235,120,13299,12173,8064,5150
2021-08-09 01:00:00+00,4880,334,4112,7545,114,2650,1109,145,0,0,20889,125,12880,11771,7659,5214
2021-08-09 01:30:00+00,4971,391,4111,6956,114,2650,1150,194,0,0,20537,133,12331,11181,7070,5362
2021-08-09 02:00:00+00,4987,358,4115,6343,114,2724,1254,251,0,0,20146,136,11826,10572,6457,5345
2021-08-09 02:30:00+00,5160,344,4118,5932,114,2712,1348,270,0,0,19998,141,11512,10164,6046,5504
2021-08-09 03:00:00+00,5345,342,4119,5633,114,2752,1477,261,0,0,20043,146,11343,9866,5747,5687
2021-08-09 03:30:00+00,5565,355,4123,5432,115,2724,1509,262,0,0,20085,150,11179,9670,5547,5920
2021-08-09 04:00:00+00,5640,410,4124,5387,112,2836,1332,273,0,214,20328,153,10955,9623,5499,6050
2021-08-09 04:30:00+00,6230,350,4125,5446,50,2946,1355,288,1,62,20853,160,10977,9622,5497,6580
2021-08-09 05:00:00+00,6965,368,4124,5105,67,4280,1298,285,72,104,22668,169,10666,9368,5244,7333
2021-08-09 05:30:00+00,8225,409,4121,5262,71,4130,1243,285,263,80,24089,177,10960,9717,5596,8634
2021-08-09 06:00:00+00,10130,339,4120,5051,125,4740,1174,208,549,196,26632,185,11019,9845,5725,10469
2021-08-09 06:30:00+00,11211,440,4120,5168,127,4750,1314,269,993,268,28660,191,11722,10408,6288,11651
2021-08-09 07:00:00+00,11732,579,4120,5224,249,5012,1689,352,1472,124,30553,194,12754,11065,6945,12311
2021-08-09 07:30:00+00,11718,805,4116,5326,251,5018,2161,256,1990,122,31763,193,13844,11683,7567,12523
2021-08-09 08:00:00+00,11838,774,4117,5328,262,5018,2282,211,2713,576,33119,186,14702,12420,8303,12612
2021-08-09 08:30:00+00,12070,954,4121,5077,268,5018,2282,230,3587,56,33663,191,15335,13053,8932,13024
2021-08-09 09:00:00+00,11843,997,4121,5170,230,5018,2276,167,4136,0,33958,187,15933,13657,9536,12840
2021-08-09 09:30:00+00,11442,995,4120,5463,213,5016,2339,150,4611,0,34349,181,16746,14407,10287,12437
2021-08-09 10:00:00+00,11556,995,4119,5224,179,5016,2362,144,5568,0,35163,178,17452,15090,10971,12551
2021-08-09 10:30:00+00,11133,878,4116,5426,176,5016,2355,142,6055,0,35297,169,18128,15773,11657,12011
2021-08-09 11:00:00+00,11352,907,4112,5270,175,4898,2355,145,5844,0,35058,172,17756,15401,11289,12259
2021-08-09 11:30:00+00,10939,994,4117,5337,172,4898,2355,140,6218,24,35194,169,18199,15844,11727,11933
2021-08-09 12:00:00+00,10996,997,4116,5243,130,4898,2297,162,6356,94,35289,170,18142,15845,11729,11993
2021-08-09 12:30:00+00,11128,998,4115,5427,129,4900,2280,167,5988,0,35132,172,17939,15659,11544,12126
2021-08-09 13:00:00+00,11051,998,4116,5348,115,4902,2274,160,6068,0,35032,172,17921,15647,11531,12049
2021-08-09 13:30:00+00,10927,998,4118,5658,112,4902,2267,142,5358,0,34482,173,17513,15246,11128,11925
2021-08-09 14:00:00+00,10907,997,4118,5959,112,4906,2186,144,5278,0,34607,171,17653,15467,11349,11904
2021-08-09 14:30:00+00,11061,910,4121,6170,113,4906,2175,143,4762,0,34361,172,17341,15166,11045,11971
2021-08-09 15:00:00+00,11569,876,4118,6173,172,5034,2124,144,3983,0,34193,179,16570,14446,10328,12445
2021-08-09 15:30:00+00,12146,995,4116,5861,196,5036,2193,161,3458,88,34250,189,15824,13631,9515,13141
2021-08-09 16:00:00+00,12900,993,4120,5332,284,5036,2201,356,2755,300,34277,199,14692,12491,8371,13893
2021-08-09 16:30:00+00,13562,995,4116,5144,311,5036,2221,363,1961,272,33981,209,13753,11532,7416,14557
2021-08-09 17:00:00+00,13832,997,4117,4843,322,5036,2316,445,1443,474,33825,214,13041,10725,6608,14829
2021-08-09 17:30:00+00,13848,1000,4116,4559,322,5038,2325,521,1056,338,33123,220,12378,10053,5937,14848
2021-08-09 18:00:00+00,13850,999,4113,4455,319,5038,2316,514,754,598,32956,221,11957,9641,5528,14849
2021-08-09 18:30:00+00,13916,1001,4113,4173,313,5036,2326,486,330,474,32168,227,11255,8929,4816,14917
2021-08-09 19:00:00+00,13801,998,4112,3714,273,5036,2311,443,64,434,31186,232,10474,8163,4051,14799
2021-08-09 19:30:00+00,13762,1000,4116,3837,273,5038,2318,412,0,136,30892,233,10544,8226,4110,14762
2021-08-09 20:00:00+00,13561,998,4116,3872,235,5016,2320,397,0,172,30687,232,10543,8223,4107,14559
2021-08-09 20:30:00+00,13078,935,4115,3979,206,5008,2323,336,0,0,29980,228,10623,8300,4185,14013
2021-08-09 21:00:00+00,12481,703,4118,4077,102,4508,2324,181,0,98,28592,220,10621,8297,4179,13184
2021-08-09 21:30:00+00,11412,492,4115,4302,89,4494,2137,142,0,0,27183,208,10643,8506,4391,11904
2021-08-09 22:00:00+00,10453,486,4115,4193,98,4022,2063,143,0,0,25573,204,10469,8406,4291,10939
2021-08-09 22:30:00+00,9418,224,4115,4137,111,4012,1977,141,0,0,24135,188,10340,8363,4248,9642
2021-08-09 23:00:00+00,8829,0,4110,3974,107,3776,2099,168,0,244,23307,176,10290,8191,4081,8829
2021-08-09 23:30:00+00,8230,0,4109,4191,107,3772,2146,180,0,0,22735,171,10553,8407,4298,8230
2021-08-10 00:00:00+00,8214,0,4105,4212,108,3772,2102,140,0,0,22653,176,10527,8425,4320,8214
2021-08-10 00:30:00+00,8133,0,4107,4064,109,3774,2098,139,0,0,22424,177,10378,8280,4173,8133
2021-08-10 01:00:00+00,8128,0,4108,3946,90,3774,2174,162,0,0,22382,178,10318,8144,4036,8128
2021-08-10 01:30:00+00,7887,0,4112,3953,90,3772,2204,159,0,0,22177,175,10359,8155,4043,7887
2021-08-10 02:00:00+00,7829,0,4112,3988,90,3534,2210,144,0,0,21907,175,10400,8190,4078,7829
2021-08-10 02:30:00+00,7867,0,4112,3800,90,3530,2213,144,0,0,21756,177,10215,8002,3890,7867
2021-08-10 03:00:00+00,7920,0,4115,3636,90,3526,2213,141,0,0,21641,178,10054,7841,3726,7920
2021-08-10 03:30:00+00,8221,0,4115,3453,90,3528,2103,141,0,0,21651,183,9761,7658,3543,8221
2021-08-10 04:00:00+00,8594,0,4119,3241,108,3528,2026,163,0,0,21779,189,9494,7468,3349,8594
2021-08-10 04:30:00+00,9041,0,4124,2977,108,3528,2063,246,1,72,22160,195,9273,7210,3086,9041
2021-08-10 05:00:00+00,10199,0,4123,2662,125,3996,2174,277,102,364,24022,202,9186,7012,2889,10199
2021-08-10 05:30:00+00,11313,0,4124,2377,125,4006,2214,397,417,618,25591,209,9257,7043,2919,11313
2021-08-10 06:00:00+00,12667,0,4124,2187,163,4702,2213,442,825,736,28059,211,9512,7299,3175,12667
2021-08-10 06:30:00+00,13939,131,4122,2163,162,4712,2225,448,1205,798,29905,219,9877,7652,3530,14070
2021-08-10 07:00:00+00,14547,532,4122,2239,252,5014,2233,509,1716,514,31678,230,10562,8329,4207,15079
2021-08-10 07:30:00+00,14662,888,4120,2271,266,5018,2233,500,2570,298,32826,233,11460,9227,5107,15550
2021-08-10 08:00:00+00,14881,987,4119,2201,237,5018,2234,493,3452,286,33908,231,12243,10009,5890,15868
2021-08-10 08:30:00+00,14989,989,4117,2072,268,5018,2227,353,4163,0,34196,229,12847,10620,6503,15978
2021-08-10 09:00:00+00,15062,989,4123,1859,263,5018,2235,181,5210,90,35030,223,13690,11455,7332,16051
2021-08-10 09:30:00+00,14718,990,4128,1810,245,5018,2234,155,5529,138,34965,219,13946,11712,7584,15708
2021-08-10 10:00:00+00,14713,989,4129,1695,160,5016,2234,190,6251,4,35381,217,14469,12235,8106,15702
2021-08-10 10:30:00+00,14765,991,4123,1722,156,5018,2237,199,6593,0,35804,215,14831,12594,8471,15756
2021-08-10 11:00:00+00,14883,990,4120,1748,142,5018,2238,197,6433,0,35769,216,14681,12443,8323,15873
2021-08-10 11:30:00+00,14647,986,4115,1866,149,5020,2239,194,7181,0,36397,210,15550,13311,9196,15633
2021-08-10 12:00:00+00,14319,990,4117,1902,149,5018,2154,145,7466,0,36260,207,15788,13634,9517,15309
2021-08-10 12:30:00+00,13848,991,4117,1948,148,5020,2167,140,6477,0,34856,210,14857,12690,8573,14839
2021-08-10 13:00:00+00,13649,973,4111,1974,131,5020,2063,140,6641,0,34702,207,14920,12857,8746,14622
2021-08-10 13:30:00+00,13561,985,4110,1962,129,5020,2070,140,6399,0,34376,209,14670,12600,8490,14546
2021-08-10 14:00:00+00,13625,991,4110,1933,146,5016,2144,141,6720,0,34826,207,15053,12909,8799,14616
2021-08-10 14:30:00+00,13734,982,4112,2026,145,5020,2124,142,6107,0,34392,211,14514,12390,8278,14716
2021-08-10 15:00:00+00,14431,852,4114,2033,180,5040,1970,158,5419,0,34197,216,13716,11746,7632,15283
2021-08-10 15:30:00+00,15347,893,4113,1977,182,5038,2020,152,4611,0,34333,227,12903,10883,6770,16240
2021-08-10 16:00:00+00,15870,963,4113,2010,263,5038,2044,229,3828,312,34670,233,12258,10214,6101,16833
2021-08-10 16:30:00+00,16219,985,4112,2011,304,5036,2032,484,3237,606,35026,238,11696,9664,5552,17204
2021-08-10 17:00:00+00,16303,995,4112,2039,348,4880,2095,546,2436,760,34514,242,11030,8935,4823,17298
2021-08-10 17:30:00+00,16376,994,4108,1923,348,4878,2143,546,1627,942,33885,247,10149,8006,3898,17370
2021-08-10 18:00:00+00,16329,993,4109,1827,332,4992,2143,535,896,928,33084,254,9307,7164,3055,17322
2021-08-10 18:30:00+00,16278,994,4108,1624,332,4994,2143,526,365,1012,32376,259,8572,6429,2321,17272
2021-08-10 19:00:00+00,16086,893,4106,1534,304,5038,2074,454,60,920,31468,260,8078,6004,1898,16979
2021-08-10 19:30:00+00,15995,893,4107,1588,283,5038,2048,478,0,856,31286,261,8026,5978,1871,16888
2021-08-10 20:00:00+00,16184,901,4108,1634,229,5020,2026,472,0,556,31130,265,7997,5971,1863,17085
2021-08-10 20:30:00+00,15771,899,4110,1825,208,5020,2016,375,0,42,30266,266,8159,6143,2033,16670
2021-08-10 21:00:00+00,14807,907,4108,1842,91,5016,2034,172,0,0,28977,263,8075,6041,1933,15714
2021-08-10 21:30:00+00,13361,832,4109,1784,79,5008,2043,144,0,0,27360,254,8015,5972,1863,14193
2021-08-10 22:00:00+00,11810,965,4111,1732,90,4538,2019,142,0,58,25465,251,7952,5933,1822,12775
2021-08-10 22:30:00+00,10233,986,4111,1885,107,4674,1921,142,0,0,24059,243,8024,6103,1992,11219
2021-08-10 23:00:00+00,9079,992,4107,1973,89,4574,1975,143,0,0,22932,238,8144,6169,2062,10071
2021-08-10 23:30:00+00,8406,994,4107,1899,79,4578,1971,145,0,0,22179,234,8056,6085,1978,9400
2021-08-11 00:00:00+00,8116,991,4103,1886,79,4294,2119,241,0,0,21829,235,8187,6068,1965,9107
2021-08-11 00:30:00+00,8012,993,4102,1977,79,4240,2140,241,0,0,21784,233,8298,6158,2056,9005
2021-08-11 01:00:00+00,7922,991,4101,1993,79,4302,2142,190,0,0,21720,234,8315,6173,2072,8913
2021-08-11 01:30:00+00,7903,996,4104,2023,79,4328,2141,153,0,0,21727,234,8347,6206,2102,8899
2021-08-11 02:00:00+00,7711,995,4108,2106,78,4448,2130,154,0,0,21730,233,8422,6292,2184,8706
2021-08-11 02:30:00+00,7560,991,4110,2266,80,4406,2038,150,0,0,21601,230,8494,6456,2346,8551
2021-08-11 03:00:00+00,7523,991,4112,2289,81,4478,2058,141,0,0,21673,230,8540,6482,2370,8514
2021-08-11 03:30:00+00,7519,995,4114,2376,79,4434,2143,149,0,0,21809,228,8712,6569,2455,8514
2021-08-11 04:00:00+00,7967,999,4113,2474,92,4132,2132,142,0,0,22051,234,8811,6679,2566,8966
2021-08-11 04:30:00+00,8247,972,4120,2674,94,4128,2046,140,0,0,22421,234,8934,6888,2768,9219
2021-08-11 05:00:00+00,8929,970,4120,2889,121,4416,1923,142,100,0,23610,229,9153,7230,3110,9899
2021-08-11 05:30:00+00,9971,927,4119,3214,136,4358,1946,141,380,0,25192,228,9795,7849,3730,10898
2021-08-11 06:00:00+00,11105,996,4121,3456,149,4712,1989,152,759,18,27457,228,10474,8485,4364,12101
2021-08-11 06:30:00+00,11482,992,4124,3692,219,4828,2118,368,1213,0,29036,225,11366,9248,5124,12474
2021-08-11 07:00:00+00,11465,875,4121,4180,301,5436,2086,364,2022,140,30990,212,12710,10624,6503,12340
2021-08-11 07:30:00+00,11457,889,4121,4671,260,5434,2082,284,2769,278,32245,204,13903,11821,7700,12346
2021-08-11 08:00:00+00,11694,843,4119,5245,256,5196,1997,221,3709,148,33428,194,15326,13329,9210,12537
2021-08-11 08:30:00+00,11413,827,4116,5690,238,5044,1981,208,4405,0,33922,185,16430,14449,10333,12240
2021-08-11 09:00:00+00,10931,810,4121,6146,208,5020,1938,153,4951,0,34278,176,17364,15426,11305,11741
2021-08-11 09:30:00+00,10531,697,4117,6460,207,5018,1968,146,5672,0,34816,166,18424,16456,12339,11228
2021-08-11 10:00:00+00,10393,654,4118,6842,166,5018,2089,147,5553,30,35010,163,18768,16679,12561,11047
2021-08-11 10:30:00+00,10421,480,4115,7117,150,5018,2085,147,5723,16,35272,157,19190,17105,12990,10901
2021-08-11 11:00:00+00,10426,566,4115,7378,145,5018,2089,147,5805,18,35707,158,19532,17443,13328,10992
2021-08-11 11:30:00+00,10446,607,4111,7498,134,5018,2089,144,5436,0,35483,160,19268,17179,13068,11053
2021-08-11 12:00:00+00,10156,529,4110,7689,95,5018,2073,142,5349,108,35269,156,19316,17243,13133,10685
2021-08-11 12:30:00+00,9937,461,4109,8287,75,5020,1979,142,5203,44,35257,151,19653,17674,13565,10398
2021-08-11 13:00:00+00,10147,474,4105,8512,88,5018,1799,142,4871,38,35194,153,19375,17576,13471,10621
2021-08-11 13:30:00+00,9956,584,4110,8795,103,5018,1756,141,4625,0,35088,154,19389,17633,13523,10540
2021-08-11 14:00:00+00,9984,738,4106,8817,109,5018,1786,142,4129,22,34851,160,18947,17161,13055,10722
2021-08-11 14:30:00+00,10221,980,4109,8643,126,5018,1739,141,3877,0,34854,169,18494,16755,12646,11201
2021-08-11 15:00:00+00,10520,942,4107,8696,169,5040,1854,142,3621,0,35091,171,18447,16593,12486,11462
2021-08-11 15:30:00+00,10613,908,4109,8827,192,5038,2061,143,3144,0,35035,172,18333,16272,12163,11521
2021-08-11 16:00:00+00,11173,930,4106,8856,254,5016,2088,159,2332,0,34914,180,17636,15548,11442,12103
2021-08-11 16:30:00+00,11541,754,4105,8654,280,5014,2085,217,1990,342,34982,179,17114,15029,10924,12295
2021-08-11 17:00:00+00,11973,818,4102,8124,308,4818,2078,289,1351,592,34453,189,15963,13885,9783,12791
2021-08-11 17:30:00+00,12274,881,4101,7261,310,4816,2081,262,926,808,33720,198,14679,12598,8497,13155
2021-08-11 18:00:00+00,12333,989,4104,6173,310,4696,2079,372,572,898,32526,208,13238,11159,7055,13322
2021-08-11 18:30:00+00,12464,988,4103,5147,323,4694,2078,409,233,1006,31445,217,11884,9806,5703,13452
2021-08-11 19:00:00+00,12496,991,4104,4633,344,4710,2078,532,38,924,30850,224,11197,9119,5015,13487
2021-08-11 19:30:00+00,12477,990,4105,4540,338,4714,2073,631,0,838,30706,226,11056,8983,4878,13467
2021-08-11 20:00:00+00,12462,984,4103,4431,291,5012,2047,624,0,424,30378,230,10872,8825,4722,13446
2021-08-11 20:30:00+00,12343,927,4104,4596,247,5008,2045,377,0,0,29647,229,10992,8947,4843,13270
2021-08-11 21:00:00+00,11958,948,4106,4673,97,4516,1972,149,0,170,28589,227,10848,8876,4770,12906
2021-08-11 21:30:00+00,10781,788,4103,4681,92,4496,1938,143,0,0,27022,218,10814,8876,4773,11569
2021-08-11 22:00:00+00,10268,464,4108,4378,113,3798,1905,141,0,270,25445,207,10504,8599,4491,10732
2021-08-11 22:30:00+00,9404,412,4107,4107,120,3786,1967,140,0,10,24053,203,10301,8334,4227,9816
2021-08-11 23:00:00+00,8933,373,4111,4133,105,3532,1987,140,0,0,23314,199,10336,8349,4238,9306
2021-08-11 23:30:00+00,8291,239,4109,4321,81,3548,1901,140,0,0,22630,188,10412,8511,4402,8530
2021-08-12 00:00:00+00,7615,234,4107,4232,80,3642,1868,140,0,0,21918,183,10287,8419,4312,7849
2021-08-12 00:30:00+00,7375,244,4103,4078,79,3752,1888,140,0,0,21659,183,10148,8260,4157,7619
2021-08-12 01:00:00+00,7411,239,4102,3860,80,3872,1884,142,0,0,21590,187,9926,8042,3940,7650
2021-08-12 01:30:00+00,7485,237,4100,3426,64,3978,1825,141,0,0,21256,193,9415,7590,3490,7722
2021-08-12 02:00:00+00,7641,261,4104,3096,63,4064,1784,142,0,0,21155,200,9047,7263,3159,7902
2021-08-12 02:30:00+00,7731,351,4103,2836,63,3976,1739,142,0,0,20941,205,8741,7002,2899,8082
2021-08-12 03:00:00+00,7757,372,4108,2696,79,4104,1741,142,0,0,20999,209,8624,6883,2775,8129
2021-08-12 03:30:00+00,7776,294,4110,2614,79,4160,1794,140,0,0,20967,207,8597,6803,2693,8070
2021-08-12 04:00:00+00,7901,234,4109,2626,79,4278,1830,141,0,0,21198,208,8644,6814,2705,8135
2021-08-12 04:30:00+00,7948,392,4110,2830,79,4408,1767,140,0,0,21674,214,8786,7019,2909,8340
2021-08-12 05:00:00+00,8621,502,4114,3249,119,4900,1798,142,107,0,23552,216,9387,7589,3475,9123
2021-08-12 05:30:00+00,9578,683,4111,3398,136,4830,1854,144,496,0,25230,222,9995,8141,4030,10261
2021-08-12 06:00:00+00,10515,950,4115,3453,180,5212,1862,142,1000,32,27461,227,10610,8748,4633,11465
2021-08-12 06:30:00+00,11043,996,4116,4052,192,5334,1987,167,1606,0,29493,222,11953,9966,5850,12039
2021-08-12 07:00:00+00,11114,996,4116,4609,261,5440,2012,290,2374,240,31452,211,13372,11360,7244,12110
2021-08-12 07:30:00+00,11138,998,4118,4882,248,5544,2036,270,3014,408,32656,204,14298,12262,8144,12136
2021-08-12 08:00:00+00,11023,996,4116,5253,248,5594,2019,206,3432,338,33225,199,15068,13049,8933,12019
2021-08-12 08:30:00+00,10747,994,4115,5800,248,5472,2033,201,4182,154,33946,190,16378,14345,10230,11741
2021-08-12 09:00:00+00,10235,994,4112,6302,237,5250,2026,154,4647,140,34097,181,17324,15298,11186,11229
2021-08-12 09:30:00+00,9614,868,4113,7133,232,5016,2022,145,4620,20,33783,168,18120,16098,11985,10482
2021-08-12 10:00:00+00,9238,681,4110,7794,178,4866,2033,144,5119,42,34205,156,19234,17201,13091,9919
2021-08-12 10:30:00+00,8900,531,4111,8381,164,4880,2034,143,5118,0,34262,148,19808,17774,13663,9431
2021-08-12 11:00:00+00,8411,571,4113,8863,149,4792,2030,144,5389,134,34596,143,20544,18514,14401,8982
2021-08-12 11:30:00+00,8089,547,4112,9391,140,4824,2032,142,5195,0,34472,140,20870,18838,14726,8636
2021-08-12 12:00:00+00,7664,588,4111,10046,77,4426,2026,142,5234,92,34406,133,21494,19468,15357,8252
2021-08-12 12:30:00+00,7369,492,4108,10431,87,4290,1962,141,4490,68,33438,129,21078,19116,15008,7861
2021-08-12 13:00:00+00,7564,472,4102,10613,69,4220,1908,141,4442,0,33531,129,21134,19226,15124,8036
2021-08-12 13:30:00+00,7109,467,4102,11112,67,4134,1866,140,4451,0,33448,122,21598,19732,15630,7576
2021-08-12 14:00:00+00,6630,464,4102,11704,68,4140,1785,140,4031,0,33064,118,21690,19905,15803,7094
2021-08-12 14:30:00+00,6688,472,4098,12056,70,4120,1670,140,3969,0,33283,117,21863,20193,16095,7160
2021-08-12 15:00:00+00,6708,465,4096,12445,98,4200,1659,143,4315,0,34129,115,22613,20954,16858,7173
2021-08-12 15:30:00+00,6995,465,4095,12654,98,4368,1671,146,3998,0,34490,119,22516,20845,16750,7460
2021-08-12 16:00:00+00,7500,474,4098,13080,161,3946,1926,150,3283,0,34618,119,22548,20622,16524,7974
2021-08-12 16:30:00+00,7672,471,4097,13204,179,4134,1958,157,2672,84,34628,124,22110,20152,16055,8143
2021-08-12 17:00:00+00,7838,505,4100,13281,227,4152,1959,161,1901,24,34148,130,21468,19509,15409,8343
2021-08-12 17:30:00+00,7838,686,4097,12873,287,4230,1960,160,1451,60,33642,138,20668,18708,14611,8524
2021-08-12 18:00:00+00,7848,666,4099,12639,288,4616,1977,156,837,192,33318,142,19840,17863,13764,8514
2021-08-12 18:30:00+00,8101,615,4100,12141,288,4658,1974,163,345,254,32639,148,18848,16874,12774,8716
2021-08-12 19:00:00+00,8184,592,4098,11546,271,4536,1980,248,54,52,31561,155,17949,15969,11871,8776
2021-08-12 19:30:00+00,8220,573,4099,11040,269,4512,1980,388,0,138,31219,157,17388,15408,11309,8793
2021-08-12 20:00:00+00,8257,608,4100,10720,249,4446,1969,486,0,282,31117,159,17038,15069,10969,8865
2021-08-12 20:30:00+00,7982,607,4099,10551,165,4338,1971,334,0,196,30243,157,16786,14815,10716,8589
2021-08-12 21:00:00+00,7409,630,4097,10416,95,4044,1817,227,0,160,28895,155,16425,14608,10511,8039
2021-08-12 21:30:00+00,6537,600,4099,10675,91,3978,1227,167,0,0,27374,145,16092,14865,10766,7137
2021-08-12 22:00:00+00,5638,491,4097,10739,124,3824,682,142,0,0,25737,134,15642,14960,10863,6129
2021-08-12 22:30:00+00,4720,525,4100,10311,149,3922,631,145,0,0,24503,130,15191,14560,10460,5245
2021-08-12 23:00:00+00,4560,620,4102,10478,135,2890,627,144,0,0,23556,135,15342,14715,10613,5180
2021-08-12 23:30:00+00,4094,542,4101,10505,135,2940,629,141,0,0,23087,129,15370,14741,10640,4636
2021-08-13 00:00:00+00,3997,530,4101,10582,135,3140,625,140,0,0,23250,122,15443,14818,10717,4527
2021-08-13 00:30:00+00,3784,509,4100,10432,135,3112,632,141,0,0,22845,119,15299,14667,10567,4293
2021-08-13 01:00:00+00,3678,507,4099,10176,135,2572,629,142,0,0,21938,112,15039,14410,10311,4185
2021-08-13 01:30:00+00,3705,512,4095,9767,135,2483,631,141,0,0,21469,112,14628,13997,9902,4217
2021-08-13 02:00:00+00,4068,606,4091,9593,135,2512,686,141,0,0,21832,121,14505,13819,9728,4674
2021-08-13 02:30:00+00,4416,679,4094,9208,137,2535,724,142,0,0,21935,130,14163,13439,9345,5095
2021-08-13 03:00:00+00,4353,654,4098,9573,154,2547,695,140,0,0,22214,126,14520,13825,9727,5007
2021-08-13 03:30:00+00,4159,612,4096,9728,155,2544,636,140,0,0,22070,120,14615,13979,9883,4771
2021-08-13 04:00:00+00,4055,615,4100,9972,155,2806,637,141,0,0,22481,127,14864,14227,10127,4670
2021-08-13 04:30:00+00,4247,591,4101,10092,154,2945,709,140,0,0,22979,130,15056,14347,10246,4838
2021-08-13 05:00:00+00,4472,585,4102,10611,199,3124,1118,145,55,0,24411,128,16085,14967,10865,5057
2021-08-13 05:30:00+00,4736,579,4101,11118,210,3188,1417,146,277,24,25796,126,17123,15706,11605,5315
2021-08-13 06:00:00+00,4547,512,4108,11451,252,3982,1479,146,587,0,27063,121,17877,16398,12290,5059
2021-08-13 06:30:00+00,5336,459,4108,11643,258,4052,1380,145,1016,104,28501,124,18405,17025,12917,5795
2021-08-13 07:00:00+00,5551,459,4110,12515,309,4172,1413,174,1558,196,30456,119,19905,18492,14382,6010
2021-08-13 07:30:00+00,5774,481,4103,12892,322,4222,1315,205,2133,110,31557,119,20765,19450,15347,6255
2021-08-13 08:00:00+00,5584,471,4107,13363,323,4353,1381,218,2679,222,32701,112,21853,20472,16365,6055
2021-08-13 08:30:00+00,5450,469,4106,13578,300,4339,1200,152,3290,112,32996,107,22474,21274,17168,5919
2021-08-13 09:00:00+00,5149,476,4016,13803,259,4254,1360,145,4237,108,33808,100,23675,22315,18299,5625
2021-08-13 09:30:00+00,5204,477,3957,14020,219,4166,1379,141,4141,0,33704,99,23716,22337,18380,5681
2021-08-13 10:00:00+00,4650,475,3964,14386,141,4258,1393,141,4337,0,33745,93,24221,22828,18864,5125
2021-08-13 10:30:00+00,4480,475,3989,14575,136,4242,1370,143,4954,0,34364,89,25024,23654,19665,4955
2021-08-13 11:00:00+00,4167,478,3991,14825,107,4264,1306,158,5410,82,34788,84,25639,24333,20342,4645
2021-08-13 11:30:00+00,3950,466,4004,14753,114,4380,1299,145,5436,0,34547,83,25606,24307,20303,4416
2021-08-13 12:00:00+00,3755,490,4043,14501,114,3938,1396,149,5587,0,33973,79,25641,24245,20202,4245
2021-08-13 12:30:00+00,3634,467,4082,14313,117,3724,1441,178,5766,46,33768,75,25719,24278,20196,4101
2021-08-13 13:00:00+00,3502,461,4104,14289,118,3652,1526,160,5778,0,33590,73,25815,24289,20185,3963
2021-08-13 13:30:00+00,3226,463,4104,14219,124,3652,1470,144,5726,0,33128,71,25643,24173,20069,3689
2021-08-13 14:00:00+00,3332,460,4101,14199,151,3654,1401,141,5292,18,32749,72,25144,23743,19642,3792
2021-08-13 14:30:00+00,3367,470,4101,14529,157,3654,1331,142,4695,0,32446,73,24813,23482,19381,3837
2021-08-13 15:00:00+00,3603,485,4102,14490,163,3870,1295,146,4354,44,32552,78,24404,23109,19007,4088
2021-08-13 15:30:00+00,3954,661,4105,14516,162,4016,1515,146,3855,0,32930,89,24153,22638,18533,4615
2021-08-13 16:00:00+00,4240,693,4102,14860,210,4134,1413,146,3176,0,32974,94,23761,22348,18246,4933
2021-08-13 16:30:00+00,4786,735,4103,14496,234,4100,1522,152,2634,88,32850,102,22989,21467,17364,5521
2021-08-13 17:00:00+00,5196,756,4103,14314,262,4352,1640,160,1915,0,32698,110,22234,20594,16492,5952
2021-08-13 17:30:00+00,5463,868,4101,13875,268,4396,1654,184,1308,0,32117,120,21206,19552,15451,6331
2021-08-13 18:00:00+00,5416,861,4106,13131,307,4374,1676,570,671,74,31186,126,19891,18215,14109,6277
2021-08-13 18:30:00+00,5643,876,4102,12542,297,4436,1643,705,257,116,30617,134,18841,17198,13096,6519
2021-08-13 19:00:00+00,5847,849,4104,12129,299,4420,1691,762,33,0,30134,138,18256,16565,12461,6696
2021-08-13 19:30:00+00,5884,857,4101,11706,325,4420,1704,814,0,34,29845,141,17836,16132,12031,6741
2021-08-13 20:00:00+00,5851,855,4102,11252,358,4380,1694,928,0,130,29550,142,17406,15712,11610,6706
2021-08-13 20:30:00+00,5757,897,4101,11337,259,4272,1639,743,0,28,29033,141,17336,15697,11596,6654
2021-08-13 21:00:00+00,6070,906,4104,11269,204,3502,1410,285,0,346,28096,139,16987,15577,11473,6976
2021-08-13 21:30:00+00,5550,743,4103,11275,153,3394,1174,197,0,216,26805,129,16705,15531,11428,6293
2021-08-13 22:00:00+00,5538,603,4102,11464,231,1930,1105,186,0,130,25289,124,16902,15797,11695,6141
2021-08-13 22:30:00+00,4746,475,4106,11350,161,2124,1064,168,0,0,24194,116,16681,15617,11511,5221
2021-08-13 23:00:00+00,4998,571,4108,11132,154,834,1131,167,0,0,23095,122,16525,15394,11286,5569
2021-08-13 23:30:00+00,4645,565,4111,11134,134,880,1007,167,0,0,22643,119,16386,15379,11268,5210
2021-08-14 00:00:00+00,4697,627,4112,11253,133,628,954,173,0,0,22577,119,16452,15498,11386,5324
2021-08-14 00:30:00+00,4785,672,4113,11200,131,538,935,167,0,0,22541,121,16379,15444,11331,5457
2021-08-14 01:00:00+00,4992,700,4110,10729,114,172,967,123,0,0,21907,127,15920,14953,10843,5692
2021-08-14 01:30:00+00,5118,685,4110,10511,113,172,1007,115,0,0,21831,129,15741,14734,10624,5803
2021-08-14 02:00:00+00,5150,514,4106,10289,112,636,1019,127,0,0,21953,123,15526,14507,10401,5664
2021-08-14 02:30:00+00,5161,477,4107,10334,113,636,1010,120,0,0,21958,122,15564,14554,10447,5638
2021-08-14 03:00:00+00,5000,551,4104,10160,115,452,1059,113,0,0,21554,124,15438,14379,10275,5551
2021-08-14 03:30:00+00,4952,556,4107,9671,116,450,1084,113,0,0,21049,126,14978,13894,9787,5508
2021-08-14 04:00:00+00,5114,649,4108,9587,119,486,1086,113,0,0,21262,132,14900,13814,9706,5763
2021-08-14 04:30:00+00,5145,781,4108,9401,135,624,1047,115,0,0,21356,140,14691,13644,9536,5926
2021-08-14 05:00:00+00,4990,511,4106,9172,134,1344,903,163,63,0,21386,127,14378,13475,9369,5501
2021-08-14 05:30:00+00,5242,502,4109,8945,137,1440,1163,244,294,0,22076,131,14648,13485,9376,5744
2021-08-14 06:00:00+00,5115,478,4109,8619,171,2580,1491,286,775,20,23644,127,15165,13674,9565,5593
2021-08-14 06:30:00+00,5723,472,4109,8485,170,2671,1714,305,1356,238,25243,130,15834,14120,10011,6195
2021-08-14 07:00:00+00,6257,468,4112,8304,170,3406,1718,370,1913,146,26864,132,16217,14499,10387,6725
2021-08-14 07:30:00+00,6904,554,4112,8035,170,3432,1729,444,2397,204,27981,139,16443,14714,10602,7458
2021-08-14 08:00:00+00,7773,664,4115,7853,308,3650,1727,423,3041,34,29588,147,17044,15317,11202,8437
2021-08-14 08:30:00+00,8087,783,4113,7410,346,3654,1689,405,3523,82,30092,152,17081,15392,11279,8870
2021-08-14 09:00:00+00,8125,804,4113,7133,365,3770,1650,386,4157,256,30759,150,17418,15768,11655,8929
2021-08-14 09:30:00+00,8220,747,4113,7052,316,3776,1653,384,4094,186,30541,151,17228,15575,11462,8967
2021-08-14 10:00:00+00,8345,658,4112,6936,246,3894,1643,272,4354,158,30618,148,17291,15648,11536,9003
2021-08-14 10:30:00+00,8370,721,4112,6769,243,3894,1722,119,4661,290,30901,148,17507,15785,11673,9091
2021-08-14 11:00:00+00,8319,708,4110,6502,318,3896,1697,119,4805,478,30952,147,17432,15735,11625,9027
2021-08-14 11:30:00+00,8309,693,4112,6497,264,3894,1666,115,5127,192,30869,146,17666,16000,11888,9002
2021-08-14 12:00:00+00,8111,640,4113,6345,173,4262,1559,115,5314,0,30632,144,17504,15945,11832,8751
2021-08-14 12:30:00+00,7883,498,4109,6420,157,4266,1496,115,5527,0,30471,137,17709,16213,12104,8381
2021-08-14 13:00:00+00,7694,466,4108,6300,142,4262,1534,113,5155,0,29774,137,17239,15705,11597,8160
2021-08-14 13:30:00+00,7827,493,4104,6194,142,4262,1583,119,4946,0,29670,140,16969,15386,11282,8320
2021-08-14 14:00:00+00,8286,475,4103,5865,146,4266,1553,119,4746,0,29559,146,16413,14860,10757,8761
2021-08-14 14:30:00+00,8573,470,4099,5608,185,4262,1547,113,4470,0,29327,151,15909,14362,10263,9043
2021-08-14 15:00:00+00,9011,472,4101,5197,233,4748,1534,113,3889,0,29298,159,14954,13420,9319,9483
2021-08-14 15:30:00+00,9986,587,4099,4731,243,4810,1591,112,3429,44,29632,175,14093,12502,8403,10573
2021-08-14 16:00:00+00,11186,820,4100,4442,262,4930,1636,155,2726,0,30257,194,13166,11530,7430,12006
2021-08-14 16:30:00+00,11762,942,4102,4237,258,4932,1705,220,2082,0,30240,206,12384,10679,6577,12704
2021-08-14 17:00:00+00,11900,981,4097,3972,273,4804,1729,301,1440,544,30041,210,11511,9782,5685,12881
2021-08-14 17:30:00+00,12120,992,4098,3608,293,4876,1730,422,858,672,29669,218,10587,8857,4759,13112
2021-08-14 18:00:00+00,12223,990,4101,3357,329,4784,1728,586,469,636,29203,223,9984,8256,4155,13213
2021-08-14 18:30:00+00,12050,992,4103,3264,393,4808,1728,671,154,736,28899,225,9642,7914,3811,13042
2021-08-14 19:00:00+00,12271,991,4103,3013,393,4528,1730,685,14,738,28466,228,9253,7523,3420,13262
2021-08-14 19:30:00+00,12288,992,4102,2927,393,4536,1730,692,0,864,28524,228,9152,7422,3320,13280
2021-08-14 20:00:00+00,12119,993,4107,2843,365,4694,1729,667,0,668,28185,230,9044,7315,3208,13112
2021-08-14 20:30:00+00,12179,939,4107,2667,344,4670,1731,543,0,182,27362,234,8849,7118,3011,13118
2021-08-14 21:00:00+00,12254,821,4105,2587,228,4422,1665,360,0,0,26442,236,8585,6920,2815,13075
2021-08-14 21:30:00+00,11621,744,4106,2412,209,4396,1405,118,0,116,25127,231,8132,6727,2621,12365
2021-08-14 22:00:00+00,10343,750,4106,2379,279,4650,1483,113,0,76,24179,226,8247,6764,2658,11093
2021-08-14 22:30:00+00,9328,664,4103,2255,285,4756,1627,114,0,0,23132,219,8270,6643,2540,9992
2021-08-14 23:00:00+00,8809,635,4105,2208,166,4458,1683,114,0,0,22178,220,8162,6479,2374,9444
2021-08-14 23:30:00+00,8414,655,4104,2100,148,4310,1689,115,0,16,21551,217,8041,6352,2248,9069
2021-08-15 00:00:00+00,8501,769,4111,1876,156,3732,1686,114,0,0,20945,226,7829,6143,2032,9270
2021-08-15 00:30:00+00,8417,852,4112,1750,248,3648,1687,114,0,0,20828,228,7797,6110,1998,9269
2021-08-15 01:00:00+00,8090,880,4114,1716,247,3588,1688,115,0,0,20438,226,7765,6077,1963,8970
2021-08-15 01:30:00+00,7827,867,4110,1578,247,3640,1688,115,0,0,20072,226,7623,5935,1825,8694
2021-08-15 02:00:00+00,7735,775,4113,1592,247,3540,1689,115,0,0,19806,220,7641,5952,1839,8510
2021-08-15 02:30:00+00,7802,739,4108,1527,247,3448,1688,115,0,0,19674,219,7570,5882,1774,8541
2021-08-15 03:00:00+00,7827,740,4109,1440,247,3440,1691,113,0,0,19607,220,7487,5796,1687,8567
2021-08-15 03:30:00+00,7718,728,4105,1722,247,3434,1682,112,0,0,19748,216,7756,6074,1969,8446
2021-08-15 04:00:00+00,7640,730,4107,2080,245,3430,1695,112,0,0,20039,211,8127,6432,2325,8370
2021-08-15 04:30:00+00,7047,756,4108,2724,158,3432,1594,113,0,0,19932,201,8584,6990,2882,7803
2021-08-15 05:00:00+00,6833,767,4105,2771,174,3432,1586,113,50,0,19831,199,8686,7100,2995,7600
2021-08-15 05:30:00+00,6989,729,4111,3077,174,3434,1715,114,297,0,20640,193,9374,7659,3548,7718
2021-08-15 06:00:00+00,7548,757,4108,3189,174,3452,1781,122,698,12,21841,194,9950,8169,4061,8305
2021-08-15 06:30:00+00,8081,824,4114,3090,204,3430,1775,143,1045,124,22830,198,10228,8453,4339,8905
2021-08-15 07:00:00+00,8630,828,4111,3394,262,3768,1773,181,1537,0,24484,196,11077,9304,5193,9458
2021-08-15 07:30:00+00,8907,982,4114,3448,266,3776,1776,242,2009,48,25568,198,11613,9837,5723,9889
2021-08-15 08:00:00+00,9068,997,4116,3569,365,4254,1765,135,2665,40,26974,191,12480,10715,6599,10065
2021-08-15 08:30:00+00,9284,995,4114,3789,374,4262,1719,120,3414,56,28127,185,13410,11691,7577,10279
2021-08-15 09:00:00+00,9503,993,4119,3829,374,4264,1711,118,3624,146,28681,184,13657,11946,7827,10496
2021-08-15 09:30:00+00,9343,989,4116,4164,293,4264,1693,117,3782,88,28849,181,14048,12355,8239,10332
2021-08-15 10:00:00+00,9370,872,4116,4377,247,4338,1666,117,4103,0,29206,176,14509,12843,8727,10242
2021-08-15 10:30:00+00,9361,819,4112,4462,245,4404,1671,119,4833,0,30026,171,15323,13652,9540,10180
2021-08-15 11:00:00+00,9467,868,4113,4494,211,4476,1670,119,5131,0,30549,172,15619,13949,9836,10335
2021-08-15 11:30:00+00,9547,788,4107,4458,189,4426,1673,120,5223,52,30583,170,15650,13977,9870,10335
2021-08-15 12:00:00+00,9494,513,4106,4566,127,4502,1717,121,5386,72,30604,162,15902,14185,10079,10007
2021-08-15 12:30:00+00,9351,480,4105,4481,123,4434,1713,116,5333,164,30300,159,15755,14042,9937,9831
2021-08-15 13:00:00+00,9308,476,4107,4653,132,4294,1626,170,5113,40,29919,159,15631,14005,9898,9784
2021-08-15 13:30:00+00,9330,351,4102,4857,142,4298,1669,126,4586,0,29461,157,15356,13687,9585,9681
2021-08-15 14:00:00+00,9478,376,4102,5337,145,4266,1692,116,4041,12,29565,159,15317,13625,9523,9854
2021-08-15 14:30:00+00,9477,127,4100,5739,154,4352,1725,118,3962,198,29952,151,15680,13955,9855,9604
2021-08-15 15:00:00+00,9520,0,4100,6253,178,4560,1748,129,3559,364,30411,148,15838,14090,9990,9520
2021-08-15 15:30:00+00,10026,0,4098,6566,232,4702,1760,301,2873,406,30964,156,15529,13769,9671,10026
2021-08-15 16:00:00+00,10277,0,4098,7004,377,4840,1780,310,2219,318,31223,160,15478,13698,9600,10277
2021-08-15 16:30:00+00,10555,0,4101,7643,376,4872,1779,272,1553,228,31379,163,15452,13673,9572,10555
2021-08-15 17:00:00+00,10510,0,4101,7911,360,4878,1741,119,1291,234,31145,162,15404,13663,9562,10510
2021-08-15 17:30:00+00,10273,0,4101,8576,294,4848,1768,116,823,0,30799,160,15562,13794,9693,10273
2021-08-15 18:00:00+00,9613,0,4101,8867,311,4880,1709,115,462,358,30416,154,15450,13741,9640,9613
2021-08-15 18:30:00+00,9676,0,4103,8865,310,4784,1687,115,180,120,29840,157,15145,13458,9355,9676
2021-08-15 19:00:00+00,9588,0,4105,8886,282,4786,1577,114,13,0,29351,157,14863,13286,9181,9588
2021-08-15 19:30:00+00,9723,0,4108,8709,280,4786,1469,115,0,0,29190,160,14566,13097,8989,9723
2021-08-15 20:00:00+00,9357,0,4106,8848,248,4704,1568,114,0,0,28945,155,14770,13202,9096,9357
2021-08-15 20:30:00+00,7923,0,4108,9247,227,4546,1609,113,0,0,27773,139,15191,13582,9474,7923
2021-08-15 21:00:00+00,7135,0,4106,9918,207,3898,1391,113,0,0,26768,127,15622,14231,10125,7135
2021-08-15 21:30:00+00,5529,0,4107,10573,194,3766,1178,113,0,0,25460,106,16052,14874,10767,5529
2021-08-15 22:00:00+00,4418,0,4106,10797,147,3510,1135,114,0,0,24227,93,16185,15050,10944,4418
2021-08-15 22:30:00+00,3733,0,4107,10560,108,3706,1123,117,0,0,23454,89,15898,14775,10668,3733
2021-08-15 23:00:00+00,3933,0,4106,10773,77,2428,1105,117,0,0,22539,88,16061,14956,10850,3933
2021-08-15 23:30:00+00,3721,0,4107,11052,68,2266,1095,113,0,0,22422,82,16322,15226,11120,3721
2021-08-16 00:00:00+00,3925,0,4107,11171,67,1704,1092,114,0,0,22180,82,16437,15345,11238,3925
2021-08-16 00:30:00+00,3687,0,4109,11603,65,1670,1092,113,0,0,22339,77,16869,15777,11668,3687
2021-08-16 01:00:00+00,4225,0,4114,11819,65,1310,1091,119,0,0,22743,82,17089,15998,11884,4225
2021-08-16 01:30:00+00,3983,0,4117,11937,65,1284,1093,119,0,0,22598,79,17212,16119,12002,3983
2021-08-16 02:00:00+00,4392,0,4113,11807,65,894,1112,123,0,0,22506,86,17097,15985,11872,4392
2021-08-16 02:30:00+00,4210,0,4114,12060,65,876,1094,123,0,0,22542,83,17333,16239,12125,4210
2021-08-16 03:00:00+00,4792,0,4111,12077,65,536,1106,124,0,0,22811,91,17359,16253,12142,4792
2021-08-16 03:30:00+00,4759,0,4107,12172,65,538,1099,118,0,0,22858,91,17443,16344,12237,4759
2021-08-16 04:00:00+00,4170,0,4107,12289,65,608,1118,115,0,0,22472,82,17579,16461,12354,4170
2021-08-16 04:30:00+00,4210,0,4110,12434,64,612,1093,112,0,0,22635,82,17701,16608,12498,4210
2021-08-16 05:00:00+00,3835,0,4105,12374,64,2022,1069,113,64,0,23646,73,17676,16607,12502,3835
2021-08-16 05:30:00+00,5098,0,4107,12161,73,2214,1081,117,315,0,25166,90,17737,16656,12549,5098
2021-08-16 06:00:00+00,5458,0,4106,12109,118,3594,1062,114,733,0,27294,95,18128,17066,12960,5458
2021-08-16 06:30:00+00,6598,0,4109,12209,128,3692,1275,118,1069,0,29198,106,18790,17515,13406,6598
2021-08-16 07:00:00+00,7388,0,4111,12132,145,4192,1531,119,1597,0,31215,111,19516,17985,13874,7388
2021-08-16 07:30:00+00,8278,0,4114,12091,147,4210,1557,119,2111,0,32627,117,20020,18463,14349,8278
2021-08-16 08:00:00+00,8544,0,4112,11921,195,4506,1648,122,2433,10,33491,119,20309,18661,14549,8544
2021-08-16 08:30:00+00,8665,0,4115,11902,328,4512,1559,248,2755,160,34244,118,20659,19100,14985,8665
2021-08-16 09:00:00+00,8605,0,4122,11850,390,4510,1578,304,3155,156,34670,117,21095,19517,15395,8605
2021-08-16 09:30:00+00,8691,0,4118,11128,376,4510,1586,372,3224,514,34519,119,20432,18846,14728,8691
2021-08-16 10:00:00+00,8864,0,4119,10521,376,4506,1644,498,3175,626,34329,123,19835,18191,14072,8864
2021-08-16 10:30:00+00,8992,0,4114,10129,377,4512,1714,635,3632,658,34763,124,19966,18252,14138,8992
2021-08-16 11:00:00+00,9111,0,4112,10042,371,4582,1717,667,3524,656,34782,127,19766,18049,13937,9111
2021-08-16 11:30:00+00,9240,0,4108,9797,373,4656,1723,667,3386,596,34546,130,19387,17664,13556,9240
2021-08-16 12:00:00+00,9486,0,4106,9777,281,4538,1723,665,3398,476,34450,133,19285,17562,13456,9486
2021-08-16 12:30:00+00,9810,0,4105,9754,193,4438,1686,573,3850,276,34685,134,19588,17902,13797,9810
2021-08-16 13:00:00+00,10118,21,4101,9805,130,4390,1745,300,3778,142,34530,135,19559,17814,13713,10139
2021-08-16 13:30:00+00,10290,42,4100,9537,121,4386,1757,124,4131,32,34520,136,19646,17889,13789,10332
2021-08-16 14:00:00+00,10650,62,4106,9081,121,4510,1764,117,4321,0,34732,141,19393,17629,13523,10712
2021-08-16 14:30:00+00,10770,83,4106,8848,134,4514,1775,117,4085,0,34432,144,18948,17173,13067,10853
2021-08-16 15:00:00+00,10502,222,4106,8703,178,4750,1758,120,3745,0,34084,147,18490,16732,12626,10724
2021-08-16 15:30:00+00,10794,337,4101,8497,187,4752,1792,136,3421,34,34051,153,17998,16206,12105,11131
2021-08-16 16:00:00+00,11832,478,4103,7950,266,4996,1799,141,3079,0,34644,167,17198,15398,11296,12310
2021-08-16 16:30:00+00,12426,498,4099,7466,291,5000,1754,145,2542,184,34405,176,16152,14398,10299,12924
2021-08-16 17:00:00+00,12751,499,4102,6919,338,5022,1754,180,1680,484,33729,183,14793,13039,8937,13250
2021-08-16 17:30:00+00,12891,497,4099,6267,402,5160,1752,263,1142,812,33285,190,13662,11910,7811,13388
2021-08-16 18:00:00+00,12892,499,4106,5763,436,5220,1756,386,645,618,32321,198,12706,10950,6844,13391
2021-08-16 18:30:00+00,12819,499,4107,5530,412,5232,1758,403,215,532,31507,203,12022,10264,6157,13318
2021-08-16 19:00:00+00,12554,499,4107,5371,317,5240,1762,369,12,804,31035,202,11569,9807,5700,13053
2021-08-16 19:30:00+00,12737,499,4110,5277,315,5242,1758,314,0,702,30954,205,11460,9702,5592,13236
2021-08-16 20:00:00+00,12801,499,4113,5167,308,5086,1755,240,0,798,30767,207,11343,9588,5475,13300
2021-08-16 20:30:00+00,12483,476,4110,5082,239,4930,1751,201,0,278,29550,207,11182,9431,5321,12959
2021-08-16 21:00:00+00,11943,230,4109,5228,164,4716,1753,163,0,0,28306,197,11254,9501,5392,12173
2021-08-16 21:30:00+00,10534,0,4111,5486,163,4678,1749,119,0,0,26840,178,11509,9760,5649,10534
2021-08-16 22:00:00+00,8961,0,4113,6080,144,4092,1732,116,0,20,25258,164,12069,10337,6224,8961
2021-08-16 22:30:00+00,7219,0,4111,6721,122,4316,1357,116,0,0,23962,147,12311,10954,6843,7219
2021-08-16 23:00:00+00,5666,0,4113,7397,85,4014,1575,117,0,0,22967,131,13170,11595,7482,5666
2021-08-16 23:30:00+00,4596,0,4113,7867,80,4106,1611,115,0,0,22488,118,13671,12060,7947,4596
2021-08-17 00:00:00+00,3917,0,4109,8367,78,3608,1746,115,0,0,21940,102,14300,12554,8445,3917
2021-08-17 00:30:00+00,3559,0,4112,8753,78,3664,1507,112,0,0,21785,97,14450,12943,8831,3559
2021-08-17 01:00:00+00,4068,0,4111,8866,78,3374,1712,116,0,0,22325,101,14767,13055,8944,4068
2021-08-17 01:30:00+00,4052,0,4116,9053,78,3176,1785,115,0,0,22375,96,15032,13247,9131,4052
2021-08-17 02:00:00+00,4427,0,4116,9390,78,2434,1788,124,0,0,22357,100,15372,13584,9468,4427
2021-08-17 02:30:00+00,4438,0,4119,9648,78,2214,1783,124,0,0,22404,96,15628,13845,9726,4438
2021-08-17 03:00:00+00,4389,0,4116,9627,76,2314,1785,114,0,0,22421,96,15604,13819,9703,4389
2021-08-17 03:30:00+00,4047,6,4119,9586,83,2388,1775,113,0,0,22117,93,15563,13788,9669,4053
2021-08-17 04:00:00+00,3505,181,4116,9987,142,2764,1638,113,0,0,22446,94,15883,14245,10129,3686
2021-08-17 04:30:00+00,3632,235,4109,10049,150,2870,1661,118,0,0,22824,99,15969,14308,10199,3867
2021-08-17 05:00:00+00,4112,355,4109,9988,176,3286,1769,118,8,0,23921,110,16050,14281,10172,4467
2021-08-17 05:30:00+00,5781,381,4105,9973,176,3166,1784,117,66,0,25549,127,16104,14320,10215,6162
2021-08-17 06:00:00+00,7006,266,4105,9888,176,4422,1653,117,213,106,27952,135,16035,14382,10277,7272
2021-08-17 06:30:00+00,8572,233,4104,10138,191,4496,1682,118,418,0,29952,146,16533,14851,10747,8805
2021-08-17 07:00:00+00,9568,341,4107,10556,191,4466,1743,120,743,38,31873,152,17340,15597,11490,9909
2021-08-17 07:30:00+00,9710,405,4107,10698,190,4534,1738,188,1069,240,32879,153,17802,16064,11957,10115
2021-08-17 08:00:00+00,10036,400,4110,10612,192,4640,1658,381,1394,294,33717,154,17966,16308,12198,10436
2021-08-17 08:30:00+00,10140,489,4112,10387,203,4568,1664,380,1740,396,34079,155,18106,16442,12330,10629
2021-08-17 09:00:00+00,10112,490,4110,10777,200,4148,1744,357,1969,400,34307,151,18800,17056,12946,10602
2021-08-17 09:30:00+00,10089,493,4113,10838,195,4070,1742,283,2457,412,34692,148,19345,17603,13490,10582
2021-08-17 10:00:00+00,10360,492,4111,10997,175,3934,1743,156,2718,222,34908,149,19744,18001,13890,10852
2021-08-17 10:30:00+00,10306,490,4111,11160,168,3954,1743,118,3094,126,35270,147,20276,18533,14422,10796
2021-08-17 11:00:00+00,10264,490,4110,11357,149,4062,1670,123,3312,142,35679,145,20598,18928,14818,10754
2021-08-17 11:30:00+00,10252,491,4112,11240,141,3982,1738,124,3455,10,35545,145,20686,18948,14836,10743
2021-08-17 12:00:00+00,9920,440,4112,10856,100,4692,1741,115,3439,0,35415,143,20248,18507,14395,10360
2021-08-17 12:30:00+00,9683,451,4112,10803,97,4718,1742,116,3405,0,35127,142,20159,18417,14305,10134
2021-08-17 13:00:00+00,9761,490,4109,10724,99,4376,1742,115,3437,0,34853,140,20111,18369,14260,10251
2021-08-17 13:30:00+00,9791,492,4106,10538,97,4438,1740,114,2921,0,34237,144,19402,17662,13556,10283
2021-08-17 14:00:00+00,10243,491,4107,10493,97,3878,1740,116,2751,0,33916,146,19188,17448,13341,10734
2021-08-17 14:30:00+00,10414,492,4107,10558,128,3938,1741,121,2473,32,34004,149,19007,17266,13159,10906
2021-08-17 15:00:00+00,10316,413,4125,10313,174,4604,1741,128,2186,218,34218,150,18539,16798,12673,10729
2021-08-17 15:30:00+00,11044,471,4129,10037,202,4618,1739,140,1730,274,34384,159,17837,16098,11969,11515
2021-08-17 16:00:00+00,11542,492,4174,9759,266,5058,1742,221,1334,214,34802,167,17275,15533,11359,12034
2021-08-17 16:30:00+00,11959,493,4201,9502,281,5098,1740,286,993,540,35093,171,16717,14977,10776,12452
2021-08-17 17:00:00+00,11980,494,4215,9185,334,5096,1740,388,676,814,34922,173,16150,14410,10195,12474
2021-08-17 17:30:00+00,12117,493,4221,8555,336,5098,1741,387,424,892,34264,178,15277,13536,9315,12610
2021-08-17 18:00:00+00,11804,493,4220,8287,334,5162,1743,343,245,948,33579,179,14829,13086,8866,12297
2021-08-17 18:30:00+00,11686,494,4221,8111,297,5138,1743,418,69,748,32925,181,14441,12698,8477,12180
2021-08-17 19:00:00+00,11660,493,4225,7843,279,5096,1740,389,3,772,32500,182,14090,12350,8125,12153
2021-08-17 19:30:00+00,11650,493,4228,7714,264,5086,1731,301,0,726,32193,183,13937,12206,7978,12143
2021-08-17 20:00:00+00,11690,491,4250,7235,224,5028,1743,381,0,284,31326,189,13452,11709,7459,12181
2021-08-17 20:30:00+00,10875,462,4283,7253,195,5020,1743,302,0,90,30223,183,13474,11731,7448,11337
2021-08-17 21:00:00+00,10997,188,4284,6933,106,4468,1620,115,0,60,28771,180,12943,11323,7039,11185
2021-08-17 21:30:00+00,9950,0,4290,6991,112,4452,1601,121,0,0,27517,167,12994,11393,7103,9950
2021-08-17 22:00:00+00,8899,0,4286,6869,135,3862,1726,115,0,0,25892,161,13016,11290,7004,8899
2021-08-17 22:30:00+00,7863,0,4292,6785,135,3919,1583,112,0,0,24689,153,12795,11212,6920,7863
2021-08-17 23:00:00+00,7428,0,4293,6585,119,3561,1718,113,0,0,23816,149,12715,10997,6704,7428
2021-08-17 23:30:00+00,7023,0,4297,6428,119,3544,1746,113,0,0,23270,145,12590,10844,6547,7023
2021-08-18 00:00:00+00,6565,0,4295,6450,119,3626,1746,113,0,0,22914,142,12610,10864,6569,6565
2021-08-18 00:30:00+00,6378,0,4295,6571,119,3680,1748,113,0,0,22904,140,12733,10985,6690,6378
2021-08-18 01:00:00+00,6013,0,4300,6922,119,3560,1743,114,0,0,22771,132,13084,11341,7041,6013
2021-08-18 01:30:00+00,5357,0,4295,7408,117,3550,1638,114,0,0,22479,122,13458,11820,7525,5357
2021-08-18 02:00:00+00,5135,0,4297,7726,116,3176,1717,114,0,0,22281,118,13856,12139,7842,5135
2021-08-18 02:30:00+00,5180,0,4291,8001,116,3138,1627,116,0,0,22469,116,14035,12408,8117,5180
2021-08-18 03:00:00+00,5153,0,4312,8340,116,3138,1530,114,0,0,22703,114,14298,12768,8456,5153
2021-08-18 03:30:00+00,5261,0,4330,8342,130,3138,1688,113,0,0,23002,115,14490,12802,8472,5261
2021-08-18 04:00:00+00,5491,0,4341,8709,130,3122,1747,118,0,0,23658,112,14927,13180,8839,5491
2021-08-18 04:30:00+00,5817,0,4340,8442,130,3130,1741,114,0,0,23714,117,14653,12912,8572,5817
2021-08-18 05:00:00+00,6677,0,4342,8291,142,3484,1744,117,11,0,24808,126,14530,12786,8444,6677
2021-08-18 05:30:00+00,8013,0,4345,8564,127,3504,1739,113,160,0,26564,138,14934,13196,8850,8013
2021-08-18 06:00:00+00,9394,0,4346,8423,141,4136,1747,120,432,0,28739,146,15089,13342,8996,9394
2021-08-18 06:30:00+00,10639,0,4341,8594,155,4154,1745,120,793,98,30639,153,15628,13883,9542,10639
2021-08-18 07:00:00+00,11539,0,4339,8659,239,4178,1747,258,1226,158,32343,154,16210,14463,10124,11539
2021-08-18 07:30:00+00,11895,0,4342,8706,239,4194,1682,377,1751,428,33614,154,16720,15038,10696,11895
2021-08-18 08:00:00+00,12197,0,4338,8641,229,4604,1669,391,2076,216,34361,157,16953,15284,10946,12197
2021-08-18 08:30:00+00,12295,0,4337,8563,228,4626,1699,388,2444,188,34768,156,17271,15572,11235,12295
2021-08-18 09:00:00+00,12292,0,4338,8656,224,4424,1660,384,2709,224,34911,153,17587,15927,11589,12292
2021-08-18 09:30:00+00,12294,0,4340,8517,219,4416,1744,382,3322,214,35448,151,18142,16398,12058,12294
2021-08-18 10:00:00+00,12408,0,4339,8545,149,4124,1746,472,3838,354,35975,149,18617,16871,12532,12408
2021-08-18 10:30:00+00,12546,0,4340,8789,145,4122,1743,453,3822,190,36150,150,18839,17096,12756,12546
2021-08-18 11:00:00+00,12167,0,4340,8750,148,4536,1741,194,3823,288,35987,149,18802,17061,12721,12167
2021-08-18 11:30:00+00,12203,0,4337,8914,150,4528,1741,160,4063,140,36236,148,19205,17464,13127,12203
2021-08-18 12:00:00+00,12104,0,4280,9234,125,4156,1737,128,4144,190,36098,146,19520,17783,13503,12104
2021-08-18 12:30:00+00,11778,0,4200,9260,125,4150,1735,120,4307,0,35675,144,19627,17892,13692,11778
2021-08-18 13:00:00+00,11785,0,4205,9057,125,4208,1735,123,4257,0,35495,146,19379,17644,13439,11785
2021-08-18 13:30:00+00,12148,0,4228,8601,137,4204,1733,122,4053,0,35226,151,18752,17019,12791,12148
2021-08-18 14:00:00+00,12283,0,4238,8545,160,4280,1712,115,3756,0,35089,154,18411,16699,12461,12283
2021-08-18 14:30:00+00,12561,0,4281,8081,205,4276,1713,266,3551,0,34934,160,17831,16118,11837,12561
2021-08-18 15:00:00+00,12624,54,4317,7763,235,4240,1730,517,2948,0,34428,164,16993,15263,10946,12678
2021-08-18 15:30:00+00,13065,209,4318,7766,223,4238,1743,603,2549,134,34848,171,16599,14856,10538,13274
2021-08-18 16:00:00+00,13877,429,4329,7650,304,4580,1740,618,2174,130,35831,186,16197,14457,10128,14306
2021-08-18 16:30:00+00,14282,493,4337,7556,361,4588,1742,574,1813,126,35872,192,15809,14067,9730,14775
2021-08-18 17:00:00+00,14431,409,4351,7326,363,4782,1710,451,1361,550,35734,193,15111,13401,9050,14840
2021-08-18 17:30:00+00,14541,449,4364,7171,360,4784,1703,362,721,648,35103,198,14319,12616,8252,14990
2021-08-18 18:00:00+00,14663,500,4369,6885,400,4848,1709,267,323,440,34404,204,13686,11977,7608,15163
2021-08-18 18:30:00+00,14794,500,4373,6482,400,4848,1709,127,90,358,33681,209,13054,11345,6972,15294
2021-08-18 19:00:00+00,14740,501,4371,6009,368,4982,1708,227,2,400,33308,213,12458,10750,6379,15241
2021-08-18 19:30:00+00,14934,500,4369,5476,362,4982,1710,194,0,326,32853,218,11917,10207,5838,15434
2021-08-18 20:00:00+00,15035,442,4370,4721,326,5026,1706,219,0,302,32147,223,11123,9417,5047,15477
2021-08-18 20:30:00+00,14759,294,4372,4382,260,5028,1706,172,0,20,30993,223,10720,9014,4642,15053
2021-08-18 21:00:00+00,13730,233,4398,4313,137,5026,1647,117,0,0,29601,217,10495,8848,4450,13963
2021-08-18 21:30:00+00,12311,237,4401,4335,97,5026,1671,115,0,0,28193,208,10504,8833,4432,12548
2021-08-18 22:00:00+00,11363,234,4406,4369,115,4278,1705,113,0,0,26583,203,10595,8890,4484,11597
2021-08-18 22:30:00+00,10504,232,4405,4362,123,4264,1709,113,0,0,25712,197,10600,8890,4486,10736
2021-08-18 23:00:00+00,9764,283,4406,4331,107,4266,1703,114,0,0,24974,193,10547,8844,4438,10047
2021-08-18 23:30:00+00,9445,241,4406,4179,106,4266,1710,115,0,0,24468,190,10401,8691,4285,9686
2021-08-19 00:00:00+00,9352,231,4414,3900,106,4266,1705,113,0,0,24087,195,10125,8420,4006,9583
2021-08-19 00:30:00+00,9319,231,4412,3507,106,4266,1704,113,0,0,23658,198,9729,8025,3613,9550
2021-08-19 01:00:00+00,9351,235,4405,3162,106,4266,1710,120,0,0,23355,202,9383,7673,3268,9586
2021-08-19 01:30:00+00,9379,300,4405,2797,105,4266,1715,119,0,0,23086,207,9022,7307,2902,9679
2021-08-19 02:00:00+00,9570,278,4406,2519,81,4022,1720,121,0,0,22717,212,8726,7006,2600,9848
2021-08-19 02:30:00+00,9715,237,4408,2311,77,4042,1723,120,0,0,22633,214,8519,6796,2388,9952
2021-08-19 03:00:00+00,9854,236,4405,2118,76,4064,1729,118,0,0,22600,217,8328,6599,2194,10090
2021-08-19 03:30:00+00,10028,230,4408,2000,76,4070,1720,117,0,0,22649,219,8204,6484,2076,10258
2021-08-19 04:00:00+00,10169,229,4409,1967,76,4278,1726,120,0,0,22974,219,8178,6452,2043,10398
2021-08-19 04:30:00+00,10534,232,4411,1800,75,4350,1748,119,0,0,23269,224,8034,6286,1875,10766
2021-08-19 05:00:00+00,11566,235,4408,1648,75,4836,1655,118,10,0,24551,231,7796,6141,1733,11801
2021-08-19 05:30:00+00,13206,303,4406,1488,75,4788,1705,114,146,0,26231,243,7820,6115,1709,13509
2021-08-19 06:00:00+00,15307,464,4409,1373,75,4820,1562,124,375,68,28577,255,7794,6232,1823,15771
2021-08-19 06:30:00+00,16224,781,4411,1343,79,4824,1718,202,837,194,30613,261,8388,6670,2259,17005
2021-08-19 07:00:00+00,16704,984,4401,1173,164,4986,2009,227,1225,132,32005,265,8972,6963,2562,17688
2021-08-19 07:30:00+00,16767,992,4401,977,203,4988,2162,273,1896,602,33261,257,9639,7477,3076,17759
2021-08-19 08:00:00+00,16863,993,4150,928,245,5028,2251,299,2376,816,33949,254,9950,7699,3549,17856
2021-08-19 08:30:00+00,16667,991,3912,1000,252,5030,2303,361,2831,972,34319,250,10298,7995,4083,17658
2021-08-19 09:00:00+00,16846,990,3910,1177,215,5026,2237,401,3371,662,34835,248,10910,8673,4763,17836
2021-08-19 09:30:00+00,16908,989,3909,1045,214,5024,2234,350,3461,764,34898,248,10863,8629,4720,17897
2021-08-19 10:00:00+00,16648,992,3906,989,215,4990,2231,347,3731,666,34715,246,11072,8841,4935,17640
2021-08-19 10:30:00+00,16549,990,3905,969,234,4990,2233,363,4721,244,35198,242,12062,9829,5924,17539
2021-08-19 11:00:00+00,16342,987,3908,946,209,5028,2235,346,4547,548,35096,240,11845,9610,5702,17329
2021-08-19 11:30:00+00,16346,992,3907,1001,177,5026,2236,289,4423,940,35337,238,11744,9508,5601,17338
2021-08-19 12:00:00+00,16406,991,3908,981,147,5028,2235,241,4543,572,35052,241,11814,9579,5671,17397
2021-08-19 12:30:00+00,16435,992,3919,1045,110,5028,2235,206,4959,172,35101,240,12268,10033,6114,17427
2021-08-19 13:00:00+00,16290,992,3966,1133,126,5026,2235,193,4981,254,35196,238,12441,10206,6240,17282
2021-08-19 13:30:00+00,15960,861,4010,1202,195,5026,2234,227,4283,344,34342,237,11924,9690,5680,16821
2021-08-19 14:00:00+00,15935,746,4020,1282,204,5030,2234,243,4088,140,33922,236,11828,9594,5574,16681
2021-08-19 14:30:00+00,15860,738,4017,1404,232,5028,2236,246,3519,344,33624,237,11408,9172,5155,16598
2021-08-19 15:00:00+00,16330,734,4023,1496,454,5048,2238,361,3033,542,34259,239,11244,9006,4983,17064
2021-08-19 15:30:00+00,16753,737,4051,1586,499,5048,2239,395,2596,556,34460,243,10971,8732,4681,17490
2021-08-19 16:00:00+00,17330,645,4056,1566,501,5046,2349,443,1918,884,34738,247,10390,8041,3985,17975
2021-08-19 16:30:00+00,17680,495,4058,1576,454,5046,2385,463,1492,1194,34843,246,9965,7580,3522,18175
2021-08-19 17:00:00+00,17933,498,4067,1697,505,5048,2385,467,1081,1112,34793,250,9735,7350,3283,18431
2021-08-19 17:30:00+00,17978,494,4098,1569,510,5048,2384,442,847,986,34356,253,9408,7024,2926,18472
2021-08-19 18:00:00+00,17952,495,4097,1463,455,5048,2379,430,378,928,33625,258,8772,6393,2296,18447
2021-08-19 18:30:00+00,17478,496,4094,1322,493,5048,2375,457,117,1096,32976,258,8401,6026,1932,17974
2021-08-19 19:00:00+00,17445,501,4097,1449,456,5048,2375,442,2,646,32461,261,8379,6004,1907,17946
2021-08-19 19:30:00+00,17349,497,4095,1493,355,5044,2362,398,0,880,32473,260,8305,5943,1848,17846
2021-08-19 20:00:00+00,16914,502,4099,1441,306,5028,2320,288,0,422,31320,262,8166,5846,1747,17416
2021-08-19 20:30:00+00,16471,372,4098,1455,283,5028,2371,207,0,66,30351,260,8207,5836,1738,16843
2021-08-19 21:00:00+00,15501,299,4098,1484,194,5078,2323,154,0,0,29131,255,8099,5776,1678,15800
2021-08-19 21:30:00+00,14472,160,4095,1544,160,5024,2258,114,0,0,27827,246,8057,5799,1704,14632
2021-08-19 22:00:00+00,13518,0,4096,1571,186,4804,2320,115,0,0,26610,236,8173,5853,1757,13518
2021-08-19 22:30:00+00,12290,0,4094,1458,158,4790,2342,114,0,0,25246,230,8052,5710,1616,12290
2021-08-19 23:00:00+00,12010,0,4092,1294,101,4534,2306,114,0,0,24451,233,7793,5487,1395,12010
2021-08-19 23:30:00+00,11392,0,4099,1152,99,4590,2328,113,0,0,23773,230,7678,5350,1251,11392
2021-08-20 00:00:00+00,10846,0,4134,1071,99,4715,2344,113,0,0,23322,230,7648,5304,1170,10846
2021-08-20 00:30:00+00,10754,0,4144,995,99,4676,2342,113,0,0,23123,230,7580,5238,1094,10754
2021-08-20 01:00:00+00,10831,0,4143,919,99,4520,2338,119,0,0,22969,230,7499,5161,1018,10831
2021-08-20 01:30:00+00,10771,0,4144,788,98,4456,2341,120,0,0,22718,230,7371,5030,886,10771
2021-08-20 02:00:00+00,10564,0,4147,732,96,4512,2374,120,0,0,22545,230,7349,4975,828,10564
2021-08-20 02:30:00+00,10473,0,4146,706,95,4520,2376,118,0,0,22434,229,7323,4947,801,10473
2021-08-20 03:00:00+00,10429,0,4147,745,93,4540,2375,113,0,0,22442,229,7360,4985,838,10429
2021-08-20 03:30:00+00,10526,0,4178,723,92,4526,2375,113,0,0,22533,229,7368,4993,815,10526
2021-08-20 04:00:00+00,10529,0,4187,679,90,4672,2374,113,0,0,22644,231,7330,4956,769,10529
2021-08-20 04:30:00+00,10932,0,4187,712,89,4792,2375,112,0,0,23199,235,7363,4988,801,10932
2021-08-20 05:00:00+00,12414,0,4190,725,89,4942,2373,115,19,0,24867,241,7396,5023,833,12414
2021-08-20 05:30:00+00,13849,0,4191,727,89,4866,2373,113,164,0,26372,247,7544,5171,980,13849
2021-08-20 06:00:00+00,15377,0,4190,766,125,4950,2373,173,442,0,28396,250,7896,5523,1333,15377
2021-08-20 06:30:00+00,15816,0,4191,882,161,5142,2372,419,960,0,29943,249,8566,6194,2003,15816
2021-08-20 07:00:00+00,16126,0,4181,935,283,5664,2371,527,1514,142,31743,245,9284,6913,2732,16126
2021-08-20 07:30:00+00,16037,0,4180,987,331,5736,2370,648,2027,354,32670,240,9895,7525,3345,16037
2021-08-20 08:00:00+00,15938,0,4178,1085,341,5688,2374,522,2687,552,33365,231,10665,8291,4113,15938
2021-08-20 08:30:00+00,15746,0,4174,1173,376,5710,2373,351,3024,708,33635,226,11120,8747,4573,15746
2021-08-20 09:00:00+00,15786,0,4180,1282,399,5750,2371,578,3540,194,34080,226,11772,9401,5221,15786
2021-08-20 09:30:00+00,15779,0,4210,1323,365,5738,2374,541,3954,126,34410,223,12226,9852,5642,15779
2021-08-20 10:00:00+00,15803,0,4187,1449,348,5758,2371,458,4042,60,34476,222,12397,10026,5839,15803
2021-08-20 10:30:00+00,15743,0,4140,1620,328,5746,2369,429,3622,150,34147,224,12079,9710,5570,15743
2021-08-20 11:00:00+00,15768,0,4060,1734,278,5828,2372,495,3531,310,34376,224,11975,9603,5543,15768
2021-08-20 11:30:00+00,15718,0,4066,1850,263,5724,2370,505,3826,186,34508,222,12375,10005,5939,15718
2021-08-20 12:00:00+00,15678,0,4109,2026,192,5722,2370,288,3937,110,34432,220,12634,10264,6155,15678
2021-08-20 12:30:00+00,15556,0,4129,2178,155,5604,2369,285,3341,140,33757,220,12172,9803,5674,15556
2021-08-20 13:00:00+00,15517,0,4141,2333,145,5410,2358,392,2945,72,33313,221,11922,9564,5423,15517
2021-08-20 13:30:00+00,15470,0,4188,2532,191,5294,2359,401,2477,72,32984,221,11747,9388,5200,15470
2021-08-20 14:00:00+00,15429,0,4220,2817,242,5214,2345,395,2271,48,32981,221,11895,9550,5330,15429
2021-08-20 14:30:00+00,15437,0,4228,2903,266,5200,2322,387,2265,74,33082,221,11984,9662,5434,15437
2021-08-20 15:00:00+00,15358,0,4232,3008,305,5262,2326,460,2032,134,33117,221,11903,9577,5345,15358
2021-08-20 15:30:00+00,15807,0,4232,3110,347,5372,2326,482,1576,226,33478,225,11591,9265,5033,15807
2021-08-20 16:00:00+00,15965,0,4240,3147,426,5162,2363,502,1264,736,33805,223,11440,9077,4837,15965
2021-08-20 16:30:00+00,16218,0,4238,3276,426,5136,2326,429,1057,892,33998,223,11323,8997,4759,16218
2021-08-20 17:00:00+00,16149,0,4251,3395,440,5096,2324,332,852,994,33833,223,11262,8938,4687,16149
2021-08-20 17:30:00+00,16210,0,4250,3526,436,5064,2319,205,555,726,33291,226,11086,8767,4517,16210
2021-08-20 18:00:00+00,16400,0,4248,3646,419,4906,2319,158,241,494,32831,230,10873,8554,4306,16400
2021-08-20 18:30:00+00,16298,0,4252,3849,354,4776,2324,169,48,266,32336,231,10827,8503,4251,16298
2021-08-20 19:00:00+00,16210,0,4250,4227,244,4844,2340,149,0,164,32428,229,11061,8721,4471,16210
2021-08-20 19:30:00+00,16060,0,4250,4293,205,4844,2362,137,0,138,32289,228,11110,8748,4498,16060
2021-08-20 20:00:00+00,15131,0,4253,4512,189,5004,2270,145,0,120,31624,222,11224,8954,4701,15131
2021-08-20 20:30:00+00,14003,0,4254,4590,185,5002,2240,114,0,0,30388,216,11269,9029,4775,14003
2021-08-20 21:00:00+00,13199,0,4258,4667,137,4754,2172,114,0,18,29319,211,11234,9062,4804,13199
2021-08-20 21:30:00+00,11927,0,4262,4809,131,4734,2032,113,0,0,28008,202,11234,9202,4940,11927
2021-08-20 22:00:00+00,10722,0,4262,4958,131,3790,2223,113,0,0,26199,194,11574,9351,5089,10722
2021-08-20 22:30:00+00,9524,0,4263,4914,126,3826,2095,113,0,0,24861,186,11398,9303,5040,9524
2021-08-20 23:00:00+00,8830,0,4265,4676,75,3790,2047,113,0,0,23796,181,11063,9016,4751,8830
2021-08-20 23:30:00+00,8369,0,4265,4443,75,3774,2134,115,0,0,23175,179,10917,8783,4518,8369
2021-08-21 00:00:00+00,8029,0,4265,4479,74,3776,2046,115,0,0,22784,175,10864,8818,4553,8029
2021-08-21 00:30:00+00,7816,0,4266,4441,74,3776,2036,115,0,0,22524,174,10817,8781,4515,7816
2021-08-21 01:00:00+00,7708,0,4265,4327,73,3780,2043,120,0,0,22316,174,10708,8665,4400,7708
2021-08-21 01:30:00+00,7714,0,4266,4107,72,3808,2098,120,0,0,22185,176,10543,8445,4179,7714
2021-08-21 02:00:00+00,7580,0,4267,3973,71,3784,2129,119,0,0,21923,175,10440,8311,4044,7580
2021-08-21 02:30:00+00,7322,0,4268,3986,71,3768,2149,119,0,0,21683,172,10474,8325,4057,7322
2021-08-21 03:00:00+00,7372,0,4266,3899,71,3768,2165,117,0,0,21658,173,10401,8236,3970,7372
2021-08-21 03:30:00+00,7382,0,4266,3965,71,3770,2160,117,0,0,21731,173,10462,8302,4036,7382
2021-08-21 04:00:00+00,7504,0,4263,3934,71,3842,2169,117,0,0,21900,175,10437,8268,4005,7504
2021-08-21 04:30:00+00,7561,0,4268,3840,71,3934,2173,117,0,0,21964,178,10352,8179,3911,7561
2021-08-21 05:00:00+00,7919,0,4269,3727,69,4070,2069,114,5,0,22242,184,10139,8070,3801,7919
2021-08-21 05:30:00+00,8702,0,4276,3508,67,4044,2044,114,33,0,22788,193,9928,7884,3608,8702
2021-08-21 06:00:00+00,9533,0,4271,3404,67,4394,2220,114,126,0,24129,196,10088,7868,3597,9533
2021-08-21 06:30:00+00,10743,0,4268,3349,67,4360,2242,116,316,12,25473,204,10242,8000,3732,10743
2021-08-21 07:00:00+00,12079,0,4271,3054,81,4744,2241,126,516,28,27140,212,10163,7922,3651,12079
2021-08-21 07:30:00+00,13016,0,4269,2681,120,4756,2195,215,698,110,28060,219,9963,7768,3499,13016
2021-08-21 08:00:00+00,13683,0,4269,2583,203,5026,1668,468,1023,42,28965,223,9746,8078,3809,13683
2021-08-21 08:30:00+00,14376,0,4269,2570,210,5028,1426,625,1293,84,29881,226,9768,8342,4073,14376
2021-08-21 09:00:00+00,14496,0,4263,2534,291,5026,1318,462,1455,844,30689,220,9861,8543,4280,14496
2021-08-21 09:30:00+00,15025,0,4267,2289,291,5026,1217,478,1876,646,31115,223,9940,8723,4456,15025
2021-08-21 10:00:00+00,15093,0,4262,1990,308,5028,1409,517,2058,290,30955,227,10027,8618,4356,15093
2021-08-21 10:30:00+00,15061,0,4263,1935,305,5026,1435,479,2316,286,31106,225,10254,8819,4556,15061
2021-08-21 11:00:00+00,15120,0,4268,1964,241,5030,1440,328,2809,670,31870,219,10722,9282,5014,15120
2021-08-21 11:30:00+00,15241,0,4265,1954,240,5028,1418,311,2570,394,31421,223,10447,9029,4764,15241
2021-08-21 12:00:00+00,15140,0,4268,2008,180,5026,1417,367,2428,2,30836,227,10301,8884,4616,15140
2021-08-21 12:30:00+00,15170,0,4274,2125,137,5028,1383,161,2411,0,30689,226,10330,8947,4673,15170
2021-08-21 13:00:00+00,15066,0,4273,1989,125,5026,1424,128,2525,186,30742,224,10336,8912,4639,15066
2021-08-21 13:30:00+00,14820,0,4276,2073,125,5024,1424,139,2508,0,30389,224,10406,8982,4706,14820
2021-08-21 14:00:00+00,14730,0,4273,2119,177,4774,1427,133,2122,0,29755,226,10118,8691,4418,14730
2021-08-21 14:30:00+00,14793,0,4272,2077,178,4770,1428,152,2008,0,29678,228,9963,8535,4263,14793
2021-08-21 15:00:00+00,14659,0,4270,2263,222,4824,1348,180,1906,508,30180,223,10009,8661,4391,14659
2021-08-21 15:30:00+00,14622,0,4274,2580,238,4840,1555,185,1688,822,30804,219,10335,8780,4506,14622
2021-08-21 16:00:00+00,14571,0,4271,2524,341,5154,1995,172,1408,910,31346,218,10539,8544,4273,14571
2021-08-21 16:30:00+00,15018,0,4267,2160,343,5168,2067,467,1167,816,31473,226,10004,7937,3670,15018
2021-08-21 17:00:00+00,15056,0,4270,2030,323,5256,2079,628,916,584,31142,231,9618,7539,3269,15056
2021-08-21 17:30:00+00,15063,0,4264,1988,275,5278,2078,628,563,632,30769,235,9168,7090,2826,15063
2021-08-21 18:00:00+00,14764,0,4265,1780,261,5318,2082,448,271,650,29839,237,8659,6577,2312,14764
2021-08-21 18:30:00+00,14814,0,4262,1433,239,5248,2089,437,71,694,29287,241,8094,6005,1743,14814
2021-08-21 19:00:00+00,15006,0,4267,1369,191,5384,2090,255,0,636,29198,244,7917,5827,1560,15006
2021-08-21 19:30:00+00,15148,0,4267,1428,180,5300,2089,404,0,426,29242,246,7964,5875,1608,15148
2021-08-21 20:00:00+00,14942,0,4270,1473,183,5130,2085,484,0,86,28653,247,8011,5926,1656,14942
2021-08-21 20:30:00+00,14765,0,4267,1455,175,5040,2084,189,0,44,28019,245,7981,5897,1630,14765
2021-08-21 21:00:00+00,14229,0,4274,1424,110,4796,2086,115,0,0,27034,244,7894,5808,1534,14229
2021-08-21 21:30:00+00,13083,0,4270,1532,106,4766,2082,115,0,0,25954,237,7990,5908,1638,13083
2021-08-21 22:00:00+00,12352,0,4274,1563,72,4272,2085,113,0,0,24731,235,7994,5909,1635,12352
2021-08-21 22:30:00+00,11198,0,4268,1490,72,4364,2062,115,0,0,23569,229,7892,5830,1562,11198
2021-08-21 23:00:00+00,10528,0,4269,1405,72,4170,2006,115,0,0,22565,226,7752,5746,1477,10528
2021-08-21 23:30:00+00,9948,0,4272,1348,72,4186,1966,114,0,0,21906,223,7658,5692,1420,9948
2021-08-22 00:00:00+00,9743,0,4270,1296,73,4182,1970,116,0,0,21650,216,7609,5639,1369,9743
2021-08-22 00:30:00+00,9540,0,4273,1297,73,4204,2011,115,0,0,21513,214,7654,5643,1370,9540
2021-08-22 01:00:00+00,9428,0,4272,1443,73,4100,2009,117,0,0,21442,211,7797,5788,1516,9428
2021-08-22 01:30:00+00,9219,0,4272,1548,74,4114,1984,117,0,0,21328,208,7878,5894,1622,9219
2021-08-22 02:00:00+00,8972,0,4272,1535,74,4086,1986,118,0,0,21043,206,7867,5881,1609,8972
2021-08-22 02:30:00+00,8813,0,4274,1537,73,4076,2007,120,0,0,20900,204,7891,5884,1610,8813
2021-08-22 03:00:00+00,9392,0,4271,1446,72,3998,1949,118,0,0,21246,210,7738,5789,1518,9392
2021-08-22 03:30:00+00,9317,0,4276,1456,72,3980,1929,116,0,0,21146,209,7733,5804,1528,9317
2021-08-22 04:00:00+00,9279,0,4269,1383,88,3972,2012,117,0,0,21120,210,7752,5740,1471,9279
2021-08-22 04:30:00+00,9172,0,4272,1423,87,3890,2078,247,0,0,21169,208,7860,5782,1510,9172
2021-08-22 05:00:00+00,9216,0,4265,1534,87,4076,2063,275,5,0,21521,208,7954,5891,1626,9216
2021-08-22 05:30:00+00,9477,0,4265,1742,86,3974,2084,279,132,0,22039,206,8309,6225,1960,9477
2021-08-22 06:00:00+00,9920,0,4263,1784,84,3932,2086,241,481,0,22791,205,8698,6612,2349,9920
2021-08-22 06:30:00+00,10510,0,4265,1765,84,3922,2084,253,878,0,23761,207,9076,6992,2727,10510
2021-08-22 07:00:00+00,10892,0,4282,1702,182,4260,2088,296,1340,0,25042,204,9594,7506,3224,10892
2021-08-22 07:30:00+00,11285,0,4284,1967,185,4266,2082,388,1758,110,26325,201,10276,8194,3910,11285
2021-08-22 08:00:00+00,11884,0,4292,2426,210,4506,2074,239,2093,74,27798,198,11095,9021,4729,11884
2021-08-22 08:30:00+00,12661,0,4315,2457,172,4510,1884,139,2469,118,28725,201,11297,9413,5098,12661
2021-08-22 09:00:00+00,12883,0,4331,2338,173,4748,1844,290,3134,24,29765,199,11820,9976,5645,12883
2021-08-22 09:30:00+00,12898,0,4348,2193,224,4752,1859,409,3525,20,30228,197,12149,10290,5942,12898
2021-08-22 10:00:00+00,12937,0,4371,2092,294,4738,1889,436,3908,126,30791,195,12554,10665,6294,12937
2021-08-22 10:30:00+00,12975,0,4383,1943,294,4740,1901,349,4094,160,30839,194,12615,10714,6331,12975
2021-08-22 11:00:00+00,12991,0,4416,1965,275,4740,1920,303,4418,138,31166,192,12994,11074,6658,12991
2021-08-22 11:30:00+00,13071,0,4442,2082,272,4740,1920,218,5164,282,32191,186,13880,11960,7518,13071
2021-08-22 12:00:00+00,13078,0,4475,2131,140,4960,1921,143,5058,156,32062,187,13725,11804,7329,13078
2021-08-22 12:30:00+00,12826,0,4502,2155,139,4964,1928,120,5020,108,31762,186,13744,11816,7314,12826
2021-08-22 13:00:00+00,12650,0,4535,2295,155,5024,1939,114,5067,44,31823,183,13991,12052,7517,12650
2021-08-22 13:30:00+00,12356,0,4565,2343,155,5026,1943,116,5084,0,31588,181,14090,12147,7582,12356
2021-08-22 14:00:00+00,12583,0,4599,2293,155,5028,1952,116,5194,0,31920,182,14193,12241,7642,12583
2021-08-22 14:30:00+00,12967,0,4629,2210,162,5026,1846,117,5020,0,31977,186,13867,12021,7392,12967
2021-08-22 15:00:00+00,13851,0,4659,2217,188,5044,1555,125,4362,104,32105,195,12981,11426,6767,13851
2021-08-22 15:30:00+00,14351,0,4690,2165,201,5046,1555,197,3484,138,31827,204,12095,10540,5850,14351
2021-08-22 16:00:00+00,14741,0,4718,2130,290,5048,1557,404,2857,140,31885,210,11552,9995,5277,14741
2021-08-22 16:30:00+00,14810,0,4747,2277,359,5046,1558,347,2337,510,31991,210,11278,9720,4973,14810
2021-08-22 17:00:00+00,14980,0,4777,2271,360,5046,1557,234,1553,750,31528,214,10518,8961,4184,14980
2021-08-22 17:30:00+00,14951,0,4793,2300,362,5048,1559,211,898,758,30880,218,9912,8353,3560,14951
2021-08-22 18:00:00+00,14968,0,4796,2270,345,5048,1556,209,395,748,30335,222,9362,7806,3010,14968
2021-08-22 18:30:00+00,14945,0,4793,2258,342,5048,1557,200,102,752,29997,224,9052,7495,2702,14945
2021-08-22 19:00:00+00,14958,0,4788,2458,199,5048,1560,186,0,584,29781,226,9005,7445,2657,14958
2021-08-22 19:30:00+00,14950,0,4786,2777,162,5048,1558,161,0,548,29990,224,9283,7725,2939,14950
2021-08-22 20:00:00+00,14851,0,4787,2797,158,5026,1559,158,0,128,29464,226,9301,7742,2955,14851
2021-08-22 20:30:00+00,14172,0,4785,2702,150,5024,1559,122,0,6,28520,224,9196,7637,2852,14172
2021-08-22 21:00:00+00,13686,0,4791,2736,96,4876,1488,116,0,0,27789,222,9111,7623,2832,13686
2021-08-22 21:30:00+00,12665,0,4787,2670,86,4866,1445,116,0,0,26635,216,8988,7543,2756,12665
2021-08-22 22:00:00+00,11705,0,4788,2622,86,4148,1468,115,0,44,24976,212,8964,7496,2708,11705
2021-08-22 22:30:00+00,10297,0,4791,2658,86,4138,1461,112,0,0,23543,201,8996,7535,2744,10297
2021-08-22 23:00:00+00,9550,0,4790,2618,71,4020,1415,113,0,0,22577,196,8894,7479,2689,9550
2021-08-22 23:30:00+00,9276,0,4792,2621,71,4020,1357,113,0,0,22250,194,8841,7484,2692,9276
2021-08-23 00:00:00+00,9340,0,4791,2571,71,4018,1385,114,0,0,22290,194,8818,7433,2642,9340
2021-08-23 00:30:00+00,9278,0,4793,2572,71,4016,1380,113,0,0,22223,193,8816,7436,2643,9278
2021-08-23 01:00:00+00,8862,0,4808,2605,71,4016,1454,119,0,0,21935,189,8938,7484,2676,8862
2021-08-23 01:30:00+00,8632,0,4832,2625,71,4018,1472,119,0,0,21769,186,9000,7528,2696,8632
2021-08-23 02:00:00+00,8157,0,4851,2728,71,4018,1523,119,0,0,21467,180,9173,7650,2799,8157
2021-08-23 02:30:00+00,8174,0,4853,2799,71,4016,1563,120,0,0,21596,180,9286,7723,2870,8174
2021-08-23 03:00:00+00,8266,0,4859,2807,69,4010,1565,117,0,0,21693,181,9300,7735,2876,8266
2021-08-23 03:30:00+00,8448,0,4860,2814,68,4010,1561,117,0,0,21878,182,9303,7742,2882,8448
2021-08-23 04:00:00+00,9106,0,4855,2781,68,4016,1455,117,0,0,22398,189,9159,7704,2849,9106
2021-08-23 04:30:00+00,9651,10,4861,2859,67,4016,1384,113,0,0,22961,194,9171,7787,2926,9661
2021-08-23 05:00:00+00,10406,33,4854,2881,67,4122,1502,114,9,0,23988,200,9313,7811,2957,10439
2021-08-23 05:30:00+00,11843,96,4855,2876,67,4124,1561,117,215,56,25810,210,9574,8013,3158,11939
2021-08-23 06:00:00+00,13651,241,4853,2855,80,4610,1523,125,588,54,28580,220,9899,8376,3523,13892
2021-08-23 06:30:00+00,14726,387,4856,2785,87,4620,1495,292,1114,56,30418,227,10337,8842,3986,15113
2021-08-23 07:00:00+00,15309,495,4853,2611,241,5018,1559,503,1627,214,32430,228,10891,9332,4479,15804
2021-08-23 07:30:00+00,15396,499,4857,2548,258,5028,1543,672,1986,314,33101,226,11192,9649,4792,15895
2021-08-23 08:00:00+00,15728,496,4855,2606,270,5026,1532,668,2492,390,34063,223,11755,10223,5368,16224
2021-08-23 08:30:00+00,15937,499,4859,2564,268,5026,1572,592,3067,314,34698,221,12330,10758,5899,16436
2021-08-23 09:00:00+00,15959,499,4847,2575,245,5024,1571,546,3398,140,34804,220,12636,11065,6218,16458
2021-08-23 09:30:00+00,16080,500,4836,3126,255,5024,1566,590,3912,46,35935,215,13695,12129,7293,16580
2021-08-23 10:00:00+00,16033,500,4834,2655,237,5026,1568,566,4262,120,35801,215,13556,11988,7154,16533
2021-08-23 10:30:00+00,15982,498,4768,2789,237,5026,1567,556,4600,42,36065,213,13961,12394,7626,16480
2021-08-23 11:00:00+00,15980,496,4718,2840,267,5026,1566,553,4914,138,36498,210,14305,12739,8021,16476
2021-08-23 11:30:00+00,15800,497,4721,2772,275,5026,1567,547,5331,0,36536,208,14666,13099,8378,16297
2021-08-23 12:00:00+00,15827,497,4722,2657,157,5026,1565,451,5657,94,36653,207,14758,13193,8471,16324
2021-08-23 12:30:00+00,15671,497,4725,2666,131,5028,1563,308,6029,0,36618,204,15114,13551,8826,16168
2021-08-23 13:00:00+00,15231,496,4722,2707,131,5028,1560,134,6135,0,36144,201,15255,13695,8973,15727
2021-08-23 13:30:00+00,14725,496,4721,2883,116,5028,1536,115,6189,24,35833,197,15445,13909,9188,15221
2021-08-23 14:00:00+00,14543,448,4715,2941,85,5026,1533,121,5797,0,35209,197,15071,13538,8823,14991
2021-08-23 14:30:00+00,14512,440,4719,3079,93,5026,1535,121,5452,0,34977,197,14878,13343,8624,14952
2021-08-23 15:00:00+00,14504,448,4718,3202,170,5046,1531,158,4898,0,34675,200,14519,12988,8270,14952
2021-08-23 15:30:00+00,15203,454,4729,3225,201,5046,1487,278,4205,16,34844,208,13847,12360,7631,15657
2021-08-23 16:00:00+00,15739,460,4721,3190,280,5044,1475,387,3560,520,35376,212,13226,11751,7030,16199
2021-08-23 16:30:00+00,16022,483,4720,3189,453,5048,1466,639,2772,730,35522,216,12600,11134,6414,16505
2021-08-23 17:00:00+00,16319,494,4724,3143,567,5046,1476,636,1961,748,35114,223,11871,10395,5671,16813
2021-08-23 17:30:00+00,16422,497,4718,3324,567,5046,1487,618,1194,758,34631,227,11290,9803,5085,16919
2021-08-23 18:00:00+00,16335,495,4722,3344,566,5046,1490,594,487,752,33831,231,10609,9119,4397,16830
2021-08-23 18:30:00+00,16155,497,4718,3302,499,5048,1495,555,93,782,33144,233,10107,8612,3894,16652
2021-08-23 19:00:00+00,16271,499,4715,3394,345,5048,1500,441,0,946,33159,234,9954,8454,3739,16770
2021-08-23 19:30:00+00,16326,496,4713,3582,304,5048,1501,476,0,418,32864,237,10100,8599,3886,16822
2021-08-23 20:00:00+00,16087,480,4718,3760,224,5026,1503,432,0,36,32266,237,10205,8702,3984,16567
2021-08-23 20:30:00+00,15022,419,4718,3722,193,5028,1488,228,0,0,30818,231,10121,8633,3915,15441
2021-08-23 21:00:00+00,13951,277,4720,3734,95,5024,1453,118,0,12,29384,222,10002,8549,3829,14228
2021-08-23 21:30:00+00,13082,0,4718,3700,76,5020,1410,145,0,0,28151,210,9904,8494,3776,13082
2021-08-23 22:00:00+00,12054,0,4660,3821,75,4516,1401,269,0,0,26796,205,9957,8556,3896,12054
2021-08-23 22:30:00+00,10562,0,4627,3818,75,4504,1396,146,0,0,25128,194,9916,8520,3893,10562
2021-08-23 23:00:00+00,10054,0,4614,3670,75,4266,1321,112,0,0,24112,192,9680,8360,3746,10054
2021-08-23 23:30:00+00,9794,0,4634,3604,75,4260,1297,113,0,0,23777,190,9610,8313,3679,9794
2021-08-24 00:00:00+00,9732,0,4638,3568,57,4140,1316,112,0,0,23563,192,9579,8263,3625,9732
2021-08-24 00:30:00+00,9694,0,4642,3381,56,4148,1322,113,0,0,23356,193,9401,8079,3437,9694
2021-08-24 01:00:00+00,9542,0,4663,3342,55,4151,1364,120,0,0,23237,192,9424,8060,3397,9542
2021-08-24 01:30:00+00,9428,0,4670,3167,53,4157,1403,119,0,0,22997,192,9293,7890,3220,9428
2021-08-24 02:00:00+00,9310,0,4677,3099,53,4164,1407,121,0,0,22832,192,9236,7829,3152,9310
2021-08-24 02:30:00+00,9212,0,4685,2997,51,4170,1459,120,0,0,22694,192,9192,7733,3048,9212
2021-08-24 03:00:00+00,9197,0,4697,3014,51,4178,1464,115,0,0,22716,191,9226,7762,3065,9197
2021-08-24 03:30:00+00,9241,0,4703,3048,51,4181,1459,115,0,0,22798,191,9261,7802,3099,9241
2021-08-24 04:00:00+00,9571,0,4713,3004,48,4187,1470,115,0,0,23108,195,9235,7765,3052,9571
2021-08-24 04:30:00+00,10310,0,4724,2889,56,4200,1465,115,0,0,23760,202,9134,7669,2945,10310
2021-08-24 05:00:00+00,10950,9,4736,2916,67,4866,1465,115,15,0,25139,205,9199,7734,2998,10959
2021-08-24 05:30:00+00,12317,33,4748,2911,62,4846,1469,114,227,0,26727,213,9417,7948,3200,12350
2021-08-24 06:00:00+00,13641,226,4759,2885,78,4804,1338,153,638,124,28646,221,9698,8360,3601,13867
2021-08-24 06:30:00+00,14228,630,4777,2768,98,4805,1426,413,1301,138,30584,229,10370,8944,4167,14858
2021-08-24 07:00:00+00,14559,894,4784,2701,204,5159,1470,451,2102,152,32476,231,11261,9791,5007,15453
2021-08-24 07:30:00+00,14775,991,4797,2709,326,5176,1472,471,2682,136,33536,229,11986,10514,5717,15766
2021-08-24 08:00:00+00,14821,994,4792,2671,379,5172,1470,446,3166,142,34053,226,12478,11008,6216,15815
2021-08-24 08:30:00+00,14949,995,4708,2490,376,5172,1471,377,3719,168,34425,224,12764,11293,6585,15944
2021-08-24 09:00:00+00,14782,997,4686,2433,356,5171,1469,480,4163,194,34731,221,13107,11638,6952,15779
2021-08-24 09:30:00+00,14619,996,4681,2433,351,5171,1468,311,4764,150,34943,217,13697,12229,7548,15615
2021-08-24 10:00:00+00,14393,994,4678,2428,236,5172,1467,434,5528,194,35525,212,14337,12870,8192,15387
2021-08-24 10:30:00+00,14384,993,4679,2297,177,5172,1468,448,6258,146,36022,209,14879,13411,8732,15377
2021-08-24 11:00:00+00,14443,984,4675,2285,140,5062,1467,417,6465,180,36118,208,15032,13565,8890,15427
2021-08-24 11:30:00+00,14397,987,4714,2278,125,5031,1466,420,6481,156,36056,208,15064,13598,8884,15384
2021-08-24 12:00:00+00,14144,997,4804,2228,102,5033,1467,454,6638,290,36157,206,15239,13772,8968,15141
2021-08-24 12:30:00+00,13956,995,4880,2189,101,5034,1464,445,6303,212,35580,207,14937,13473,8593,14951
2021-08-24 13:00:00+00,13866,997,4895,2219,131,5032,1456,356,6003,152,35107,208,14704,13248,8353,14863
2021-08-24 13:30:00+00,13970,996,4896,2227,129,5032,1450,331,5774,222,35027,209,14476,13026,8130,14966
2021-08-24 14:00:00+00,13944,923,4898,2444,142,5031,1450,318,5624,226,35000,207,14558,13108,8210,14867
2021-08-24 14:30:00+00,14110,914,4898,2617,178,5031,1460,169,5301,224,34902,208,14454,12994,8096,15024
2021-08-24 15:00:00+00,14505,926,4900,2833,237,4852,1459,143,4668,130,34654,214,14097,12638,7738,15431
2021-08-24 15:30:00+00,15144,894,4899,3095,269,4852,1461,320,3956,56,34946,220,13680,12219,7320,16038
2021-08-24 16:00:00+00,14893,906,4904,3355,592,5046,1492,433,3228,454,35303,216,13571,12079,7175,15799
2021-08-24 16:30:00+00,15078,964,4903,3461,578,5049,1525,529,2566,670,35323,221,13033,11508,6605,16042
2021-08-24 17:00:00+00,15262,988,4906,3578,592,5047,1546,648,1825,648,35039,227,12447,10901,5995,16250
2021-08-24 17:30:00+00,15346,960,4909,3638,599,5048,1618,615,1152,596,34482,231,11916,10298,5389,16306
2021-08-24 18:00:00+00,15057,933,4920,3553,571,5074,1842,583,466,678,33677,233,11352,9510,4590,15990
2021-08-24 18:30:00+00,15079,954,4927,3566,471,5046,1974,525,83,516,33141,237,11021,9047,4120,16033
2021-08-24 19:00:00+00,15426,881,4941,3507,467,4966,1976,423,0,354,32941,238,10891,8915,3974,16307
2021-08-24 19:30:00+00,15768,798,4950,3446,422,4938,1962,283,0,214,32781,239,10780,8818,3868,16566
2021-08-24 20:00:00+00,14905,751,4932,3487,320,5156,1921,223,0,236,31931,236,10660,8739,3807,15656
2021-08-24 20:30:00+00,14089,765,4862,3396,293,5062,1914,127,0,0,30508,235,10465,8551,3689,14854
2021-08-24 21:00:00+00,13567,406,4797,3308,127,5028,1842,115,0,0,29190,226,10074,8232,3435,13973
2021-08-24 21:30:00+00,12513,242,4788,3042,121,5014,1861,114,0,0,27695,218,9812,7951,3163,12755
2021-08-24 22:00:00+00,11642,303,4803,2789,114,4274,1917,117,0,0,25959,218,9623,7706,2903,11945
2021-08-24 22:30:00+00,10724,21,4818,2493,96,4303,1914,116,0,0,24485,206,9321,7407,2589,10745
2021-08-24 23:00:00+00,10018,0,4835,2238,80,4342,1875,113,0,0,23501,202,9028,7153,2318,10018
2021-08-24 23:30:00+00,9631,0,4851,2116,79,4320,1851,113,0,0,22961,200,8897,7046,2195,9631
2021-08-25 00:00:00+00,9553,0,4923,2004,79,4410,1839,112,0,0,22920,201,8845,7006,2083,9553
2021-08-25 00:30:00+00,9578,0,5007,1952,79,4446,1935,113,0,0,23110,201,8973,7038,2031,9578
2021-08-25 01:00:00+00,9284,0,5026,1938,78,4314,1966,119,0,0,22725,197,9008,7042,2016,9284
2021-08-25 01:30:00+00,9208,0,5039,2002,75,4266,1959,117,0,0,22666,195,9075,7116,2077,9208
2021-08-25 02:00:00+00,9087,0,5021,1969,120,4266,1951,118,0,0,22532,194,9061,7110,2089,9087
2021-08-25 02:30:00+00,9023,0,4952,1923,134,4266,1955,118,0,0,22371,195,8964,7009,2057,9023
2021-08-25 03:00:00+00,9166,0,4947,1845,133,4264,1961,115,0,0,22431,197,8886,6925,1978,9166
2021-08-25 03:30:00+00,9128,38,4962,1816,133,4266,1966,114,0,0,22423,198,8877,6911,1949,9166
2021-08-25 04:00:00+00,9326,76,5024,1909,133,4264,1981,114,0,0,22827,199,9047,7066,2042,9402
2021-08-25 04:30:00+00,9474,114,5122,1887,132,4342,1962,114,0,0,23147,202,9103,7141,2019,9588
2021-08-25 05:00:00+00,10275,152,5209,1826,76,4956,1899,114,6,0,24513,210,9016,7117,1908,10427
2021-08-25 05:30:00+00,11780,338,5230,1759,84,4854,1840,114,152,0,26151,224,9065,7225,1995,12118
2021-08-25 06:00:00+00,13250,402,5250,1889,107,5026,1920,124,474,0,28442,228,9640,7720,2470,13652
2021-08-25 06:30:00+00,14449,500,5249,1967,151,5026,1907,127,993,38,30407,232,10267,8360,3111,14949
2021-08-25 07:00:00+00,15057,499,5252,2012,314,5040,1889,294,1562,300,32219,228,11029,9140,3888,15556
2021-08-25 07:30:00+00,15112,501,5254,1964,316,5044,1881,396,2108,436,33012,224,11523,9642,4388,15613
2021-08-25 08:00:00+00,15111,497,5254,1988,326,5028,1869,429,2431,588,33521,221,11868,9999,4745,15608
2021-08-25 08:30:00+00,15094,500,5255,2009,378,5026,1796,435,2752,466,33711,219,12190,10394,5139,15594
2021-08-25 09:00:00+00,14984,499,5249,2144,360,5028,1778,433,3068,260,33803,217,12599,10821,5572,15483
2021-08-25 09:30:00+00,15113,500,5239,2214,344,5028,1784,433,3485,106,34246,216,13066,11282,6043,15613
2021-08-25 10:00:00+00,15082,500,5246,2088,258,5042,1770,433,3955,282,34656,213,13317,11547,6301,15582
2021-08-25 10:30:00+00,15237,500,5252,1881,240,5046,1792,439,4421,58,34866,214,13586,11794,6542,15737
2021-08-25 11:00:00+00,15112,500,5262,1960,238,5030,1770,432,4921,0,35225,210,14151,12381,7119,15612
2021-08-25 11:30:00+00,14972,500,5226,2140,239,5028,1780,443,5097,4,35429,207,14482,12702,7476,15472
2021-08-25 12:00:00+00,14834,500,5207,2354,89,5028,1770,432,5575,0,35789,204,14995,13225,8018,15334
2021-08-25 12:30:00+00,14527,422,5203,2485,88,5028,1767,202,5718,0,35440,198,15261,13494,8291,14949
2021-08-25 13:00:00+00,14296,404,5175,2684,88,4884,1774,114,5586,66,35071,194,15307,13533,8358,14700
2021-08-25 13:30:00+00,14260,316,5104,2976,89,4882,1753,115,5336,0,34832,193,15258,13506,8402,14576
2021-08-25 14:00:00+00,14100,230,5132,3265,104,4878,1762,114,4892,0,34477,191,15155,13393,8261,14330
2021-08-25 14:30:00+00,14065,234,5182,3667,110,4874,1779,116,4362,46,34435,191,15100,13321,8139,14299
2021-08-25 15:00:00+00,14181,230,5227,4160,154,4752,1768,125,3771,0,34368,190,15080,13312,8085,14411
2021-08-25 15:30:00+00,14524,231,5252,4484,284,4750,1786,144,3238,0,34693,193,15044,13258,8006,14755
2021-08-25 16:00:00+00,14836,236,5260,4583,400,4748,1836,190,2559,350,34998,195,14638,12802,7542,15072
2021-08-25 16:30:00+00,14702,300,5262,4823,455,4750,2009,422,1976,270,34969,198,14525,12516,7254,15002
2021-08-25 17:00:00+00,14601,264,5263,5110,473,4700,2106,325,1324,444,34610,197,14276,12170,6907,14865
2021-08-25 17:30:00+00,14904,132,5263,5462,465,4702,2108,327,741,504,34608,197,14039,11931,6668,15036
2021-08-25 18:00:00+00,14788,0,5263,5789,353,4898,2099,385,300,332,34207,197,13804,11705,6442,14788
2021-08-25 18:30:00+00,14661,0,5267,5897,316,4902,2101,295,51,148,33638,199,13632,11531,6264,14661
2021-08-25 19:00:00+00,14688,0,5264,6062,210,4948,2056,119,0,168,33515,199,13592,11536,6272,14688
2021-08-25 19:30:00+00,14698,0,5261,6143,166,4948,2030,126,0,200,33572,198,13600,11570,6309,14698
2021-08-25 20:00:00+00,14243,0,5258,6195,116,4952,1863,129,0,8,32764,197,13432,11569,6311,14243
2021-08-25 20:30:00+00,12928,0,5253,6000,117,4940,1894,117,0,0,31249,190,13264,11370,6117,12928
2021-08-25 21:00:00+00,11716,0,5259,6077,110,4242,2095,114,0,0,29613,181,13541,11446,6187,11716
2021-08-25 21:30:00+00,9966,0,5262,6274,109,4216,2104,114,0,0,28045,167,13749,11645,6383,9966
2021-08-25 22:00:00+00,9039,0,5267,6396,110,3446,2001,114,0,0,26373,162,13774,11773,6506,9039
2021-08-25 22:30:00+00,7540,0,5265,6395,110,3430,1914,116,0,0,24770,148,13684,11770,6505,7540
2021-08-25 23:00:00+00,6538,0,5270,6294,110,3428,1942,114,0,0,23696,138,13616,11674,6404,6538
2021-08-25 23:30:00+00,6040,0,5276,6182,108,3428,1971,113,0,0,23118,133,13537,11566,6290,6040
2021-08-26 00:00:00+00,5968,0,5273,6036,89,3428,1945,113,0,0,22852,131,13343,11398,6125,5968
2021-08-26 00:30:00+00,5746,0,5277,6175,89,3430,1897,113,0,0,22727,128,13438,11541,6264,5746
2021-08-26 01:00:00+00,5223,0,5273,6370,91,3428,1991,118,0,0,22494,121,13725,11734,6461,5223
2021-08-26 01:30:00+00,5066,0,5277,6512,59,3428,1903,119,0,0,22364,118,13751,11848,6571,5066
2021-08-26 02:00:00+00,5074,0,5274,6563,119,3430,1994,120,0,0,22574,118,13950,11956,6682,5074
2021-08-26 02:30:00+00,5142,0,5275,6577,155,3428,2006,122,0,0,22705,118,14013,12007,6732,5142
2021-08-26 03:00:00+00,5162,0,5278,6679,155,3428,2004,116,0,0,22822,118,14116,12112,6834,5162
2021-08-26 03:30:00+00,4959,0,5277,6809,155,3428,1966,114,0,0,22708,115,14207,12241,6964,4959
2021-08-26 04:00:00+00,5136,0,5276,6762,155,3428,1996,116,0,0,22869,117,14189,12193,6917,5136
2021-08-26 04:30:00+00,5621,0,5279,6874,154,3430,1757,113,0,0,23228,122,14064,12307,7028,5621
2021-08-26 05:00:00+00,6514,0,5276,7014,166,3462,1551,227,3,4,24217,133,14010,12459,7183,6514
2021-08-26 05:30:00+00,7953,0,5273,7188,175,3464,1587,170,106,168,26084,144,14329,12742,7469,7953
2021-08-26 06:00:00+00,9873,0,5271,7196,165,3638,1413,185,372,236,28349,153,14417,13004,7733,9873
2021-08-26 06:30:00+00,11394,0,5271,7152,169,3636,1440,205,746,244,30257,163,14778,13338,8067,11394
2021-08-26 07:00:00+00,11492,0,5269,7066,182,4722,1598,253,1169,468,32219,165,15284,13686,8417,11492
2021-08-26 07:30:00+00,11916,0,5263,6971,206,4750,1598,254,1590,554,33102,166,15628,14030,8767,11916
2021-08-26 08:00:00+00,12201,0,5266,7201,219,4872,1478,389,2151,230,34007,166,16315,14837,9571,12201
2021-08-26 08:30:00+00,11933,0,5264,7233,223,4874,1408,392,2670,258,34255,161,16798,15390,10126,11933
2021-08-26 09:00:00+00,11883,0,5255,7204,178,4874,1382,410,3250,22,34458,160,17269,15887,10632,11883
2021-08-26 09:30:00+00,11652,0,5248,7135,163,4874,1420,290,3905,0,34687,155,17871,16451,11203,11652
2021-08-26 10:00:00+00,11511,0,5250,7102,112,4874,1517,236,4581,46,35229,151,18562,17045,11795,11511
2021-08-26 10:30:00+00,11400,0,5253,7082,108,4874,1445,195,5139,128,35624,148,19027,17582,12329,11400
2021-08-26 11:00:00+00,11409,0,5250,6944,96,4996,1460,163,5294,120,35732,148,19044,17584,12334,11409
2021-08-26 11:30:00+00,11411,0,5251,6767,96,5002,1426,147,5708,0,35808,147,19248,17822,12571,11411
2021-08-26 12:00:00+00,10878,0,5253,6840,96,5030,1458,147,5693,32,35427,143,19340,17882,12629,10878
2021-08-26 12:30:00+00,10304,0,5251,6980,50,5038,1536,144,5753,0,35056,138,19570,18034,12783,10304
2021-08-26 13:00:00+00,10106,0,5255,7005,66,4840,1592,117,5582,76,34639,137,19500,17908,12653,10106
2021-08-26 13:30:00+00,9881,0,5256,7086,89,4836,1603,114,5476,62,34403,136,19510,17907,12651,9881
2021-08-26 14:00:00+00,9994,0,5256,7155,90,4804,1616,114,5388,62,34479,137,19505,17889,12633,9994
2021-08-26 14:30:00+00,10386,0,5252,7156,108,4800,1589,114,4800,62,34267,142,18905,17316,12064,10386
2021-08-26 15:00:00+00,10449,82,5255,7383,175,5044,1497,122,4223,50,34280,145,18533,17036,11781,10531
2021-08-26 15:30:00+00,11225,267,5252,7346,194,5048,1541,125,3578,28,34604,158,17911,16370,11118,11492
2021-08-26 16:00:00+00,11647,474,5210,7440,355,5044,1624,170,2911,18,34893,167,17540,15916,10706,12121
2021-08-26 16:30:00+00,12001,499,5156,7423,386,5044,1632,177,2204,292,34814,173,16801,15169,10013,12500
2021-08-26 17:00:00+00,12049,501,5147,7313,438,5046,1625,337,1524,592,34572,176,16047,14422,9275,12550
2021-08-26 17:30:00+00,12162,499,5139,7232,438,5048,1618,397,903,836,34272,179,15330,13712,8573,12661
2021-08-26 18:00:00+00,12481,500,5151,6899,345,5048,1608,494,356,590,33472,188,14359,12751,7600,12981
2021-08-26 18:30:00+00,12253,499,5148,6750,321,5044,1610,489,53,738,32905,188,13882,12272,7124,12752
2021-08-26 19:00:00+00,12425,500,5148,6605,177,5048,1606,494,0,776,32779,191,13536,11930,6782,12925
2021-08-26 19:30:00+00,12567,500,5149,6459,171,5046,1613,495,0,640,32640,194,13392,11779,6630,13067
2021-08-26 20:00:00+00,12347,499,5149,6262,81,5026,1610,423,0,286,31683,196,13102,11492,6343,12846
2021-08-26 20:30:00+00,11601,396,5146,6104,80,5020,1610,395,0,0,30352,192,12940,11330,6184,11997
2021-08-26 21:00:00+00,10910,340,5144,5967,66,4740,1612,242,0,130,29151,185,12789,11177,6033,11250
2021-08-26 21:30:00+00,10009,243,5143,5829,65,4726,1603,121,0,0,27739,177,12640,11037,5894,10252
2021-08-26 22:00:00+00,9385,265,5147,5517,64,4028,1534,114,0,0,26054,177,12262,10728,5581,9650
2021-08-26 22:30:00+00,8282,238,5148,5284,49,4014,1542,113,0,0,24670,168,12023,10481,5333,8520
2021-08-26 23:00:00+00,7657,269,5150,4903,49,3776,1606,116,0,0,23526,166,11708,10102,4952,7926
2021-08-26 23:30:00+00,7394,215,5153,4639,49,3774,1547,115,0,0,22886,164,11388,9841,4688,7609
2021-08-27 00:00:00+00,7619,1,5158,4306,49,3772,1635,113,0,0,22653,162,11148,9513,4355,7620
2021-08-27 00:30:00+00,7797,1,5158,4115,48,3772,1638,114,0,0,22643,165,10959,9321,4163,7798
2021-08-27 01:00:00+00,7930,0,5160,3888,47,3772,1644,112,0,0,22553,168,10739,9095,3935,7930
2021-08-27 01:30:00+00,7769,0,5157,3795,48,3772,1653,113,0,0,22307,167,10653,9000,3843,7769
2021-08-27 02:00:00+00,7472,0,5166,3779,141,3772,1655,112,0,0,22097,163,10741,9086,3920,7472
2021-08-27 02:30:00+00,7642,0,5160,3534,156,3772,1651,113,0,0,22028,167,10501,8850,3690,7642
2021-08-27 03:00:00+00,7802,0,5169,3412,156,3774,1649,114,0,0,22076,169,10386,8737,3568,7802
2021-08-27 03:30:00+00,7814,0,5164,3355,157,3774,1650,115,0,0,22029,170,10326,8676,3512,7814
2021-08-27 04:00:00+00,7747,0,5169,3305,165,3766,1650,116,0,0,21918,170,10289,8639,3470,7747
2021-08-27 04:30:00+00,8320,0,5166,3263,183,3802,1653,118,0,0,22505,176,10265,8612,3446,8320
2021-08-27 05:00:00+00,9398,0,5166,3148,201,4148,1656,116,2,6,23841,187,10173,8517,3351,9398
2021-08-27 05:30:00+00,11252,0,5168,2985,215,4056,1617,181,130,0,25604,202,10115,8498,3330,11252
2021-08-27 06:00:00+00,12718,117,5163,2938,215,4804,1425,198,523,0,28101,210,10264,8839,3676,12835
2021-08-27 06:30:00+00,13815,350,5163,2908,202,4820,1461,200,1132,0,30051,218,10866,9405,4242,14165
2021-08-27 07:00:00+00,14480,499,5158,2928,374,5074,1589,221,1769,0,32092,219,11818,10229,5071,14979
2021-08-27 07:30:00+00,14939,499,5160,2864,418,5082,1601,207,2294,58,33122,217,12337,10736,5576,15438
2021-08-27 08:00:00+00,14800,498,5165,2821,418,5046,1598,293,2802,280,33721,212,12804,11206,6041,15298
2021-08-27 08:30:00+00,14964,500,5161,2631,416,5046,1596,275,3327,0,33916,213,13131,11535,6374,15464
2021-08-27 09:00:00+00,14987,500,5154,2556,349,5066,1598,368,3691,0,34269,212,13348,11750,6596,15487
2021-08-27 09:30:00+00,15071,500,5146,2522,321,5082,1602,287,3907,0,34438,211,13498,11896,6750,15571
2021-08-27 10:00:00+00,15074,499,5178,2367,183,5028,1593,254,3925,158,34259,212,13246,11653,6475,15573
2021-08-27 10:30:00+00,15110,501,5263,2261,180,5026,1601,246,3820,168,34176,213,13125,11524,6261,15611
2021-08-27 11:00:00+00,15022,500,5294,2161,131,5028,1598,237,3867,532,34370,211,13051,11453,6159,15522
2021-08-27 11:30:00+00,14999,500,5300,2043,77,5028,1601,222,4123,466,34359,210,13144,11543,6243,15499
2021-08-27 12:00:00+00,14977,501,5301,2047,89,5030,1600,210,4338,166,34259,211,13375,11775,6474,15478
2021-08-27 12:30:00+00,14788,500,5303,2020,87,5030,1598,161,4254,124,33865,210,13262,11664,6361,15288
2021-08-27 13:00:00+00,14803,498,5297,2058,70,5028,1588,140,3918,24,33424,213,12931,11343,6046,15301
2021-08-27 13:30:00+00,14667,390,5301,2123,56,5030,1593,137,3748,0,33045,211,12821,11228,5927,15057
2021-08-27 14:00:00+00,14585,343,5303,2227,71,5030,1519,137,3655,0,32870,209,12775,11256,5953,14928
2021-08-27 14:30:00+00,14529,371,5295,2444,72,5028,1480,137,3319,0,32675,210,12610,11130,5835,14900
2021-08-27 15:00:00+00,14496,500,5295,2590,94,5050,1594,133,2948,0,32700,214,12521,10927,5632,14996
2021-08-27 15:30:00+00,14768,500,5293,2752,128,5046,1658,191,2496,0,32832,217,12327,10669,5376,15268
2021-08-27 16:00:00+00,14891,500,5293,2819,255,5048,1664,347,2271,182,33270,217,12302,10638,5345,15391
2021-08-27 16:30:00+00,15148,501,5294,2940,331,5046,1666,401,1829,372,33528,219,12060,10394,5100,15649
2021-08-27 17:00:00+00,15189,501,5291,3115,498,5046,1605,398,1231,496,33370,220,11740,10135,4844,15690
2021-08-27 17:30:00+00,15210,499,5296,3291,497,5048,1576,395,728,458,32998,223,11388,9812,4516,15709
2021-08-27 18:00:00+00,14963,499,5291,3624,496,5046,1600,387,257,276,32439,224,11268,9668,4377,15462
2021-08-27 18:30:00+00,14882,499,5295,3772,378,5048,1591,399,31,336,32231,224,11067,9476,4181,15381
2021-08-27 19:00:00+00,15018,500,5294,3934,215,5048,1605,357,0,150,32121,226,11048,9443,4149,15518
2021-08-27 19:30:00+00,14604,499,5295,4160,213,5046,1630,404,0,26,31877,224,11298,9668,4373,15103
2021-08-27 20:00:00+00,13617,487,5296,4328,143,5028,1702,365,0,0,30966,217,11469,9767,4471,14104
2021-08-27 20:30:00+00,12570,263,5297,4536,125,5026,1654,166,0,0,29637,204,11612,9958,4661,12833
2021-08-27 21:00:00+00,11805,132,5296,4430,68,4874,1618,113,0,22,28358,196,11412,9794,4498,11936
2021-08-27 21:30:00+00,10509,0,5299,4438,64,4868,1611,114,0,0,26903,183,11412,9801,4502,10509
2021-08-27 22:00:00+00,9443,0,5294,4320,64,4514,1629,114,0,2,25380,176,11307,9678,4384,9443
2021-08-27 22:30:00+00,7989,0,5300,4523,63,4498,1590,114,0,0,24077,162,11476,9886,4586,7989
2021-08-27 23:00:00+00,7426,0,5296,4520,86,3786,1614,115,0,36,22879,157,11516,9902,4606,7426
2021-08-27 23:30:00+00,6666,0,5297,4548,102,3826,1619,114,0,0,22172,149,11566,9947,4650,6666
2021-08-28 00:00:00+00,5907,0,5295,4779,102,3972,1614,113,0,0,21782,138,11790,10176,4881,5907
2021-08-28 00:30:00+00,5904,0,5295,4749,119,4028,1678,114,0,0,21887,139,11841,10163,4868,5904
2021-08-28 01:00:00+00,6249,0,5289,4497,201,3692,1720,116,0,0,21764,145,11707,9987,4698,6249
2021-08-28 01:30:00+00,6227,0,5292,4632,178,3522,1705,115,0,0,21671,142,11807,10102,4810,6227
2021-08-28 02:00:00+00,6141,0,5287,4716,126,3434,1725,115,0,0,21544,139,11854,10129,4842,6141
2021-08-28 02:30:00+00,6058,0,5290,4636,125,3436,1723,114,0,0,21382,139,11774,10051,4761,6058
2021-08-28 03:00:00+00,5866,0,5290,4711,125,3436,1723,112,0,0,21263,136,11849,10126,4836,5866
2021-08-28 03:30:00+00,5724,0,5292,4857,125,3434,1720,113,0,0,21265,133,11994,10274,4982,5724
2021-08-28 04:00:00+00,5531,0,5292,5062,135,3438,1725,113,0,0,21296,129,12214,10489,5197,5531
2021-08-28 04:30:00+00,5695,0,5292,5026,135,3438,1774,114,0,0,21474,132,12227,10453,5161,5695
2021-08-28 05:00:00+00,6126,0,5291,5057,137,3434,1799,115,1,0,21960,137,12285,10486,5195,6126
2021-08-28 05:30:00+00,6583,0,5291,5121,151,3448,1830,115,133,0,22672,141,12526,10696,5405,6583
2021-08-28 06:00:00+00,7010,0,5295,5324,126,3766,1866,118,564,0,24069,141,13175,11309,6014,7010
2021-08-28 06:30:00+00,7706,0,5292,5380,99,3774,1956,119,1098,0,25424,145,13825,11869,6577,7706
2021-08-28 07:00:00+00,8415,0,5293,5495,139,4254,1973,121,1663,0,27353,146,14563,12590,7297,8415
2021-08-28 07:30:00+00,8809,0,5292,5434,173,4260,2166,119,2331,0,28584,146,15396,13230,7938,8809
2021-08-28 08:00:00+00,9309,0,5294,5196,172,4262,2143,116,3177,0,29669,147,15982,13839,8545,9309
2021-08-28 08:30:00+00,9331,0,5294,5138,172,4262,2083,115,4181,0,30576,143,16868,14785,9491,9331
2021-08-28 09:00:00+00,8936,0,5280,5171,170,4506,2054,117,4886,0,31120,136,17561,15507,10227,8936
2021-08-28 09:30:00+00,8579,0,5280,5036,156,4510,2114,119,5297,0,31091,132,17883,15769,10489,8579
2021-08-28 10:00:00+00,8730,0,5278,4548,86,4506,2129,118,5619,190,31204,134,17660,15531,10253,8730
2021-08-28 10:30:00+00,9004,0,5278,4323,69,4508,2141,121,6229,0,31673,135,18040,15899,10621,9004
2021-08-28 11:00:00+00,8911,0,5276,4080,69,4510,2147,118,6427,20,31558,134,17999,15852,10576,8911
2021-08-28 11:30:00+00,8867,0,5279,3919,68,4512,2117,116,6381,146,31405,134,17764,15647,10368,8867
2021-08-28 12:00:00+00,8778,0,5282,3875,59,4392,2082,117,6597,0,31182,134,17895,15813,10531,8778
2021-08-28 12:30:00+00,8558,0,5280,3676,60,4386,2099,117,6333,0,30509,134,17448,15349,10069,8558
2021-08-28 13:00:00+00,8495,0,5280,3727,60,4384,2069,116,6018,0,30149,135,17154,15085,9805,8495
2021-08-28 13:30:00+00,8464,0,5282,3706,60,4386,2057,117,5750,0,29822,136,16855,14798,9516,8464
2021-08-28 14:00:00+00,8486,0,5281,3887,60,4388,2069,116,5379,0,29666,137,16676,14607,9326,8486
2021-08-28 14:30:00+00,8564,0,5282,3966,61,4388,2099,116,4959,0,29435,139,16367,14268,8986,8564
2021-08-28 15:00:00+00,9173,0,5276,3936,83,4506,2146,118,4544,0,29782,146,15985,13839,8563,9173
2021-08-28 15:30:00+00,9752,0,5277,4025,102,4508,2143,117,3852,132,29908,153,15399,13256,7979,9752
2021-08-28 16:00:00+00,10719,57,5275,4089,150,4988,2123,117,3122,48,30688,165,14759,12636,7361,10776
2021-08-28 16:30:00+00,11004,269,5278,3986,167,5000,2102,118,2394,258,30576,175,13927,11825,6547,11273
2021-08-28 17:00:00+00,11057,471,5273,3858,463,5000,2076,123,1734,498,30553,182,13404,11328,6055,11528
2021-08-28 17:30:00+00,11460,501,5277,3899,468,4998,2012,124,934,288,29961,192,12590,10578,5301,11961
2021-08-28 18:00:00+00,11466,500,5279,3778,483,5000,1931,135,361,654,29587,194,11832,9901,4622,11966
2021-08-28 18:30:00+00,11364,499,5277,3854,476,4998,1884,142,38,608,29140,196,11529,9645,4368,11863
2021-08-28 19:00:00+00,11535,501,5279,3651,398,5086,1618,245,0,798,29111,200,10946,9328,4049,12036
2021-08-28 19:30:00+00,11644,500,5279,3499,388,5088,1657,346,0,682,29083,202,10823,9166,3887,12144
2021-08-28 20:00:00+00,11781,501,5279,3116,322,4754,1721,365,0,384,28223,209,10438,8717,3438,12282
2021-08-28 20:30:00+00,11652,499,5281,2831,232,4754,1720,261,0,106,27336,212,10064,8344,3063,12151
2021-08-28 21:00:00+00,11473,499,5278,2699,98,4752,1720,223,0,22,26764,214,9795,8075,2797,11972
2021-08-28 21:30:00+00,10857,384,5280,2575,74,4742,1712,139,0,12,25775,207,9641,7929,2649,11241
2021-08-28 22:00:00+00,10182,423,5282,2381,74,4220,1712,114,0,4,24392,208,9449,7737,2455,10605
2021-08-28 22:30:00+00,9122,356,5278,2220,74,4270,1701,115,0,14,23150,200,9273,7572,2294,9478
2021-08-28 23:00:00+00,8422,349,5279,2215,72,3728,1691,116,0,62,21934,195,9257,7566,2287,8771
2021-08-28 23:30:00+00,7617,392,5282,2263,72,3768,1684,115,0,0,21193,189,9301,7617,2335,8009
2021-08-29 00:00:00+00,7304,323,5268,2365,73,3664,1686,115,0,0,20798,186,9392,7706,2438,7627
2021-08-29 00:30:00+00,6911,304,5278,2507,78,3572,1691,114,0,0,20455,178,9554,7863,2585,7215
2021-08-29 01:00:00+00,6702,294,5279,2514,105,3432,1692,115,0,0,20133,174,9590,7898,2619,6996
2021-08-29 01:30:00+00,6441,283,5275,2550,104,3430,1707,115,0,0,19905,170,9636,7929,2654,6724
2021-08-29 02:00:00+00,6379,409,5281,2767,105,3430,1758,115,0,0,20244,172,9911,8153,2872,6788
2021-08-29 02:30:00+00,5982,297,5283,3184,105,3430,1757,115,0,0,20153,160,10329,8572,3289,6279
2021-08-29 03:00:00+00,5737,232,5284,3286,105,3430,1740,113,0,0,19927,154,10415,8675,3391,5969
2021-08-29 03:30:00+00,5890,233,5285,3349,104,3430,1578,113,0,0,19982,155,10316,8738,3453,6123
2021-08-29 04:00:00+00,6091,261,5281,3387,154,3430,1446,114,0,0,20164,158,10268,8822,3541,6352
2021-08-29 04:30:00+00,6256,392,5282,3272,295,3430,1101,176,0,0,20204,166,9950,8849,3567,6648
2021-08-29 05:00:00+00,6245,276,5282,3481,310,3430,1106,257,0,0,20387,160,10179,9073,3791,6521
2021-08-29 05:30:00+00,6217,269,5284,3468,310,3432,1108,283,168,0,20539,159,10338,9230,3946,6486
2021-08-29 06:00:00+00,6468,380,5283,3612,293,3668,1110,272,642,0,21728,159,10940,9830,4547,6848
2021-08-29 06:30:00+00,6814,343,5285,3793,265,3666,1113,192,1318,0,22789,155,11774,10661,5376,7157
2021-08-29 07:00:00+00,7865,321,5286,3819,271,3444,1113,117,1862,86,24184,162,12351,11238,5952,8186
2021-08-29 07:30:00+00,8420,327,5285,3938,258,3432,1116,116,2319,0,25211,164,12916,11800,6515,8747
2021-08-29 08:00:00+00,8704,323,5285,4194,275,3774,1116,150,2827,0,26648,161,13697,12581,7296,9027
2021-08-29 08:30:00+00,8844,243,5280,4197,318,3780,1117,305,3403,54,27541,157,14315,13198,7918,9087
2021-08-29 09:00:00+00,8702,5,5275,4403,374,4016,1116,418,3813,136,28258,145,14981,13865,8590,8707
2021-08-29 09:30:00+00,8797,2,5270,4599,392,4020,1117,366,3924,164,28651,143,15302,14185,8915,8800
2021-08-29 10:00:00+00,8656,0,5274,4777,343,4020,1361,364,4275,306,29376,139,16030,14669,9395,8656
2021-08-29 10:30:00+00,8678,0,5272,4883,265,4020,1773,419,4297,204,29811,139,16490,14717,9445,8678
2021-08-29 11:00:00+00,8855,0,5273,4707,250,3852,1782,533,4724,352,30328,138,16736,14954,9681,8855
2021-08-29 11:30:00+00,8731,0,5273,4618,264,3852,1782,701,4610,250,30081,139,16547,14765,9492,8731
2021-08-29 12:00:00+00,8817,0,5273,4854,215,3964,1288,611,4673,150,29845,140,16303,15015,9742,8817
2021-08-29 12:30:00+00,8878,0,5275,5000,218,3960,1123,589,4600,72,29715,141,16216,15093,9818,8878
2021-08-29 13:00:00+00,9011,0,5274,5175,215,4020,1119,409,4378,132,29733,141,16161,15042,9768,9011
2021-08-29 13:30:00+00,9053,0,5277,5255,194,4020,1183,242,4184,150,29558,141,16093,14910,9633,9053
2021-08-29 14:00:00+00,8948,0,5276,5341,74,4024,1648,116,3966,140,29533,141,16305,14657,9381,8948
2021-08-29 14:30:00+00,8797,60,5279,5542,60,4018,1984,116,3739,46,29642,141,16604,14620,9341,8858
2021-08-29 15:00:00+00,8989,121,5278,5765,86,4262,2217,116,3346,0,30180,145,16692,14475,9197,9110
2021-08-29 15:30:00+00,9229,384,5277,5895,113,4266,2256,118,2659,96,30293,156,16200,13944,8667,9613
2021-08-29 16:00:00+00,9463,500,5279,6203,194,4508,2318,121,2200,0,30786,161,16194,13876,8597,9963
2021-08-29 16:30:00+00,9699,500,5279,6447,202,4510,2409,131,1637,0,30814,164,15974,13565,8286,10199
2021-08-29 17:00:00+00,9798,500,5274,6377,289,4510,2272,131,1045,282,30478,167,15257,12985,7711,10298
2021-08-29 17:30:00+00,10051,500,5271,6477,297,4510,2370,123,536,74,30209,172,14951,12581,7310,10551
2021-08-29 18:00:00+00,9907,501,5272,6525,297,4512,2416,162,205,0,29797,173,14715,12299,7027,10408
2021-08-29 18:30:00+00,9623,499,5272,6613,290,4510,2407,166,18,0,29398,171,14600,12193,6921,10122
2021-08-29 19:00:00+00,9524,499,5270,6933,239,4530,2411,142,0,0,29548,169,14853,12442,7172,10023
2021-08-29 19:30:00+00,9183,499,5270,7256,199,4506,2353,140,0,0,29406,165,15078,12725,7455,9682
2021-08-29 20:00:00+00,8682,501,5266,7497,128,4302,2103,136,0,0,28615,161,14994,12891,7625,9183
2021-08-29 20:30:00+00,7934,365,5267,7624,117,4254,1820,136,0,42,27559,150,14828,13008,7741,8299
2021-08-29 21:00:00+00,7620,230,5264,7555,61,3678,1827,135,0,94,26464,145,14707,12880,7616,7850
2021-08-29 21:30:00+00,7011,240,5265,7395,61,3670,1454,133,0,44,25273,141,14175,12721,7456,7251
2021-08-29 22:00:00+00,6219,397,5262,6999,61,3504,1057,136,0,198,23833,141,13379,12322,7060,6616
2021-08-29 22:30:00+00,5394,363,5263,6978,61,3484,935,133,0,0,22611,132,13237,12302,7039,5757
2021-08-29 23:00:00+00,4963,263,5261,6846,61,3198,925,136,0,0,21653,124,13093,12168,6907,5226
2021-08-29 23:30:00+00,4847,233,5264,6570,61,3184,922,134,0,0,21215,122,12817,11895,6631,5080
2021-08-30 00:00:00+00,5024,235,5266,6205,61,3306,969,134,0,0,21200,130,12501,11532,6266,5259
2021-08-30 00:30:00+00,5218,239,5268,5709,62,3306,1042,136,0,0,20980,135,12081,11039,5771,5457
2021-08-30 01:00:00+00,4984,237,5268,5410,96,3430,1057,136,0,0,20618,133,11831,10774,5506,5221
2021-08-30 01:30:00+00,5154,243,5264,5108,102,3460,944,135,0,0,20410,138,11418,10474,5210,5397
2021-08-30 02:00:00+00,4898,278,5272,4998,101,3520,999,135,0,0,20201,138,11370,10371,5099,5176
2021-08-30 02:30:00+00,4871,274,5268,5068,101,3462,1163,135,0,0,20342,136,11600,10437,5169,5145
2021-08-30 03:00:00+00,4686,280,5273,5217,97,3444,1160,133,0,0,20290,133,11747,10587,5314,4966
2021-08-30 03:30:00+00,4570,276,5273,5414,97,3468,1065,133,0,0,20296,130,11849,10784,5511,4846
2021-08-30 04:00:00+00,4547,275,5270,5708,97,3558,1066,134,0,0,20655,129,12141,11075,5805,4822
2021-08-30 04:30:00+00,4696,261,5272,5954,98,3694,1015,136,0,0,21126,131,12339,11324,6052,4957
2021-08-30 05:00:00+00,5229,253,5271,5857,97,3670,948,134,0,0,21459,139,12173,11225,5954,5482
2021-08-30 05:30:00+00,5734,407,5272,5942,89,3426,1010,134,28,0,22042,146,12341,11331,6059,6141
2021-08-30 06:00:00+00,7492,283,5276,6166,57,2975,1071,135,203,0,23658,156,12773,11702,6426,7775
2021-08-30 06:30:00+00,8456,233,5274,6210,57,2934,1094,139,477,4,24878,161,13112,12018,6744,8689
2021-08-30 07:00:00+00,8886,239,5272,6191,144,4052,1134,138,736,44,26836,162,13477,12343,7071,9125
2021-08-30 07:30:00+00,9562,293,5271,6138,182,4074,1172,166,1058,76,27992,167,13821,12649,7378,9855
2021-08-30 08:00:00+00,9722,341,5272,6188,210,4046,1170,464,1342,42,28797,168,14182,13012,7740,10063
2021-08-30 08:30:00+00,10224,321,5274,6209,209,4048,1165,461,1692,146,29749,169,14549,13384,8110,10545
2021-08-30 09:00:00+00,10265,285,5253,6085,183,4620,1169,400,1853,164,30277,169,14543,13374,8121,10550
2021-08-30 09:30:00+00,10343,332,5248,5944,160,4630,1175,352,2083,152,30419,170,14610,13435,8187,10675
2021-08-30 10:00:00+00,10532,332,5247,5787,83,4630,1181,420,2182,154,30548,172,14480,13299,8052,10864
2021-08-30 10:30:00+00,10551,320,5250,5678,83,4630,1178,452,2380,368,30890,170,14569,13391,8141,10871
2021-08-30 11:00:00+00,10671,370,5234,5462,104,4630,1182,484,2391,542,31070,173,14373,13191,7957,11041
2021-08-30 11:30:00+00,10680,360,5233,5308,216,4630,1186,683,2415,506,31217,174,14358,13172,7939,11040
2021-08-30 12:00:00+00,10717,360,5236,5273,135,4754,1186,607,2292,650,31210,174,14122,12936,7700,11077
2021-08-30 12:30:00+00,10730,356,5222,5128,122,4754,1187,497,2222,636,30854,175,13881,12694,7472,11086
2021-08-30 13:00:00+00,10910,362,5095,5278,122,4754,1182,367,2189,652,30911,176,13866,12684,7589,11272
2021-08-30 13:30:00+00,11168,489,5093,5374,95,4752,1179,192,1938,292,30572,183,13679,12500,7407,11657
2021-08-30 14:00:00+00,11429,497,5092,5420,72,4774,1179,192,1761,212,30628,187,13524,12345,7253,11926
2021-08-30 14:30:00+00,11530,497,5103,5595,76,4770,1179,191,1540,268,30749,187,13493,12314,7211,12027
2021-08-30 15:00:00+00,11897,498,5099,5654,104,4996,1180,193,1352,274,31247,190,13389,12209,7110,12395
2021-08-30 15:30:00+00,12017,500,5102,5769,128,5000,1185,259,1120,636,31716,189,13304,12119,7017,12517
2021-08-30 16:00:00+00,12102,497,5105,6110,211,5046,1184,373,849,1088,32565,187,13459,12275,7170,12599
2021-08-30 16:30:00+00,12213,498,5103,6132,231,5046,1188,388,617,1142,32558,188,13271,12083,6980,12711
2021-08-30 17:00:00+00,12651,494,5104,6286,315,5048,1189,391,408,852,32738,192,13302,12113,7009,13145
2021-08-30 17:30:00+00,12911,418,5106,6198,368,5048,1189,271,200,730,32439,194,13061,11872,6766,13329
2021-08-30 18:00:00+00,12656,417,5102,6178,367,5048,1187,251,48,768,32022,193,12882,11695,6593,13073
2021-08-30 18:30:00+00,12478,419,5103,6307,360,5046,1189,201,1,452,31556,193,12960,11771,6668,12897
2021-08-30 19:00:00+00,12423,427,5101,6684,290,5000,1178,167,0,522,31792,191,13253,12075,6974,12850
2021-08-30 19:30:00+00,11705,439,5101,6964,238,4990,1173,165,0,546,31321,185,13476,12303,7202,12144
2021-08-30 20:00:00+00,11668,350,5097,6944,176,4518,1096,161,0,350,30360,185,13313,12217,7120,12018
2021-08-30 20:30:00+00,11391,26,5102,7219,167,4504,1076,155,0,0,29640,176,13564,12488,7386,11417
2021-08-30 21:00:00+00,10014,13,5096,7118,73,3972,1095,160,0,22,27563,166,13382,12287,7191,10027
2021-08-30 21:30:00+00,8913,0,5094,6972,72,3964,1077,153,0,0,26245,157,13215,12138,7044,8913
2021-08-30 22:00:00+00,7644,0,5096,6954,72,3776,1095,154,0,0,24791,146,13217,12122,7026,7644
2021-08-30 22:30:00+00,6555,0,5095,6793,73,3770,1065,153,0,0,23504,136,13026,11961,6866,6555
2021-08-30 23:00:00+00,6142,0,5093,6600,61,3436,1095,156,0,0,22583,133,12849,11754,6661,6142
2021-08-30 23:30:00+00,5962,0,5085,6469,61,3430,1085,154,0,0,22246,131,12700,11615,6530,5962
2021-08-31 00:00:00+00,5818,0,5082,6310,61,3434,1129,156,0,0,21990,133,12582,11453,6371,5818
2021-08-31 00:30:00+00,5869,0,5086,6209,61,3436,1110,153,0,0,21924,134,12466,11356,6270,5869
2021-08-31 01:00:00+00,5861,0,5085,6085,61,3437,1088,158,0,0,21775,135,12319,11231,6146,5861
2021-08-31 01:30:00+00,5949,0,5080,5813,61,3435,1101,159,0,0,21598,138,12055,10954,5874,5949
2021-08-31 02:00:00+00,6047,0,5028,5783,58,3398,1129,157,0,0,21601,139,11998,10869,5841,6047
2021-08-31 02:30:00+00,6187,0,5077,5613,58,3404,1098,157,0,0,21594,142,11846,10748,5671,6187
2021-08-31 03:00:00+00,6130,0,5076,5810,57,3443,1068,153,0,0,21737,140,12011,10943,5867,6130
2021-08-31 03:30:00+00,6144,0,5075,5657,57,3443,1097,156,0,0,21629,141,11886,10789,5714,6144
2021-08-31 04:00:00+00,5922,165,5074,5880,57,3452,1022,153,0,0,21725,143,12033,11011,5937,6087
2021-08-31 04:30:00+00,6540,299,5077,6132,57,3479,970,156,0,0,22709,154,12236,11266,6189,6839
2021-08-31 05:00:00+00,7172,240,5079,6030,57,4240,1086,156,0,0,24060,159,12252,11166,6087,7412
2021-08-31 05:30:00+00,8720,359,5020,5920,61,4141,1051,155,26,0,25452,177,12078,11027,6007,9079
2021-08-31 06:00:00+00,11201,459,5000,5828,73,4080,986,154,191,0,27972,196,12078,11092,6092,11660
2021-08-31 06:30:00+00,12807,499,5000,5794,74,4068,975,176,482,78,29953,205,12325,11350,6350,13306
2021-08-31 07:00:00+00,13312,499,5004,5617,165,5034,1051,187,825,338,32032,205,12662,11611,6607,13811
2021-08-31 07:30:00+00,13726,500,5003,5761,226,5068,1100,295,1291,258,33228,203,13381,12281,7278,14226
2021-08-31 08:00:00+00,13793,500,5001,5612,177,5068,1174,205,1669,626,33825,200,13633,12459,7458,14293
2021-08-31 08:30:00+00,13882,500,4997,5588,172,5074,1186,203,2137,454,34193,199,14080,12894,7897,14382
2021-08-31 09:00:00+00,13856,500,4903,5575,152,5026,1187,194,2407,364,34164,199,14224,13037,8134,14356
2021-08-31 09:30:00+00,13711,500,4773,5790,130,5028,1185,234,2669,436,34456,196,14547,13362,8589,14211
2021-08-31 10:00:00+00,13704,501,4774,5843,83,5028,1182,259,2716,466,34556,195,14598,13416,8642,14205
2021-08-31 10:30:00+00,13891,502,4775,5733,83,5026,1165,264,3021,282,34742,196,14777,13612,8837,14393
2021-08-31 11:00:00+00,13948,500,4789,5523,85,5028,1181,326,3132,520,35032,196,14710,13529,8740,14448
2021-08-31 11:30:00+00,13880,500,4991,5353,95,5028,1188,354,3026,408,34823,197,14653,13465,8474,14380
2021-08-31 12:00:00+00,14065,500,5096,5204,77,5028,1182,251,2855,440,34698,199,14414,13232,8136,14565
2021-08-31 12:30:00+00,14233,499,5110,5237,72,5024,1160,211,2837,176,34559,201,14416,13256,8146,14732
2021-08-31 13:00:00+00,14431,501,5111,5305,71,5026,1145,208,2527,166,34491,203,14159,13014,7903,14932
2021-08-31 13:30:00+00,14489,500,5114,5115,72,5026,1159,234,2267,262,34238,206,13727,12568,7454,14989
2021-08-31 14:00:00+00,14311,500,5115,5035,73,5074,1177,441,2086,266,34078,207,13486,12309,7194,14811
2021-08-31 14:30:00+00,14363,499,5114,5387,73,5082,1178,463,1753,142,34054,208,13505,12327,7213,14862
2021-08-31 15:00:00+00,14701,500,5112,5645,85,5048,1176,492,1471,290,34520,210,13489,12313,7201,15201
2021-08-31 15:30:00+00,14905,500,5112,5748,183,5048,1171,502,1197,420,34786,210,13411,12240,7128,15405
2021-08-31 16:00:00+00,15071,500,5116,5911,293,5046,1170,526,964,750,35347,209,13454,12284,7168,15571
2021-08-31 16:30:00+00,15260,500,5116,5866,344,5046,1168,519,715,868,35402,211,13209,12041,6925,15760
2021-08-31 17:00:00+00,15341,500,5113,5690,361,5048,1174,484,471,846,35028,214,12809,11635,6522,15841
2021-08-31 17:30:00+00,15457,500,4959,5827,361,5046,1168,508,241,492,34559,218,12556,11388,6429,15957
2021-08-31 18:00:00+00,15568,501,4852,5773,355,5046,1166,440,72,436,34209,221,12218,11052,6200,16069
2021-08-31 18:30:00+00,15351,499,4845,5980,343,5048,1162,420,1,372,34021,219,12331,11169,6324,15850
2021-08-31 19:00:00+00,15257,500,4844,5966,314,5046,1172,343,0,696,34138,217,12296,11124,6280,15757
2021-08-31 19:30:00+00,14976,501,4883,5708,285,5046,1168,172,0,942,33681,215,12044,10876,5993,15477
2021-08-31 20:00:00+00,14431,501,5073,5829,138,5026,1175,129,0,110,32412,216,12215,11040,5967,14932
2021-08-31 20:30:00+00,12778,365,5127,6346,120,5024,1145,115,0,0,31020,200,12738,11593,6466,13143
2021-08-31 21:00:00+00,11439,41,5114,6550,88,4728,1093,114,0,0,29167,184,12845,11752,6638,11480
2021-08-31 21:30:00+00,10279,0,5115,6452,88,4710,1107,115,0,0,27866,174,12762,11655,6540,10279
2021-08-31 22:00:00+00,9549,0,5114,6502,148,3908,1171,148,0,0,26540,168,12935,11764,6650,9549
2021-08-31 22:30:00+00,8264,0,5116,6410,104,3896,1177,145,0,0,25112,157,12807,11630,6514,8264
2021-08-31 23:00:00+00,8020,0,5118,5881,73,3904,1181,123,0,0,24300,158,12253,11072,5954,8020
2021-08-31 23:30:00+00,7773,0,5118,5814,73,3903,1181,124,0,0,23986,156,12186,11004,5886,7773
2021-09-01 00:00:00+00,7592,0,5116,5534,73,3901,1178,116,0,0,23510,158,11901,10723,5607,7592
2021-09-01 00:30:00+00,7708,0,5030,5313,73,3898,1177,123,0,0,23322,161,11593,10416,5386,7708
2021-09-01 01:00:00+00,7751,0,4851,5156,73,3896,1180,126,0,0,23033,164,11260,10080,5229,7751
2021-09-01 01:30:00+00,7900,0,4841,4804,73,3896,1183,119,0,0,22816,168,10901,9718,4877,7900
2021-09-01 02:00:00+00,7793,0,4849,4770,73,3898,1177,117,0,0,22677,167,10869,9692,4843,7793
2021-09-01 02:30:00+00,7894,0,5022,4476,73,3898,1161,116,0,0,22640,169,10732,9571,4549,7894
2021-09-01 03:00:00+00,7755,0,5121,4623,73,3923,1155,113,0,0,22764,166,10972,9817,4696,7755
2021-09-01 03:30:00+00,7615,5,5117,4776,73,3947,1136,114,0,0,22783,164,11102,9966,4849,7620
2021-09-01 04:00:00+00,7865,169,5119,4986,73,3904,1168,114,0,0,23398,168,11346,10178,5059,8034
2021-09-01 04:30:00+00,8444,230,5120,4940,75,3936,1119,115,0,0,23980,176,11254,10136,5016,8674
2021-09-01 05:00:00+00,9253,230,5120,4782,92,3894,1100,118,0,0,24589,176,11094,9994,4874,9483
2021-09-01 05:30:00+00,11217,375,5119,4727,96,3560,1007,114,15,0,26230,193,10964,9957,4838,11592
2021-09-01 06:00:00+00,13664,487,5118,4721,121,3104,1123,221,137,228,28924,212,11220,10097,4979,14151
2021-09-01 06:30:00+00,14994,500,5118,4881,128,3120,1252,280,360,236,30869,217,11739,10487,5369,15494
2021-09-01 07:00:00+00,15194,500,5121,4749,201,4400,1470,324,656,176,32791,218,12197,10727,5606,15694
2021-09-01 07:30:00+00,15311,501,5119,4671,203,4500,1637,600,1013,132,33687,218,12643,11006,5887,15812
2021-09-01 08:00:00+00,15559,500,5119,4448,203,4566,1662,664,1432,296,34449,219,12864,11202,6083,16059
2021-09-01 08:30:00+00,15549,499,5121,4260,267,4576,1610,650,1850,336,34718,216,13108,11498,6377,16048
2021-09-01 09:00:00+00,15560,500,5015,4461,252,4570,1595,624,2307,234,35118,216,13630,12035,7020,16060
2021-09-01 09:30:00+00,15872,500,4857,4532,148,4584,1547,523,2474,174,35211,218,13558,12011,7154,16372
2021-09-01 10:00:00+00,15810,500,4849,4437,96,5018,1476,362,2750,274,35572,216,13608,12132,7283,16310
2021-09-01 10:30:00+00,15702,501,4849,4184,106,5022,1574,405,2793,310,35446,216,13506,11932,7083,16203
2021-09-01 11:00:00+00,15441,500,4954,4169,142,5070,1593,600,2989,270,35728,214,13847,12254,7300,15941
2021-09-01 11:30:00+00,15538,501,5107,4118,165,5080,1595,669,2988,132,35893,214,13973,12378,7271,16039
2021-09-01 12:00:00+00,15674,501,5109,4157,168,5048,1593,641,2955,0,35846,216,13982,12389,7280,16175
2021-09-01 12:30:00+00,15531,500,5108,4199,182,5046,1607,553,2885,16,35627,215,13981,12374,7266,16031
2021-09-01 13:00:00+00,15407,477,5108,4357,152,5074,1658,404,2809,34,35480,213,14084,12426,7318,15884
2021-09-01 13:30:00+00,15420,500,5110,4357,161,5068,1657,478,2760,48,35559,213,14045,12388,7278,15920
2021-09-01 14:00:00+00,15988,500,5109,4390,109,4452,1660,489,2567,82,35346,216,13835,12175,7066,16488
2021-09-01 14:30:00+00,15893,501,5081,4433,96,4448,1661,474,2244,182,35013,216,13515,11854,6773,16394
2021-09-01 15:00:00+00,16154,501,4603,4350,156,4536,1659,538,1974,154,34626,222,12742,11084,6480,16655
2021-09-01 15:30:00+00,16234,500,4608,4388,219,4538,1656,641,1837,590,35211,221,12708,11052,6444,16734
2021-09-01 16:00:00+00,16713,500,4505,4336,334,4428,1629,634,1474,966,35519,224,12278,10649,6144,17213
2021-09-01 16:30:00+00,17142,500,4348,4464,362,4428,1606,638,1063,724,35275,230,11843,10237,5889,17642
2021-09-01 17:00:00+00,17003,432,4335,4585,337,4458,1628,540,670,990,34978,228,11555,9927,5592,17435
2021-09-01 17:30:00+00,16821,342,4334,4767,341,4458,1612,552,350,1102,34679,225,11404,9792,5458,17163
2021-09-01 18:00:00+00,16570,352,4423,5059,339,5038,1270,564,97,762,34474,229,11188,9918,5495,16922
2021-09-01 18:30:00+00,16492,405,4596,5178,338,5044,1134,529,3,614,34333,229,11249,10115,5519,16897
2021-09-01 19:00:00+00,16511,482,4607,5294,338,4938,1132,516,0,508,34326,231,11371,10239,5632,16993
2021-09-01 19:30:00+00,16463,500,4612,5075,314,4938,1137,480,0,344,33863,234,11138,10001,5389,16963
2021-09-01 20:00:00+00,15962,500,4603,5111,176,5026,1068,410,0,122,32978,234,10958,9890,5287,16462
2021-09-01 20:30:00+00,14618,499,4603,5188,145,5028,989,323,0,0,31393,228,10925,9936,5333,15117
2021-09-01 21:00:00+00,13898,370,4600,4847,81,5026,961,287,0,0,30070,224,10489,9528,4928,14268
2021-09-01 21:30:00+00,12726,229,4603,4777,76,5026,1017,145,0,0,28599,213,10473,9456,4853,12955
2021-09-01 22:00:00+00,11444,343,4603,4729,62,4756,1119,116,0,0,27172,208,10513,9394,4791,11787
2021-09-01 22:30:00+00,10397,459,4604,4403,61,4752,1056,115,0,0,25847,207,10124,9068,4464,10856
2021-09-01 23:00:00+00,10139,413,4521,3980,47,4270,1110,115,0,0,24595,209,9658,8548,4027,10552
2021-09-01 23:30:00+00,9919,360,4265,3974,47,4264,1129,114,0,0,24072,208,9415,8286,4021,10279
2021-09-02 00:00:00+00,9614,316,4186,3845,47,4264,1107,113,0,0,23492,205,9185,8078,3892,9930
2021-09-02 00:30:00+00,9628,236,4183,3833,47,4266,1129,115,0,0,23437,203,9192,8063,3880,9864
2021-09-02 01:00:00+00,9643,293,4184,3780,47,4152,1113,114,0,0,23326,206,9124,8011,3827,9936
2021-09-02 01:30:00+00,9583,277,4200,3633,47,4152,1033,114,0,0,23039,206,8913,7880,3680,9860
2021-09-02 02:00:00+00,9295,244,4368,3626,47,4160,1021,114,0,0,22875,201,9062,8041,3673,9539
2021-09-02 02:30:00+00,8940,270,4454,3711,47,4158,968,114,0,0,22662,198,9180,8212,3758,9210
2021-09-02 03:00:00+00,9187,344,4461,3551,47,4152,967,114,0,0,22823,204,9026,8059,3598,9531
2021-09-02 03:30:00+00,9115,457,4459,3662,46,4152,938,114,0,0,22943,206,9105,8167,3708,9572
2021-09-02 04:00:00+00,9812,572,4463,3552,46,3462,966,114,0,0,22987,211,9027,8061,3598,10384
2021-09-02 04:30:00+00,10646,705,4466,3431,45,3562,952,114,0,0,23921,224,8894,7942,3476,11351
2021-09-02 05:00:00+00,11994,734,4460,3583,75,3274,984,116,0,0,25220,229,9102,8118,3658,12728
2021-09-02 05:30:00+00,13730,833,4461,3517,75,3073,974,115,3,0,26782,241,9030,8056,3595,14563
2021-09-02 06:00:00+00,15587,872,4462,3495,97,3561,1032,145,65,228,29544,250,9151,8119,3657,16459
2021-09-02 06:30:00+00,16463,962,4351,3410,109,3606,1124,448,231,306,31010,256,9225,8101,3750,17425
2021-09-02 07:00:00+00,16704,994,4193,3517,124,4708,1126,592,453,348,32759,259,9413,8287,4094,17698
2021-09-02 07:30:00+00,16816,996,4187,3551,127,4728,1125,578,704,674,33486,255,9694,8569,4382,17812
2021-09-02 08:00:00+00,16871,997,4185,3430,120,5055,1125,568,1002,1052,34405,249,9862,8737,4552,17868
2021-09-02 08:30:00+00,17056,996,4273,3452,123,5053,1129,567,1303,770,34722,249,10280,9151,4878,18052
2021-09-02 09:00:00+00,17097,995,4453,3533,123,5063,1133,548,1641,586,35172,246,10883,9750,5297,18092
2021-09-02 09:30:00+00,17156,994,4461,3536,260,5053,1135,571,1955,704,35825,242,11347,10212,5751,18150
2021-09-02 10:00:00+00,17229,955,4462,3587,270,5089,1125,639,2369,396,36121,241,11813,10688,6226,18184
2021-09-02 10:30:00+00,16936,801,4460,3696,210,5031,1135,649,2656,298,35872,235,12157,11022,6562,17737
2021-09-02 11:00:00+00,16774,751,4462,3726,84,5016,1139,671,3023,366,36013,231,12434,11295,6833,17525
2021-09-02 11:30:00+00,16960,880,4459,3693,72,5003,1138,613,3313,362,36493,233,12675,11537,7078,17840
2021-09-02 12:00:00+00,17032,999,4377,3657,65,4971,1140,473,3583,290,36587,235,12822,11682,7305,18031
2021-09-02 12:30:00+00,16570,972,4337,3626,62,4956,1140,408,3811,234,36117,232,12976,11836,7499,17542
2021-09-02 13:00:00+00,16464,987,4295,3636,113,4929,1141,347,4065,254,36231,230,13250,12109,7814,17451
2021-09-02 13:30:00+00,16632,879,4099,3511,125,4917,1138,461,4103,176,36041,231,12976,11838,7739,17511
2021-09-02 14:00:00+00,16629,853,4109,3526,100,4924,1275,418,3924,228,35986,233,12934,11659,7550,17482
2021-09-02 14:30:00+00,16587,877,4233,3435,77,4914,1444,407,3548,216,35738,235,12737,11293,7060,17464
2021-09-02 15:00:00+00,16645,739,4275,3407,113,4971,1553,458,3164,386,35711,233,12512,10959,6684,17384
2021-09-02 15:30:00+00,16910,746,4472,3306,116,4965,1516,562,2795,604,35993,235,12205,10689,6217,17656
2021-09-02 16:00:00+00,17074,745,4527,3425,321,4772,1545,579,2191,452,35631,239,12009,10464,5937,17819
2021-09-02 16:30:00+00,16893,886,4526,3722,344,4766,1559,657,1561,826,35740,240,11712,10153,5627,17779
2021-09-02 17:00:00+00,16417,987,4528,3734,379,4768,1560,673,943,940,34929,243,11144,9584,5056,17404
2021-09-02 17:30:00+00,16446,996,4529,3695,394,4768,1563,698,444,762,34295,249,10625,9062,4533,17442
2021-09-02 18:00:00+00,16289,1001,4529,3592,352,4780,1562,723,109,744,33681,252,10144,8582,4053,17290
2021-09-02 18:30:00+00,16373,997,4524,3626,370,4818,1443,724,2,774,33651,253,9965,8522,3998,17370
2021-09-02 19:00:00+00,16591,999,4525,3757,318,5020,1161,733,0,760,33864,254,9761,8600,4075,17590
2021-09-02 19:30:00+00,16412,999,4455,3901,283,4972,1157,730,0,520,33429,255,9796,8639,4184,17411
2021-09-02 20:00:00+00,15984,947,4340,4106,111,5026,1154,652,0,16,32336,254,9711,8557,4217,16931
2021-09-02 20:30:00+00,15416,846,4236,4148,105,5026,1154,425,0,0,31356,249,9643,8489,4253,16262
2021-09-02 21:00:00+00,15109,686,4071,4119,105,4942,1153,158,0,0,30343,245,9448,8295,4224,15795
2021-09-02 21:30:00+00,13718,568,4059,4197,101,4942,1151,123,0,0,28859,234,9508,8357,4298,14286
2021-09-02 22:00:00+00,12738,596,4066,4139,77,4998,1128,123,0,0,27865,230,9410,8282,4216,13334
2021-09-02 22:30:00+00,11418,468,4111,4067,69,4990,1153,123,0,0,26399,219,9400,8247,4136,11886
2021-09-02 23:00:00+00,10691,477,4387,3929,46,4516,1154,118,0,0,25318,215,9516,8362,3975,11168
2021-09-02 23:30:00+00,10476,489,4466,3628,46,4510,1154,120,0,0,24889,215,9294,8140,3674,10965
2021-09-03 00:00:00+00,10458,514,4466,3434,46,4510,1155,118,0,0,24701,216,9101,7946,3480,10972
2021-09-03 00:30:00+00,10452,511,4461,3141,46,4508,1155,118,0,0,24392,219,8803,7648,3187,10963
2021-09-03 01:00:00+00,10090,559,4377,3016,46,4352,1154,115,0,0,23709,221,8593,7439,3062,10649
2021-09-03 01:30:00+00,9987,519,4331,2890,46,4350,1155,117,0,0,23395,220,8422,7267,2936,10506
2021-09-03 02:00:00+00,10327,470,4335,2768,46,4348,1156,116,0,0,23566,222,8305,7149,2814,10797
2021-09-03 02:30:00+00,10229,470,4334,2721,46,4348,1157,116,0,0,23421,222,8258,7101,2767,10699
2021-09-03 03:00:00+00,10282,466,4444,2681,46,4332,1151,116,0,0,23518,222,8322,7171,2727,10748
2021-09-03 03:30:00+00,10302,469,4523,2703,46,4332,1154,116,0,0,23645,221,8426,7272,2749,10771
2021-09-03 04:00:00+00,11212,649,4481,2770,46,3808,1062,118,0,0,24146,233,8359,7297,2816,11861
2021-09-03 04:30:00+00,11680,966,4280,2753,49,3798,1061,116,0,0,24703,247,8143,7082,2802,12646
2021-09-03 05:00:00+00,13148,966,4252,2651,72,3828,1118,122,0,0,26157,254,8093,6975,2723,14114
2021-09-03 05:30:00+00,14221,999,4253,2726,73,3844,1178,277,19,0,27590,259,8249,7071,2818,15220
2021-09-03 06:00:00+00,14569,997,4273,2798,91,4716,1332,357,145,126,29404,257,8639,7307,3034,15566
2021-09-03 06:30:00+00,15154,1000,4480,2731,113,4740,1618,489,378,344,31047,255,9320,7702,3222,16154
2021-09-03 07:00:00+00,15273,1000,4533,2704,138,5046,1735,639,670,498,32236,250,9780,8045,3512,16273
2021-09-03 07:30:00+00,15566,998,4529,2611,142,5028,1736,725,1111,864,33310,246,10129,8393,3864,16564
2021-09-03 08:00:00+00,15651,998,4531,2550,164,4998,1787,771,1615,984,34049,242,10647,8860,4329,16649
2021-09-03 08:30:00+00,15667,1001,4531,2485,168,4998,1790,799,2064,686,34189,242,11038,9248,4717,16668
2021-09-03 09:00:00+00,15877,999,4530,2373,174,5000,1775,760,2438,404,34330,243,11290,9515,4985,16876
2021-09-03 09:30:00+00,15816,995,4531,2324,162,5000,1735,700,2924,466,34653,239,11676,9941,5410,16811
2021-09-03 10:00:00+00,15911,995,4529,2138,89,5000,1734,691,3428,630,35145,237,11918,10184,5655,16906
2021-09-03 10:30:00+00,15895,996,4530,2042,87,4998,1734,748,3815,456,35301,236,12208,10474,5944,16891
2021-09-03 11:00:00+00,16062,1000,4532,1975,87,5000,1765,728,3885,246,35280,238,12244,10479,5947,17062
2021-09-03 11:30:00+00,16057,1000,4458,1973,88,5000,1780,747,4139,348,35590,236,12438,10658,6200,17057
2021-09-03 12:00:00+00,16052,998,4246,2040,77,5000,1787,754,4159,322,35435,237,12309,10522,6276,17050
2021-09-03 12:30:00+00,15668,988,4074,2118,77,4998,1788,588,4367,294,34960,233,12424,10636,6562,16656
2021-09-03 13:00:00+00,15648,893,4068,2139,77,5000,1787,485,4328,266,34691,232,12399,10612,6544,16541
2021-09-03 13:30:00+00,15683,727,4066,2258,76,4998,1786,434,4327,94,34449,229,12513,10727,6661,16410
2021-09-03 14:00:00+00,15565,728,4073,2374,77,4998,1786,267,4192,42,34102,228,12502,10716,6643,16293
2021-09-03 14:30:00+00,15645,728,4244,2480,77,5000,1785,283,3858,0,34100,230,12444,10659,6415,16373
2021-09-03 15:00:00+00,15724,728,4294,2662,127,5020,1780,383,3365,104,34187,231,12228,10448,6154,16452
2021-09-03 15:30:00+00,15776,728,4292,2771,157,5018,1781,779,2931,346,34579,233,11932,10151,5859,16504
2021-09-03 16:00:00+00,15744,728,4397,2864,328,5018,1788,784,2259,756,34666,231,11636,9848,5451,16472
2021-09-03 16:30:00+00,16037,728,4418,2855,349,5020,1792,779,1577,788,34343,237,10991,9199,4781,16765
2021-09-03 17:00:00+00,15961,728,4419,2984,348,5020,1792,780,981,890,33903,240,10524,8732,4313,16689
2021-09-03 17:30:00+00,16243,729,4412,3076,349,5020,1674,789,452,804,33548,245,9963,8289,3877,16972
2021-09-03 18:00:00+00,16441,727,4418,3139,325,5018,1556,780,109,794,33307,248,9547,7991,3573,17168
2021-09-03 18:30:00+00,16411,705,4418,3093,316,5018,1558,777,0,750,33046,249,9385,7827,3409,17116
2021-09-03 19:00:00+00,16380,645,4414,3180,315,5016,1561,771,0,814,33096,247,9470,7909,3495,17025
2021-09-03 19:30:00+00,16267,664,4416,3149,306,5018,1559,707,0,456,32542,250,9430,7871,3455,16931
2021-09-03 20:00:00+00,16148,695,4421,3042,127,4998,1624,521,0,124,31700,254,9214,7590,3169,16843
2021-09-03 20:30:00+00,15610,667,4422,2926,103,4998,1441,290,0,114,30571,251,8892,7451,3029,16277
2021-09-03 21:00:00+00,15228,608,4415,2879,78,5000,1146,194,0,0,29548,250,8518,7372,2957,15836
2021-09-03 21:30:00+00,14199,338,4403,2768,78,4992,1150,121,0,0,28049,239,8399,7249,2846,14537
2021-09-03 22:00:00+00,12974,279,4400,2770,59,4518,1152,121,0,0,26273,233,8381,7229,2829,13253
2021-09-03 22:30:00+00,11588,230,4405,2848,57,4504,1148,122,0,0,24902,222,8458,7310,2905,11818
2021-09-03 23:00:00+00,10808,234,4390,2738,47,4220,1149,125,0,0,23711,219,8324,7175,2785,11042
2021-09-03 23:30:00+00,10154,235,4377,2750,47,4216,1149,125,0,0,23053,214,8323,7174,2797,10389
2021-09-04 00:00:00+00,9680,235,4371,2808,47,4218,1146,125,0,0,22630,209,8372,7226,2855,9915
2021-09-04 00:30:00+00,9675,237,4403,2751,47,4218,1149,126,0,0,22606,210,8350,7201,2798,9912
2021-09-04 01:00:00+00,9580,232,4421,2660,47,4218,1153,125,0,0,22436,209,8281,7128,2707,9812
2021-09-04 01:30:00+00,9588,229,4350,2656,47,4218,1142,124,0,0,22354,210,8195,7053,2703,9817
2021-09-04 02:00:00+00,9629,230,4286,2691,47,4020,1145,125,0,0,22173,211,8169,7024,2738,9859
2021-09-04 02:30:00+00,9579,229,4287,2636,47,4018,1150,125,0,0,22071,211,8120,6970,2683,9808
2021-09-04 03:00:00+00,9515,250,4283,2622,47,4018,1150,121,0,0,22006,212,8102,6952,2669,9765
2021-09-04 03:30:00+00,9530,278,4286,2648,46,4018,1151,118,0,0,22075,212,8131,6980,2694,9808
2021-09-04 04:00:00+00,9811,247,4286,2669,46,4018,1152,120,0,0,22349,214,8153,7001,2715,10058
2021-09-04 04:30:00+00,9838,243,4340,2813,46,4016,1144,118,0,0,22558,212,8343,7199,2859,10081
2021-09-04 05:00:00+00,9626,229,4468,2980,75,4210,1156,124,0,0,22868,206,8679,7523,3055,9855
2021-09-04 05:30:00+00,9858,230,4492,3073,75,4216,1220,124,26,0,23314,206,8886,7666,3174,10088
2021-09-04 06:00:00+00,10642,270,4486,3246,75,4308,1505,130,216,0,24878,209,9528,8023,3537,10912
2021-09-04 06:30:00+00,11012,262,4491,3388,90,4312,1723,125,568,0,25971,206,10260,8537,4046,11274
2021-09-04 07:00:00+00,12366,246,4484,3491,105,4508,1743,123,1036,0,28102,210,10859,9116,4632,12612
2021-09-04 07:30:00+00,12838,476,4488,3552,117,4516,1745,128,1590,0,29450,214,11492,9747,5259,13314
2021-09-04 08:00:00+00,12557,715,4493,3471,213,4990,1744,173,2208,14,30578,213,12129,10385,5892,13272
2021-09-04 08:30:00+00,12796,746,4509,3422,212,4998,1733,139,2746,0,31301,211,12622,10889,6380,13542
2021-09-04 09:00:00+00,12634,731,4500,3525,194,5000,1743,128,3409,0,31864,205,13371,11628,7128,13365
2021-09-04 09:30:00+00,12604,638,4502,3340,172,4994,1746,173,3746,38,31953,202,13506,11760,7258,13242
2021-09-04 10:00:00+00,12581,835,4506,3235,86,4694,1764,225,4102,18,32046,207,13693,11929,7423,13416
2021-09-04 10:30:00+00,12403,845,4506,3261,86,4688,1760,269,4130,0,31948,206,13743,11983,7477,13248
2021-09-04 11:00:00+00,12415,880,4506,3125,70,4752,1769,270,4293,0,32080,206,13763,11994,7488,13295
2021-09-04 11:30:00+00,12458,819,4501,2988,70,4754,1766,258,4407,0,32021,205,13732,11966,7465,13277
2021-09-04 12:00:00+00,12502,833,4505,2991,64,4510,1766,311,4551,0,32033,206,13877,12111,7606,13335
2021-09-04 12:30:00+00,12253,774,4509,3001,60,4508,1767,248,4387,0,31507,204,13724,11957,7448,13027
2021-09-04 13:00:00+00,11882,707,4515,2944,60,4988,1588,139,4016,0,30839,201,13123,11535,7020,12589
2021-09-04 13:30:00+00,11952,502,4495,3004,60,4998,1575,130,3833,0,30549,197,12967,11392,6897,12454
2021-09-04 14:00:00+00,12116,465,4374,2999,60,4998,1566,122,3716,0,30416,199,12715,11149,6775,12581
2021-09-04 14:30:00+00,12253,484,4341,3040,60,4998,1562,126,3146,0,30010,204,12149,10587,6246,12737
2021-09-04 15:00:00+00,12490,549,4348,3112,69,4998,1737,212,2746,6,30267,209,12012,10275,5927,13039
2021-09-04 15:30:00+00,12727,674,4366,3067,79,5000,1793,295,2318,38,30357,217,11623,9830,5464,13401
2021-09-04 16:00:00+00,13029,727,4480,3184,143,5046,1782,507,1803,216,30917,221,11392,9610,5130,13756
2021-09-04 16:30:00+00,13453,729,4523,3351,172,5044,1774,537,1334,300,31217,224,11154,9380,4857,14182
2021-09-04 17:00:00+00,13581,729,4518,3390,222,5048,1774,658,836,602,31358,226,10740,8966,4448,14310
2021-09-04 17:30:00+00,13539,703,4519,3478,233,5046,1689,661,440,714,31022,227,10359,8670,4151,14242
2021-09-04 18:00:00+00,13397,684,4519,3470,240,5026,1642,641,106,832,30557,227,9977,8335,3816,14081
2021-09-04 18:30:00+00,13253,653,4526,3516,238,5024,1552,599,0,778,30139,227,9832,8280,3754,13906
2021-09-04 19:00:00+00,13492,689,4523,3701,238,5048,1553,592,0,642,30478,228,10015,8462,3939,14181
2021-09-04 19:30:00+00,13182,596,4523,3802,194,5046,1550,506,0,566,29965,225,10069,8519,3996,13778
2021-09-04 20:00:00+00,13312,607,4522,3819,85,4934,1387,240,0,94,29000,229,9813,8426,3904,13919
2021-09-04 20:30:00+00,12877,573,4521,3886,69,4930,1152,130,0,0,28138,227,9628,8476,3955,13450
2021-09-04 21:00:00+00,12701,352,4519,3827,70,4682,1144,116,0,0,27411,221,9560,8416,3897,13053
2021-09-04 21:30:00+00,11624,242,4521,3875,69,4672,1144,115,0,0,26262,211,9609,8465,3944,11866
2021-09-04 22:00:00+00,10427,381,4522,3816,56,4268,1150,119,0,0,24739,209,9544,8394,3872,10808
2021-09-04 22:30:00+00,9476,336,4519,3731,56,4262,1149,121,0,0,23650,201,9455,8306,3787,9812
2021-09-04 23:00:00+00,8877,334,4523,3640,46,4018,1148,119,0,0,22705,198,9357,8209,3686,9211
2021-09-04 23:30:00+00,8630,287,4519,3486,46,4014,1149,120,0,0,22251,195,9200,8051,3532,8917
2021-09-05 00:00:00+00,8604,334,4515,3420,46,3776,1092,114,0,0,21901,198,9073,7981,3466,8938
2021-09-05 00:30:00+00,8664,249,4520,3370,46,3774,1149,114,0,0,21886,196,9085,7936,3416,8913
2021-09-05 01:00:00+00,8532,231,4539,3420,46,3776,1147,113,0,0,21804,194,9152,8005,3466,8763
2021-09-05 01:30:00+00,8358,234,4542,3397,46,3774,1143,113,0,0,21607,192,9128,7985,3443,8592
2021-09-05 02:00:00+00,8165,241,4544,3311,46,3776,1146,114,0,0,21343,191,9047,7901,3357,8406
2021-09-05 02:30:00+00,8099,274,4547,3208,46,3774,1145,115,0,0,21208,193,8946,7801,3254,8373
2021-09-05 03:00:00+00,8054,291,4565,3091,46,3776,1145,145,0,0,21113,194,8847,7702,3137,8345
2021-09-05 03:30:00+00,7923,372,4569,3070,46,3774,1150,226,0,0,21130,196,8835,7685,3116,8295
2021-09-05 04:00:00+00,7959,330,4569,3125,46,3776,1151,139,0,0,21095,194,8891,7740,3171,8289
2021-09-05 04:30:00+00,8061,330,4570,3206,46,3776,1150,114,0,0,21253,194,8972,7822,3252,8391
2021-09-05 05:00:00+00,8520,330,4568,3209,46,3776,1150,161,0,0,21760,199,8973,7823,3255,8850
2021-09-05 05:30:00+00,8648,318,4574,3272,46,3776,1150,229,84,0,22097,198,9126,7976,3402,8966
2021-09-05 06:00:00+00,9037,252,4571,3342,46,4012,1152,116,500,0,23028,194,9611,8459,3888,9289
2021-09-05 06:30:00+00,9547,230,4572,3288,46,4018,1146,117,1046,0,24010,194,10098,8952,4380,9777
2021-09-05 07:00:00+00,10263,238,4572,3323,99,4260,1151,120,1627,0,25653,194,10772,9621,5049,10501
2021-09-05 07:30:00+00,10886,373,4574,3355,122,4264,1150,117,2326,0,27167,197,11527,10377,5803,11259
2021-09-05 08:00:00+00,11407,493,4574,3306,137,4506,1151,143,2915,0,28632,199,12083,10932,6358,11900
2021-09-05 08:30:00+00,11880,408,4574,3217,140,4512,1154,268,3738,0,29891,196,12823,11669,7095,12288
2021-09-05 09:00:00+00,11643,328,4581,3158,192,4750,1203,293,4596,0,30744,186,13730,12527,7946,11971
2021-09-05 09:30:00+00,11198,258,4579,3211,177,4756,1391,326,5420,0,31316,176,14778,13387,8808,11456
2021-09-05 10:00:00+00,10801,251,4579,3239,160,4996,1601,138,6151,0,31916,168,15730,14129,9550,11052
2021-09-05 10:30:00+00,10590,242,4576,3355,79,5000,1592,118,6778,0,32330,162,16380,14788,10212,10832
2021-09-05 11:00:00+00,10528,255,4584,3286,62,4998,1571,119,7217,0,32620,160,16720,15149,10565,10783
2021-09-05 11:30:00+00,10308,251,4587,3251,60,5000,1553,123,7375,0,32508,158,16826,15273,10686,10559
2021-09-05 12:00:00+00,10148,232,4588,3200,60,4998,1546,121,7588,0,32481,156,16982,15436,10848,10380
2021-09-05 12:30:00+00,10022,264,4475,3106,59,5000,1549,122,7543,54,32194,157,16732,15183,10708,10286
2021-09-05 13:00:00+00,10086,313,4405,3063,47,4998,1546,117,7272,0,31847,160,16333,14787,10382,10399
2021-09-05 13:30:00+00,10386,234,4399,2939,46,4998,1636,119,6783,0,31540,164,15803,14167,9768,10620
2021-09-05 14:00:00+00,11004,230,4423,2890,46,5000,1638,117,6188,0,31536,171,15185,13547,9124,11234
2021-09-05 14:30:00+00,11631,305,4528,2824,46,4998,1641,118,5417,0,31508,182,14456,12815,8287,11936
2021-09-05 15:00:00+00,12397,430,4560,2860,68,5046,1628,137,4663,24,31813,194,13779,12151,7591,12827
2021-09-05 15:30:00+00,13096,519,4564,2900,81,5046,1628,426,3681,176,32117,206,12854,11226,6662,13615
2021-09-05 16:00:00+00,13700,705,4558,2722,171,5046,1625,578,2864,590,32559,217,11940,10315,5757,14405
2021-09-05 16:30:00+00,14084,920,4560,2585,192,5048,1625,778,2003,606,32401,231,10965,9340,4780,15004
2021-09-05 17:00:00+00,14557,985,4562,2502,253,5046,1627,830,1196,514,32072,241,10140,8513,3951,15542
2021-09-05 17:30:00+00,14951,987,4559,2444,254,5046,1590,829,545,674,31879,248,9392,7802,3243,15938
2021-09-05 18:00:00+00,15107,981,4556,2419,259,5046,1526,738,116,864,31612,251,8876,7350,2794,16088
2021-09-05 18:30:00+00,15184,927,4559,2335,268,5048,1525,591,0,872,31309,251,8687,7162,2603,16111
2021-09-05 19:00:00+00,15303,982,4556,2228,241,5018,1411,560,0,1164,31463,253,8436,7025,2469,16285
2021-09-05 19:30:00+00,15211,989,4542,2185,205,5016,1122,543,0,1256,31069,254,8054,6932,2390,16200
2021-09-05 20:00:00+00,14868,988,4418,2084,101,4980,1124,473,0,638,29674,260,7727,6603,2185,15856
2021-09-05 20:30:00+00,14754,918,4393,1933,82,4978,1125,289,0,248,28720,262,7533,6408,2015,15672
2021-09-05 21:00:00+00,14356,757,4393,1853,83,4998,1119,118,0,126,27803,257,7448,6329,1936,15113
2021-09-05 21:30:00+00,13385,661,4448,1815,88,4990,1115,116,0,0,26618,251,7466,6351,1903,14046
2021-09-05 22:00:00+00,12849,724,4552,1793,78,4512,1116,114,0,0,25738,251,7539,6423,1871,13573
2021-09-05 22:30:00+00,11928,649,4561,1696,79,4508,1112,113,0,0,24646,245,7448,6336,1775,12577
2021-09-05 23:00:00+00,11484,617,4567,1638,79,4506,1112,114,0,0,24117,242,7396,6284,1717,12101
2021-09-05 23:30:00+00,11215,583,4572,1487,79,4508,1113,113,0,0,23670,241,7251,6138,1566,11798
2021-09-06 00:00:00+00,11123,475,4566,1324,79,4508,1114,115,0,0,23304,241,7083,5969,1403,11598
2021-09-06 00:30:00+00,11006,469,4567,1241,79,4512,1114,114,0,0,23102,241,7001,5887,1320,11475
2021-09-06 01:00:00+00,10889,465,4563,1159,79,4516,1119,119,0,0,22908,241,6920,5801,1238,11354
2021-09-06 01:30:00+00,10722,472,4562,1064,79,4519,1119,121,0,0,22658,241,6824,5705,1143,11194
2021-09-06 02:00:00+00,10465,460,4564,1004,79,4521,1119,120,0,0,22332,240,6766,5647,1083,10925
2021-09-06 02:30:00+00,10414,460,4543,944,79,4521,1117,119,0,0,22197,240,6683,5566,1023,10874
2021-09-06 03:00:00+00,10854,464,4418,960,79,4287,1230,116,0,0,22408,245,6687,5457,1039,11318
2021-09-06 03:30:00+00,10565,659,4396,938,79,4282,1449,113,0,0,22481,249,6862,5413,1017,11224
2021-09-06 04:00:00+00,10782,764,4395,916,92,3942,1586,117,0,0,22594,252,6989,5403,1008,11546
2021-09-06 04:30:00+00,11185,675,4447,899,92,3944,1751,120,0,0,23113,251,7189,5438,991,11860
2021-09-06 05:00:00+00,12372,731,4559,850,92,4442,1751,152,0,0,24949,261,7252,5501,942,13103
2021-09-06 05:30:00+00,13709,917,4567,837,92,4214,1730,154,53,0,26273,277,7279,5549,982,14626
2021-09-06 06:00:00+00,15322,958,4562,854,92,4096,1735,304,342,344,28609,280,7585,5850,1288,16280
2021-09-06 06:30:00+00,16121,947,4564,838,300,4080,1774,393,795,616,30428,274,8271,6497,1933,17068
2021-09-06 07:00:00+00,16311,1063,4566,832,350,4542,1777,437,1431,582,31891,268,8956,7179,2613,17374
2021-09-06 07:30:00+00,16479,1136,4567,850,326,4524,1771,414,2186,512,32765,264,9700,7929,3362,17615
2021-09-06 08:00:00+00,16564,1234,4566,832,389,4524,1772,453,2941,652,33927,259,10500,8728,4162,17798
2021-09-06 08:30:00+00,16629,1124,4571,794,494,4522,1772,405,3528,492,34330,254,11158,9386,4816,17753
2021-09-06 09:00:00+00,16330,1124,4564,876,377,4522,1770,345,4149,308,34365,250,11736,9966,5402,17454
2021-09-06 09:30:00+00,15852,1235,4561,1030,293,4520,1775,325,4891,346,34828,243,12550,10775,6214,17087
2021-09-06 10:00:00+00,15765,1306,4484,1137,321,4522,1768,318,5730,714,36065,236,13440,11672,7188,17071
2021-09-06 10:30:00+00,15919,1247,4396,1196,279,4524,1770,336,6094,416,36177,236,13735,11965,7569,17166
2021-09-06 11:00:00+00,15970,1247,4395,1225,119,4524,1768,307,6308,384,36247,236,13815,12047,7652,17217
2021-09-06 11:30:00+00,15739,1277,4391,1365,119,4522,1768,301,6400,644,36526,232,14043,12275,7884,17016
2021-09-06 12:00:00+00,15728,1332,4507,1559,132,4524,1763,303,6455,368,36671,233,14416,12653,8146,17060
2021-09-06 12:30:00+00,15601,1405,4563,1651,82,4524,1766,274,6701,94,36661,233,14763,12997,8434,17006
2021-09-06 13:00:00+00,15308,1423,4562,1746,76,4522,1766,303,6580,56,36342,232,14730,12964,8402,16731
2021-09-06 13:30:00+00,14782,1506,4584,1892,75,4524,1768,404,6312,42,35889,232,14631,12863,8279,16288
2021-09-06 14:00:00+00,14530,1529,4609,1986,76,4524,1769,472,6041,352,35888,231,14481,12712,8103,16059
2021-09-06 14:30:00+00,14911,1580,4627,2134,215,4522,1768,434,5455,420,36066,235,14199,12431,7804,16491
2021-09-06 15:00:00+00,15633,1627,4628,2241,465,4542,1767,587,4544,0,36034,246,13645,11878,7250,17260
2021-09-06 15:30:00+00,15512,1714,4633,2395,525,4542,1768,755,3858,246,35948,249,13179,11411,6778,17226
2021-09-06 16:00:00+00,15524,1763,4627,2406,522,4458,1771,858,2944,1158,36031,249,12270,10499,5872,17287
2021-09-06 16:30:00+00,15661,1957,4651,2437,523,4458,1770,881,2124,1738,36200,255,11505,9735,5084,17618
2021-09-06 17:00:00+00,16120,1969,4687,2376,540,4458,1769,1080,1297,1222,35518,266,10669,8900,4213,18089
2021-09-06 17:30:00+00,16095,1942,4717,2463,538,4458,1771,1133,576,1016,34709,272,10065,8294,3577,18037
2021-09-06 18:00:00+00,15985,1730,4722,2424,535,4458,1774,1091,102,1514,34335,267,9557,7783,3061,17715
2021-09-06 18:30:00+00,16228,1776,4723,2426,537,4458,1773,990,0,1348,34259,271,9459,7686,2963,18004
2021-09-06 19:00:00+00,16038,1706,4724,2673,596,4458,1776,1044,0,1472,34487,265,9769,7993,3269,17744
2021-09-06 19:30:00+00,15551,1594,4734,2816,481,4458,1775,1067,0,1394,33870,261,9806,8031,3297,17145
2021-09-06 20:00:00+00,15088,1519,4749,2970,394,4522,1778,757,0,816,32593,263,9891,8113,3364,16607
2021-09-06 20:30:00+00,14934,1171,4768,3146,231,4520,1775,576,0,166,31287,260,9920,8145,3377,16105
2021-09-06 21:00:00+00,14173,947,4788,3379,254,4404,1779,162,0,26,29912,249,10200,8421,3633,15120
2021-09-06 21:30:00+00,12992,707,4809,3465,252,4404,1777,115,0,0,28521,236,10303,8526,3717,13699
2021-09-06 22:00:00+00,12190,836,4820,3386,250,4494,1781,116,0,0,27873,234,10237,8456,3636,13026
2021-09-06 22:30:00+00,11436,706,4827,3231,217,4490,1782,114,0,0,26803,227,10057,8275,3448,12142
2021-09-06 23:00:00+00,11125,730,4839,3017,161,4278,1768,115,0,0,26033,228,9785,8017,3178,11855
2021-09-06 23:30:00+00,10750,619,4855,2930,156,4274,1766,113,0,0,25463,224,9707,7941,3086,11369
2021-09-07 00:00:00+00,10402,460,4864,2872,156,4048,1771,114,0,0,24687,216,9663,7892,3028,10862
2021-09-07 00:30:00+00,10395,467,4867,2635,155,4048,1780,115,0,0,24462,218,9437,7657,2790,10862
2021-09-07 01:00:00+00,10033,463,4877,2447,137,3944,1780,120,0,0,23801,217,9241,7461,2584,10496
2021-09-07 01:30:00+00,10170,480,4874,2315,136,3944,1779,120,0,0,23818,220,9104,7325,2451,10650
2021-09-07 02:00:00+00,10267,467,4884,2225,136,3892,1778,119,0,0,23768,221,9023,7245,2361,10734
2021-09-07 02:30:00+00,10169,461,4886,1978,135,3894,1781,119,0,0,23423,222,8780,6999,2113,10630
2021-09-07 03:00:00+00,10408,478,4889,1821,135,3724,1782,115,0,0,23352,224,8627,6845,1956,10886
2021-09-07 03:30:00+00,10677,465,4888,1634,135,3648,1781,113,0,0,23341,227,8438,6657,1769,11142
2021-09-07 04:00:00+00,12306,514,4894,1610,135,2616,1785,114,0,0,23974,237,8424,6639,1745,12820
2021-09-07 04:30:00+00,12872,661,4894,1599,134,2600,1782,113,0,0,24655,245,8409,6627,1733,13533
2021-09-07 05:00:00+00,14249,688,4892,1531,135,3308,1784,114,0,0,26701,256,8342,6558,1666,14937
2021-09-07 05:30:00+00,15190,844,4899,1459,154,3370,1780,119,51,0,27866,265,8343,6563,1664,16034
2021-09-07 06:00:00+00,16182,919,4908,1442,161,4302,1780,194,459,228,30575,268,8750,6970,2062,17101
2021-09-07 06:30:00+00,16740,996,4917,1343,128,4322,1780,286,1186,324,32022,267,9354,7574,2657,17736
2021-09-07 07:00:00+00,17099,994,4914,1268,286,4396,1777,565,2059,326,33684,261,10304,8527,3613,18093
2021-09-07 07:30:00+00,16974,944,4916,1338,415,4398,1778,558,2982,142,34445,252,11429,9651,4735,17918
2021-09-07 08:00:00+00,16946,949,4914,1391,225,4520,1775,616,3929,260,35525,245,12234,10459,5545,17895
2021-09-07 08:30:00+00,16691,944,4926,1367,215,4522,1775,536,4824,170,35970,238,13107,11332,6406,17635
2021-09-07 09:00:00+00,16560,948,4939,1307,164,4524,1767,283,5669,200,36361,232,13846,12079,7140,17508
2021-09-07 09:30:00+00,16672,890,4947,1266,164,4524,1773,237,6459,0,36932,229,14609,12836,7889,17562
2021-09-07 10:00:00+00,16494,852,4962,1351,132,4522,1770,240,7100,0,37423,222,15315,13545,8583,17346
2021-09-07 10:30:00+00,16494,846,4968,1449,109,4524,1768,222,7567,0,37947,219,15861,14093,9125,17340
2021-09-07 11:00:00+00,16589,882,4966,1543,107,4524,1771,285,7882,96,38645,217,16269,14498,9532,17471
2021-09-07 11:30:00+00,16379,851,4895,1637,287,4522,1771,368,8065,62,38837,214,16655,14884,9989,17230
2021-09-07 12:00:00+00,16329,766,4902,1631,315,4524,1767,347,8055,56,38692,212,16670,14903,10001,17095
2021-09-07 12:30:00+00,16362,653,4912,1672,136,4522,1763,328,7922,26,38296,212,16405,14642,9730,17015
2021-09-07 13:00:00+00,16370,482,4915,1775,79,4524,1711,272,7604,298,38030,208,16084,14373,9458,16852
2021-09-07 13:30:00+00,16170,475,4924,1758,237,4524,1312,361,7134,618,37513,208,15365,14053,9129,16645
2021-09-07 14:00:00+00,16253,596,4933,1794,280,4524,1120,651,6474,324,36949,217,14601,13481,8548,16849
2021-09-07 14:30:00+00,16502,530,4943,1865,304,4520,1118,732,5731,442,36687,220,13961,12843,7900,17032
2021-09-07 15:00:00+00,16775,466,4966,1937,360,4390,1104,833,4962,1044,36837,221,13329,12225,7259,17241
2021-09-07 15:30:00+00,16812,473,4984,2056,492,4390,1081,875,4074,1790,37027,220,12687,11606,6622,17285
2021-09-07 16:00:00+00,17279,464,4993,2103,641,4262,1104,880,3156,1966,36848,227,11997,10893,5900,17743
2021-09-07 16:30:00+00,17509,539,5015,2368,643,4262,1143,926,2205,1940,36550,235,11374,10231,5216,18048
2021-09-07 17:00:00+00,17344,633,5032,2582,692,4269,1112,938,1298,1816,35716,241,10716,9604,4572,17977
2021-09-07 17:30:00+00,17226,582,5036,2787,624,4278,1124,939,573,1890,35059,242,10144,9020,3984,17808
2021-09-07 18:00:00+00,16680,458,5042,3099,514,4462,1117,944,93,1536,33944,238,9865,8748,3706,17138
2021-09-07 18:30:00+00,16306,450,5039,3473,535,4509,1120,948,0,1854,34234,233,10167,9047,4008,16756
2021-09-07 19:00:00+00,16588,230,5053,3752,457,4650,1115,840,0,1492,34177,232,10377,9262,4209,16818
2021-09-07 19:30:00+00,16498,147,5060,3921,457,4597,1116,754,0,556,33106,235,10554,9438,4378,16645
2021-09-07 20:00:00+00,15949,0,5061,4144,239,4568,1121,385,0,818,32285,226,10565,9444,4383,15949
2021-09-07 20:30:00+00,15467,0,5074,4227,130,4524,1120,231,0,12,30785,228,10551,9431,4357,15467
2021-09-07 21:00:00+00,14224,0,5110,4245,286,4522,1119,129,0,0,29635,218,10760,9641,4531,14224
2021-09-07 21:30:00+00,13005,0,5158,4254,284,4516,1120,118,0,0,28455,209,10816,9696,4538,13005
2021-09-07 22:00:00+00,11985,0,5189,4253,269,4206,1117,119,0,0,27138,203,10828,9711,4522,11985
2021-09-07 22:30:00+00,10798,0,5201,4237,268,4202,1117,119,0,0,25942,194,10823,9706,4505,10798
2021-09-07 23:00:00+00,10179,0,5211,4189,235,4106,1103,115,0,0,25138,190,10738,9635,4424,10179
2021-09-07 23:30:00+00,9808,0,5217,4137,234,4102,1105,115,0,0,24718,187,10693,9588,4371,9808
2021-09-08 00:00:00+00,9520,0,5224,4099,232,3910,1108,114,0,0,24207,184,10663,9555,4331,9520
2021-09-08 00:30:00+00,9367,0,5228,3774,232,3908,1110,115,0,0,23734,185,10344,9234,4006,9367
2021-09-08 01:00:00+00,9710,0,5231,3673,230,3908,1113,114,0,0,23979,189,10247,9134,3903,9710
2021-09-08 01:30:00+00,9644,0,5230,3486,230,3910,1113,114,0,0,23727,190,10059,8946,3716,9644
2021-09-08 02:00:00+00,9584,0,5228,3356,230,3908,1116,114,0,0,23536,190,9930,8814,3586,9584
2021-09-08 02:30:00+00,9706,0,5227,3248,225,3908,1109,115,0,0,23538,192,9809,8700,3473,9706
2021-09-08 03:00:00+00,9786,2,5229,3186,230,3908,1109,116,0,0,23566,193,9754,8645,3416,9788
2021-09-08 03:30:00+00,9771,150,5231,3183,230,3910,1108,115,0,0,23698,198,9752,8644,3413,9921
2021-09-08 04:00:00+00,9956,426,5231,3259,230,3158,1104,115,0,0,23479,207,9824,8720,3489,10382
2021-09-08 04:30:00+00,10075,541,5228,3253,226,3176,1101,118,0,0,23718,212,9808,8707,3479,10616
2021-09-08 05:00:00+00,11532,780,5226,3254,170,3438,1102,122,0,0,25624,226,9752,8650,3424,12312
2021-09-08 05:30:00+00,13399,880,5227,3209,98,3400,1102,118,45,0,27478,240,9681,8579,3352,14279
2021-09-08 06:00:00+00,14638,948,5228,3063,108,4220,1103,123,449,2,29882,248,9951,8848,3620,15586
2021-09-08 06:30:00+00,15173,996,5224,3039,107,4270,1100,459,1220,258,31846,245,10690,9590,4366,16169
2021-09-08 07:00:00+00,15171,995,5227,2989,125,4596,1099,573,2067,664,33506,235,11507,10408,5181,16166
2021-09-08 07:30:00+00,15095,994,5224,2955,141,4536,1099,631,2922,570,34167,230,12341,11242,6018,16089
2021-09-08 08:00:00+00,15126,990,5223,2860,143,4522,1100,621,3738,486,34809,225,13064,11964,6741,16116
2021-09-08 08:30:00+00,15016,990,5224,2732,155,4522,1100,639,4440,508,35326,221,13651,12551,7327,16006
2021-09-08 09:00:00+00,14866,1000,5091,3221,156,4522,1097,752,5142,208,36055,216,14707,13610,8519,15866
2021-09-08 09:30:00+00,14980,991,5217,2844,121,4522,1086,553,5756,0,36070,215,15024,13938,8721,15971
2021-09-08 10:00:00+00,15109,989,5218,2887,75,4522,1091,591,6275,0,36757,213,15546,14455,9237,16098
2021-09-08 10:30:00+00,14809,985,5220,3272,85,4522,1096,392,6802,0,37183,206,16475,15379,10159,15794
2021-09-08 11:00:00+00,14896,872,5215,3525,84,4522,1093,267,7150,40,37664,200,17067,15974,10759,15768
2021-09-08 11:30:00+00,14770,798,5217,3608,84,4522,1092,250,7208,0,37549,197,17209,16117,10900,15568
2021-09-08 12:00:00+00,14840,724,5212,3415,84,4522,1090,219,7274,80,37460,196,17075,15985,10773,15564
2021-09-08 12:30:00+00,14681,708,5214,3557,84,4524,1089,213,7041,78,37189,196,16985,15896,10682,15389
2021-09-08 13:00:00+00,14624,635,5211,3824,84,4522,1087,194,6635,0,36816,195,16841,15754,10543,15259
2021-09-08 13:30:00+00,14795,603,5207,3784,104,4522,1089,194,5939,58,36295,199,16123,15034,9827,15398
2021-09-08 14:00:00+00,14564,753,5209,3955,118,4524,1089,126,5384,0,35722,203,15755,14666,9457,15317
2021-09-08 14:30:00+00,14728,810,5203,4219,145,4522,1088,161,4976,0,35852,206,15631,14543,9340,15538
2021-09-08 15:00:00+00,14886,794,5206,4499,268,4544,1088,312,4264,328,36189,206,15325,14237,9031,15680
2021-09-08 15:30:00+00,15511,810,5207,4657,307,4534,1088,348,3198,482,36142,215,14457,13369,8162,16321
2021-09-08 16:00:00+00,16094,795,5207,4574,322,4104,1085,409,2249,1154,35993,218,13437,12352,7145,16889
2021-09-08 16:30:00+00,16146,810,5212,4401,346,4094,1087,425,1556,1738,35815,219,12602,11515,6303,16956
2021-09-08 17:00:00+00,16383,793,5208,4260,406,3816,1090,798,878,1612,35244,228,11842,10752,5544,17176
2021-09-08 17:30:00+00,16416,801,5210,4299,482,3818,1090,805,309,1538,34768,232,11390,10300,5090,17217
2021-09-08 18:00:00+00,16607,827,5210,4328,398,4202,1094,781,38,886,34371,243,11068,9974,4764,17434
2021-09-08 18:30:00+00,16695,800,5209,4248,379,4216,1080,774,0,1140,34541,242,10916,9836,4627,17495
2021-09-08 19:00:00+00,16647,770,5210,4189,280,4364,1095,710,0,1020,34285,241,10774,9679,4469,17417
2021-09-08 19:30:00+00,16651,677,5211,4158,238,3936,1094,680,0,954,33599,237,10701,9607,4396,17328
2021-09-08 20:00:00+00,16077,681,5209,4246,137,4108,1093,523,0,316,32390,239,10685,9592,4383,16758
2021-09-08 20:30:00+00,15305,665,5202,4511,115,4250,1092,166,0,118,31424,234,10920,9828,4626,15970
2021-09-08 21:00:00+00,14285,544,5205,4939,96,4166,1095,122,0,0,30452,224,11335,10240,5035,14829
2021-09-08 21:30:00+00,13809,756,5209,4716,61,4166,1097,119,0,0,29933,228,11083,9986,4777,14565
2021-09-08 22:00:00+00,12813,602,5206,4510,64,4300,1096,119,0,0,28710,222,10876,9780,4574,13415
2021-09-08 22:30:00+00,11646,469,5208,4403,82,4298,1097,119,0,0,27322,212,10790,9693,4485,12115
2021-09-08 23:00:00+00,11024,474,5206,4139,63,4298,1086,119,0,0,26409,210,10494,9408,4202,11498
2021-09-08 23:30:00+00,10784,477,5204,3569,63,4290,1081,119,0,0,25587,213,9917,8836,3632,11261
2021-09-09 00:00:00+00,10720,462,5202,3421,63,3816,1079,119,0,0,24882,218,9765,8686,3484,11182
2021-09-09 00:30:00+00,10689,472,5203,3210,62,3806,1080,119,0,0,24641,220,9555,8475,3272,11161
2021-09-09 01:00:00+00,10658,477,5202,3143,61,3806,1080,119,0,0,24546,219,9486,8406,3204,11135
2021-09-09 01:30:00+00,10554,469,5203,2987,60,3810,1081,119,0,0,24283,220,9331,8250,3047,11023
2021-09-09 02:00:00+00,10619,480,5204,2847,57,3734,1082,119,0,0,24142,220,9190,8108,2904,11099
2021-09-09 02:30:00+00,10773,471,5202,2673,56,3734,1079,119,0,0,24107,223,9010,7931,2729,11244
2021-09-09 03:00:00+00,10749,460,5207,2591,55,3778,1080,123,0,0,24043,220,8933,7853,2646,11209
2021-09-09 03:30:00+00,11188,472,5206,2286,54,3778,1080,120,0,0,24184,226,8626,7546,2340,11660
2021-09-09 04:00:00+00,12292,465,5207,2244,54,3156,1080,122,0,0,24620,240,8585,7505,2298,12757
2021-09-09 04:30:00+00,13087,470,5209,2221,54,3138,1081,122,0,0,25382,245,8565,7484,2275,13557
2021-09-09 05:00:00+00,13694,686,5206,2299,54,4172,1079,127,0,0,27317,250,8638,7559,2353,14380
2021-09-09 05:30:00+00,14420,947,5208,2413,54,4198,1079,125,21,0,28465,259,8775,7696,2488,15367
2021-09-09 06:00:00+00,15239,996,5206,2558,82,4516,1079,216,201,262,30355,259,9126,8047,2841,16235
2021-09-09 06:30:00+00,16011,1001,5204,2720,83,4524,1077,269,443,248,31580,260,9527,8450,3246,17012
2021-09-09 07:00:00+00,16299,998,5206,2554,101,4528,1074,381,782,746,32669,256,9717,8643,3437,17297
2021-09-09 07:30:00+00,16394,996,5206,2335,121,4552,1076,418,1068,892,33058,254,9806,8730,3524,17390
2021-09-09 08:00:00+00,16522,994,5203,2169,135,4650,1068,439,1462,1188,33830,250,10037,8969,3766,17516
2021-09-09 08:30:00+00,16339,991,5206,1928,254,4662,1078,455,1887,1308,34108,246,10353,9275,4069,17330
2021-09-09 09:00:00+00,16617,996,5205,1827,405,4784,1080,469,2237,522,34142,249,10754,9674,4469,17613
2021-09-09 09:30:00+00,16936,996,5201,1777,213,4824,1080,454,2819,390,34690,249,11090,10010,4809,17932
2021-09-09 10:00:00+00,16956,903,5204,1821,81,5050,1081,495,3568,34,35193,243,11755,10674,5470,17859
2021-09-09 10:30:00+00,17032,704,5206,1899,79,5082,1088,576,3722,220,35608,237,11994,10906,5700,17736
2021-09-09 11:00:00+00,16786,694,5212,1938,79,5204,1086,553,4275,302,36129,230,12590,11504,6292,17480
2021-09-09 11:30:00+00,16761,724,5208,1882,79,5222,1089,488,4447,294,36194,230,12705,11616,6408,17485
2021-09-09 12:00:00+00,16630,717,5206,1939,79,5220,1051,444,4109,484,35879,230,12384,11333,6127,17347
2021-09-09 12:30:00+00,16480,718,5205,2001,79,5220,860,416,3832,146,34957,233,11977,11117,5912,17198
2021-09-09 13:00:00+00,16356,753,5203,2069,127,5220,839,394,3876,106,34943,232,12114,11275,6072,17109
2021-09-09 13:30:00+00,16040,767,5203,2095,200,5208,832,421,3615,308,34689,231,11945,11113,5910,16807
2021-09-09 14:00:00+00,16057,782,5197,2031,296,4834,848,389,3530,406,34370,233,11902,11054,5857,16839
2021-09-09 14:30:00+00,16167,923,5195,1986,272,4792,1040,454,3373,442,34644,238,11866,10826,5631,17090
2021-09-09 15:00:00+00,17200,1239,5192,2010,354,4566,1079,560,2674,362,35236,256,11309,10230,5038,18439
2021-09-09 15:30:00+00,17562,1306,5194,2056,376,4544,1090,541,1898,762,35329,261,10614,9524,4330,18868
2021-09-09 16:00:00+00,17336,1379,5199,2118,665,4310,1091,590,1308,1370,35366,260,10381,9290,4091,18715
2021-09-09 16:30:00+00,17395,1418,5200,2243,719,4310,1093,646,923,1480,35427,262,10178,9085,3885,18813
2021-09-09 17:00:00+00,17441,1505,5202,2446,760,4262,1094,694,560,1118,35082,268,10062,8968,3766,18946
2021-09-09 17:30:00+00,17488,1447,5202,2540,756,4262,1095,713,201,862,34566,271,9794,8699,3497,18935
2021-09-09 18:00:00+00,17315,1237,5201,2744,643,4408,1096,586,19,954,34203,265,9703,8607,3406,18552
2021-09-09 18:30:00+00,17323,1128,5201,2638,696,4410,1095,554,0,1182,34227,262,9630,8535,3334,18451
2021-09-09 19:00:00+00,17340,1244,5204,2535,428,4556,1096,533,0,876,33812,269,9263,8167,2963,18584
2021-09-09 19:30:00+00,16738,1219,5203,2446,374,4556,1093,529,0,706,32864,268,9116,8023,2820,17957
2021-09-09 20:00:00+00,16634,1086,5206,2576,268,4522,1094,439,0,88,31913,270,9144,8050,2844,17720
2021-09-09 20:30:00+00,15886,1246,5205,2779,200,4522,1084,315,0,0,31237,270,9268,8184,2979,17132
2021-09-09 21:00:00+00,15189,1132,5202,2831,194,4520,1085,134,0,0,30287,262,9312,8227,3025,16321
2021-09-09 21:30:00+00,14260,988,5207,2751,180,4520,1091,123,0,0,29120,256,9229,8138,2931,15248
2021-09-09 22:00:00+00,13538,988,5212,2616,174,4522,1090,123,0,0,28263,252,9092,8002,2790,14526
2021-09-09 22:30:00+00,12740,731,5213,2481,171,4520,1090,113,0,0,27059,242,8955,7865,2652,13471
2021-09-09 23:00:00+00,12490,560,5210,2379,150,4304,1092,115,0,0,26300,237,8831,7739,2529,13050
2021-09-09 23:30:00+00,11556,578,5207,2293,150,4300,1091,114,0,0,25289,233,8741,7650,2443,12134
2021-09-10 00:00:00+00,11067,578,5206,2221,136,4302,1092,114,0,0,24716,230,8655,7563,2357,11645
2021-09-10 00:30:00+00,10871,476,5203,2228,136,4300,1089,120,0,0,24423,226,8656,7567,2364,11347
2021-09-10 01:00:00+00,10542,459,5206,2425,135,4300,1084,113,0,0,24264,222,8850,7766,2560,11001
2021-09-10 01:30:00+00,10137,466,5208,2416,135,4300,1060,114,0,0,23836,219,8819,7759,2551,10603
2021-09-10 02:00:00+00,9972,460,5205,2435,133,4300,1090,113,0,0,23708,217,8863,7773,2568,10432
2021-09-10 02:30:00+00,9842,460,5204,2439,133,4302,1066,114,0,0,23560,216,8842,7776,2572,10302
2021-09-10 03:00:00+00,10319,468,5200,2268,133,4090,1089,114,0,0,23681,222,8690,7601,2401,10787
2021-09-10 03:30:00+00,10458,572,5206,2215,131,4054,1067,113,0,0,23816,227,8619,7552,2346,11030
2021-09-10 04:00:00+00,11386,802,5205,2195,131,2947,1083,115,0,0,23864,237,8614,7531,2326,12188
2021-09-10 04:30:00+00,12212,899,5205,2144,131,2916,1087,114,0,0,24708,245,8567,7480,2275,13111
2021-09-10 05:00:00+00,13784,989,5206,2128,128,3382,1059,116,0,0,26792,261,8521,7462,2256,14773
2021-09-10 05:30:00+00,15347,994,5206,2193,87,3498,1092,114,4,0,28535,270,8582,7490,2284,16341
2021-09-10 06:00:00+00,15963,925,5205,2149,113,4232,1089,172,110,0,29958,272,8666,7577,2372,16888
2021-09-10 06:30:00+00,16678,898,5208,2173,153,4248,1090,373,427,130,31378,270,9051,7961,2753,17576
2021-09-10 07:00:00+00,17109,910,5206,2242,170,4270,1091,384,757,270,32409,268,9466,8375,3169,18019
2021-09-10 07:30:00+00,17312,919,5204,2196,148,4270,1083,416,1060,288,32896,267,9691,8608,3404,18231
2021-09-10 08:00:00+00,17389,915,5205,2136,160,4270,1085,496,1402,598,33656,262,9988,8903,3698,18304
2021-09-10 08:30:00+00,17336,901,5208,2102,162,4272,1080,479,1917,586,34043,258,10469,9389,4181,18237
2021-09-10 09:00:00+00,17234,921,5194,2184,144,4356,1081,390,2188,396,34088,257,10791,9710,4516,18155
2021-09-10 09:30:00+00,17142,864,5193,2096,116,4486,1080,388,2354,442,34161,256,10839,9759,4566,18006
2021-09-10 10:00:00+00,17181,837,5196,2161,101,4426,1080,442,2542,628,34594,252,11080,10000,4804,18018
2021-09-10 10:30:00+00,17517,842,5194,2347,98,4140,1079,391,3182,494,35284,247,11900,10821,5627,18359
2021-09-10 11:00:00+00,17569,827,5196,2495,105,4030,1080,374,3466,356,35498,244,12342,11262,6066,18396
2021-09-10 11:30:00+00,17423,829,5194,2664,94,4032,1079,374,3280,390,35359,243,12311,11232,6038,18252
2021-09-10 12:00:00+00,16795,973,5186,2860,91,4032,1079,425,3362,406,35209,242,12578,11499,6313,17768
2021-09-10 12:30:00+00,16183,967,5189,3034,90,4034,1076,379,3502,424,34878,236,12891,11815,6626,17150
2021-09-10 13:00:00+00,15954,909,5196,3187,90,4004,1075,378,3206,444,34443,234,12754,11679,6483,16863
2021-09-10 13:30:00+00,16017,987,5189,3232,90,4004,1071,348,3167,110,34215,239,12749,11678,6489,17004
2021-09-10 14:00:00+00,15839,989,5193,3271,106,4032,1070,342,3011,0,33853,240,12651,11581,6388,16828
2021-09-10 14:30:00+00,15810,952,5188,3426,140,4028,1075,405,2669,272,33965,238,12498,11423,6235,16762
2021-09-10 15:00:00+00,16218,988,5192,3600,226,3654,1079,442,2212,288,33899,241,12309,11230,6038,17206
2021-09-10 15:30:00+00,16210,934,5187,3772,261,3652,1080,450,1737,696,33979,239,12037,10957,5770,17144
2021-09-10 16:00:00+00,16279,979,5188,3706,352,3724,1080,551,1522,1112,34493,241,11848,10768,5580,17258
2021-09-10 16:30:00+00,16531,940,5184,3568,412,3726,1079,569,1073,1140,34222,245,11316,10237,5053,17471
2021-09-10 17:00:00+00,16844,986,5185,3483,429,3854,1081,580,668,994,34104,251,10846,9765,4580,17830
2021-09-10 17:30:00+00,16794,824,5187,3416,428,3854,1080,568,193,1060,33404,251,10304,9224,4037,17618
2021-09-10 18:00:00+00,16635,738,5188,3476,417,4050,1080,538,10,1004,33136,249,10171,9091,3903,17373
2021-09-10 18:30:00+00,16700,848,5187,3343,415,4054,1079,542,0,1102,33270,252,10024,8945,3758,17548
2021-09-10 19:00:00+00,16529,890,5190,3394,355,4054,1080,502,0,604,32598,256,10019,8939,3749,17419
2021-09-10 19:30:00+00,15889,799,5189,3528,302,4052,1080,450,0,460,31749,252,10099,9019,3830,16688
2021-09-10 20:00:00+00,15393,845,5189,3750,167,4138,1086,294,0,36,30898,252,10192,9106,3917,16238
2021-09-10 20:30:00+00,14371,655,5192,4127,150,4060,1083,207,0,0,29845,239,10552,9469,4277,15026
2021-09-10 21:00:00+00,13434,596,5192,4229,150,3934,1075,124,0,8,28742,232,10646,9571,4379,14030
2021-09-10 21:30:00+00,12104,666,5197,4468,136,3930,1072,113,0,0,27686,224,10873,9801,4604,12770
2021-09-10 22:00:00+00,11191,468,5195,4506,127,3792,1077,114,0,0,26470,212,10905,9828,4633,11659
2021-09-10 22:30:00+00,9734,494,5199,4434,128,3788,1081,124,0,0,24982,203,10842,9761,4562,10228
2021-09-10 23:00:00+00,9057,474,5196,4424,110,3410,1081,117,0,0,23869,198,10811,9730,4534,9531
2021-09-10 23:30:00+00,8732,469,5199,4460,109,3404,1081,113,0,0,23567,195,10849,9768,4569,9201
2021-09-11 00:00:00+00,8820,493,5195,4458,108,3212,1080,114,0,0,23480,193,10841,9761,4566,9313
2021-09-11 00:30:00+00,8776,495,5194,4339,108,3210,1078,115,0,0,23315,194,10719,9641,4447,9271
2021-09-11 01:00:00+00,8831,496,5195,4163,107,3208,1077,113,0,0,23190,196,10542,9465,4270,9327
2021-09-11 01:30:00+00,8555,494,5197,4218,106,3208,1075,113,0,0,22966,193,10596,9521,4324,9049
2021-09-11 02:00:00+00,8107,404,5201,4321,104,3210,1072,114,0,0,22533,185,10698,9626,4425,8511
2021-09-11 02:30:00+00,7996,230,5196,4450,104,3210,1082,119,0,0,22387,177,10832,9750,4554,8226
2021-09-11 03:00:00+00,7833,230,5201,4574,102,3212,1080,113,0,0,22345,174,10957,9877,4676,8063
2021-09-11 03:30:00+00,8001,230,5195,4282,102,3212,1081,115,0,0,22218,178,10660,9579,4384,8231
2021-09-11 04:00:00+00,8112,312,5200,4207,102,3198,1081,114,0,0,22326,183,10590,9509,4309,8424
2021-09-11 04:30:00+00,8454,380,5201,4274,102,3198,1080,114,0,0,22803,188,10657,9577,4376,8834
2021-09-11 05:00:00+00,8660,386,5200,4443,101,3166,1079,117,0,0,23152,188,10823,9744,4544,9046
2021-09-11 05:30:00+00,8980,387,5202,4576,115,3166,1081,114,5,0,23626,190,10979,9898,4696,9367
2021-09-11 06:00:00+00,9581,388,5199,4755,146,3282,1081,116,138,0,24686,191,11319,10238,5039,9969
2021-09-11 06:30:00+00,10403,389,5201,4923,142,3286,1072,172,424,0,26012,195,11762,10690,5489,10792
2021-09-11 07:00:00+00,11593,486,5200,5019,113,3368,1072,264,911,0,28026,202,12315,11243,6043,12079
2021-09-11 07:30:00+00,12073,498,5198,5143,128,3368,1078,265,1338,0,29089,202,12885,11807,6609,12571
2021-09-11 08:00:00+00,12296,495,5199,5188,167,3298,1072,242,1739,130,29826,197,13365,12293,7094,12791
2021-09-11 08:30:00+00,12079,492,5198,5305,173,3296,1070,285,2216,182,30296,191,13962,12892,7694,12571
2021-09-11 09:00:00+00,12002,493,5195,5437,174,3500,1071,297,2733,0,30902,189,14610,13539,8344,12495
2021-09-11 09:30:00+00,11816,493,5197,5540,160,3502,1050,256,3230,0,31244,184,15177,14127,8930,12309
2021-09-11 10:00:00+00,11877,487,5199,5762,98,3234,1039,192,3682,0,31570,179,15780,14741,9542,12364
2021-09-11 10:30:00+00,11456,446,5196,6068,98,3228,1038,127,4511,0,32168,169,16911,15873,10677,11902
2021-09-11 11:00:00+00,11444,447,5199,6193,79,2980,1037,117,5143,0,32639,163,17651,16614,11415,11891
2021-09-11 11:30:00+00,11100,490,5203,6444,77,2978,1039,116,5073,0,32520,161,17836,16797,11594,11590
2021-09-11 12:00:00+00,11087,408,5203,6496,67,2868,1038,117,5125,0,32409,155,17929,16891,11688,11495
2021-09-11 12:30:00+00,10572,254,5199,6391,63,2872,1038,118,5393,0,31900,147,18084,17046,11847,10826
2021-09-11 13:00:00+00,9911,246,5209,6549,57,3030,1038,117,5340,0,31497,143,18193,17155,11946,10157
2021-09-11 13:30:00+00,9587,236,5207,6615,51,3040,1049,118,5202,0,31105,140,18124,17075,11868,9823
2021-09-11 14:00:00+00,9432,236,5208,6820,51,3100,1058,118,4824,0,30847,139,17961,16903,11695,9668
2021-09-11 14:30:00+00,9596,238,5205,6975,51,3102,1067,117,4347,0,30698,142,17645,16578,11373,9834
2021-09-11 15:00:00+00,10481,265,5206,7175,65,2882,1067,116,3687,0,30944,152,17200,16133,10927,10746
2021-09-11 15:30:00+00,11669,524,5202,7238,94,2429,1067,121,3028,0,31372,172,16629,15562,10360,12193
2021-09-11 16:00:00+00,12251,774,5206,7440,165,2116,1066,199,2123,0,31340,187,16000,14934,9728,13025
2021-09-11 16:30:00+00,12860,909,4872,7605,211,2132,1068,360,1514,10,31541,199,15270,14202,9330,13769
2021-09-11 17:00:00+00,12983,915,4860,7587,250,2590,1068,374,890,0,31517,207,14655,13587,8727,13898
2021-09-11 17:30:00+00,13356,919,4861,7347,241,2606,1068,377,369,0,31144,215,13886,12818,7957,14275
2021-09-11 18:00:00+00,13281,789,4862,7258,229,2898,1067,316,33,82,30815,215,13449,12382,7520,14070
2021-09-11 18:30:00+00,13449,653,4862,7294,226,2902,1068,310,0,126,30890,212,13450,12382,7520,14102
2021-09-11 19:00:00+00,13536,693,4866,7183,228,2920,1070,306,0,0,30802,215,13347,12277,7411,14229
2021-09-11 19:30:00+00,13429,608,4864,6945,212,2920,1069,155,0,0,30202,214,13090,12021,7157,14037
2021-09-11 20:00:00+00,13247,564,4864,6640,149,2870,1069,117,0,0,29520,214,12722,11653,6789,13811
2021-09-11 20:30:00+00,12218,541,4861,6363,147,3202,1067,118,0,6,28523,208,12438,11371,6510,12759
2021-09-11 21:00:00+00,10963,537,4861,6080,112,3510,1070,115,0,0,27248,196,12123,11053,6192,11500
2021-09-11 21:30:00+00,10437,533,4864,5409,73,3498,1064,119,0,62,26059,197,11410,10346,5482,10970
2021-09-11 22:00:00+00,10045,305,4864,4991,72,3388,1069,116,0,0,24850,192,10996,9927,5063,10350
2021-09-11 22:30:00+00,9248,311,4863,4666,72,3382,1070,115,0,0,23727,188,10671,9601,4738,9559
2021-09-11 23:00:00+00,8595,454,4866,4437,62,3256,1072,119,0,0,22861,191,10437,9365,4499,9049
2021-09-11 23:30:00+00,8353,372,4866,4144,60,3256,1073,117,0,0,22241,189,10143,9070,4204,8725
2021-09-12 00:00:00+00,8135,231,4866,3993,60,3406,1073,113,0,0,21877,185,9992,8919,4053,8366
2021-09-12 00:30:00+00,7974,240,4858,3827,60,3408,1073,116,0,0,21556,185,9818,8745,3887,8214
2021-09-12 01:00:00+00,8156,235,4865,3574,60,3408,1067,114,0,0,21479,189,9566,8499,3634,8391
2021-09-12 01:30:00+00,8270,320,4865,3288,60,3408,1069,112,0,0,21392,196,9282,8213,3348,8590
2021-09-12 02:00:00+00,8494,476,4860,2968,59,3408,1071,117,0,0,21453,206,8958,7887,3027,8970
2021-09-12 02:30:00+00,8740,497,4862,2621,57,3408,1073,117,0,0,21375,212,8613,7540,2678,9237
2021-09-12 03:00:00+00,8858,451,4864,2469,59,3408,1075,113,0,0,21297,213,8467,7392,2528,9309
2021-09-12 03:30:00+00,8822,491,4864,2359,59,3408,1074,113,0,0,21190,215,8356,7282,2418,9313
2021-09-12 04:00:00+00,8784,430,4866,2233,59,3404,1075,116,0,0,20967,214,8233,7158,2292,9214
2021-09-12 04:30:00+00,8731,594,4867,2109,59,3411,1075,114,0,0,20960,221,8110,7035,2168,9325
2021-09-12 05:00:00+00,9164,693,4866,1971,59,3420,1076,122,0,0,21371,229,7972,6896,2030,9857
2021-09-12 05:30:00+00,9463,767,4870,1922,74,3422,1072,115,17,0,21722,234,7955,6883,2013,10230
2021-09-12 06:00:00+00,10566,625,4871,1808,73,3598,1073,117,350,0,23081,234,8175,7102,2231,11191
2021-09-12 06:30:00+00,11354,684,4871,1604,59,3602,1074,118,904,0,24270,238,8512,7438,2567,12038
2021-09-12 07:00:00+00,11833,683,4872,1406,90,3908,1072,116,1434,0,25414,235,8874,7802,2930,12516
2021-09-12 07:30:00+00,12479,805,4876,1292,93,3916,1068,115,2080,0,26724,237,9409,8341,3465,13284
2021-09-12 08:00:00+00,12991,804,4872,1296,119,3990,1074,115,2760,0,28021,235,10121,9047,4175,13795
2021-09-12 08:30:00+00,13291,881,4872,1289,120,3990,1075,118,3646,0,29282,231,11002,9927,5055,14172
2021-09-12 09:00:00+00,13798,844,4859,1312,105,3694,1077,116,4386,0,30191,225,11739,10662,5803,14642
2021-09-12 09:30:00+00,14094,839,4853,1272,89,3688,1078,121,4514,0,30548,226,11806,10728,5875,14933
2021-09-12 10:00:00+00,14013,837,4853,1216,74,3944,1079,126,4702,0,30844,227,11924,10845,5992,14850
2021-09-12 10:30:00+00,14389,798,4851,1121,72,3946,1078,128,4719,0,31102,229,11841,10763,5912,15187
2021-09-12 11:00:00+00,14829,511,4850,1193,72,4020,1079,125,4638,0,31317,225,11832,10753,5903,15340
2021-09-12 11:30:00+00,15025,713,4852,1239,72,4020,1078,126,4217,0,31342,233,11458,10380,5528,15738
2021-09-12 12:00:00+00,15063,821,4855,1212,59,4020,1078,190,3959,32,31289,238,11163,10085,5230,15884
2021-09-12 12:30:00+00,15041,893,4860,1184,58,4018,1076,239,3518,98,30985,243,10696,9620,4760,15934
2021-09-12 13:00:00+00,15075,962,4864,1154,58,4020,1076,221,3182,98,30710,247,10334,9258,4394,16037
2021-09-12 13:30:00+00,15114,994,4860,1181,58,4018,1078,254,2765,98,30420,251,9942,8864,4004,16108
2021-09-12 14:00:00+00,15342,1000,4863,1175,82,3928,1078,326,2298,80,30172,256,9496,8418,3555,16342
2021-09-12 14:30:00+00,15809,996,4861,1123,88,3940,1079,275,1973,56,30200,261,9124,8045,3184,16805
2021-09-12 15:00:00+00,16293,1002,4863,1083,100,3822,1079,380,1587,308,30517,265,8712,7633,2770,17295
2021-09-12 15:30:00+00,16758,1000,4864,1038,111,3964,1078,500,1305,362,30980,272,8396,7318,2454,17758
2021-09-12 16:00:00+00,17086,1002,4864,999,260,3766,1078,749,1001,1134,31939,269,8202,7124,2260,18088
2021-09-12 16:30:00+00,17639,1002,4867,1051,297,3886,1078,835,655,814,32124,276,7948,6870,2003,18641
2021-09-12 17:00:00+00,17837,996,4866,1099,298,3690,1078,871,366,966,32067,276,7707,6629,1763,18833
2021-09-12 17:30:00+00,17909,985,4869,1124,316,3778,1079,868,113,902,31943,278,7501,6422,1553,18894
2021-09-12 18:00:00+00,17670,897,4869,1191,285,3794,1072,844,5,1188,31815,273,7422,6350,1481,18567
2021-09-12 18:30:00+00,17784,929,4870,1309,272,3798,1070,825,0,988,31845,275,7521,6451,1581,18713
2021-09-12 19:00:00+00,17568,938,4868,1362,253,3730,1072,809,0,874,31474,275,7555,6483,1615,18506
2021-09-12 19:30:00+00,17348,807,4872,1402,224,3526,1073,629,0,574,30455,272,7571,6498,1626,18155
2021-09-12 20:00:00+00,16671,793,4869,1437,122,3632,1071,527,0,296,29418,273,7499,6428,1559,17464
2021-09-12 20:30:00+00,15597,758,4870,1511,100,3596,1072,409,0,62,27975,267,7553,6481,1611,16355
2021-09-12 21:00:00+00,14438,708,4869,1662,100,3392,1073,134,0,302,26678,255,7704,6631,1762,15146
2021-09-12 21:30:00+00,13479,474,4868,2025,91,3398,1072,113,0,0,25520,243,8056,6984,2116,13953
2021-09-12 22:00:00+00,11199,639,4870,2380,91,3782,1071,114,0,0,24146,235,8412,7341,2471,11838
2021-09-12 22:30:00+00,9709,611,4869,2576,91,3794,1071,113,0,0,22834,222,8607,7536,2667,10320
2021-09-12 23:00:00+00,9643,754,4870,2683,78,3508,1072,114,0,0,22722,226,8703,7631,2761,10397
2021-09-12 23:30:00+00,9298,823,4874,2816,77,3504,1070,113,0,0,22575,225,8837,7767,2893,10121
2021-09-13 00:00:00+00,9281,843,4872,2968,77,3504,1068,113,0,0,22726,226,8985,7917,3045,10124
2021-09-13 00:30:00+00,9223,674,4874,3035,77,3504,1025,114,0,0,22526,220,9011,7986,3112,9897
2021-09-13 01:00:00+00,9087,607,4871,2884,77,3504,1041,116,0,0,22187,218,8873,7832,2961,9694
2021-09-13 01:30:00+00,9178,471,4871,2694,77,3504,1070,116,0,0,21982,216,8712,7642,2772,9649
2021-09-13 02:00:00+00,9120,473,4866,2634,77,3364,1072,118,0,0,21724,217,8649,7577,2711,9593
2021-09-13 02:30:00+00,9172,462,4866,2568,77,3362,1073,115,0,0,21695,218,8584,7511,2645,9634
2021-09-13 03:00:00+00,9241,478,4867,2530,77,3244,1028,115,0,0,21580,219,8502,7474,2607,9719
2021-09-13 03:30:00+00,9175,468,4866,2485,78,3240,1009,115,0,0,21436,219,8438,7429,2563,9643
2021-09-13 04:00:00+00,9619,471,4864,2495,95,2922,984,114,0,0,21564,222,8438,7454,2590,10090
2021-09-13 04:30:00+00,10138,463,4867,2582,95,2992,1084,113,0,0,22334,225,8628,7544,2677,10601
2021-09-13 05:00:00+00,12710,681,4865,2612,95,2528,1091,115,0,0,24697,247,8663,7572,2707,13391
2021-09-13 05:30:00+00,14410,780,4864,2630,95,2534,1090,226,7,0,26636,258,8686,7596,2732,15190
2021-09-13 06:00:00+00,16388,734,4867,2699,94,3410,1081,139,134,44,29590,262,8875,7794,2927,17122
2021-09-13 06:30:00+00,17903,724,4866,2675,95,3434,1084,178,389,66,31414,266,9109,8025,3159,18627
2021-09-13 07:00:00+00,18359,831,4869,2796,194,3443,1087,297,676,222,32774,264,9622,8535,3666,19190
2021-09-13 07:30:00+00,18403,982,4868,2879,222,3420,1088,347,1049,148,33406,264,10106,9018,4150,19385
2021-09-13 08:00:00+00,18226,876,4867,3084,220,3676,1090,368,1448,136,33991,257,10709,9619,4752,19102
2021-09-13 08:30:00+00,18150,760,4867,3367,215,3666,1088,410,1985,88,34596,249,11522,10434,5567,18910
2021-09-13 09:00:00+00,18002,735,4868,3590,176,3782,1088,269,2453,30,34993,243,12175,11087,6219,18737
2021-09-13 09:30:00+00,17664,702,4871,3799,103,3784,1087,232,3010,12,35264,236,12870,11783,6912,18366
2021-09-13 10:00:00+00,17035,786,4865,4049,98,3784,1086,218,3503,134,35558,229,13601,12515,7650,17821
2021-09-13 10:30:00+00,16871,845,4865,4071,105,3782,1084,175,4033,88,35919,227,14158,13074,8209,17716
2021-09-13 11:00:00+00,16953,898,4860,4137,105,3536,1085,151,4116,18,35859,227,14303,13218,8358,17851
2021-09-13 11:30:00+00,16796,885,4863,4239,105,3536,1082,146,4424,0,36076,223,14713,13631,8768,17681
2021-09-13 12:00:00+00,16340,846,4863,4289,92,3782,1079,202,4213,0,35706,222,14536,13457,8594,17186
2021-09-13 12:30:00+00,16157,791,4858,4251,91,3770,1081,189,4082,12,35282,221,14363,13282,8424,16948
2021-09-13 13:00:00+00,16525,768,4864,4213,91,3406,1082,170,4150,34,35303,220,14400,13318,8454,17293
2021-09-13 13:30:00+00,16363,821,4860,4306,76,3400,1079,164,3444,40,34553,224,13765,12686,7826,17184
2021-09-13 14:00:00+00,16429,833,4876,4133,75,3652,1080,155,2972,50,34255,231,13136,12056,7180,17262
2021-09-13 14:30:00+00,16870,909,4866,3977,96,3668,1084,171,2418,94,34153,240,12441,11357,6491,17779
2021-09-13 15:00:00+00,17257,997,4858,3945,246,3770,1084,488,2095,96,34836,249,12228,11144,6286,18254
2021-09-13 15:30:00+00,17563,998,4857,3965,283,3774,1085,686,1697,168,35076,252,11887,10802,5945,18561
2021-09-13 16:00:00+00,17923,998,4862,4031,313,3742,1085,755,1251,996,35956,250,11542,10457,5595,18921
2021-09-13 16:30:00+00,18012,997,4861,4066,311,3742,1085,821,761,1306,35962,252,11084,9999,5138,19009
2021-09-13 17:00:00+00,17978,998,4862,4109,326,3772,1086,837,378,1198,35544,255,10761,9675,4813,18976
2021-09-13 17:30:00+00,17827,996,4860,4086,332,3772,1086,829,119,1108,35015,256,10483,9397,4537,18823
2021-09-13 18:00:00+00,18052,996,4862,4035,332,3644,1087,819,2,898,34727,260,10318,9231,4369,19048
2021-09-13 18:30:00+00,18103,996,4856,4169,327,3642,1088,804,0,972,34957,259,10440,9352,4496,19099
2021-09-13 19:00:00+00,17772,998,4861,4346,243,3966,1087,793,0,334,34400,260,10537,9450,4589,18770
2021-09-13 19:30:00+00,17318,1000,4859,4356,204,3942,1088,416,0,164,33347,258,10507,9419,4560,18318
2021-09-13 20:00:00+00,16896,1000,4864,4248,137,3086,1085,159,0,106,31581,258,10334,9249,4385,17896
2021-09-13 20:30:00+00,15941,998,4859,4138,137,2968,1086,118,0,0,30245,256,10220,9134,4275,16939
2021-09-13 21:00:00+00,16277,999,4863,3887,124,984,1078,115,0,44,28371,266,9952,8874,4011,17276
2021-09-13 21:30:00+00,15405,999,4861,3784,124,988,1037,126,0,0,27324,264,9806,8769,3908,16404
2021-09-13 22:00:00+00,12377,1000,4865,3620,105,3020,978,114,0,0,26079,245,9568,8590,3725,13377
2021-09-13 22:30:00+00,10931,999,4865,3542,97,3218,964,113,0,0,24729,238,9468,8504,3639,11930
2021-09-13 23:00:00+00,10717,898,4866,3410,81,3056,969,114,0,0,24111,238,9326,8357,3491,11615
2021-09-13 23:30:00+00,10438,860,4866,3299,80,3058,967,115,0,0,23683,236,9212,8245,3379,11298
2021-09-14 00:00:00+00,10066,860,4869,3392,80,3096,966,114,0,0,23443,230,9307,8341,3472,10926
2021-09-14 00:30:00+00,10107,868,4868,3434,80,3092,964,118,0,0,23531,230,9346,8382,3514,10975
2021-09-14 01:00:00+00,10216,850,4869,3655,80,2390,967,121,0,0,23148,226,9571,8604,3735,11066
2021-09-14 01:30:00+00,9814,710,4870,3816,80,2377,968,127,0,0,22762,217,9734,8766,3896,10524
2021-09-14 02:00:00+00,9817,473,4869,4126,80,2293,967,122,0,0,22747,206,10042,9075,4206,10290
2021-09-14 02:30:00+00,9876,475,4867,4127,81,2279,968,122,0,0,22795,207,10043,9075,4208,10351
2021-09-14 03:00:00+00,10204,474,4865,4185,81,1869,970,117,0,0,22764,215,10101,9131,4266,10678
2021-09-14 03:30:00+00,9615,471,4862,4076,81,1828,970,151,0,0,22054,212,9989,9019,4157,10086
2021-09-14 04:00:00+00,11251,587,4867,3922,81,1122,971,121,0,0,22922,228,9841,8870,4003,11838
2021-09-14 04:30:00+00,12063,869,4867,3700,81,1254,971,113,0,0,23918,245,9619,8648,3781,12932
2021-09-14 05:00:00+00,13484,1001,4862,3278,97,1792,968,113,0,0,25595,254,9205,8237,3375,14485
2021-09-14 05:30:00+00,15167,999,4860,3211,104,1793,967,114,0,94,27309,263,9142,8175,3315,16166
2021-09-14 06:00:00+00,16574,985,4861,3240,137,3067,968,122,42,152,30148,265,9248,8280,3419,17559
2021-09-14 06:30:00+00,17535,925,4858,3047,162,3166,966,210,116,540,31525,265,9149,8183,3325,18460
2021-09-14 07:00:00+00,17827,875,4856,3001,187,4374,966,364,255,406,33111,263,9265,8299,3443,18702
2021-09-14 07:30:00+00,17855,913,4854,3140,188,4452,968,348,481,414,33613,261,9631,8663,3809,18768
2021-09-14 08:00:00+00,17917,946,4857,3239,171,4542,964,466,819,240,34161,254,10050,9086,4229,18863
2021-09-14 08:30:00+00,17930,955,4858,3274,172,4590,964,439,1058,72,34312,253,10326,9362,4504,18885
2021-09-14 09:00:00+00,17972,939,4858,3313,174,5210,965,387,1335,62,35215,253,10645,9680,4822,18911
2021-09-14 09:30:00+00,17839,995,4856,3246,175,5128,964,340,1668,122,35333,252,10909,9945,5089,18834
2021-09-14 10:00:00+00,17813,995,4858,3076,157,5208,964,322,1728,0,35121,253,10783,9819,4961,18808
2021-09-14 10:30:00+00,17968,992,4854,3129,157,5202,964,407,1682,0,35355,254,10786,9822,4968,18960
2021-09-14 11:00:00+00,18096,997,4847,3018,134,5250,963,428,1722,0,35455,255,10684,9721,4874,19093
2021-09-14 11:30:00+00,18057,994,4853,2860,114,5250,963,448,1901,42,35482,254,10691,9728,4875,19051
2021-09-14 12:00:00+00,17661,1003,4853,2850,104,5250,962,400,1928,174,35185,252,10697,9735,4882,18664
2021-09-14 12:30:00+00,17433,1023,4856,2739,96,5248,959,389,2021,100,34864,252,10671,9712,4856,18456
2021-09-14 13:00:00+00,17321,1053,4854,2652,95,5250,959,382,1893,22,34481,254,10453,9494,4640,18374
2021-09-14 13:30:00+00,17471,1082,4853,2619,95,5250,960,326,1929,0,34585,255,10456,9496,4643,18553
2021-09-14 14:00:00+00,17431,1129,4852,2719,109,5238,962,213,1852,364,34869,252,10494,9532,4680,18560
2021-09-14 14:30:00+00,17391,1174,4856,2939,125,5238,961,250,1877,274,35085,253,10758,9797,4941,18565
2021-09-14 15:00:00+00,17109,1325,4855,3314,210,4606,964,486,1698,550,35117,254,11041,10077,5222,18434
2021-09-14 15:30:00+00,17037,1476,4852,3490,213,4466,964,443,1526,1194,35661,254,11045,10081,5229,18513
2021-09-14 16:00:00+00,17440,1559,4848,3431,400,4092,964,592,1101,1696,36123,258,10744,9780,4932,18999
2021-09-14 16:30:00+00,17346,1542,4858,3455,440,4028,965,719,716,1588,35657,261,10434,9469,4611,18888
2021-09-14 17:00:00+00,17496,1555,4855,3650,439,3798,964,566,422,1812,35557,262,10330,9366,4511,19051
2021-09-14 17:30:00+00,17840,1488,4852,3446,371,3776,966,483,159,1834,35215,266,9794,8828,3976,19328
2021-09-14 18:00:00+00,17835,1253,4856,3198,357,3856,984,530,5,1534,34408,267,9400,8416,3560,19088
2021-09-14 18:30:00+00,17767,1267,4851,2842,357,3858,1033,896,0,1574,34445,270,9083,8050,3199,19034
2021-09-14 19:00:00+00,17600,1265,4851,2655,297,4052,1071,937,0,1164,33892,273,8874,7803,2952,18865
2021-09-14 19:30:00+00,17467,1261,4851,2574,290,4052,1068,707,0,668,32938,277,8783,7715,2864,18728
2021-09-14 20:00:00+00,17183,1261,4849,2535,201,4032,1084,624,0,110,31879,282,8669,7585,2736,18444
2021-09-14 20:30:00+00,16363,1258,4849,2661,150,4012,1087,355,0,0,30735,279,8747,7660,2811,17621
2021-09-14 21:00:00+00,15871,1262,4850,2677,146,3512,1091,137,0,0,29546,274,8764,7673,2823,17133
2021-09-14 21:30:00+00,14680,1136,4855,2667,121,3490,1092,127,0,0,28168,266,8735,7643,2788,15816
2021-09-14 22:00:00+00,12928,997,4849,2552,120,3984,1096,132,0,0,26658,256,8617,7521,2672,13925
2021-09-14 22:30:00+00,12307,994,4850,2275,119,3962,1099,132,0,0,25738,255,8343,7244,2394,13301
2021-09-14 23:00:00+00,12728,996,4850,2259,119,2830,1099,128,0,0,25009,267,8327,7228,2378,13724
2021-09-14 23:30:00+00,12375,995,4855,2392,119,2520,1099,126,0,0,24481,267,8465,7366,2511,13370
2021-09-15 00:00:00+00,11867,997,4854,2404,119,2418,1100,127,0,0,23886,265,8477,7377,2523,12864
2021-09-15 00:30:00+00,11654,998,4854,2464,119,2416,1100,127,0,0,23731,263,8537,7437,2583,12652
2021-09-15 01:00:00+00,11405,1000,4853,2611,119,2419,1099,129,0,0,23635,261,8682,7583,2730,12405
2021-09-15 01:30:00+00,10811,994,4859,2626,119,2425,1099,130,0,0,23063,257,8703,7604,2745,11805
2021-09-15 02:00:00+00,10538,879,4853,2467,119,2733,1102,130,0,0,22821,251,8541,7439,2586,11417
2021-09-15 02:30:00+00,10590,803,4853,2537,119,2742,1076,130,0,0,22850,248,8585,7509,2656,11393
2021-09-15 03:00:00+00,10941,868,4856,2603,119,2258,1082,134,0,0,22860,253,8660,7578,2722,11809
2021-09-15 03:30:00+00,11004,977,4857,2711,119,2229,1119,147,0,0,23164,255,8806,7687,2830,11981
2021-09-15 04:00:00+00,14671,994,4858,2789,115,29,1156,145,0,0,24757,279,8918,7762,2904,15665
2021-09-15 04:30:00+00,15585,998,4854,2660,115,33,1182,136,0,0,25563,285,8811,7629,2775,16583
2021-09-15 05:00:00+00,15861,999,4858,2519,115,806,1205,131,0,0,26494,281,8697,7492,2634,16860
2021-09-15 05:30:00+00,17041,997,4854,2455,115,944,1240,128,1,0,27775,286,8665,7425,2571,18038
2021-09-15 06:00:00+00,17610,997,4852,2440,147,2556,1380,149,104,40,30275,281,8923,7543,2691,18607
2021-09-15 06:30:00+00,18456,983,4856,2475,147,2676,1497,326,469,0,31885,282,9444,7947,3091,19439
2021-09-15 07:00:00+00,18699,998,4849,2495,192,2500,1502,538,992,110,32875,277,10030,8528,3679,19697
2021-09-15 07:30:00+00,18948,997,4850,2334,192,2498,1502,555,1639,12,33527,274,10517,9015,4165,19945
2021-09-15 08:00:00+00,19085,998,4850,2183,193,2642,1505,618,2307,0,34381,270,11038,9533,4683,20083
2021-09-15 08:30:00+00,19031,996,4845,1992,193,2654,1503,575,2982,232,35003,264,11515,10012,5167,20027
2021-09-15 09:00:00+00,18488,994,4845,1989,193,3230,1526,532,3687,222,35706,253,12240,10714,5869,19482
2021-09-15 09:30:00+00,18192,994,4844,2032,190,3278,1580,429,4133,204,35876,248,12779,11199,6355,19186
2021-09-15 10:00:00+00,18066,992,4843,2012,155,3184,1613,279,4778,0,35922,244,13401,11788,6945,19058
2021-09-15 10:30:00+00,17431,996,4842,2052,153,3190,1677,251,5410,0,36002,237,14134,12457,7615,18427
2021-09-15 11:00:00+00,17058,1000,4839,2055,130,3622,1678,246,5808,0,36436,235,14510,12832,7993,18058
2021-09-15 11:30:00+00,16612,996,4841,2027,128,3632,1704,256,6241,0,36437,231,14941,13237,8396,17608
2021-09-15 12:00:00+00,16084,943,4840,2008,128,3720,1731,228,6208,0,35890,228,14915,13184,8344,17027
2021-09-15 12:30:00+00,15953,805,4839,1949,128,3718,1734,166,5926,40,35258,226,14576,12842,8003,16758
2021-09-15 13:00:00+00,16020,884,4842,1940,128,3524,1726,157,5525,0,34746,231,14161,12435,7593,16904
2021-09-15 13:30:00+00,15922,993,4840,1918,128,3524,1734,161,5161,4,34385,235,13781,12047,7207,16915
2021-09-15 14:00:00+00,15758,993,4844,2016,128,3718,1730,215,4603,6,34011,237,13321,11591,6747,16751
2021-09-15 14:30:00+00,16227,1004,4841,2039,142,3736,1724,329,4068,10,34120,243,12814,11090,6249,17231
2021-09-15 15:00:00+00,17013,944,4844,1978,226,3740,1736,392,3425,0,34298,251,12209,10473,5629,17957
2021-09-15 15:30:00+00,17687,908,4846,1920,210,3750,1733,505,2842,116,34517,257,11551,9818,4972,18595
2021-09-15 16:00:00+00,17841,913,4844,1865,255,3478,1732,581,2205,1068,34782,257,10901,9169,4325,18754
2021-09-15 16:30:00+00,18218,917,4845,1796,266,3472,1729,595,1351,1248,34437,264,9987,8258,3413,19135
2021-09-15 17:00:00+00,18000,1118,4845,1709,295,3640,1732,624,663,1340,33966,272,9244,7512,2667,19118
2021-09-15 17:30:00+00,17986,1198,4845,1677,295,3622,1729,659,174,1472,33657,277,8720,6991,2146,19184
2021-09-15 18:00:00+00,18038,1294,4846,1679,331,3112,1734,884,3,1536,33457,284,8593,6859,2013,19332
2021-09-15 18:30:00+00,18449,1298,4846,1513,335,3058,1726,917,0,1582,33724,287,8420,6694,1848,19747
2021-09-15 19:00:00+00,18084,1356,4848,1456,266,3058,1737,831,0,1514,33150,288,8307,6570,1722,19440
2021-09-15 19:30:00+00,17722,1377,4848,1398,239,3056,1739,751,0,944,32074,294,8224,6485,1637,19099
2021-09-15 20:00:00+00,17542,1344,4851,1359,145,3038,1740,649,0,30,30698,303,8095,6355,1504,18886
2021-09-15 20:30:00+00,16766,1273,4845,1315,128,3020,1742,410,0,0,29499,299,8030,6288,1443,18039
2021-09-15 21:00:00+00,16147,1217,4845,1330,115,2992,1747,207,0,0,28600,295,8037,6290,1445,17364
2021-09-15 21:30:00+00,15854,992,4848,1322,115,2888,1746,148,0,0,27913,288,8031,6285,1437,16846
2021-09-15 22:00:00+00,14749,997,4849,1307,115,2674,1741,145,0,0,26577,281,8012,6271,1422,15746
2021-09-15 22:30:00+00,13759,999,4846,1474,114,2666,1738,142,0,0,25738,274,8172,6434,1588,14758
2021-09-15 23:00:00+00,13051,996,4847,1508,98,2302,1739,142,0,0,24683,268,8192,6453,1606,14047
2021-09-15 23:30:00+00,12624,996,4844,1569,97,2294,1737,135,0,0,24296,265,8247,6510,1666,13620
2021-09-16 00:00:00+00,12175,998,4843,1608,97,2208,1738,127,0,0,23794,261,8286,6548,1705,13173
2021-09-16 00:30:00+00,11725,959,4841,1519,96,2208,1739,127,0,0,23214,258,8195,6456,1615,12684
2021-09-16 01:00:00+00,11676,959,4843,1403,96,2226,1737,127,0,0,23067,259,8079,6342,1499,12635
2021-09-16 01:30:00+00,11490,1002,4841,1421,97,2228,1739,127,0,0,22945,259,8098,6359,1518,12492
2021-09-16 02:00:00+00,11045,995,4840,1486,97,2568,1742,126,0,0,22899,258,8165,6423,1583,12040
2021-09-16 02:30:00+00,10784,993,4842,1603,97,2568,1742,126,0,0,22755,256,8284,6542,1700,11777
2021-09-16 03:00:00+00,11106,993,4843,1644,97,2142,1742,125,0,0,22692,255,8326,6584,1741,12099
2021-09-16 03:30:00+00,11529,997,4842,1528,97,2060,1737,126,0,0,22916,259,8204,6467,1625,12526
2021-09-16 04:00:00+00,13612,998,4841,1450,97,608,1741,127,0,0,23474,283,8129,6388,1547,14610
2021-09-16 04:30:00+00,14204,997,4847,1408,96,592,1742,125,0,0,24011,286,8093,6351,1504,15201
2021-09-16 05:00:00+00,15267,997,4847,1343,96,1475,1741,125,0,0,25891,290,8027,6286,1439,16264
2021-09-16 05:30:00+00,16667,997,4844,1234,96,1682,1740,127,0,0,27387,298,7914,6174,1330,17664
2021-09-16 06:00:00+00,17218,999,4841,1237,114,3120,1747,319,147,154,29896,292,8086,6339,1498,18217
2021-09-16 06:30:00+00,18111,998,4843,1243,119,3404,1748,526,590,190,31772,294,8543,6795,1952,19109
2021-09-16 07:00:00+00,18490,999,4841,1250,184,3434,1749,580,1217,140,32884,288,9241,7492,2651,19489
2021-09-16 07:30:00+00,18694,999,4843,1204,187,3444,1750,587,1954,0,33662,283,9938,8188,3345,19693
2021-09-16 08:00:00+00,18505,1000,4837,1186,187,3674,1751,585,2815,58,34598,275,10776,9025,4188,19505
2021-09-16 08:30:00+00,17814,1000,4845,1236,187,3722,1745,481,3608,108,34746,265,11621,9876,5031,18814
2021-09-16 09:00:00+00,17311,999,4834,1304,171,3740,1741,369,4636,0,35105,253,12686,10945,6111,18310
2021-09-16 09:30:00+00,16848,998,4829,1436,153,3770,1746,254,5257,0,35291,245,13421,11675,6846,17846
2021-09-16 10:00:00+00,16618,999,4821,1497,134,3968,1744,198,5552,0,35531,242,13748,12004,7183,17617
2021-09-16 10:30:00+00,16475,999,4804,1534,127,3968,1745,170,5713,0,35535,240,13923,12178,7374,17474
2021-09-16 11:00:00+00,16437,997,4807,1615,119,3676,1741,137,5822,52,35403,239,14104,12363,7556,17434
2021-09-16 11:30:00+00,16455,998,4808,1606,97,3670,1739,142,6446,0,35962,235,14696,12958,8150,17453
2021-09-16 12:00:00+00,16102,996,4808,1617,83,3938,1735,139,6479,0,35897,234,14722,12987,8179,17098
2021-09-16 12:30:00+00,15667,996,4806,1703,83,4080,1731,137,6455,0,35658,233,14778,13047,8241,16663
2021-09-16 13:00:00+00,15418,996,4809,1883,76,3972,1734,169,6213,0,35270,234,14715,12981,8172,16414
2021-09-16 13:30:00+00,15158,999,4806,1884,63,3932,1738,146,5613,76,34415,237,14104,12366,7560,16157
2021-09-16 14:00:00+00,15379,999,4807,1961,68,3878,1736,230,5085,0,34143,241,13657,11921,7114,16378
2021-09-16 14:30:00+00,15660,913,4804,2060,74,3992,1738,343,4237,228,34049,246,12913,11175,6371,16573
2021-09-16 15:00:00+00,16172,811,4807,2168,150,4450,1736,538,3792,96,34720,246,12653,10917,6110,16983
2021-09-16 15:30:00+00,16501,817,4801,2369,172,4468,1739,711,2960,538,35076,249,12041,10302,5501,17318
2021-09-16 16:00:00+00,16624,877,4804,2394,230,4636,1738,781,2206,1218,35508,250,11372,9634,4830,17501
2021-09-16 16:30:00+00,16780,968,4799,2516,223,4638,1735,803,1453,1470,35385,255,10726,8991,4192,17748
2021-09-16 17:00:00+00,16782,1069,4829,2855,235,4506,1737,861,694,1272,34840,262,10350,8613,3784,17851
2021-09-16 17:30:00+00,16480,1270,4831,3142,235,4442,1738,866,155,1260,34419,267,10101,8363,3532,17750
2021-09-16 18:00:00+00,16698,1297,4830,3452,236,3566,1736,919,1,1242,33977,269,10255,8519,3689,17995
2021-09-16 18:30:00+00,16330,1304,4830,3994,212,3496,1739,916,0,1564,34385,261,10775,9036,4206,17634
2021-09-16 19:00:00+00,16079,1304,4832,4374,238,3424,1739,814,0,1232,34036,261,11183,9444,4612,17383
2021-09-16 19:30:00+00,15605,1302,4832,4635,222,3430,1740,629,0,652,33047,261,11429,9689,4857,16907
2021-09-16 20:00:00+00,14689,1306,4836,4992,98,3916,1738,455,0,68,32098,260,11664,9926,5090,15995
2021-09-16 20:30:00+00,13455,1113,4834,5056,98,3768,1733,253,0,0,30310,249,11721,9988,5154,14568
2021-09-16 21:00:00+00,13714,821,4835,5027,84,3300,1736,132,0,0,29649,244,11682,9946,5111,14535
2021-09-16 21:30:00+00,12410,759,4838,5088,84,3026,1733,119,0,0,28057,233,11743,10010,5172,13169
2021-09-16 22:00:00+00,11091,495,4840,5451,75,2448,1734,121,0,0,26255,209,12100,10366,5526,11586
2021-09-16 22:30:00+00,9573,500,4841,5518,75,2662,1730,120,0,0,25019,199,12164,10434,5593,10073
2021-09-16 23:00:00+00,7945,470,4844,5584,56,3146,1732,113,0,0,23890,191,12216,10484,5640,8415
2021-09-16 23:30:00+00,7546,312,4839,5847,57,2942,1725,113,0,0,23381,178,12468,10743,5904,7858
2021-09-17 00:00:00+00,7280,259,4840,5938,57,2904,1732,115,0,0,23125,175,12567,10835,5995,7539
2021-09-17 00:30:00+00,7309,260,4842,6172,57,2928,1722,114,0,0,23404,174,12793,11071,6229,7569
2021-09-17 01:00:00+00,7187,260,4840,6228,57,2492,1719,115,0,0,22898,167,12844,11125,6285,7447
2021-09-17 01:30:00+00,6949,260,4836,5911,57,2420,1556,116,0,0,22105,167,12360,10804,5968,7209
2021-09-17 02:00:00+00,6846,260,4837,5787,57,2006,1548,115,0,0,21456,165,12229,10681,5844,7106
2021-09-17 02:30:00+00,6795,260,4837,5818,57,1834,1670,115,0,0,21387,162,12382,10712,5875,7055
2021-09-17 03:00:00+00,6770,327,4837,5869,57,1450,1728,114,0,0,21152,166,12491,10763,5926,7097
2021-09-17 03:30:00+00,6660,420,4835,6063,57,1326,1733,112,0,0,21205,165,12688,10955,6120,7080
2021-09-17 04:00:00+00,6826,482,4835,6211,57,272,1732,114,0,0,20529,169,12835,11103,6268,7308
2021-09-17 04:30:00+00,7045,500,4832,6208,59,334,1740,114,0,0,20832,174,12839,11099,6267,7545
2021-09-17 05:00:00+00,7721,451,4833,6247,73,382,1733,117,0,10,21567,180,12886,11153,6320,8172
2021-09-17 05:30:00+00,8567,428,4832,6403,72,212,1739,119,0,100,22472,183,13046,11307,6475,8995
2021-09-17 06:00:00+00,9836,380,4830,6474,103,1986,1759,117,174,86,25745,185,13340,11581,6751,10216
2021-09-17 06:30:00+00,10951,382,4832,6501,114,2100,1716,199,682,60,27537,190,13845,12129,7297,11333
2021-09-17 07:00:00+00,11953,362,4834,6802,344,2252,1710,302,1269,0,29828,186,14959,13249,8415,12315
2021-09-17 07:30:00+00,12526,379,4831,6866,313,2280,1709,244,1985,0,31133,186,15704,13995,9164,12905
2021-09-17 08:00:00+00,12932,375,4832,7016,312,2554,1710,178,2620,0,32529,185,16490,14780,9948,13307
2021-09-17 08:30:00+00,13213,387,4830,7210,219,2588,1696,182,3518,0,33843,182,17473,15777,10947,13600
2021-09-17 09:00:00+00,13437,389,4833,7115,184,1778,1679,320,3905,12,33652,179,17716,16037,11204,13826
2021-09-17 09:30:00+00,13545,396,4832,7030,167,1774,1678,205,4318,0,33946,178,18025,16347,11515,13941
2021-09-17 10:00:00+00,13649,391,4834,7126,149,3090,1678,134,4925,0,35976,179,18712,17034,12200,14040
2021-09-17 10:30:00+00,13750,396,4833,7043,148,3272,1678,119,4845,0,36084,181,18547,16869,12036,14146
2021-09-17 11:00:00+00,13851,440,4833,6969,132,3476,1678,120,5035,0,36534,181,18647,16969,12136,14291
2021-09-17 11:30:00+00,13651,463,4834,6963,91,3502,1678,119,5212,0,36513,180,18778,17100,12266,14114
2021-09-17 12:00:00+00,12688,407,4833,6826,70,4270,1703,118,5170,0,36085,173,18602,16899,12066,13095
2021-09-17 12:30:00+00,12587,412,4835,6474,70,4282,1674,119,5000,18,35471,175,18053,16379,11544,12999
2021-09-17 13:00:00+00,13247,406,4835,6187,72,3768,1675,117,4437,0,34744,183,17206,15531,10696,13653
2021-09-17 13:30:00+00,13332,403,4836,6013,70,3750,1674,116,3922,0,34116,187,16515,14841,10005,13735
2021-09-17 14:00:00+00,13828,482,4836,5861,75,3448,1676,116,3624,58,34004,197,16072,14396,9560,14310
2021-09-17 14:30:00+00,14532,500,4839,5620,76,3444,1677,116,3391,68,34263,204,15603,13926,9087,15032
2021-09-17 15:00:00+00,14807,455,4834,5517,109,3938,1677,124,2921,38,34420,206,15058,13381,8547,15262
2021-09-17 15:30:00+00,15726,405,4838,5350,115,3928,1715,134,2176,142,34529,215,14194,12479,7641,16131
2021-09-17 16:00:00+00,16347,451,4836,5034,225,3876,1720,245,1610,342,34686,226,13425,11705,6869,16798
2021-09-17 16:30:00+00,16629,496,4836,4689,245,3826,1720,293,978,478,34190,234,12468,10748,5912,17125
2021-09-17 17:00:00+00,16879,498,4832,4343,257,3252,1721,535,500,868,33685,243,11653,9932,5100,17377
2021-09-17 17:30:00+00,16981,495,4831,4080,250,3186,1720,662,123,778,33106,249,11004,9284,4453,17476
2021-09-17 18:00:00+00,17116,499,4831,3847,258,2964,1684,839,0,1004,33042,253,10620,8936,4105,17615
2021-09-17 18:30:00+00,17152,497,4832,3482,256,2946,1676,994,0,1336,33171,254,10246,8570,3738,17649
2021-09-17 19:00:00+00,17246,499,4831,3171,201,3118,1677,899,0,744,32386,261,9880,8203,3372,17745
2021-09-17 19:30:00+00,17138,499,4830,2751,178,3074,1676,770,0,556,31471,265,9435,7759,2929,17637
2021-09-17 20:00:00+00,17162,501,4827,2377,104,3045,1678,653,0,130,30477,273,8986,7308,2481,17663
2021-09-17 20:30:00+00,16648,473,4829,2283,103,3032,1676,442,0,0,29486,271,8891,7215,2386,17121
2021-09-17 21:00:00+00,16388,423,4825,2035,89,2775,1675,133,0,112,28455,269,8624,6949,2124,16811
2021-09-17 21:30:00+00,15348,468,4830,1786,91,2766,1678,113,0,0,27081,269,8385,6707,1877,15816
2021-09-17 22:00:00+00,13989,498,4832,1685,92,2846,1706,120,0,0,25768,264,8315,6609,1777,14487
2021-09-17 22:30:00+00,12758,498,4834,1622,91,2848,1711,119,0,0,24481,258,8258,6547,1713,13256
2021-09-17 23:00:00+00,11923,499,4830,1574,92,2846,1715,115,0,0,23594,254,8211,6496,1666,12422
2021-09-17 23:30:00+00,10935,499,4832,1420,93,2846,1713,114,0,0,22452,249,8058,6345,1513,11434
2021-09-18 00:00:00+00,10940,500,4831,1343,94,2848,1619,117,0,0,22292,248,7887,6268,1437,11440
2021-09-18 00:30:00+00,10890,498,4830,1333,94,2844,1590,118,0,0,22197,248,7847,6257,1427,11388
2021-09-18 01:00:00+00,10759,496,4830,1223,94,2704,1591,119,0,0,21816,249,7738,6147,1317,11255
2021-09-18 01:30:00+00,10440,495,4834,1220,94,2700,1589,118,0,0,21490,247,7737,6148,1314,10935
2021-09-18 02:00:00+00,10057,495,4835,1307,93,2700,1591,118,0,0,21196,243,7826,6235,1400,10552
2021-09-18 02:30:00+00,10369,496,4832,1252,93,2700,1592,118,0,0,21452,246,7769,6177,1345,10865
2021-09-18 03:00:00+00,10370,497,4833,1137,93,2700,1589,116,0,0,21335,247,7652,6063,1230,10867
2021-09-18 03:30:00+00,10416,496,4835,1030,93,2702,1588,115,0,0,21275,249,7546,5958,1123,10912
2021-09-18 04:00:00+00,10385,498,4831,1023,93,2700,1562,114,0,0,21206,249,7509,5947,1116,10883
2021-09-18 04:30:00+00,10598,496,4834,978,93,2702,1553,113,0,0,21367,251,7458,5905,1071,11094
2021-09-18 05:00:00+00,11486,497,4829,914,92,2846,1546,116,0,0,22326,257,7381,5835,1006,11983
2021-09-18 05:30:00+00,12033,499,4833,933,91,2850,1559,113,0,0,22911,260,7416,5857,1024,12532
2021-09-18 06:00:00+00,13233,500,4835,945,124,2888,1566,124,123,0,24338,263,7593,6027,1192,13733
2021-09-18 06:30:00+00,14301,502,4835,761,125,2890,1565,176,564,0,25719,266,7850,6285,1450,14803
2021-09-18 07:00:00+00,14841,501,4835,716,141,3022,1564,304,1158,460,27542,260,8414,6850,2015,15342
2021-09-18 07:30:00+00,15122,499,4834,745,141,3024,1563,398,1878,626,28830,253,9161,7598,2764,15621
2021-09-18 08:00:00+00,15150,499,4833,740,194,3022,1562,412,2708,408,29528,248,10037,8475,3642,15649
2021-09-18 08:30:00+00,14805,496,4831,704,199,3024,1563,388,3550,494,30054,238,10847,9284,4453,15301
2021-09-18 09:00:00+00,14632,501,4828,707,184,3022,1561,360,4238,512,30545,232,11518,9957,5129,15133
2021-09-18 09:30:00+00,14699,498,4822,689,162,3022,1558,300,5261,292,31303,227,12492,10934,6112,15197
2021-09-18 10:00:00+00,14620,499,4822,674,152,3022,1561,178,5977,0,31505,223,13186,11625,6803,15119
2021-09-18 10:30:00+00,14486,500,4823,680,153,3024,1559,145,6051,0,31421,222,13266,11707,6884,14986
2021-09-18 11:00:00+00,14288,499,4821,745,109,3024,1560,180,6249,268,31743,217,13484,11924,7103,14787
2021-09-18 11:30:00+00,14311,499,4822,792,108,3022,1560,202,5863,360,31539,219,13145,11585,6763,14810
2021-09-18 12:00:00+00,14585,499,4824,821,108,3024,1560,136,5352,342,31251,224,12665,11105,6281,15084
2021-09-18 12:30:00+00,14504,500,4825,937,108,3022,1561,163,4890,344,30854,226,12321,10760,5935,15004
2021-09-18 13:00:00+00,14378,497,4831,1125,106,3024,1566,183,4496,116,30322,229,12124,10558,5727,14875
2021-09-18 13:30:00+00,14449,498,4826,1284,106,3024,1579,134,3869,0,29769,234,11664,10085,5259,14947
2021-09-18 14:00:00+00,14594,499,4830,1518,98,3022,1583,123,3463,62,29792,235,11492,9908,5078,15093
2021-09-18 14:30:00+00,14772,499,4829,1730,94,3022,1580,116,2873,0,29515,240,11106,9526,4697,15271
2021-09-18 15:00:00+00,15211,498,4830,1910,106,3042,1579,158,2413,0,29747,244,10838,9259,4429,15709
2021-09-18 15:30:00+00,15317,496,4830,2114,126,3056,1571,159,1898,0,29567,247,10539,8968,4138,15813
2021-09-18 16:00:00+00,15544,496,4832,2404,224,3100,1580,176,1413,394,30163,247,10453,8873,4041,16040
2021-09-18 16:30:00+00,15681,495,4830,2602,232,3108,1583,416,908,598,30453,248,10155,8572,3742,16176
2021-09-18 17:00:00+00,15767,493,4831,2833,222,3146,1590,495,428,520,30325,251,9904,8314,3483,16260
2021-09-18 17:30:00+00,15825,497,4828,3271,224,3146,1594,343,81,640,30449,250,9998,8404,3576,16322
2021-09-18 18:00:00+00,15778,494,4823,3675,234,3144,1594,456,0,824,31022,246,10326,8732,3909,16272
2021-09-18 18:30:00+00,15581,496,4830,3991,232,3144,1592,524,0,552,30942,244,10645,9053,4223,16077
2021-09-18 19:00:00+00,15116,493,4827,4466,192,3202,1585,170,0,488,30539,239,11070,9485,4658,15609
2021-09-18 19:30:00+00,14168,496,4825,4657,175,3128,1582,134,0,418,29583,233,11239,9657,4832,14664
2021-09-18 20:00:00+00,13419,495,4826,4888,101,3200,1573,116,0,0,28618,231,11388,9815,4989,13914
2021-09-18 20:30:00+00,12485,494,4825,4973,101,3042,1575,112,0,0,27607,224,11474,9899,5074,12979
2021-09-18 21:00:00+00,11723,493,4825,5054,101,2604,1573,115,0,0,26488,214,11553,9980,5155,12216
2021-09-18 21:30:00+00,10619,458,4820,5178,101,2524,1578,118,0,0,25396,204,11677,10099,5279,11077
2021-09-18 22:00:00+00,9221,427,4823,5366,68,2598,1569,114,0,0,24186,196,11826,10257,5434,9648
2021-09-18 22:30:00+00,8329,484,4824,5559,68,2600,1571,113,0,0,23548,189,12022,10451,5627,8813
2021-09-18 23:00:00+00,7734,400,4820,5478,68,2672,1550,115,0,0,22837,181,11916,10366,5546,8134
2021-09-18 23:30:00+00,7574,399,4820,5332,68,2670,1551,115,0,0,22529,181,11771,10220,5400,7973
2021-09-19 00:00:00+00,7620,476,4813,5246,68,2528,1549,117,0,0,22417,182,11676,10127,5314,8096
2021-09-19 00:30:00+00,7152,492,4818,5487,68,2526,1544,117,0,0,22204,176,11917,10373,5555,7644
2021-09-19 01:00:00+00,6611,353,4822,5628,68,2526,1547,119,0,0,21674,165,12065,10518,5696,6964
2021-09-19 01:30:00+00,6585,286,4817,5324,68,2522,1547,120,0,0,21269,165,11756,10209,5392,6871
2021-09-19 02:00:00+00,6550,403,4821,4996,68,2382,1550,118,0,0,20888,171,11435,9885,5064,6953
2021-09-19 02:30:00+00,6643,291,4814,4797,68,2380,1538,117,0,0,20648,170,11217,9679,4865,6934
2021-09-19 03:00:00+00,6745,230,4816,4651,68,2380,1448,116,0,0,20454,170,10983,9535,4719,6975
2021-09-19 03:30:00+00,7033,237,4816,4538,68,2380,1456,116,0,0,20644,174,10878,9422,4606,7270
2021-09-19 04:00:00+00,7185,236,4816,4382,68,2380,1530,114,0,0,20711,177,10796,9266,4450,7421
2021-09-19 04:30:00+00,7721,237,4818,4115,68,2380,1516,116,0,0,20971,185,10517,9001,4183,7958
2021-09-19 05:00:00+00,8325,345,4817,3758,68,2524,1484,115,0,0,21436,197,10127,8643,3826,8670
2021-09-19 05:30:00+00,8919,371,4823,3641,68,2530,1488,113,0,0,21953,205,10020,8532,3709,9290
2021-09-19 06:00:00+00,9580,239,4820,3341,78,2670,1496,117,57,0,22398,208,9792,8296,3476,9819
2021-09-19 06:30:00+00,10622,266,4822,3107,82,2672,1497,115,268,0,23451,217,9776,8279,3457,10888
2021-09-19 07:00:00+00,11289,347,4818,3104,112,3014,1500,122,644,0,24950,220,10178,8678,3860,11636
2021-09-19 07:30:00+00,12468,398,4824,2848,116,3022,1501,117,1132,0,26426,227,10421,8920,4096,12866
2021-09-19 08:00:00+00,13333,485,4823,2774,165,3022,1504,120,1594,0,27820,231,10860,9356,4533,13818
2021-09-19 08:30:00+00,13903,500,4822,2723,172,3022,1512,128,2551,0,29333,227,11780,10268,5446,14403
2021-09-19 09:00:00+00,14052,499,4825,2735,157,3024,1516,147,2871,0,29826,226,12104,10588,5763,14551
2021-09-19 09:30:00+00,13979,499,4823,2732,142,3022,1517,148,3222,0,30084,223,12436,10919,6096,14478
2021-09-19 10:00:00+00,14055,453,4824,2898,128,2924,1587,125,3640,0,30634,218,13077,11490,6666,14508
2021-09-19 10:30:00+00,14172,391,4824,3059,127,2922,1588,124,4046,0,31253,213,13644,12056,7232,14563
2021-09-19 11:00:00+00,14046,396,4824,3313,87,3036,1587,121,4180,0,31590,210,13991,12404,7580,14442
2021-09-19 11:30:00+00,14044,393,4820,3337,82,3022,1586,121,4060,0,31465,211,13885,12299,7479,14437
2021-09-19 12:00:00+00,13975,477,4817,3243,82,3022,1585,115,4038,0,31354,213,13765,12180,7363,14452
2021-09-19 12:30:00+00,13713,499,4823,3218,82,3024,1586,115,4162,0,31222,211,13871,12285,7462,14212
2021-09-19 13:00:00+00,13462,500,4819,3187,82,3022,1585,115,4300,0,31072,209,13973,12388,7569,13962
2021-09-19 13:30:00+00,13177,500,4822,3283,82,3022,1578,117,4076,0,30657,208,13841,12263,7441,13677
2021-09-19 14:00:00+00,13821,421,4818,3186,82,3022,1564,117,3595,0,30626,214,13245,11681,6863,14242
2021-09-19 14:30:00+00,14168,500,4821,3132,85,3022,1579,117,3258,0,30682,221,12875,11296,6475,14668
2021-09-19 15:00:00+00,15167,499,4822,3084,127,3004,1583,127,2496,114,31023,232,12112,10529,5707,15666
2021-09-19 15:30:00+00,16072,498,4833,2990,135,3110,1590,163,1980,284,31655,240,11528,9938,5105,16570
2021-09-19 16:00:00+00,16940,499,4820,2687,183,2942,1585,250,1532,868,32306,246,10807,9222,4402,17439
2021-09-19 16:30:00+00,17196,499,4820,2457,189,2942,1587,294,1059,1102,32145,251,10112,8525,3705,17695
2021-09-19 17:00:00+00,17345,499,4822,2189,225,2954,1585,373,539,1196,31727,257,9360,7775,2953,17844
2021-09-19 17:30:00+00,17585,500,4823,2028,228,2944,1587,583,117,964,31359,265,8783,7196,2373,18085
2021-09-19 18:00:00+00,17838,500,4824,1952,242,2752,1589,708,0,946,31351,266,8607,7018,2194,18338
2021-09-19 18:30:00+00,17911,501,4819,1809,237,2750,1602,713,0,1070,31412,267,8467,6865,2046,18412
2021-09-19 19:00:00+00,17895,500,4822,1655,168,2762,1607,712,0,758,30879,271,8252,6645,1823,18395
2021-09-19 19:30:00+00,17780,501,4821,1647,157,2676,1600,670,0,258,30110,275,8225,6625,1804,18281
2021-09-19 20:00:00+00,17449,499,4822,1583,108,2340,1594,555,0,174,29124,279,8107,6513,1691,17948
2021-09-19 20:30:00+00,16688,500,4820,1511,105,2340,1614,158,0,124,27860,276,8050,6436,1616,17188
2021-09-19 21:00:00+00,15529,501,4820,1449,72,2470,1620,116,0,68,26645,272,7961,6341,1521,16030
2021-09-19 21:30:00+00,14368,497,4825,1407,71,2468,1622,113,0,0,25371,268,7925,6303,1478,14865
2021-09-19 22:00:00+00,12825,498,4829,1403,58,2552,1624,113,0,0,23902,255,7914,6290,1461,13323
2021-09-19 22:30:00+00,11630,499,4827,1396,58,2560,1625,113,0,0,22708,248,7906,6281,1454,12129
2021-09-19 23:00:00+00,11218,361,4828,1339,58,2878,1627,113,0,0,22422,244,7852,6225,1397,11579
2021-09-19 23:30:00+00,10868,233,4825,1419,58,2880,1624,114,0,0,22021,237,7926,6302,1477,11101
2021-09-20 00:00:00+00,10670,229,4827,1386,58,2850,1622,116,0,0,21758,239,7893,6271,1444,10899
2021-09-20 00:30:00+00,10731,237,4826,1354,58,2854,1622,117,0,0,21799,240,7860,6238,1412,10968
2021-09-20 01:00:00+00,10383,235,4824,1384,58,2681,1664,119,0,0,21348,237,7930,6266,1442,10618
2021-09-20 01:30:00+00,10109,232,4825,1450,58,2665,1669,119,0,0,21128,235,8002,6333,1508,10341
2021-09-20 02:00:00+00,10169,258,4820,1625,58,2398,1671,119,0,0,21118,236,8174,6503,1683,10427
2021-09-20 02:30:00+00,9960,342,4822,1747,58,2368,1671,119,0,0,21088,236,8298,6627,1805,10302
2021-09-20 03:00:00+00,10307,371,4819,1771,58,1831,1672,117,0,0,20946,243,8320,6648,1829,10678
2021-09-20 03:30:00+00,10370,464,4817,1839,58,1695,1672,117,0,0,21032,245,8386,6714,1897,10834
2021-09-20 04:00:00+00,11281,583,4815,1928,58,474,1669,114,0,0,20922,252,8470,6801,1986,11864
2021-09-20 04:30:00+00,11747,827,4816,2121,58,518,1673,112,0,0,21872,261,8668,6995,2179,12574
2021-09-20 05:00:00+00,13308,994,4817,2287,58,1370,1673,112,0,0,24619,275,8835,7162,2345,14302
2021-09-20 05:30:00+00,15226,1000,4818,2373,59,1538,1671,115,0,0,26800,283,8921,7250,2432,16226
2021-09-20 06:00:00+00,16666,997,4821,2461,87,2704,1661,278,70,68,29813,280,9100,7439,2618,17663
2021-09-20 06:30:00+00,17072,996,4822,2624,127,2722,1655,528,473,220,31239,275,9701,8046,3224,18068
2021-09-20 07:00:00+00,17271,994,4821,2755,200,3014,1659,434,1170,132,32450,267,10605,8946,4125,18265
2021-09-20 07:30:00+00,17135,999,4823,2993,202,3024,1657,409,1890,132,33264,258,11565,9908,5085,18134
2021-09-20 08:00:00+00,17087,999,4819,3232,201,3022,1656,458,2700,142,34316,250,12608,10952,6133,18086
2021-09-20 08:30:00+00,16720,999,4823,3275,182,3012,1656,383,3499,0,34549,244,13435,11779,6956,17719
2021-09-20 09:00:00+00,16800,1000,4816,3254,82,2576,1655,188,4251,0,34622,241,14058,12403,7587,17800
2021-09-20 09:30:00+00,16414,1000,4817,3305,77,2564,1656,120,4922,0,34875,235,14777,13121,8304,17414
2021-09-20 10:00:00+00,16315,1000,4819,3295,59,2358,1658,117,5470,0,35091,232,15301,13643,8824,17315
2021-09-20 10:30:00+00,16050,1000,4818,3462,58,2344,1656,113,5884,0,35385,227,15878,14222,9404,17050
2021-09-20 11:00:00+00,15819,998,4817,3742,58,2472,1657,112,6209,0,35884,222,16483,14826,10009,16817
2021-09-20 11:30:00+00,15569,998,4817,3769,58,2486,1654,114,6378,0,35843,219,16676,15022,10205,16567
2021-09-20 12:00:00+00,15056,997,4815,3953,58,2806,1654,114,6398,0,35851,214,16878,15224,10409,16053
2021-09-20 12:30:00+00,14405,994,4818,4271,58,2816,1650,115,6139,66,35332,210,16936,15286,10468,15399
2021-09-20 13:00:00+00,13670,949,4813,4573,58,2884,1643,115,5741,66,34512,205,16828,15185,10372,14619
2021-09-20 13:30:00+00,13353,925,4818,4864,58,2892,1640,115,5523,68,34256,203,16903,15263,10445,14278
2021-09-20 14:00:00+00,13291,968,4819,4996,81,2958,1637,115,5028,68,33961,205,16561,14924,10105,14259
2021-09-20 14:30:00+00,13678,993,4820,5132,84,2962,1645,119,4438,68,33939,210,16119,14474,9654,14671
2021-09-20 15:00:00+00,14588,994,4814,5313,178,3042,1648,191,3842,64,34674,217,15795,14147,9333,15582
2021-09-20 15:30:00+00,15795,994,4813,5279,207,3028,1644,237,3069,86,35152,228,15012,13368,8555,16789
2021-09-20 16:00:00+00,16717,993,4811,5217,273,2288,1647,345,2249,882,35422,232,14197,12550,7739,17710
2021-09-20 16:30:00+00,17272,994,4811,5043,369,2274,1644,461,1406,1190,35464,238,13273,11629,6818,18266
2021-09-20 17:00:00+00,17597,990,4812,4817,475,2126,1654,585,611,1292,34959,245,12369,10715,5903,18587
2021-09-20 17:30:00+00,17879,990,4815,4619,700,2124,1652,598,98,1222,34697,250,11884,10232,5417,18869
2021-09-20 18:00:00+00,17640,988,4816,4863,601,2450,1647,609,0,1188,34802,248,11927,10280,5464,18628
2021-09-20 18:30:00+00,17542,990,4813,4967,600,2456,1644,571,0,1266,34849,246,12024,10380,5567,18532
2021-09-20 19:00:00+00,17105,993,4813,4345,239,2826,1649,430,0,1238,33638,253,11046,9397,4584,18098
2021-09-20 19:30:00+00,16660,989,4815,4307,175,2836,1639,505,0,792,32718,255,10936,9297,4482,17649
2021-09-20 20:00:00+00,16071,990,4813,4428,101,3020,1645,319,0,140,31527,258,10987,9342,4529,17061
2021-09-20 20:30:00+00,14556,988,4815,4767,97,3016,1643,158,0,0,30040,249,11322,9679,4864,15544
2021-09-20 21:00:00+00,13575,992,4815,4746,74,2640,1644,115,0,0,28601,246,11279,9635,4820,14567
2021-09-20 21:30:00+00,12244,990,4814,4560,74,2630,1645,117,0,20,27094,240,11093,9448,4634,13234
2021-09-20 22:00:00+00,10481,998,4815,4406,58,2300,1634,114,0,0,24806,230,10913,9279,4464,11479
2021-09-20 22:30:00+00,8791,1000,4813,4320,58,2558,1634,113,0,0,23287,220,10825,9191,4378,9791
2021-09-20 23:00:00+00,8420,984,4816,4199,58,2558,1638,115,0,0,22788,218,10711,9073,4257,9404
2021-09-20 23:30:00+00,8170,977,4813,4218,58,2558,1639,113,0,0,22546,215,10728,9089,4276,9147
2021-09-21 00:00:00+00,7746,998,4815,4363,58,2556,1638,113,0,0,22287,212,10874,9236,4421,8744
2021-09-21 00:30:00+00,7753,1000,4810,4391,58,2556,1630,114,0,0,22312,212,10889,9259,4449,8753
2021-09-21 01:00:00+00,7782,1000,4809,4014,58,2538,1624,119,0,0,21944,216,10505,8881,4072,8782
2021-09-21 01:30:00+00,7685,1000,4809,3847,58,2538,1636,117,0,0,21690,217,10350,8714,3905,8685
2021-09-21 02:00:00+00,7646,999,4811,3689,59,2494,1637,116,0,0,21451,218,10196,8559,3748,8645
2021-09-21 02:30:00+00,7704,1000,4811,3569,59,2494,1641,117,0,0,21395,220,10080,8439,3628,8704
2021-09-21 03:00:00+00,8086,999,4808,3427,59,2518,1641,119,0,0,21657,224,9935,8294,3486,9085
2021-09-21 03:30:00+00,8348,1001,4857,3255,59,2518,1639,119,0,0,21796,228,9810,8171,3314,9349
2021-09-21 04:00:00+00,9930,1000,4866,3097,75,1214,1632,113,0,0,21927,239,9670,8038,3172,10930
2021-09-21 04:30:00+00,10809,992,4865,3139,78,1202,1635,112,0,0,22832,244,9717,8082,3217,11801
2021-09-21 05:00:00+00,12607,960,4863,3170,79,1918,1638,112,0,0,25347,260,9750,8112,3249,13567
2021-09-21 05:30:00+00,14549,942,4861,3201,96,1929,1638,113,0,30,27359,268,9796,8158,3297,15491
2021-09-21 06:00:00+00,16653,993,4861,3374,96,2020,1655,300,119,166,30237,275,10105,8450,3589,17646
2021-09-21 06:30:00+00,17062,985,4865,3271,97,2026,1659,435,558,170,31128,273,10450,8791,3926,18047
2021-09-21 07:00:00+00,17243,999,4862,3257,132,2064,1664,569,1123,294,32207,268,11038,9374,4512,18242
2021-09-21 07:30:00+00,17119,1000,4859,3348,134,2022,1660,518,1866,606,33132,258,11867,10207,5348,18119
2021-09-21 08:00:00+00,17439,998,4860,3355,115,2022,1661,474,3012,504,34440,252,13003,11342,6482,18437
2021-09-21 08:30:00+00,17043,996,4863,3430,114,2068,1640,264,4091,330,34839,242,14138,12498,7635,18039
2021-09-21 09:00:00+00,16561,995,4871,3542,113,2082,1645,126,4965,222,35122,234,15136,13491,8620,17556
2021-09-21 09:30:00+00,16312,997,4869,3529,80,2076,1636,132,5575,64,35270,230,15689,14053,9184,17309
2021-09-21 10:00:00+00,16021,998,4873,3691,56,2028,1633,116,5950,106,35472,226,16203,14570,9697,17019
2021-09-21 10:30:00+00,15663,971,4886,3929,56,2022,1636,114,6241,116,35634,220,16748,15112,10226,16634
2021-09-21 11:00:00+00,15441,783,4890,4185,56,2024,1632,116,6325,78,35530,213,17088,15456,10566,16224
2021-09-21 11:30:00+00,15527,498,4932,4337,55,2024,1628,115,6376,110,35602,206,17328,15700,10768,16025
2021-09-21 12:00:00+00,15296,473,4932,4504,55,2022,1634,115,6189,110,35330,204,17314,15680,10748,15769
2021-09-21 12:30:00+00,15264,461,4933,4662,54,2022,1631,115,5961,154,35257,204,17241,15610,10677,15725
2021-09-21 13:00:00+00,15085,469,4934,4879,55,2022,1627,115,5644,262,35092,203,17139,15512,10578,15554
2021-09-21 13:30:00+00,15185,563,4936,5173,55,2022,1627,115,5141,0,34817,209,16932,15305,10369,15748
2021-09-21 14:00:00+00,15402,503,4933,5231,58,1974,1630,116,4909,0,34756,209,16761,15131,10198,15905
2021-09-21 14:30:00+00,15819,517,4934,5458,64,1974,1628,115,4350,0,34859,214,16434,14806,9872,16336
2021-09-21 15:00:00+00,16505,747,4943,5443,141,1946,1631,117,3610,0,35083,226,15768,14137,9194,17252
2021-09-21 15:30:00+00,17128,829,4944,5595,157,1944,1637,207,2938,84,35463,233,15271,13634,8690,17957
2021-09-21 16:00:00+00,17262,755,4964,5530,261,2036,1649,276,2068,656,35457,235,14472,12823,7859,18017
2021-09-21 16:30:00+00,17680,731,4968,5518,279,2038,1647,351,1258,1008,35478,239,13670,12023,7055,18411
2021-09-21 17:00:00+00,17727,852,4996,5411,373,2038,1654,387,567,904,34909,247,13001,11347,6351,18579
2021-09-21 17:30:00+00,17803,887,5067,5524,351,2038,1652,406,84,886,34698,251,12678,11026,5959,18690
2021-09-21 18:00:00+00,17609,887,5070,5590,299,2038,1656,351,0,1174,34674,248,12615,10959,5889,18496
2021-09-21 18:30:00+00,17605,923,5071,5546,278,2038,1659,541,0,1326,34987,248,12554,10895,5824,18528
2021-09-21 19:00:00+00,17363,850,5075,5690,182,2038,1662,497,0,698,34055,250,12609,10947,5872,18213
2021-09-21 19:30:00+00,16936,522,5075,6008,164,2024,1661,205,0,378,32973,241,12908,11247,6172,17458
2021-09-21 20:00:00+00,16147,254,5072,6337,65,2038,1652,115,0,140,31820,231,13126,11474,6402,16401
2021-09-21 20:30:00+00,14793,0,5074,6565,60,2020,1610,115,0,0,30237,218,13309,11699,6625,14793
2021-09-21 21:00:00+00,13147,0,5075,6636,60,1996,1595,114,0,0,28623,207,13366,11771,6696,13147
2021-09-21 21:30:00+00,11355,0,5077,6688,59,2006,1596,114,0,0,26895,195,13420,11824,6747,11355
2021-09-21 22:00:00+00,9777,0,5073,6774,59,1972,1597,119,0,22,25393,183,13503,11906,6833,9777
2021-09-21 22:30:00+00,8101,0,5074,7018,59,2050,1593,113,0,0,24008,167,13744,12151,7077,8101
2021-09-21 23:00:00+00,7606,0,5071,7048,59,1772,1594,112,0,0,23262,161,13772,12178,7107,7606
2021-09-21 23:30:00+00,6898,0,5068,7180,59,1696,1597,112,0,0,22610,152,13904,12307,7239,6898
2021-09-22 00:00:00+00,6656,0,5067,7209,59,1770,1594,115,0,0,22470,151,13929,12335,7268,6656
2021-09-22 00:30:00+00,6629,0,5065,7042,59,1740,1596,116,0,0,22247,151,13762,12166,7101,6629
2021-09-22 01:00:00+00,6742,0,5066,6794,59,1756,1595,116,0,0,22128,154,13514,11919,6853,6742
2021-09-22 01:30:00+00,6593,0,5067,6782,59,1738,1594,115,0,0,21948,153,13502,11908,6841,6593
2021-09-22 02:00:00+00,6424,0,5068,6963,59,1718,1597,115,0,0,21944,149,13687,12090,7022,6424
2021-09-22 02:30:00+00,6344,0,5075,6919,59,1686,1599,116,0,0,21798,148,13652,12053,6978,6344
2021-09-22 03:00:00+00,6282,0,5077,6952,59,1734,1598,114,0,0,21816,148,13686,12088,7011,6282
2021-09-22 03:30:00+00,6334,0,5079,6834,59,1674,1594,114,0,0,21688,148,13566,11972,6893,6334
2021-09-22 04:00:00+00,6253,0,5074,6869,59,1806,1595,113,0,0,21769,147,13597,12002,6928,6253
2021-09-22 04:30:00+00,6789,0,5077,7215,59,1792,1596,116,0,0,22644,151,13947,12351,7274,6789
2021-09-22 05:00:00+00,8945,0,5072,7605,59,1496,1596,295,0,110,25178,166,14332,12736,7664,8945
2021-09-22 05:30:00+00,10587,0,5075,8054,59,1474,1595,395,0,0,27239,178,14783,13188,8113,10587
2021-09-22 06:00:00+00,12232,0,5076,7995,92,2016,1594,411,103,186,29705,191,14860,13266,8190,12232
2021-09-22 06:30:00+00,12860,0,5075,8008,97,2122,1595,530,587,548,31422,191,15362,13767,8692,12860
2021-09-22 07:00:00+00,12951,0,5075,8186,133,2172,1596,588,1333,652,32686,187,16323,14727,9652,12951
2021-09-22 07:30:00+00,12898,0,5081,8097,134,2060,1592,567,2117,612,33158,182,17021,15429,10348,12898
2021-09-22 08:00:00+00,12824,0,5073,7773,136,2176,1590,586,2881,758,33797,179,17453,15863,10790,12824
2021-09-22 08:30:00+00,12561,0,5069,7588,132,2200,1595,461,3522,796,33924,175,17906,16311,11242,12561
2021-09-22 09:00:00+00,12479,0,4727,7597,126,2452,1591,236,4166,812,34186,172,18207,16616,11889,12479
2021-09-22 09:30:00+00,12615,0,4713,7576,111,2266,1595,196,4857,466,34395,169,18852,17257,12544,12615
2021-09-22 10:00:00+00,12548,0,4719,7706,109,2262,1590,275,5427,88,34724,169,19551,17961,13242,12548
2021-09-22 10:30:00+00,12494,0,4718,7659,106,2342,1593,273,5644,76,34905,169,19720,18127,13409,12494
2021-09-22 11:00:00+00,12683,0,4717,7776,86,2126,1589,335,5864,126,35302,167,20032,18443,13726,12683
2021-09-22 11:30:00+00,12569,0,4720,7835,84,2022,1589,385,5840,0,35044,166,20068,18479,13759,12569
2021-09-22 12:00:00+00,11575,0,4720,8136,96,2258,1585,378,5986,0,34734,157,20523,18938,14218,11575
2021-09-22 12:30:00+00,11579,0,4716,8300,104,2152,1580,143,6115,0,34689,154,20815,19235,14519,11579
2021-09-22 13:00:00+00,11095,0,4779,8930,104,2022,1586,115,6092,0,34723,148,21491,19905,15126,11095
2021-09-22 13:30:00+00,10249,0,4817,9506,99,2022,1588,114,5604,0,33999,141,21614,20026,15209,10249
2021-09-22 14:00:00+00,10008,0,4819,9850,89,2000,1589,115,5156,0,33626,140,21503,19914,15095,10008
2021-09-22 14:30:00+00,10456,0,4795,10105,106,2024,1590,119,4445,0,33640,146,21041,19451,14656,10456
2021-09-22 15:00:00+00,11583,0,4791,10446,186,1876,1592,118,3769,0,34361,153,20784,19192,14401,11583
2021-09-22 15:30:00+00,12759,0,4790,10799,197,1926,1592,126,2940,0,35129,164,20318,18726,13936,12759
2021-09-22 16:00:00+00,13461,0,4789,11120,240,2006,1592,150,2064,0,35422,172,19805,18213,13424,13461
2021-09-22 16:30:00+00,13758,0,4790,11460,300,2126,1594,175,1198,14,35415,177,19342,17748,12958,13758
2021-09-22 17:00:00+00,13484,0,4789,11465,374,2040,1595,258,476,622,35103,175,18699,17104,12315,13484
2021-09-22 17:30:00+00,13788,0,4786,10998,389,2152,1596,288,64,904,34965,180,17833,16237,11451,13788
2021-09-22 18:00:00+00,13937,0,4788,10636,375,2222,1596,411,0,790,34755,186,17395,15799,11011,13937
2021-09-22 18:30:00+00,14062,0,4790,10844,367,2144,1595,439,0,296,34537,188,17596,16001,11211,14062
2021-09-22 19:00:00+00,13453,0,4788,11215,215,2018,1595,287,0,366,33937,182,17813,16218,11430,13453
2021-09-22 19:30:00+00,13038,0,4789,11232,195,1930,1596,55,0,0,32835,179,17812,16216,11427,13038
2021-09-22 20:00:00+00,11399,0,4794,11393,96,2020,1594,42,0,0,31338,167,17877,16283,11489,11399
2021-09-22 20:30:00+00,9203,0,4795,11720,92,2050,1595,43,0,90,29588,148,18202,16607,11812,9203
2021-09-22 21:00:00+00,7978,0,4799,11645,77,1760,1593,44,0,128,28024,137,18114,16521,11722,7978
2021-09-22 21:30:00+00,6739,0,4797,11541,76,1612,1588,42,0,46,26441,125,18002,16414,11617,6739
2021-09-22 22:00:00+00,5593,0,4800,11452,63,1188,1593,42,0,0,24731,113,17908,16315,11515,5593
2021-09-22 22:30:00+00,4489,0,4795,11335,64,1470,1442,43,0,0,23638,105,17636,16194,11399,4489
2021-09-22 23:00:00+00,4157,0,4794,11606,64,974,1564,41,0,0,23200,94,18028,16464,11670,4157
2021-09-22 23:30:00+00,3546,0,4791,11837,67,668,1536,42,0,0,22487,81,18231,16695,11904,3546
2021-09-23 00:00:00+00,3761,0,4789,12287,67,286,1395,43,0,0,22628,78,18538,17143,12354,3761
2021-09-23 00:30:00+00,3676,0,4786,12888,67,224,1273,45,0,0,22959,73,19014,17741,12955,3676
2021-09-23 01:00:00+00,3531,0,4785,13131,66,84,1217,46,0,0,22860,68,19199,17982,13197,3531
2021-09-23 01:30:00+00,3427,0,4786,13242,66,86,1199,46,0,0,22852,66,19293,18094,13308,3427
2021-09-23 02:00:00+00,3550,0,4787,13048,66,0,1396,47,0,0,22894,69,19297,17901,13114,3550
2021-09-23 02:30:00+00,3466,0,4793,13218,66,0,1359,47,0,0,22949,67,19436,18077,13284,3466
2021-09-23 03:00:00+00,3332,0,4786,13358,66,0,1341,45,0,0,22928,65,19551,18210,13424,3332
2021-09-23 03:30:00+00,3530,0,4785,13413,67,0,1395,45,0,0,23235,68,19660,18265,13480,3530
2021-09-23 04:00:00+00,3447,0,4789,13411,90,102,1527,46,0,0,23412,68,19817,18290,13501,3447
2021-09-23 04:30:00+00,3614,0,4790,13619,93,102,1727,51,0,0,23996,70,20229,18502,13712,3614
2021-09-23 05:00:00+00,3950,0,4791,14134,112,582,1911,47,0,0,25527,80,20948,19037,14246,3950
2021-09-23 05:30:00+00,5093,0,4791,14884,125,630,2037,40,0,0,27600,92,21837,19800,15009,5093
2021-09-23 06:00:00+00,6762,0,4787,15209,135,768,2118,44,12,64,29899,103,22261,20143,15356,6762
2021-09-23 06:30:00+00,8149,0,4786,15375,140,802,2072,43,313,14,31694,115,22686,20614,15828,8149
2021-09-23 07:00:00+00,8548,0,4787,15368,183,1436,2063,42,893,82,33402,120,23294,21230,16444,8548
2021-09-23 07:30:00+00,8717,0,4789,15250,185,1550,2078,43,1496,50,34158,119,23798,21720,16931,8717
2021-09-23 08:00:00+00,8537,0,4790,14840,185,2042,2095,42,2060,76,34667,116,23970,21875,17085,8537
2021-09-23 08:30:00+00,8407,0,4790,14518,164,2102,2091,42,2512,242,34868,114,24075,21984,17194,8407
2021-09-23 09:00:00+00,8503,0,4794,14438,144,2152,2091,46,2707,58,34933,115,24174,22083,17289,8503
2021-09-23 09:30:00+00,8641,0,4793,14089,141,2156,2081,48,3086,54,35089,116,24190,22109,17316,8641
2021-09-23 10:00:00+00,8289,0,4794,13613,113,2548,2073,52,3412,86,34980,113,24005,21932,17138,8289
2021-09-23 10:30:00+00,8489,0,4795,13206,113,2610,2076,50,3674,94,35107,115,23864,21788,16993,8489
2021-09-23 11:00:00+00,9063,0,4794,12778,94,2726,2078,44,3892,0,35469,120,23636,21558,16764,9063
2021-09-23 11:30:00+00,9230,0,4846,12035,93,2738,2078,42,4159,0,35221,123,23211,21133,16287,9230
2021-09-23 12:00:00+00,9037,0,4866,11368,65,3350,2048,45,4278,34,35091,122,22625,20577,15711,9037
2021-09-23 12:30:00+00,9077,0,4858,11079,64,3374,2074,43,4187,38,34794,124,22262,20188,15330,9077
2021-09-23 13:00:00+00,9458,0,4874,10634,65,3332,2100,46,3873,38,34420,130,21546,19446,14572,9458
2021-09-23 13:30:00+00,9885,0,4890,9918,76,3322,2105,44,3563,32,33835,137,20552,18447,13557,9885
2021-09-23 14:00:00+00,11341,0,4887,8694,79,3236,2084,47,3283,38,33689,155,19027,16943,12056,11341
2021-09-23 14:30:00+00,12375,0,4893,8011,90,3208,2136,72,3017,38,33840,166,18147,16011,11118,12375
2021-09-23 15:00:00+00,13764,59,4913,7588,98,2594,2149,397,2628,30,34220,184,17376,15227,10314,13823
2021-09-23 15:30:00+00,14784,226,4910,7331,124,2484,2147,430,2123,106,34665,198,16635,14488,9578,15010
2021-09-23 16:00:00+00,15534,432,4906,7191,241,1970,2169,545,1562,806,35356,209,16069,13900,8994,15966
2021-09-23 16:30:00+00,16044,494,4908,6839,260,1922,2181,564,941,890,35043,218,15129,12948,8040,16538
2021-09-23 17:00:00+00,16460,491,4908,6516,340,1846,2181,601,357,1014,34714,224,14302,12121,7213,16951
2021-09-23 17:30:00+00,16663,491,4908,6483,363,1844,2163,620,16,1038,34589,227,13933,11770,6862,17154
2021-09-23 18:00:00+00,16747,492,4910,6789,342,1922,2145,721,0,924,34992,227,14186,12041,7131,17239
2021-09-23 18:30:00+00,16517,493,4913,7247,321,1922,2151,754,0,896,35214,224,14632,12481,7568,17010
2021-09-23 19:00:00+00,16106,492,4911,7446,213,1880,2146,454,0,818,34466,221,14716,12570,7659,16598
2021-09-23 19:30:00+00,15670,494,4957,7649,202,1866,2149,190,0,462,33639,219,14957,12808,7851,16164
2021-09-23 20:00:00+00,14904,491,4972,8107,68,1340,2148,116,0,12,32158,212,15295,13147,8175,15395
2021-09-23 20:30:00+00,13187,296,4972,8281,66,1302,2147,116,0,36,30403,195,15466,13319,8347,13483
2021-09-23 21:00:00+00,12063,148,4970,8297,67,942,2147,116,0,176,28926,188,15481,13334,8364,12211
2021-09-23 21:30:00+00,10696,0,4973,8265,67,884,2145,115,0,0,27145,174,15450,13305,8332,10696
2021-09-23 22:00:00+00,8601,0,4970,8204,67,1380,2147,118,0,0,25487,156,15388,13241,8271,8601
2021-09-23 22:30:00+00,7490,0,4972,7806,66,1392,2146,116,0,0,23988,148,14990,12844,7872,7490
2021-09-23 23:00:00+00,6786,0,4974,7663,65,1258,2139,115,0,0,23000,140,14841,12702,7728,6786
2021-09-23 23:30:00+00,6221,0,4970,7628,65,1270,2143,113,0,26,22436,134,14806,12663,7693,6221
2021-09-24 00:00:00+00,5647,0,4971,7792,65,1394,2145,115,0,0,22129,130,14973,12828,7857,5647
2021-09-24 00:30:00+00,5297,0,4971,8086,65,1408,2138,115,0,0,22080,124,15260,13122,8151,5297
2021-09-24 01:00:00+00,5350,0,4972,8120,65,1410,2074,116,0,0,22107,124,15231,13157,8185,5350
2021-09-24 01:30:00+00,5411,0,4972,8037,65,1446,2074,115,0,0,22120,126,15148,13074,8102,5411
2021-09-24 02:00:00+00,5308,0,4972,8157,64,1420,2077,117,0,0,22115,124,15270,13193,8221,5308
2021-09-24 02:30:00+00,5080,0,4972,8321,64,1398,2070,117,0,0,22022,120,15427,13357,8385,5080
2021-09-24 03:00:00+00,4586,0,4973,9019,63,1380,2071,117,0,0,22209,110,16126,14055,9082,4586
2021-09-24 03:30:00+00,3867,0,4974,9751,62,1378,2065,118,0,0,22215,97,16852,14787,9813,3867
2021-09-24 04:00:00+00,4209,0,4973,10142,62,1408,1995,114,0,0,22903,100,17172,15177,10204,4209
2021-09-24 04:30:00+00,4872,0,4973,10211,64,1482,1837,114,0,0,23553,109,17085,15248,10275,4872
2021-09-24 05:00:00+00,6095,0,4975,10369,108,1503,2011,114,0,0,25175,122,17463,15452,10477,6095
2021-09-24 05:30:00+00,7831,0,4974,10944,145,1470,1886,120,0,0,27370,136,17949,16063,11089,7831
2021-09-24 06:00:00+00,9951,0,4977,11334,166,1450,1515,296,51,0,29740,152,18043,16528,11551,9951
2021-09-24 06:30:00+00,10830,0,4973,11499,178,1448,1637,519,417,0,31501,157,18704,17067,12094,10830
2021-09-24 07:00:00+00,10613,0,4973,11839,230,1732,2090,427,1077,36,33017,150,20209,18119,13146,10613
2021-09-24 07:30:00+00,10393,0,4975,12016,230,1698,2184,400,1810,6,33712,145,21215,19031,14056,10393
2021-09-24 08:00:00+00,10413,0,4972,12295,228,1506,2181,311,2433,80,34419,139,22109,19928,14956,10413
2021-09-24 08:30:00+00,9751,0,4975,12747,214,1486,2182,182,2814,42,34393,131,22932,20750,15775,9751
2021-09-24 09:00:00+00,9581,0,4974,13167,117,1100,2182,166,3267,0,34554,126,23707,21525,16551,9581
2021-09-24 09:30:00+00,8757,0,4978,13696,117,1096,2183,165,3508,0,34500,117,24482,22299,17321,8757
2021-09-24 10:00:00+00,7893,0,4980,13820,114,1652,2183,165,4549,0,35356,110,25646,23463,18483,7893
2021-09-24 10:30:00+00,7348,0,4982,13699,107,1638,2194,167,5337,0,35472,103,26319,24125,19143,7348
2021-09-24 11:00:00+00,6875,0,4983,13679,88,2008,2204,166,5335,0,35338,98,26289,24085,19102,6875
2021-09-24 11:30:00+00,6547,0,4980,13713,88,2014,2192,164,5418,0,35116,94,26391,24199,19219,6547
2021-09-24 12:00:00+00,6184,0,4978,13733,87,2004,2214,164,5467,0,34831,92,26479,24265,19287,6184
2021-09-24 12:30:00+00,6139,0,4981,13673,85,2018,2220,163,5316,0,34595,93,26275,24055,19074,6139
2021-09-24 13:00:00+00,6326,0,4979,13392,73,2050,2221,144,5237,0,34422,95,25902,23681,18702,6326
2021-09-24 13:30:00+00,6342,0,4979,13567,67,2052,2224,145,5002,0,34378,95,25839,23615,18636,6342
2021-09-24 14:00:00+00,5954,0,5028,13700,72,2462,2193,146,4497,0,34052,92,25490,23297,18269,5954
2021-09-24 14:30:00+00,6471,0,5050,13521,73,2484,2210,150,3794,22,33775,99,24648,22438,17388,6471
2021-09-24 15:00:00+00,7704,0,5051,13220,105,2908,2205,156,3074,40,34463,113,23655,21450,16399,7704
2021-09-24 15:30:00+00,8965,0,5046,12632,117,2920,2208,180,2280,232,34580,127,22283,20075,15029,8965
2021-09-24 16:00:00+00,11486,0,5044,12171,163,1622,2216,458,1421,232,34813,155,21015,18799,13755,11486
2021-09-24 16:30:00+00,12283,0,5042,11753,167,1574,2230,505,742,300,34596,166,19934,17704,12662,12283
2021-09-24 17:00:00+00,12779,0,5039,11221,287,2260,2228,315,243,216,34588,171,19018,16790,11751,12779
2021-09-24 17:30:00+00,13364,0,5039,10942,352,2282,2206,174,14,264,34637,176,18553,16347,11308,13364
2021-09-24 18:00:00+00,13176,0,5038,10594,409,3022,2221,263,0,152,34875,176,18262,16041,11003,13176
2021-09-24 18:30:00+00,13333,0,5040,10255,410,3042,2221,241,0,124,34666,178,17926,15705,10665,13333
2021-09-24 19:00:00+00,12938,0,5039,9825,379,3040,2228,151,0,114,33714,178,17471,15243,10204,12938
2021-09-24 19:30:00+00,12332,0,5038,9212,370,3014,2227,140,0,108,32441,177,16847,14620,9582,12332
2021-09-24 20:00:00+00,12306,0,5040,9028,289,2254,2227,133,0,2,31279,181,16584,14357,9317,12306
2021-09-24 20:30:00+00,11631,0,5037,8274,275,2228,2223,131,0,0,29799,181,15809,13586,8549,11631
2021-09-24 21:00:00+00,10976,0,5038,7655,95,2328,2219,128,0,0,28439,182,15007,12788,7750,10976
2021-09-24 21:30:00+00,10034,0,5036,7158,89,2330,2216,128,0,0,26991,178,14499,12283,7247,10034
2021-09-24 22:00:00+00,8698,0,5038,6785,71,2636,2192,126,0,0,25546,166,14086,11894,6856,8698
2021-09-24 22:30:00+00,8041,0,5044,6280,64,2648,2225,126,0,0,24428,163,13613,11388,6344,8041
2021-09-24 23:00:00+00,7962,0,5045,5779,63,2374,2226,126,0,0,23575,165,13113,10887,5842,7962
2021-09-24 23:30:00+00,7142,0,5044,5258,63,2370,2220,115,0,0,22212,160,12585,10365,5321,7142
2021-09-25 00:00:00+00,6824,0,5042,5066,63,2400,2213,117,0,0,21725,160,12384,10171,5129,6824
2021-09-25 00:30:00+00,7313,0,5038,4538,62,2398,2206,118,0,0,21673,170,11844,9638,4600,7313
2021-09-25 01:00:00+00,7323,0,5039,4244,62,2404,2194,120,0,0,21386,172,11539,9345,4306,7323
2021-09-25 01:30:00+00,7077,0,5038,4042,61,2402,2221,121,0,0,20962,171,11362,9141,4103,7077
2021-09-25 02:00:00+00,7287,0,5038,3696,61,2350,2226,121,0,0,20779,177,11021,8795,3757,7287
2021-09-25 02:30:00+00,8151,0,5039,3321,61,2350,2228,122,0,0,21272,189,10649,8421,3382,8151
2021-09-25 03:00:00+00,8283,0,5040,2981,62,2408,2220,115,0,0,21109,193,10303,8083,3043,8283
2021-09-25 03:30:00+00,8366,0,5038,2704,62,2410,2228,115,0,0,20923,196,10032,7804,2766,8366
2021-09-25 04:00:00+00,8285,0,5044,2563,62,2700,2228,117,0,0,20999,198,9897,7669,2625,8285
2021-09-25 04:30:00+00,8712,0,5044,2487,62,2750,2129,115,0,0,21299,203,9722,7593,2549,8712
2021-09-25 05:00:00+00,9604,0,5050,2257,62,2934,2114,114,0,68,22203,214,9483,7369,2319,9604
2021-09-25 05:30:00+00,10592,0,5051,2286,62,2754,2175,232,0,0,23152,221,9574,7398,2348,10592
2021-09-25 06:00:00+00,11847,0,5047,2145,70,2790,2216,378,16,0,24509,229,9494,7278,2231,11847
2021-09-25 06:30:00+00,13000,0,5050,1904,74,2774,2234,376,151,332,25895,234,9413,7179,2129,13000
2021-09-25 07:00:00+00,13957,0,5049,1848,159,3018,2238,458,372,614,27713,236,9666,7428,2379,13957
2021-09-25 07:30:00+00,14454,0,5046,1894,182,3024,2243,593,661,684,28781,236,10026,7783,2737,14454
2021-09-25 08:00:00+00,15063,0,5048,1896,235,3022,2237,653,1099,886,30139,233,10515,8278,3230,15063
2021-09-25 08:30:00+00,15297,0,5047,1945,236,3022,2244,655,1397,880,30723,232,10869,8625,3578,15297
2021-09-25 09:00:00+00,15417,0,5045,2168,236,3022,2248,650,1669,662,31117,231,11366,9118,4073,15417
2021-09-25 09:30:00+00,15249,0,5045,2278,231,3022,2251,645,1831,942,31494,226,11636,9385,4340,15249
2021-09-25 10:00:00+00,15288,0,5046,2590,174,3022,2222,634,1979,338,31293,227,12011,9789,4743,15288
2021-09-25 10:30:00+00,15115,0,5046,2707,155,3022,2219,611,2275,390,31540,223,12402,10183,5137,15115
2021-09-25 11:00:00+00,14807,0,5046,2783,122,3022,2210,598,2481,490,31559,219,12642,10432,5386,14807
2021-09-25 11:30:00+00,14826,0,5047,2859,122,3022,2201,588,2714,154,31533,219,12943,10742,5695,14826
2021-09-25 12:00:00+00,14722,0,5047,3159,114,3022,2203,503,2796,112,31678,216,13319,11116,6069,14722
2021-09-25 12:30:00+00,14456,0,5043,3396,109,3024,2203,190,3083,118,31622,210,13834,11631,6588,14456
2021-09-25 13:00:00+00,14473,0,5044,3429,85,3022,2219,127,2836,46,31281,212,13613,11394,6350,14473
2021-09-25 13:30:00+00,14412,0,5046,3568,81,3022,2230,115,2584,0,31058,213,13509,11279,6233,14412
2021-09-25 14:00:00+00,14149,0,5051,3709,85,3022,2237,116,2342,0,30711,212,13424,11187,6136,14149
2021-09-25 14:30:00+00,14119,0,5051,3807,87,3022,2249,115,2001,0,30451,214,13195,10946,5895,14119
2021-09-25 15:00:00+00,14878,0,5046,3737,206,2828,2193,115,1636,0,30639,222,12818,10625,5579,14878
2021-09-25 15:30:00+00,15465,0,5042,3629,214,2938,2205,141,1478,66,31178,227,12568,10363,5321,15465
2021-09-25 16:00:00+00,15958,0,5045,3399,290,3050,2244,227,1107,286,31606,230,12085,9841,4796,15958
2021-09-25 16:30:00+00,15793,0,5043,3307,320,3118,2256,382,587,542,31348,232,11513,9257,4214,15793
2021-09-25 17:00:00+00,15796,0,5041,3442,411,3020,2238,416,220,744,31328,233,11352,9114,4073,15796
2021-09-25 17:30:00+00,15847,0,5041,3546,424,3110,2251,367,12,738,31336,235,11274,9023,3982,15847
2021-09-25 18:00:00+00,15837,0,5040,3850,423,3314,2245,284,0,738,31731,232,11558,9313,4273,15837
2021-09-25 18:30:00+00,15589,0,5042,4231,401,3308,2236,373,0,536,31716,230,11910,9674,4632,15589
2021-09-25 19:00:00+00,15115,0,5041,4582,253,3290,2232,381,0,130,31024,229,12108,9876,4835,15115
2021-09-25 19:30:00+00,14355,0,5037,4843,249,3042,2230,142,0,0,29898,222,12359,10129,5092,14355
2021-09-25 20:00:00+00,14228,0,5032,4891,174,2128,2231,116,0,138,28938,223,12328,10097,5065,14228
2021-09-25 20:30:00+00,13350,0,5031,4993,155,2174,2222,117,0,66,28108,218,12401,10179,5148,13350
2021-09-25 21:00:00+00,11957,0,5036,5130,64,2588,2233,115,0,12,27135,210,12463,10230,5194,11957
2021-09-25 21:30:00+00,10476,0,5035,5397,63,2450,2231,118,0,0,25770,196,12726,10495,5460,10476
2021-09-25 22:00:00+00,9133,0,5035,5401,62,2550,2231,119,0,42,24573,182,12729,10498,5463,9133
2021-09-25 22:30:00+00,8125,0,5035,5428,62,2590,2234,116,0,0,23590,173,12759,10525,5490,8125
2021-09-25 23:00:00+00,7470,0,5037,5519,61,2314,2237,113,0,0,22751,164,12854,10617,5580,7470
2021-09-25 23:30:00+00,6543,0,5038,5682,60,2428,2237,113,0,0,22101,155,13017,10780,5742,6543
2021-09-26 00:00:00+00,6035,0,5028,5795,58,2146,2234,114,0,0,21410,152,13115,10881,5853,6035
2021-09-26 00:30:00+00,5595,0,5031,5901,59,2322,2233,115,0,0,21256,149,13224,10991,5960,5595
2021-09-26 01:00:00+00,5745,0,5029,5770,61,2228,2233,113,0,0,21179,149,13093,10860,5831,5745
2021-09-26 01:30:00+00,6037,0,5028,5432,61,2122,2231,114,0,0,21025,154,12752,10521,5493,6037
2021-09-26 02:00:00+00,5920,0,5031,5559,61,2088,2234,119,0,0,21012,152,12885,10651,5620,5920
2021-09-26 02:30:00+00,5731,0,5029,5869,61,2026,2245,117,0,0,21078,146,13204,10959,5930,5731
2021-09-26 03:00:00+00,5526,0,5032,5946,61,2060,2250,116,0,0,20991,142,13289,11039,6007,5526
2021-09-26 03:30:00+00,5222,0,5034,6061,61,2118,2259,116,0,0,20871,139,13415,11156,6122,5222
2021-09-26 04:00:00+00,5203,0,5037,6252,61,2064,2258,117,0,0,20992,137,13608,11350,6312,5203
2021-09-26 04:30:00+00,5215,0,5037,6345,58,2118,2261,118,0,0,21152,137,13701,11440,6403,5215
2021-09-26 05:00:00+00,5490,0,5041,6341,55,2316,2261,118,0,0,21622,142,13698,11437,6396,5490
2021-09-26 05:30:00+00,5807,0,5042,6535,59,2392,2262,117,0,0,22214,145,13898,11636,6594,5807
2021-09-26 06:00:00+00,5613,0,5044,6721,87,2900,2263,115,26,0,22769,146,14141,11878,6834,5613
2021-09-26 06:30:00+00,6305,0,5045,7226,102,2918,2224,114,182,0,24116,149,14779,12555,7510,6305
2021-09-26 07:00:00+00,6917,0,5047,7776,144,2910,2223,114,511,0,25642,148,15700,13478,8430,6917
2021-09-26 07:30:00+00,7212,0,5043,8253,153,3048,2225,116,1124,0,27174,146,16798,14573,9530,7212
2021-09-26 08:00:00+00,7747,0,5044,8375,211,3218,2193,127,1655,0,28570,148,17478,15285,10241,7747
2021-09-26 08:30:00+00,7716,0,5046,9011,215,3220,2153,129,2275,0,29765,142,18700,16547,11501,7716
2021-09-26 09:00:00+00,7892,0,5039,9067,232,3186,2193,126,2734,0,30469,140,19265,17072,12033,7892
2021-09-26 09:30:00+00,8033,0,5040,8952,207,3028,2207,121,3409,0,30997,137,19815,17608,12568,8033
2021-09-26 10:00:00+00,7606,0,5041,9219,201,2952,2206,116,4183,0,31524,128,20850,18644,13603,7606
2021-09-26 10:30:00+00,6998,0,5039,9375,188,2974,2223,116,5041,0,31954,120,21866,19643,14604,6998
2021-09-26 11:00:00+00,6690,0,5038,9558,163,2946,2232,115,5530,0,32272,114,22521,20289,15251,6690
2021-09-26 11:30:00+00,6396,0,5040,9689,156,2774,2234,116,5922,0,32327,108,23041,20807,15767,6396
2021-09-26 12:00:00+00,5951,0,5040,9931,129,2692,2139,113,5665,0,31660,102,22904,20765,15725,5951
2021-09-26 12:30:00+00,5209,0,5038,10468,129,2592,2088,114,5239,0,30877,94,22962,20874,15836,5209
2021-09-26 13:00:00+00,5827,0,5034,10806,129,1870,2090,115,4510,178,30559,94,22569,20479,15445,5827
2021-09-26 13:30:00+00,5440,0,5036,11627,129,1832,2137,114,4239,0,30554,89,23168,21031,15995,5440
2021-09-26 14:00:00+00,5151,0,5039,12303,130,2394,2181,112,3871,0,31181,89,23524,21343,16304,5151
2021-09-26 14:30:00+00,5426,0,5039,12666,131,2406,2102,114,3442,0,31326,92,23380,21278,16239,5426
2021-09-26 15:00:00+00,6789,0,5037,12698,165,1966,2207,115,2750,78,31805,104,22857,20650,15613,6789
2021-09-26 15:30:00+00,8240,0,5038,12371,174,1958,2230,116,2321,150,32598,119,22134,19904,14866,8240
2021-09-26 16:00:00+00,9612,0,5038,12482,276,1600,2242,127,1478,248,33103,130,21516,19274,14236,9612
2021-09-26 16:30:00+00,9975,0,5042,12677,300,1598,2241,149,746,288,33016,135,21006,18765,13723,9975
2021-09-26 17:00:00+00,10039,0,5040,12546,325,1886,2241,149,280,600,33106,138,20432,18191,13151,10039
2021-09-26 17:30:00+00,9757,0,5039,12858,325,1888,2238,153,14,850,33122,135,20474,18236,13197,9757
2021-09-26 18:00:00+00,9041,0,5037,13288,309,2826,2237,167,0,746,33651,133,20871,18634,13597,9041
2021-09-26 18:30:00+00,8671,0,5039,13640,296,2836,2236,147,0,468,33333,130,21211,18975,13936,8671
2021-09-26 19:00:00+00,8351,0,5037,13710,279,2336,2238,137,0,242,32330,126,21264,19026,13989,8351
2021-09-26 19:30:00+00,7439,0,5037,13677,272,2326,2225,117,0,164,31257,118,21211,18986,13949,7439
2021-09-26 20:00:00+00,6244,0,5036,13274,207,2464,2231,114,0,0,29570,110,20748,18517,13481,6244
2021-09-26 20:30:00+00,5191,0,5036,12848,206,2444,2238,116,0,0,28079,101,20328,18090,13054,5191
2021-09-26 21:00:00+00,4979,0,5035,12650,191,1512,2230,113,0,246,26956,96,20106,17876,12841,4979
2021-09-26 21:30:00+00,4236,0,5039,12212,183,1500,2212,113,0,0,25495,90,19646,17434,12395,4236
2021-09-26 22:00:00+00,3424,0,5041,11452,135,2108,2037,115,0,0,24312,85,18665,16628,11587,3424
2021-09-26 22:30:00+00,3234,0,5044,10661,151,2118,1945,116,0,0,23269,85,17801,15856,10812,3234
2021-09-26 23:00:00+00,3343,0,5043,9864,134,1910,1960,117,0,0,22371,87,17001,15041,9998,3343
2021-09-26 23:30:00+00,3299,0,5045,9601,133,1898,1950,114,0,0,22040,87,16729,14779,9734,3299
2021-09-27 00:00:00+00,3374,0,5044,9367,132,1270,2043,119,0,0,21349,85,16586,14543,9499,3374
2021-09-27 00:30:00+00,3729,0,5044,8829,117,1214,2191,119,0,0,21243,92,16181,13990,8946,3729
2021-09-27 01:00:00+00,4710,0,5044,8582,113,330,2236,118,0,0,21133,103,15975,13739,8695,4710
2021-09-27 01:30:00+00,4741,0,5038,8144,137,290,2233,119,0,0,20702,106,15552,13319,8281,4741
2021-09-27 02:00:00+00,4889,0,5035,8071,150,108,2236,118,0,0,20607,109,15492,13256,8221,4889
2021-09-27 02:30:00+00,4775,0,5038,8647,149,94,2228,118,0,0,21049,104,16062,13834,8796,4775
2021-09-27 03:00:00+00,4072,2,5040,9728,150,0,2230,119,0,0,21341,89,17148,14918,9878,4074
2021-09-27 03:30:00+00,3687,22,5042,10633,149,0,1931,118,0,0,21582,81,17755,15824,10782,3709
2021-09-27 04:00:00+00,4086,56,5040,11106,151,88,1723,115,0,0,22365,87,18020,16297,11257,4142
2021-09-27 04:30:00+00,4513,172,5040,11259,150,268,1636,117,0,0,23155,99,18085,16449,11409,4685
2021-09-27 05:00:00+00,5435,322,5043,11244,148,306,1852,114,0,0,24464,116,18287,16435,11392,5757
2021-09-27 05:30:00+00,6839,365,5040,11884,159,208,2225,114,0,34,26868,128,19308,17083,12043,7204
2021-09-27 06:00:00+00,8240,400,5044,12014,250,881,2224,115,3,32,29203,137,19535,17311,12267,8640
2021-09-27 06:30:00+00,9426,397,5046,12596,269,958,2205,137,114,200,31348,143,20230,18025,12979,9823
2021-09-27 07:00:00+00,9945,364,5044,12698,300,1360,2212,156,369,270,32718,142,20623,18411,13367,10309
2021-09-27 07:30:00+00,9733,450,5047,12917,315,1372,2107,139,926,134,33140,139,21312,19205,14158,10183
2021-09-27 08:00:00+00,9290,494,5045,13430,327,1342,2110,157,1705,136,34036,132,22617,20507,15462,9784
2021-09-27 08:30:00+00,8470,461,5046,14010,333,1334,2108,141,2294,204,34401,120,23791,21683,16637,8931
2021-09-27 09:00:00+00,8455,125,5047,14402,333,908,2122,116,3338,136,34982,108,25242,23120,18073,8580
2021-09-27 09:30:00+00,7789,62,5046,14580,287,886,2124,115,4170,98,35157,99,26207,24083,19037,7852
2021-09-27 10:00:00+00,7021,0,5036,14802,255,994,2112,116,4828,0,35164,89,27033,24921,19885,7021
2021-09-27 10:30:00+00,6030,0,5034,15267,259,1000,2067,116,5331,0,35104,78,27958,25891,20857,6030
2021-09-27 11:00:00+00,5657,0,5033,15222,258,1188,2071,116,6165,0,35710,73,28749,26678,21645,5657
2021-09-27 11:30:00+00,5477,0,5035,15366,258,1204,2067,117,6258,0,35782,70,28984,26917,21882,5477
2021-09-27 12:00:00+00,5246,0,5038,15547,253,1106,1915,114,6301,0,35520,68,29054,27139,22101,5246
2021-09-27 12:30:00+00,5208,0,5037,15553,257,1078,1699,114,6402,0,35348,67,28948,27249,22212,5208
2021-09-27 13:00:00+00,5418,0,5033,15784,262,1000,1737,117,5892,0,35243,70,28708,26971,21938,5418
2021-09-27 13:30:00+00,5660,0,5032,15535,270,1000,1768,114,5518,0,34897,73,28123,26355,21323,5660
2021-09-27 14:00:00+00,5933,0,5039,15289,280,582,1939,113,4518,0,33693,79,27065,25126,20087,5933
2021-09-27 14:30:00+00,6601,0,5039,15365,297,616,1944,112,3963,0,33937,86,26608,24664,19625,6601
2021-09-27 15:00:00+00,7075,0,5039,15151,322,1370,2004,123,3579,0,34663,91,26095,24091,19052,7075
2021-09-27 15:30:00+00,8410,0,5037,14935,329,1487,1924,131,2932,0,35185,105,25157,23233,18196,8410
2021-09-27 16:00:00+00,8896,0,5037,14563,463,1916,1999,179,1996,480,35528,110,24058,22059,17022,8896
2021-09-27 16:30:00+00,10698,0,5037,13636,480,1998,2105,172,1052,638,35816,130,22310,20205,15168,10698
2021-09-27 17:00:00+00,11608,0,5038,13292,436,2040,2077,213,288,464,35456,143,21131,19054,14016,11608
2021-09-27 17:30:00+00,12471,0,5036,12271,460,2072,2070,223,7,714,35324,154,19844,17774,12738,12471
2021-09-27 18:00:00+00,12998,0,5033,11872,474,2336,2075,324,0,700,35812,160,19454,17379,12346,12998
2021-09-27 18:30:00+00,12359,0,5034,12249,459,2332,2063,309,0,536,35341,155,19805,17742,12708,12359
2021-09-27 19:00:00+00,11330,0,5027,12832,437,2242,2082,179,0,276,34405,145,20378,18296,13269,11330
2021-09-27 19:30:00+00,10493,0,5029,13038,402,2030,2083,120,0,22,33217,137,20552,18469,13440,10493
2021-09-27 20:00:00+00,9544,0,5031,12916,249,1704,2084,114,0,0,31642,131,20280,18196,13165,9544
2021-09-27 20:30:00+00,7894,0,5031,12827,249,1664,2096,113,0,0,29874,117,20203,18107,13076,7894
2021-09-27 21:00:00+00,6085,0,5035,13585,241,1486,2092,113,0,0,28636,97,20953,18861,13826,6085
2021-09-27 21:30:00+00,4562,0,5037,13695,225,1427,2108,115,0,0,27169,80,21065,18957,13920,4562
2021-09-27 22:00:00+00,3662,0,5037,13505,211,780,2059,114,0,0,25369,71,20812,18753,13716,3662
2021-09-27 22:30:00+00,2950,0,5041,12711,204,850,1975,115,0,0,23846,65,19931,17956,12915,2950
2021-09-27 23:00:00+00,3059,0,5040,11898,187,486,2084,120,0,0,22874,67,19209,17125,12085,3059
2021-09-27 23:30:00+00,3084,0,5039,11400,180,438,2125,117,0,0,22383,69,18744,16619,11580,3084
2021-09-28 00:00:00+00,3442,0,5040,11229,164,0,2122,122,0,0,22119,74,18555,16433,11393,3442
2021-09-28 00:30:00+00,3218,0,5040,11444,161,0,2122,122,0,0,22107,71,18767,16645,11605,3218
2021-09-28 01:00:00+00,3282,0,5042,11431,145,2,2120,120,0,0,22142,72,18738,16618,11576,3282
2021-09-28 01:30:00+00,3219,0,5046,11299,130,0,2110,118,0,0,21922,71,18585,16475,11429,3219
2021-09-28 02:00:00+00,3288,0,5049,11436,130,0,2110,120,0,0,22132,72,18725,16615,11566,3288
2021-09-28 02:30:00+00,3401,0,5044,11446,130,2,2121,118,0,0,22262,73,18741,16620,11576,3401
2021-09-28 03:00:00+00,3542,0,5046,10967,126,34,2110,117,0,0,21942,77,18249,16139,11093,3542
2021-09-28 03:30:00+00,3595,0,5043,11063,125,37,2120,120,0,0,22103,77,18351,16231,11188,3595
2021-09-28 04:00:00+00,3912,0,5044,10845,109,78,2123,117,0,0,22228,84,18121,15998,10954,3912
2021-09-28 04:30:00+00,4263,0,5044,10513,108,221,2124,114,0,0,22387,92,17789,15665,10621,4263
2021-09-28 05:00:00+00,5043,0,5046,10705,152,412,2120,114,0,0,23592,102,18023,15903,10857,5043
2021-09-28 05:30:00+00,5971,0,5046,10475,167,370,2125,115,0,146,24415,113,17813,15688,10642,5971
2021-09-28 06:00:00+00,7310,0,5040,10220,284,233,2138,161,16,342,25744,125,17698,15560,10520,7310
2021-09-28 06:30:00+00,8496,0,5042,9941,320,243,2131,299,208,914,27593,134,17642,15511,10469,8496
2021-09-28 07:00:00+00,9572,0,5043,10332,337,1105,2111,363,545,410,29818,140,18368,16257,11214,9572
2021-09-28 07:30:00+00,10221,0,5043,10504,349,1179,2119,314,1009,264,31003,143,19024,16905,11862,10221
2021-09-28 08:00:00+00,10690,0,5042,10398,366,1369,2123,188,1698,414,32289,142,19627,17504,12462,10690
2021-09-28 08:30:00+00,11020,0,5044,10628,362,1408,2083,150,2452,226,33372,141,20569,18486,13442,11020
2021-09-28 09:00:00+00,11294,0,5049,11289,341,1450,2046,118,3003,132,34722,138,21728,19682,14633,11294
2021-09-28 09:30:00+00,11455,0,5041,11224,308,1481,2046,118,3678,68,35419,137,22297,20251,15210,11455
2021-09-28 10:00:00+00,11602,0,5047,11670,256,760,2056,115,3690,226,35422,138,22719,20663,15616,11602
2021-09-28 10:30:00+00,11702,0,5043,11448,141,668,2087,120,3889,182,35281,140,22608,20521,15478,11702
2021-09-28 11:00:00+00,11841,0,5039,12260,174,596,2118,116,3828,540,36511,137,23419,21301,16262,11841
2021-09-28 11:30:00+00,11881,0,5040,12346,241,617,2130,118,3251,302,35926,140,23008,20878,15838,11881
2021-09-28 12:00:00+00,11540,0,5040,11705,235,1424,2118,116,2774,92,35044,140,21872,19754,14714,11540
2021-09-28 12:30:00+00,11635,0,5037,12196,245,1510,2137,124,2564,28,35476,140,22179,20042,15005,11635
2021-09-28 13:00:00+00,11880,0,5037,11895,232,1495,2133,125,2329,200,35326,143,21626,19493,14456,11880
2021-09-28 13:30:00+00,12331,0,5050,11616,253,1535,2130,124,1947,60,35046,149,20996,18866,13816,12331
2021-09-28 14:00:00+00,12695,0,5049,11446,282,1592,2111,122,1449,10,34756,155,20337,18226,13177,12695
2021-09-28 14:30:00+00,13413,0,5044,11017,324,1633,2101,273,1092,354,35251,162,19578,17477,12433,13413
2021-09-28 15:00:00+00,14276,0,5046,10503,472,1728,2130,461,1008,262,35887,171,19159,17029,11983,14276
2021-09-28 15:30:00+00,15318,0,5051,10081,500,1773,2135,597,593,414,36463,181,18360,16225,11174,15318
2021-09-28 16:00:00+00,15794,0,5046,9550,621,1967,2138,671,393,958,37138,183,17748,15610,10564,15794
2021-09-28 16:30:00+00,16133,0,5043,9397,620,2013,2143,707,187,1218,37461,186,17390,15247,10204,16133
2021-09-28 17:00:00+00,16249,0,5035,9412,620,2014,2141,726,38,1190,37425,187,17246,15105,10070,16249
2021-09-28 17:30:00+00,16334,0,5038,9184,601,2106,2142,726,0,1200,37331,190,16965,14823,9785,16334
2021-09-28 18:00:00+00,16813,0,5039,8968,510,2110,2141,693,0,1084,37358,194,16658,14517,9478,16813
2021-09-28 18:30:00+00,16457,0,5032,8300,500,2060,2142,606,0,1218,36315,194,15974,13832,8800,16457
2021-09-28 19:00:00+00,16111,0,5033,8270,458,2012,2134,341,0,446,34805,196,15895,13761,8728,16111
2021-09-28 19:30:00+00,15301,0,5030,8791,404,2012,2130,132,0,326,34126,188,16355,14225,9195,15301
2021-09-28 20:00:00+00,14467,0,5029,8983,268,1992,2132,117,0,10,32998,185,16412,14280,9251,14467
2021-09-28 20:30:00+00,13083,0,5028,8383,265,2020,2142,115,0,136,31172,178,15818,13676,8648,13083
2021-09-28 21:00:00+00,11532,0,5028,8463,277,1976,2091,113,0,0,29480,170,15859,13768,8740,11532
2021-09-28 21:30:00+00,9799,0,5032,8647,279,1912,1806,113,0,0,27588,154,15764,13958,8926,9799
2021-09-28 22:00:00+00,8492,0,5028,8741,294,1619,1491,116,0,50,25831,141,15554,14063,9035,8492
2021-09-28 22:30:00+00,7141,0,5025,8960,293,1602,1490,114,0,74,24699,126,15768,14278,9253,7141
2021-09-28 23:00:00+00,6621,0,5030,8746,292,1417,1488,114,0,0,23709,122,15556,14068,9038,6621
2021-09-28 23:30:00+00,6348,0,5030,8289,288,1413,1488,116,0,0,22971,121,15095,13607,8577,6348
2021-09-29 00:00:00+00,6373,0,5030,7857,251,1412,1487,115,0,0,22525,123,14625,13138,8108,6373
2021-09-29 00:30:00+00,6483,0,5035,7667,250,1412,1480,113,0,0,22440,126,14432,12952,7917,6483
2021-09-29 01:00:00+00,6989,0,5035,6982,249,1412,1487,113,0,0,22267,136,13753,12266,7231,6989
2021-09-29 01:30:00+00,6904,0,5036,6988,251,1419,1480,112,0,0,22190,135,13755,12275,7239,6904
2021-09-29 02:00:00+00,6623,0,5038,7315,269,1425,1483,121,0,0,22274,129,14105,12622,7584,6623
2021-09-29 02:30:00+00,6166,0,5039,8062,269,1412,1476,117,0,0,22541,120,14846,13370,8331,6166
2021-09-29 03:00:00+00,5886,0,5033,8851,269,1030,1487,115,0,0,22671,114,15640,14153,9120,5886
2021-09-29 03:30:00+00,5502,0,5032,9247,270,1000,1483,114,0,0,22648,107,16032,14549,9517,5502
2021-09-29 04:00:00+00,5256,0,5036,9808,279,525,1483,113,0,0,22500,103,16606,15123,10087,5256
2021-09-29 04:30:00+00,5551,0,5035,10255,301,510,1483,113,0,0,23248,104,17074,15591,10556,5551
2021-09-29 05:00:00+00,6662,0,5035,10997,352,944,1490,116,0,0,25596,113,17874,16384,11349,6662
2021-09-29 05:30:00+00,8542,0,5037,11584,364,1100,1486,114,0,0,28227,131,18471,16985,11948,8542
2021-09-29 06:00:00+00,10578,0,5035,11947,381,1317,1484,234,24,0,31000,145,18871,17387,12352,10578
2021-09-29 06:30:00+00,11189,0,5033,12223,410,1278,1478,266,342,204,32424,146,19486,18008,12975,11189
2021-09-29 07:00:00+00,10874,0,5034,12601,373,1872,1468,302,1213,348,34085,136,20689,19221,14187,10874
2021-09-29 07:30:00+00,10500,0,5038,12729,373,1894,1456,266,2385,146,34787,128,21981,20525,15487,10500
2021-09-29 08:00:00+00,10481,0,5036,12730,374,1832,1471,165,3557,150,35796,124,23168,21697,16661,10481
2021-09-29 08:30:00+00,9821,0,5041,13098,364,1830,1459,161,4651,0,36425,114,24613,23154,18113,9821
2021-09-29 09:00:00+00,9503,0,5035,13332,325,1255,1470,155,5524,0,36599,110,25686,24216,19181,9503
2021-09-29 09:30:00+00,8609,0,5032,13753,319,1236,1461,154,6163,0,36727,100,26728,25267,20235,8609
2021-09-29 10:00:00+00,7944,0,5027,14067,302,1388,1471,158,6478,0,36835,93,27345,25874,20847,7944
2021-09-29 10:30:00+00,7828,0,5024,14168,284,1404,1475,160,6413,0,36756,92,27364,25889,20865,7828
2021-09-29 11:00:00+00,7759,0,5021,13993,283,1604,1507,182,6504,0,36853,91,27308,25801,20780,7759
2021-09-29 11:30:00+00,7551,0,5020,14273,283,1616,1548,178,6547,0,37016,89,27671,26123,21103,7551
2021-09-29 12:00:00+00,7063,0,5023,14392,286,1870,1556,229,6687,0,37106,84,27944,26388,21365,7063
2021-09-29 12:30:00+00,6752,0,5035,14459,286,1872,1568,181,6135,26,36314,82,27483,25915,20880,6752
2021-09-29 13:00:00+00,6459,0,5040,14813,284,1622,1567,162,5970,0,35917,79,27674,26107,21067,6459
2021-09-29 13:30:00+00,6573,0,5037,14642,287,1618,1594,158,5694,0,35603,81,27254,25660,20623,6573
2021-09-29 14:00:00+00,6716,0,5040,14622,274,1776,1598,152,5127,68,35373,83,26661,25063,20023,6716
2021-09-29 14:30:00+00,7813,0,5035,14264,273,1784,1609,159,4608,0,35545,95,25789,24180,19145,7813
2021-09-29 15:00:00+00,8979,0,5037,14083,347,1626,1615,176,3898,56,35817,108,24980,23365,18328,8979
2021-09-29 15:30:00+00,10710,0,5037,13620,352,1616,1620,172,2877,34,36038,126,23506,21886,16849,10710
2021-09-29 16:00:00+00,12175,0,5039,12921,408,1992,1628,192,1880,434,36669,140,21876,20248,15209,12175
2021-09-29 16:30:00+00,13797,0,5012,12186,409,2013,1627,192,911,354,36501,158,20145,18518,13506,13797
2021-09-29 17:00:00+00,14651,0,4890,11816,400,2013,1626,231,217,552,36396,168,18949,17323,12433,14651
2021-09-29 17:30:00+00,14701,0,4894,11130,375,2014,1623,352,2,1308,36399,170,18024,16401,11507,14701
2021-09-29 18:00:00+00,15272,0,4893,10487,380,2188,1628,664,0,1238,36750,179,17388,15760,10867,15272
2021-09-29 18:30:00+00,15195,0,4888,9994,388,2262,1623,733,0,1142,36225,182,16893,15270,10382,15195
2021-09-29 19:00:00+00,15053,0,4892,9767,379,2488,1621,539,0,824,35563,185,16659,15038,10146,15053
2021-09-29 19:30:00+00,14791,0,4889,9456,372,2450,1621,245,0,286,34110,187,16338,14717,9828,14791
2021-09-29 20:00:00+00,14446,0,4892,9147,256,2585,1623,132,0,94,33174,189,15918,14295,9403,14446
2021-09-29 20:30:00+00,12636,0,4893,9312,237,2619,1636,117,0,130,31581,177,16078,14442,9549,12636
2021-09-29 21:00:00+00,10999,0,4889,9055,207,2556,1634,117,0,154,29611,168,15785,14151,9262,10999
2021-09-29 21:30:00+00,9269,0,4897,9300,195,2504,1630,116,0,0,27911,153,16022,14392,9495,9269
2021-09-29 22:00:00+00,7480,0,4888,9232,179,2245,1639,116,0,2,25781,138,15938,14299,9411,7480
2021-09-29 22:30:00+00,6401,0,4893,8972,176,2291,1637,121,0,0,24491,129,15678,14041,9148,6401
2021-09-29 23:00:00+00,5687,0,4893,8899,176,2174,1639,123,0,0,23591,123,15607,13968,9075,5687
2021-09-29 23:30:00+00,4997,0,4898,8994,176,2172,1599,123,0,0,22959,115,15667,14068,9170,4997
2021-09-30 00:00:00+00,4644,0,4895,9115,176,2218,1622,117,0,0,22787,110,15808,14186,9291,4644
2021-09-30 00:30:00+00,4334,0,4893,9386,176,2220,1626,117,0,0,22752,105,16081,14455,9562,4334
2021-09-30 01:00:00+00,4021,0,4895,9758,157,2126,1626,116,0,0,22699,99,16436,14810,9915,4021
2021-09-30 01:30:00+00,3929,0,4897,10157,156,2066,1629,114,0,0,22948,96,16839,15210,10313,3929
2021-09-30 02:00:00+00,4336,0,4898,10271,156,1448,1630,122,0,0,22861,102,16955,15325,10427,4336
2021-09-30 02:30:00+00,3976,0,4902,10506,156,1446,1625,121,0,0,22732,96,17189,15564,10662,3976
2021-09-30 03:00:00+00,3884,0,4900,10971,156,1444,1621,112,0,0,23088,93,17648,16027,11127,3884
2021-09-30 03:30:00+00,3544,0,4897,11559,156,1352,1579,113,0,0,23200,85,18191,16612,11715,3544
2021-09-30 04:00:00+00,4159,0,4895,11561,158,1210,1625,116,0,0,23724,91,18239,16614,11719,4159
2021-09-30 04:30:00+00,4266,0,4895,12233,170,1276,1630,113,0,0,24583,91,18928,17298,12403,4266
2021-09-30 05:00:00+00,6152,0,4900,12514,221,592,1627,114,0,0,26120,112,19262,17635,12735,6152
2021-09-30 05:30:00+00,7832,0,4899,13104,247,544,1621,114,0,0,28361,126,19871,18250,13351,7832
2021-09-30 06:00:00+00,9015,0,4899,13906,289,1200,1634,114,6,0,31063,127,20734,19100,14201,9015
2021-09-30 06:30:00+00,9907,0,4896,14887,346,1190,1721,121,84,0,33152,129,21934,20213,15317,9907
2021-09-30 07:00:00+00,10408,0,4902,15175,393,1246,1708,263,209,26,34330,131,22387,20679,15777,10408
2021-09-30 07:30:00+00,10467,0,4899,15506,383,1160,1719,296,535,0,34965,128,23042,21323,16424,10467
2021-09-30 08:00:00+00,10563,0,4900,15820,373,1206,1669,301,753,144,35729,127,23515,21846,16946,10563
2021-09-30 08:30:00+00,10627,0,4904,15752,360,1158,1727,302,1059,270,36159,126,23802,22075,17171,10627
2021-09-30 09:00:00+00,10627,0,4802,16068,350,1234,1723,297,1286,162,36549,125,24229,22506,17704,10627
2021-09-30 09:30:00+00,10558,0,4685,16305,380,1200,1718,226,1538,146,36756,122,24626,22908,18223,10558
2021-09-30 10:00:00+00,9802,0,4686,16185,382,2100,1710,117,1971,156,37109,115,24934,23224,18538,9802
2021-09-30 10:30:00+00,9930,0,4685,15864,370,2165,1712,118,1801,190,36836,118,24432,22720,18035,9930
2021-09-30 11:00:00+00,10118,0,4683,15825,346,2283,1700,115,1772,292,37134,120,24326,22626,17943,10118
2021-09-30 11:30:00+00,10124,0,4769,15736,293,2183,1709,115,1599,270,36798,120,24106,22397,17628,10124
2021-09-30 12:00:00+00,10079,0,4947,15329,267,2315,1705,114,1813,272,36841,121,24061,22356,17409,10079
2021-09-30 12:30:00+00,9626,0,4954,15483,269,2302,1708,115,1818,288,36564,117,24232,22524,17570,9626
2021-09-30 13:00:00+00,9635,0,4950,15256,275,2224,1720,116,1733,462,36371,116,23934,22214,17264,9635
2021-09-30 13:30:00+00,9637,0,4957,15290,264,2214,1714,113,1543,206,35938,118,23768,22054,17097,9637
2021-09-30 14:00:00+00,9845,0,4950,15293,310,2060,1688,120,1306,28,35600,119,23547,21859,16909,9845
2021-09-30 14:30:00+00,10538,0,4947,15048,327,2044,1688,114,1009,6,35721,126,23019,21331,16384,10538
2021-09-30 15:00:00+00,11136,0,4949,15499,363,2012,1716,137,691,0,36503,129,23218,21502,16553,11136
2021-09-30 15:30:00+00,11951,0,4948,15753,375,2012,1719,128,429,0,37315,135,23224,21505,16557,11951
2021-09-30 16:00:00+00,12579,0,4945,15292,421,2012,1729,153,270,240,37641,141,22657,20928,15983,12579
2021-09-30 16:30:00+00,12615,0,4949,14900,524,2026,1743,160,116,480,37513,142,22232,20489,15540,12615
2021-09-30 17:00:00+00,12640,0,4943,14723,588,2024,1712,242,26,732,37630,142,21992,20280,15337,12640
2021-09-30 17:30:00+00,12865,0,4807,14261,588,2076,1740,277,0,992,37606,146,21396,19656,14849,12865
2021-09-30 18:00:00+00,12794,0,4682,13954,577,2238,1753,509,0,904,37411,149,20966,19213,14531,12794
2021-09-30 18:30:00+00,12634,0,4682,13531,515,2248,1685,510,0,984,36789,150,20413,18728,14046,12634
2021-09-30 19:00:00+00,12426,0,4684,13230,560,1395,1660,187,0,738,34880,150,20134,18474,13790,12426
2021-09-30 19:30:00+00,12402,0,4724,13103,408,2013,1645,132,0,64,34490,151,19880,18235,13511,12402
2021-09-30 20:00:00+00,10432,0,4834,13245,352,2010,1622,121,0,24,32640,136,20053,18431,13597,10432
2021-09-30 20:30:00+00,8548,0,4944,13116,349,2182,1676,120,0,70,31005,123,20085,18409,13465,8548
2021-09-30 21:00:00+00,7110,0,4955,12918,316,2130,1681,116,0,0,29226,114,19870,18189,13234,7110
2021-09-30 21:30:00+00,5802,0,4951,12485,301,2184,1681,115,0,0,27519,104,19418,17737,12786,5802
2021-09-30 22:00:00+00,4693,0,4958,12430,300,1274,1683,117,0,266,25721,93,19371,17688,12730,4693
2021-09-30 22:30:00+00,3504,0,4954,12343,294,1192,1679,117,0,326,24409,77,19270,17591,12637,3504
2021-09-30 23:00:00+00,3436,0,4952,12155,226,1002,1681,120,0,124,23696,78,19014,17333,12381,3436
2021-09-30 23:30:00+00,3013,0,4958,11951,225,1024,1678,117,0,0,22966,74,18812,17134,12176,3013
2021-10-01 00:00:00+00,3306,0,4951,11871,225,810,1683,117,0,0,22963,77,18730,17047,12096,3306
2021-10-01 00:30:00+00,3372,0,4950,11844,210,835,1684,116,0,0,23010,79,18688,17004,12054,3372
2021-10-01 01:00:00+00,3658,0,4866,12000,206,653,1699,114,0,0,23196,83,18771,17072,12206,3658
2021-10-01 01:30:00+00,3384,0,4699,12208,203,646,1721,114,0,0,22975,79,18831,17110,12411,3384
2021-10-01 02:00:00+00,2954,0,4685,12245,197,1096,1653,121,0,0,22951,71,18780,17127,12442,2954
2021-10-01 02:30:00+00,3041,0,4683,12219,203,1134,1627,122,0,0,23029,73,18732,17105,12422,3041
2021-10-01 03:00:00+00,3167,0,4686,12450,203,888,1636,123,0,0,23153,75,18975,17339,12653,3167
2021-10-01 03:30:00+00,2970,0,4821,12723,192,850,1641,122,0,0,23319,70,19377,17736,12915,2970
2021-10-01 04:00:00+00,3003,0,4945,12846,233,542,1675,115,0,0,23359,68,19699,18024,13079,3003
2021-10-01 04:30:00+00,2954,0,4948,13217,247,664,1601,114,0,0,23745,68,20013,18412,13464,2954
2021-10-01 05:00:00+00,3522,0,4950,13663,329,1156,1745,117,0,0,25482,72,20687,18942,13992,3522
2021-10-01 05:30:00+00,5089,0,4948,14313,473,1240,1791,121,0,0,27975,88,21525,19734,14786,5089
2021-10-01 06:00:00+00,5900,0,4947,14711,503,2012,1970,157,0,198,30398,94,22131,20161,15214,5900
2021-10-01 06:30:00+00,7098,0,4943,14707,514,2044,2218,248,45,334,32151,105,22427,20209,15266,7098
2021-10-01 07:00:00+00,7378,0,4947,15042,575,2320,2356,284,333,392,33627,103,23253,20897,15950,7378
2021-10-01 07:30:00+00,7161,0,4948,15187,624,2354,2365,249,801,350,34039,99,23925,21560,16612,7161
2021-10-01 08:00:00+00,7019,0,4935,15454,466,2688,2370,250,1225,410,34817,96,24450,22080,17145,7019
2021-10-01 08:30:00+00,6927,0,4793,15472,365,2704,2348,266,2020,370,35265,94,24998,22650,17857,6927
2021-10-01 09:00:00+00,6624,0,4680,16157,348,2816,2363,157,2982,0,36127,89,26530,24167,19487,6624
2021-10-01 09:30:00+00,6230,0,4680,16229,348,2768,2365,124,3866,0,36610,83,27488,25123,20443,6230
2021-10-01 10:00:00+00,6036,0,4681,16093,352,2688,2363,118,4438,0,36769,81,27927,25564,20883,6036
2021-10-01 10:30:00+00,5307,0,4786,16029,380,2790,2359,119,4809,0,36579,75,28363,26004,21218,5307
2021-10-01 11:00:00+00,5243,0,4937,15803,387,2672,2361,115,5335,0,36853,72,28823,26462,21525,5243
2021-10-01 11:30:00+00,4911,0,4955,15732,347,2398,2356,113,5183,0,35995,67,28573,26217,21262,4911
2021-10-01 12:00:00+00,5151,0,4946,15366,316,1978,2368,116,5135,0,35376,68,28131,25763,20817,5151
2021-10-01 12:30:00+00,4573,0,4951,15387,310,1966,2360,114,5483,0,35144,62,28491,26131,21180,4573
2021-10-01 13:00:00+00,4677,0,4944,14815,309,1964,2349,115,5304,0,34477,64,27721,25372,20428,4677
2021-10-01 13:30:00+00,4946,0,4947,14126,324,1954,2339,115,5457,6,34214,68,27193,24854,19907,4946
2021-10-01 14:00:00+00,4197,0,4952,13783,365,2984,2214,114,4870,0,33479,68,26184,23970,19018,4197
2021-10-01 14:30:00+00,4738,0,4951,13574,360,3232,1878,119,4314,110,33276,77,25077,23199,18248,4738
2021-10-01 15:00:00+00,5809,0,4948,13041,394,3570,2063,116,3718,6,33665,91,24164,22101,17153,5809
2021-10-01 15:30:00+00,7028,0,4949,12800,394,3704,2344,121,2744,94,34178,107,23231,20887,15938,7028
2021-10-01 16:00:00+00,8277,0,4946,12625,392,3238,2356,130,1745,806,34515,118,22064,19708,14762,8277
2021-10-01 16:30:00+00,8888,0,4865,12695,424,3282,2356,159,808,882,34359,127,21148,18792,13927,8888
2021-10-01 17:00:00+00,9642,0,4691,11920,434,3860,2353,205,153,1122,34380,136,19551,17198,12507,9642
2021-10-01 17:30:00+00,9812,0,4681,12082,456,3924,2347,389,0,1106,34796,138,19566,17218,12538,9812
2021-10-01 18:00:00+00,10070,0,4679,11982,503,3718,2357,512,0,1248,35069,139,19521,17164,12485,10070
2021-10-01 18:30:00+00,10053,0,4679,11774,515,3610,2340,479,0,1136,34586,139,19308,16968,12289,10053
2021-10-01 19:00:00+00,9892,0,4693,12010,517,3542,2341,291,0,620,33906,138,19561,17220,12527,9892
2021-10-01 19:30:00+00,8796,0,4865,12365,477,3542,2340,172,0,440,32997,128,20047,17707,12842,8796
2021-10-01 20:00:00+00,8037,0,4950,12366,408,3612,2336,135,0,114,31958,122,20060,17724,12774,8037
2021-10-01 20:30:00+00,6959,0,4952,12289,393,3602,2319,125,0,0,30639,113,19953,17634,12682,6959
2021-10-01 21:00:00+00,6313,0,4943,11967,351,2998,2326,121,0,0,29019,105,19587,17261,12318,6313
2021-10-01 21:30:00+00,5431,0,4948,11514,338,2886,2257,118,0,0,27492,97,19057,16800,11852,5431
2021-10-01 22:00:00+00,6182,0,4949,11054,355,1208,2322,118,0,0,26188,111,18680,16358,11409,6182
2021-10-01 22:30:00+00,6177,0,4948,10274,355,1802,2293,115,0,0,25964,114,17870,15577,10629,6177
2021-10-01 23:00:00+00,6538,0,4950,10014,356,1284,2327,116,0,0,25585,118,17647,15320,10370,6538
2021-10-01 23:30:00+00,5928,0,4887,9912,316,1266,2193,113,0,0,24615,114,17308,15115,10228,5928
2021-10-02 00:00:00+00,6161,0,4713,9699,313,1200,2305,114,0,0,24505,120,17030,14725,10012,6161
2021-10-02 00:30:00+00,6544,0,4677,9361,295,1276,2277,118,0,0,24548,127,16610,14333,9656,6544
2021-10-02 01:00:00+00,7003,0,4682,8944,292,1196,2277,117,0,0,24511,135,16195,13918,9236,7003
2021-10-02 01:30:00+00,6679,0,4691,9084,292,1244,2075,112,0,0,24177,131,16142,14067,9376,6679
2021-10-02 02:00:00+00,6394,0,4874,9245,292,1404,1691,116,0,0,24016,128,16102,14411,9537,6394
2021-10-02 02:30:00+00,5327,0,4956,9101,292,1356,1504,116,0,0,22652,115,15853,14349,9393,5327
2021-10-02 03:00:00+00,4931,0,4951,9068,291,1658,1357,115,0,0,22371,110,15667,14310,9359,4931
2021-10-02 03:30:00+00,4485,0,4956,9266,291,1604,1587,114,0,0,22303,102,16100,14513,9557,4485
2021-10-02 04:00:00+00,4419,0,4953,9560,293,1560,1597,113,0,0,22495,100,16403,14806,9853,4419
2021-10-02 04:30:00+00,4547,0,4952,9649,327,1738,1237,115,0,0,22565,104,16165,14928,9976,4547
2021-10-02 05:00:00+00,4864,0,4952,9867,341,1680,1084,120,0,0,22908,106,16244,15160,10208,4864
2021-10-02 05:30:00+00,5281,0,4952,10224,342,1750,1081,125,0,128,23883,110,16599,15518,10566,5281
2021-10-02 06:00:00+00,5824,0,4948,10394,376,2262,1077,125,5,56,25067,111,16800,15723,10775,5824
2021-10-02 06:30:00+00,6800,0,4801,10832,379,2386,1080,119,120,0,26517,121,17212,16132,11331,6800
2021-10-02 07:00:00+00,6723,0,4683,11748,550,3106,1081,137,319,0,28347,116,18381,17300,12617,6723
2021-10-02 07:30:00+00,7351,0,4683,12536,509,2978,1080,159,483,26,29805,116,19291,18211,13528,7351
2021-10-02 08:00:00+00,7680,0,4684,13149,508,2962,1082,172,668,150,31055,116,20091,19009,14325,7680
2021-10-02 08:30:00+00,7572,0,4683,13910,509,2962,1081,168,840,0,31725,112,21023,19942,15259,7572
2021-10-02 09:00:00+00,7640,0,4680,14542,498,2962,1081,136,900,216,32655,109,21701,20620,15940,7640
2021-10-02 09:30:00+00,7856,0,4679,14897,496,2964,1080,189,965,260,33386,110,22117,21037,16358,7856
2021-10-02 10:00:00+00,7841,0,4683,15197,448,3106,1081,154,1064,276,33850,108,22473,21392,16709,7841
2021-10-02 10:30:00+00,7941,0,4778,15482,428,3110,1081,148,989,84,34041,109,22758,21677,16899,7941
2021-10-02 11:00:00+00,7994,0,4940,15393,392,3078,1080,154,838,562,34431,108,22643,21563,16623,7994
2021-10-02 11:30:00+00,7895,0,4953,15389,390,3076,1080,312,794,680,34569,108,22606,21526,16573,7895
2021-10-02 12:00:00+00,7994,0,4950,14905,451,3246,1077,169,717,648,34157,110,22100,21023,16073,7994
2021-10-02 12:30:00+00,7826,0,4957,14916,476,3252,1080,239,671,452,33869,110,22100,21020,16063,7826
2021-10-02 13:00:00+00,7548,0,4953,15035,394,3324,1076,191,671,50,33242,108,22129,21053,16100,7548
2021-10-02 13:30:00+00,7738,0,4951,14471,386,3324,1072,198,696,160,32996,112,21576,20504,15553,7738
2021-10-02 14:00:00+00,8279,0,4953,14059,403,3624,1079,176,649,0,33222,119,21143,20064,15111,8279
2021-10-02 14:30:00+00,8899,0,4954,13561,404,3738,1081,136,567,0,33340,127,20567,19486,14532,8899
2021-10-02 15:00:00+00,9594,0,4955,12870,452,3756,1077,144,530,0,33378,134,19884,18807,13852,9594
2021-10-02 15:30:00+00,10446,0,4960,12276,509,3822,1077,159,433,0,33682,144,19255,18178,13218,10446
2021-10-02 16:00:00+00,10637,0,4955,11696,544,3816,1201,254,277,1084,34464,144,18673,17472,12517,10637
2021-10-02 16:30:00+00,10965,0,4958,11210,562,3896,1410,303,119,1184,34607,149,18259,16849,11891,10965
2021-10-02 17:00:00+00,11345,0,4957,10959,554,3850,1578,511,31,986,34771,155,18079,16501,11544,11345
2021-10-02 17:30:00+00,11463,0,4956,10631,553,3922,1623,536,0,1148,34832,157,17763,16140,11184,11463
2021-10-02 18:00:00+00,11870,0,4965,10120,644,4002,1621,617,0,976,34815,164,17350,15729,10764,11870
2021-10-02 18:30:00+00,11435,0,4965,9875,644,3910,1621,601,0,740,33791,162,17105,15484,10519,11435
2021-10-02 19:00:00+00,11139,0,4962,9646,632,3862,1600,421,0,360,32622,162,16840,15240,10278,11139
2021-10-02 19:30:00+00,10672,0,4963,9378,627,3762,1597,254,0,366,31619,159,16565,14968,10005,10672
2021-10-02 20:00:00+00,10732,0,4961,8993,589,3298,1621,150,0,440,30784,161,16164,14543,9582,10732
2021-10-02 20:30:00+00,9401,0,4964,9108,593,3294,1614,162,0,134,29270,152,16279,14665,9701,9401
2021-10-02 21:00:00+00,7540,0,4964,9722,550,3142,1640,142,0,318,28018,133,16876,15236,10272,7540
2021-10-02 21:30:00+00,6599,0,4961,9930,530,2944,1672,135,0,44,26815,123,17093,15421,10460,6599
2021-10-02 22:00:00+00,6118,0,4958,10601,453,2138,1685,168,0,0,26121,117,17697,16012,11054,6118
2021-10-02 22:30:00+00,4618,0,4962,10950,358,2156,1702,171,0,0,24917,99,17972,16270,11308,4618
2021-10-02 23:00:00+00,3889,0,4959,11142,351,1842,1707,164,0,0,24054,85,18159,16452,11493,3889
2021-10-02 23:30:00+00,3375,0,4955,11167,347,1816,1719,165,0,0,23544,78,18188,16469,11514,3375
2021-10-03 00:00:00+00,3908,0,4952,11066,316,1882,1693,167,0,0,23984,88,18027,16334,11382,3908
2021-10-03 00:30:00+00,4084,0,4950,11203,314,1878,1657,160,0,0,24246,89,18124,16467,11517,4084
2021-10-03 01:00:00+00,3575,0,4955,11261,313,1772,1656,155,0,0,23687,79,18185,16529,11574,3575
2021-10-03 01:30:00+00,3203,0,4961,11366,312,1540,1666,155,0,0,23203,70,18305,16639,11678,3203
2021-10-03 02:00:00+00,3012,0,4965,11429,311,1396,1631,160,0,0,22904,65,18336,16705,11740,3012
2021-10-03 02:30:00+00,2782,0,4964,11451,311,1356,1510,160,0,0,22534,61,18236,16726,11762,2782
2021-10-03 03:00:00+00,2892,0,4963,11288,311,1354,1348,127,0,0,22283,62,17910,16562,11599,2892
2021-10-03 03:30:00+00,3015,0,4969,11130,310,1354,1335,117,0,0,22230,64,17744,16409,11440,3015
2021-10-03 04:00:00+00,3297,0,4967,10868,309,1366,1383,118,0,0,22308,70,17527,16144,11177,3297
2021-10-03 04:30:00+00,3684,0,4964,10555,311,1402,1698,119,0,0,22733,77,17528,15830,10866,3684
2021-10-03 05:00:00+00,3805,0,4969,10415,328,1784,1710,120,0,0,23131,85,17422,15712,10743,3805
2021-10-03 05:30:00+00,3987,0,4959,10397,343,1800,1715,121,0,0,23322,88,17414,15699,10740,3987
2021-10-03 06:00:00+00,4004,0,4937,10306,381,2588,1558,115,0,0,23889,87,17182,15624,10687,4004
2021-10-03 06:30:00+00,4326,0,4914,10558,408,2746,1715,131,140,0,24938,91,17735,16020,11106,4326
2021-10-03 07:00:00+00,5109,0,4886,10562,656,2794,1725,134,569,0,26435,98,18398,16673,11787,5109
2021-10-03 07:30:00+00,5160,0,4856,10595,662,2942,1725,283,1155,50,27428,99,18993,17268,12412,5160
2021-10-03 08:00:00+00,5401,0,4817,10955,735,2938,1631,443,1736,246,28902,100,19874,18243,13426,5401
2021-10-03 08:30:00+00,5262,0,4683,11554,759,3084,1605,437,2254,194,29832,98,20855,19250,14567,5262
2021-10-03 09:00:00+00,5135,0,4476,12121,740,3100,1720,299,3136,450,31177,91,22193,20473,15997,5135
2021-10-03 09:30:00+00,4609,0,4199,12721,713,2876,1718,292,3692,436,31256,80,23043,21325,17126,4609
2021-10-03 10:00:00+00,4693,0,4192,13102,631,2632,1728,170,4585,170,31903,75,24238,22510,18318,4693
2021-10-03 10:30:00+00,4357,0,4203,13601,611,2576,1724,131,5278,0,32481,68,25417,23693,19490,4357
2021-10-03 11:00:00+00,5076,0,4384,14226,449,1342,1725,116,5852,248,33418,72,26636,24911,20527,5076
2021-10-03 11:30:00+00,4681,0,4476,14774,457,1148,1724,114,5933,138,33445,65,27364,25640,21164,4681
2021-10-03 12:00:00+00,4822,0,4472,15493,409,1238,1737,113,5577,0,33861,64,27688,25951,21479,4822
2021-10-03 12:30:00+00,4832,0,4473,16150,400,1242,1741,113,5280,0,34231,63,28044,26303,21830,4832
2021-10-03 13:00:00+00,5139,0,4469,16613,376,1152,1725,113,4533,0,34120,67,27716,25991,21522,5139
2021-10-03 13:30:00+00,4789,0,4467,16915,351,1146,1723,114,4263,0,33768,64,27719,25996,21529,4789
2021-10-03 14:00:00+00,4951,0,4466,16641,347,1258,1724,113,4351,0,33851,66,27529,25805,21339,4951
2021-10-03 14:30:00+00,5376,0,4465,16728,356,1262,1720,116,3662,0,33685,71,26931,25211,20746,5376
2021-10-03 15:00:00+00,5447,0,4463,16450,544,2062,1725,115,2683,0,33489,77,25865,24140,19677,5447
2021-10-03 15:30:00+00,6460,0,4383,16178,470,2244,1726,250,2377,0,34088,91,25134,23408,19025,6460
2021-10-03 16:00:00+00,6327,0,4202,16005,622,3402,1716,201,1482,0,33957,95,24027,22311,18109,6327
2021-10-03 16:30:00+00,6627,0,4191,15770,637,3614,1721,294,595,568,34017,102,22914,21193,17002,6627
2021-10-03 17:00:00+00,6810,0,4195,15739,663,3560,1724,357,104,812,33964,104,22425,20701,16506,6810
2021-10-03 17:30:00+00,7383,0,4230,15562,674,3568,1726,390,0,928,34461,109,22192,20466,16236,7383
2021-10-03 18:00:00+00,7550,0,4442,15357,661,3324,1725,523,0,1030,34612,109,22185,20460,16018,7550
2021-10-03 18:30:00+00,7478,0,4473,15133,649,3250,1724,562,0,858,34127,109,21979,20255,15782,7478
2021-10-03 19:00:00+00,7422,0,4471,15096,620,3122,1767,503,0,126,33127,110,21954,20187,15716,7422
2021-10-03 19:30:00+00,6786,0,4475,14990,438,3102,1766,417,0,10,31984,105,21669,19903,15428,6786
2021-10-03 20:00:00+00,5859,0,4472,14767,387,2892,1783,131,0,170,30461,94,21409,19626,15154,5859
2021-10-03 20:30:00+00,5051,0,4474,14479,387,2886,1827,119,0,0,29223,88,21167,19340,14866,5051
2021-10-03 21:00:00+00,4533,0,4472,14346,349,2796,1774,116,0,0,28386,83,20941,19167,14695,4533
2021-10-03 21:30:00+00,3978,0,4473,13807,328,2690,1749,122,0,0,27147,77,20357,18608,14135,3978
2021-10-03 22:00:00+00,3576,0,4469,13598,323,1556,2152,114,0,0,25788,68,20542,18390,13921,3576
2021-10-03 22:30:00+00,3139,0,4465,13038,319,1510,2241,116,0,0,24828,64,20063,17822,13357,3139
2021-10-03 23:00:00+00,2897,0,4464,12630,324,1620,2122,113,0,0,24170,65,19540,17418,12954,2897
2021-10-03 23:30:00+00,3079,0,4458,12133,329,1634,2024,122,0,0,23779,69,18944,16920,12462,3079
2021-10-04 00:00:00+00,3037,0,4310,12012,312,1660,1994,114,0,0,23439,70,18628,16634,12324,3037
2021-10-04 00:30:00+00,3259,0,4199,11676,309,1716,1941,115,0,0,23215,75,18125,16184,11985,3259
2021-10-04 01:00:00+00,3286,0,4200,11424,309,1410,2012,118,0,0,22759,73,17945,15933,11733,3286
2021-10-04 01:30:00+00,3455,0,4202,11159,309,1358,2077,119,0,0,22679,75,17747,15670,11468,3455
2021-10-04 02:00:00+00,3483,0,4300,10843,309,1518,2075,118,0,0,22646,78,17527,15452,11152,3483
2021-10-04 02:30:00+00,3525,0,4466,10685,310,1436,2054,118,0,0,22594,77,17515,15461,10995,3525
2021-10-04 03:00:00+00,3486,0,4472,10426,310,1462,2040,118,0,0,22314,78,17248,15208,10736,3486
2021-10-04 03:30:00+00,3354,0,4474,10297,311,1456,1889,117,0,0,21898,76,16971,15082,10608,3354
2021-10-04 04:00:00+00,3629,0,4470,10077,316,1606,1992,113,0,0,22203,84,16855,14863,10393,3629
2021-10-04 04:30:00+00,4758,0,4475,9924,342,1648,2308,112,0,0,23567,100,17049,14741,10266,4758
2021-10-04 05:00:00+00,6783,0,4474,9734,399,2336,2363,115,0,0,26204,129,16970,14607,10133,6783
2021-10-04 05:30:00+00,9135,0,4474,9479,447,2368,2362,115,0,258,28638,150,16762,14400,9926,9135
2021-10-04 06:00:00+00,11495,0,4418,9788,631,2994,2363,136,0,0,31825,166,17200,14837,10419,11495
2021-10-04 06:30:00+00,12912,0,4224,10024,636,3010,2363,130,256,98,33653,174,17503,15140,10916,12912
2021-10-04 07:00:00+00,13382,0,4193,9410,656,3688,2365,217,988,420,35319,174,17612,15247,11054,13382
2021-10-04 07:30:00+00,12985,0,4197,9867,654,3716,2366,309,1831,52,35977,167,18915,16549,12352,12985
2021-10-04 08:00:00+00,13045,0,4198,9846,600,3714,2371,178,2785,146,36883,162,19800,17429,13231,13045
2021-10-04 08:30:00+00,12515,0,4199,10038,603,3716,2363,170,3727,0,37331,155,20930,18567,14368,12515
2021-10-04 09:00:00+00,11887,0,4195,10102,592,3644,2365,165,4247,0,37197,148,21501,19136,14941,11887
2021-10-04 09:30:00+00,11496,0,4199,10341,491,3644,2359,160,4919,0,37609,143,22309,19950,15751,11496
2021-10-04 10:00:00+00,11208,0,4197,10383,479,3666,2368,161,5280,0,37742,139,22707,20339,16142,11208
2021-10-04 10:30:00+00,11004,0,4202,10654,452,3666,2367,156,5171,0,37672,137,22846,20479,16277,11004
2021-10-04 11:00:00+00,11201,0,4199,10653,382,3622,2372,160,5294,8,37891,139,22900,20528,16329,11201
2021-10-04 11:30:00+00,11329,0,4226,10828,382,3626,2374,156,4677,0,37598,141,22487,20113,15887,11329
2021-10-04 12:00:00+00,11240,0,4391,10762,382,3714,2364,157,4702,0,37712,140,22601,20237,15846,11240
2021-10-04 12:30:00+00,11280,0,4427,10506,382,3718,2360,159,3885,14,36731,144,21560,19200,14773,11280
2021-10-04 13:00:00+00,11959,7,4421,10191,382,3506,2359,157,3753,0,36735,151,21106,18747,14326,11966
2021-10-04 13:30:00+00,12224,40,4421,10094,382,3492,2364,156,3355,0,36528,156,20616,18252,13831,12264
2021-10-04 14:00:00+00,12443,147,4421,9882,426,3706,2302,157,2578,0,36062,163,19609,17307,12886,12590
2021-10-04 14:30:00+00,13207,360,4448,9830,448,3718,2312,155,2168,0,36646,174,19206,16894,12446,13567
2021-10-04 15:00:00+00,14205,658,4457,9432,610,3676,2358,133,2089,34,37652,187,18946,16588,12131,14863
2021-10-04 15:30:00+00,15518,882,4459,8993,694,3678,2354,122,1300,42,38042,204,17800,15446,10987,16400
2021-10-04 16:00:00+00,16237,925,4459,8642,737,3562,2368,234,712,810,38686,209,16918,14550,10091,17162
2021-10-04 16:30:00+00,16649,945,4458,8098,758,3558,2364,359,322,1132,38643,215,16000,13636,9178,17594
2021-10-04 17:00:00+00,16999,909,4455,7898,797,3636,2366,420,41,1084,38605,220,15557,13191,8736,17908
2021-10-04 17:30:00+00,17413,924,4453,7606,817,3640,2366,420,0,1276,38915,223,15242,12876,8423,18337
2021-10-04 18:00:00+00,17072,966,4454,7273,832,3732,2365,541,0,1416,38651,223,14924,12559,8105,18038
2021-10-04 18:30:00+00,16694,815,4454,7244,832,3736,2365,534,0,1200,37874,220,14895,12530,8076,17509
2021-10-04 19:00:00+00,16256,703,4458,7215,833,3736,2367,245,0,1284,37097,214,14873,12506,8048,16959
2021-10-04 19:30:00+00,15997,695,4457,7341,831,3738,2272,162,0,128,35621,219,14901,12629,8172,16692
2021-10-04 20:00:00+00,14623,744,4462,7483,775,3694,2226,128,0,8,34143,213,14946,12720,8258,15367
2021-10-04 20:30:00+00,12837,308,4458,8010,703,3686,2234,125,0,0,32361,190,15405,13171,8713,13145
2021-10-04 21:00:00+00,11578,10,4288,8188,602,3398,2235,122,0,74,30495,175,15313,13078,8790,11588
2021-10-04 21:30:00+00,9863,0,4139,8452,524,3388,2237,120,0,0,28723,162,15352,13115,8976,9863
2021-10-04 22:00:00+00,7978,0,3848,8537,504,3108,2241,127,0,352,26695,144,15130,12889,9041,7978
2021-10-04 22:30:00+00,6945,0,3846,8265,551,3117,2235,118,0,128,25205,137,14897,12662,8816,6945
2021-10-04 23:00:00+00,6247,0,3846,8234,388,2803,2234,119,0,52,23923,131,14702,12468,8622,6247
2021-10-04 23:30:00+00,5360,0,3842,8335,382,2814,2240,121,0,26,23120,121,14799,12559,8717,5360
2021-10-05 00:00:00+00,5112,0,3843,8428,382,2806,2229,124,0,0,22924,117,14882,12653,8810,5112
2021-10-05 00:30:00+00,5265,0,3845,8641,382,2768,2230,126,0,0,23257,117,15098,12868,9023,5265
2021-10-05 01:00:00+00,5359,0,3847,8953,358,2772,2222,125,0,0,23636,117,15380,13158,9311,5359
2021-10-05 01:30:00+00,4845,0,3847,9245,359,2758,2233,124,0,0,23411,109,15684,13451,9604,4845
2021-10-05 02:00:00+00,4855,0,3845,9390,347,2754,2213,125,0,0,23528,109,15794,13582,9736,4855
2021-10-05 02:30:00+00,4764,0,3848,9580,343,2754,2237,123,0,0,23649,107,16008,13771,9923,4764
2021-10-05 03:00:00+00,4734,0,3851,9781,355,2744,2239,119,0,0,23823,105,16226,13987,10136,4734
2021-10-05 03:30:00+00,4338,0,3851,10172,354,2744,2222,118,0,0,23799,99,16599,14377,10526,4338
2021-10-05 04:00:00+00,4030,0,3853,10387,373,2726,2234,118,0,0,23721,94,16847,14613,10760,4030
2021-10-05 04:30:00+00,4816,0,3855,10665,391,2764,2238,119,0,0,24848,103,17149,14911,11056,4816
2021-10-05 05:00:00+00,5995,0,3857,11322,506,3108,2217,120,0,0,27125,115,17902,15685,11828,5995
2021-10-05 05:30:00+00,7363,0,3863,11958,512,3218,2201,120,0,0,29235,126,18534,16333,12470,7363
2021-10-05 06:00:00+00,9770,0,3856,12343,601,3664,2228,128,0,80,32670,144,19028,16800,12944,9770
2021-10-05 06:30:00+00,11119,0,3856,12516,642,3760,2204,130,85,18,34330,153,19303,17099,13243,11119
2021-10-05 07:00:00+00,11646,0,3855,12582,653,3362,2208,134,469,182,35091,153,19767,17559,13704,11646
2021-10-05 07:30:00+00,11660,0,3850,12331,629,3322,2215,140,1421,160,35728,150,20446,18231,14381,11660
2021-10-05 08:00:00+00,11633,0,3847,12108,622,3778,2208,145,2274,138,36753,148,21059,18851,15004,11633
2021-10-05 08:30:00+00,11595,0,3851,11967,623,3786,2206,132,2617,48,36825,147,21264,19058,15207,11595
2021-10-05 09:00:00+00,11481,0,3856,12168,606,3716,2202,127,2614,22,36792,146,21446,19244,15388,11481
2021-10-05 09:30:00+00,11304,7,3856,12409,586,3714,2209,126,2902,0,37113,143,21962,19753,15897,11311
2021-10-05 10:00:00+00,10980,32,3880,12699,493,3712,2205,122,3007,140,37270,140,22284,20079,16199,11012
2021-10-05 10:30:00+00,10166,49,3885,12657,490,3094,2191,100,3079,44,35755,134,22302,20111,16226,10215
2021-10-05 11:00:00+00,9729,87,3888,14197,380,3768,2201,82,3271,192,37795,126,23937,21736,17848,9816
2021-10-05 11:30:00+00,9388,104,3889,14635,378,3652,2203,83,3730,2,38064,121,24835,22632,18743,9492
2021-10-05 12:00:00+00,8243,147,3891,15341,367,3706,2136,83,3960,0,37874,110,25695,23559,19668,8390
2021-10-05 12:30:00+00,7313,194,3890,15814,365,3646,2136,85,3641,0,37084,103,25846,23710,19820,7507
2021-10-05 13:00:00+00,7799,220,3891,16091,395,2680,2138,83,3577,0,36874,107,26092,23954,20063,8019
2021-10-05 13:30:00+00,7541,227,3897,16405,401,2650,2135,82,3432,0,36770,104,26270,24135,20238,7768
2021-10-05 14:00:00+00,7134,226,3914,16769,411,2580,2113,83,2690,0,35920,95,25897,23784,19870,7360
2021-10-05 14:30:00+00,7456,229,3909,17014,385,2660,2150,88,2623,0,36514,98,26081,23931,20022,7685
2021-10-05 15:00:00+00,8783,229,3909,17221,472,2480,2141,86,2178,0,37499,109,25921,23780,19871,9012
2021-10-05 15:30:00+00,9812,230,3907,17238,502,2546,2151,96,1489,50,38021,119,25287,23136,19229,10042
2021-10-05 16:00:00+00,10109,230,3921,17057,604,3336,2161,104,943,302,38767,127,24686,22525,18604,10339
2021-10-05 16:30:00+00,10626,230,3921,16838,597,3394,2155,105,412,730,39008,132,23923,21768,17847,10856
2021-10-05 17:00:00+00,10868,230,3924,16627,585,3508,2155,162,56,1044,39159,134,23347,21192,17268,11098
2021-10-05 17:30:00+00,11109,230,3921,16450,583,3510,2162,176,0,1164,39305,136,23116,20954,17033,11339
2021-10-05 18:00:00+00,10953,229,3927,16181,585,3726,2148,395,0,1286,39430,137,22841,20693,16766,11182
2021-10-05 18:30:00+00,10553,230,3929,16101,547,3734,2137,322,0,1056,38609,136,22714,20577,16648,10783
2021-10-05 19:00:00+00,10279,230,3929,15979,536,3736,2141,124,0,524,37478,135,22585,20444,16515,10509
2021-10-05 19:30:00+00,9384,230,3929,15794,535,3728,2110,165,0,104,35979,131,22368,20258,16329,9614
2021-10-05 20:00:00+00,8469,230,3932,15689,505,3266,2086,148,0,58,34383,124,22212,20126,16194,8699
2021-10-05 20:30:00+00,7011,230,3931,15688,506,3246,2079,96,0,0,32787,112,22204,20125,16194,7241
2021-10-05 21:00:00+00,5919,230,3936,15513,484,2834,2076,85,0,0,31077,102,22009,19933,15997,6149
2021-10-05 21:30:00+00,4686,231,3942,15332,489,2666,1945,86,0,0,29377,90,21708,19763,15821,4917
2021-10-05 22:00:00+00,5039,230,3939,15319,497,1336,2101,177,0,0,28638,93,21856,19755,15816,5269
2021-10-05 22:30:00+00,4241,231,3936,15120,410,1016,2152,97,0,0,27203,81,21618,19466,15530,4472
2021-10-05 23:00:00+00,4333,230,3935,14985,370,1052,2154,76,0,0,27135,82,21444,19290,15355,4563
2021-10-05 23:30:00+00,4206,230,3932,14724,370,1054,2187,77,0,0,26780,82,21213,19026,15094,4436
2021-10-06 00:00:00+00,4388,230,3928,14418,368,1126,2161,82,0,0,26701,85,20875,18714,14786,4618
2021-10-06 00:30:00+00,4539,230,3931,14230,367,1126,2152,81,0,0,26656,87,20680,18528,14597,4769
2021-10-06 01:00:00+00,4723,230,3932,13985,366,1090,2155,83,0,0,26564,90,20438,18283,14351,4953
2021-10-06 01:30:00+00,4616,231,3937,13848,366,1090,2157,83,0,0,26327,89,20308,18151,14214,4847
2021-10-06 02:00:00+00,4653,230,3936,13797,366,1110,2158,82,0,0,26332,90,20257,18099,14163,4883
2021-10-06 02:30:00+00,4751,230,3921,13606,366,1110,2157,83,0,0,26223,92,20050,17893,13972,4981
2021-10-06 03:00:00+00,4875,230,3930,13424,366,1110,2203,79,0,0,26217,94,19923,17720,13790,5105
2021-10-06 03:30:00+00,4912,229,3936,13084,365,1110,2209,78,0,0,25923,95,19594,17385,13449,5141
2021-10-06 04:00:00+00,5211,230,3926,12840,365,690,2195,74,0,0,25530,100,19326,17131,13205,5441
2021-10-06 04:30:00+00,5567,230,3929,12582,447,680,2208,73,0,0,25716,105,19166,16958,13029,5797
2021-10-06 05:00:00+00,6436,230,3922,12180,485,950,2211,185,0,376,26976,116,18798,16587,12665,6666
2021-10-06 05:30:00+00,7469,230,3914,11807,492,1038,2210,257,0,874,28291,128,18423,16213,12299,7699
2021-10-06 06:00:00+00,8848,230,3913,11178,596,2458,2226,106,0,1062,30617,142,17913,15687,11774,9078
2021-10-06 06:30:00+00,9922,229,3914,10434,688,2570,2254,160,160,928,31259,153,17450,15196,11282,10151
2021-10-06 07:00:00+00,11074,229,3913,9863,728,2806,2261,370,738,1378,33361,160,17503,15242,11329,11303
2021-10-06 07:30:00+00,11789,231,3920,9035,722,2816,2256,387,1775,1246,34177,165,17708,15452,11532,12020
2021-10-06 08:00:00+00,12285,229,3919,8450,682,2816,2255,410,2928,1102,35075,166,18234,15979,12060,12514
2021-10-06 08:30:00+00,12634,230,3923,8096,665,2816,2290,432,3634,674,35394,169,18608,16318,12395,12864
2021-10-06 09:00:00+00,12921,241,3925,7794,584,2816,2299,360,4112,564,35616,171,18714,16415,12490,13162
2021-10-06 09:30:00+00,13089,242,3929,7457,538,2816,2301,291,4542,662,35867,171,18767,16466,12537,13331
2021-10-06 10:00:00+00,13228,298,3948,7308,414,2816,2305,302,4909,642,36169,173,18884,16579,12631,13526
2021-10-06 10:30:00+00,13303,283,3961,7265,464,2816,2295,349,5237,544,36517,172,19222,16927,12966,13586
2021-10-06 11:00:00+00,13417,297,3968,7203,453,2812,2335,357,5417,338,36597,173,19376,17041,13073,13714
2021-10-06 11:30:00+00,13403,301,3957,7197,433,2812,2345,282,5958,70,36758,172,19890,17545,13588,13704
2021-10-06 12:00:00+00,13379,300,3953,7265,340,3700,2343,85,6297,0,37662,170,20198,17855,13902,13679
2021-10-06 12:30:00+00,12871,300,3960,7408,343,3720,2337,80,6156,0,37175,167,20204,17867,13907,13171
2021-10-06 13:00:00+00,12449,301,3961,7682,356,3826,2333,79,5674,0,36661,166,20006,17673,13712,12750
2021-10-06 13:30:00+00,12550,300,3959,7657,357,3914,2345,80,5030,0,36192,170,19348,17003,13044,12850
2021-10-06 14:00:00+00,13450,387,3965,7760,402,3140,2343,82,4163,0,35692,178,18633,16290,12325,13837
2021-10-06 14:30:00+00,14146,536,3967,7690,419,3132,2351,80,3244,0,35565,190,17671,15320,11353,14682
2021-10-06 15:00:00+00,15344,724,3966,7418,521,3172,2361,84,2777,0,36367,204,17043,14682,10716,16068
2021-10-06 15:30:00+00,16362,798,3966,7375,647,3128,2363,89,1825,364,36917,213,16176,13813,9847,17160
2021-10-06 16:00:00+00,16729,800,3964,6843,779,3814,2367,205,1010,972,37483,220,14963,12596,8632,17529
2021-10-06 16:30:00+00,16992,801,3965,6523,869,4026,2367,400,263,1196,37402,228,13987,11620,7655,17793
2021-10-06 17:00:00+00,16825,801,3965,6473,890,4094,2363,553,20,1186,37170,230,13711,11348,7383,17626
2021-10-06 17:30:00+00,17378,798,3964,6901,891,4094,2366,536,0,1312,38240,229,14122,11756,7792,18176
2021-10-06 18:00:00+00,17596,797,3964,7048,892,4234,2364,516,0,1130,38541,232,14268,11904,7940,18393
2021-10-06 18:30:00+00,17005,780,3965,7432,732,4068,2365,394,0,868,37609,228,14494,12129,8164,17785
2021-10-06 19:00:00+00,16944,729,3966,7473,666,3562,2356,188,0,636,36520,229,14461,12105,8139,17673
2021-10-06 19:30:00+00,15862,742,3965,7422,523,3432,2361,167,0,398,34872,226,14271,11910,7945,16604
2021-10-06 20:00:00+00,14887,683,3964,7182,474,3810,2370,104,0,0,33474,223,13990,11620,7656,15570
2021-10-06 20:30:00+00,13486,354,3967,6981,468,3974,2370,76,0,98,31774,210,13786,11416,7449,13840
2021-10-06 21:00:00+00,12349,300,3974,6901,423,3706,2363,73,0,0,30089,204,13661,11298,7324,12649
2021-10-06 21:30:00+00,10711,299,3972,6792,404,3774,2359,73,0,0,28384,195,13527,11168,7196,11010
2021-10-06 22:00:00+00,9135,299,3973,6729,375,3656,2356,75,0,0,26598,182,13433,11077,7104,9434
2021-10-06 22:30:00+00,7884,299,3970,6867,346,3794,2367,74,0,0,25601,173,13550,11183,7213,8183
2021-10-06 23:00:00+00,7041,340,3968,7002,344,3896,2369,73,0,0,25033,166,13683,11314,7346,7381
2021-10-06 23:30:00+00,6641,346,3967,7159,341,3926,2368,79,0,0,24827,162,13835,11467,7500,6987
2021-10-07 00:00:00+00,6607,239,3963,7277,341,3878,2365,79,0,0,24749,163,13946,11581,7618,6846
2021-10-07 00:30:00+00,6615,229,3963,7490,337,3934,2365,79,0,0,25012,162,14155,11790,7827,6844
2021-10-07 01:00:00+00,6349,229,3961,7609,330,3830,2359,80,0,0,24747,159,14259,11900,7939,6578
2021-10-07 01:30:00+00,6166,231,3962,7391,338,3800,2363,80,0,0,24331,158,14054,11691,7729,6397
2021-10-07 02:00:00+00,5915,230,3963,7115,337,3978,2368,74,0,0,23980,157,13783,11415,7452,6145
2021-10-07 02:30:00+00,5769,228,3961,7047,325,3974,2368,73,0,0,23745,156,13701,11333,7372,5997
2021-10-07 03:00:00+00,5732,230,3959,7292,325,3530,2359,74,0,0,23501,154,13935,11576,7617,5962
2021-10-07 03:30:00+00,5603,230,3963,7684,325,3496,2366,74,0,0,23741,151,14338,11972,8009,5833
2021-10-07 04:00:00+00,6419,376,3961,7779,341,2410,2368,81,0,0,23735,159,14449,12081,8120,6795
2021-10-07 04:30:00+00,7171,623,3961,7771,368,2248,2371,86,0,0,24599,173,14471,12100,8139,7794
2021-10-07 05:00:00+00,9604,661,3966,7921,585,1790,2368,538,0,0,27433,191,14840,12472,8506,10265
2021-10-07 05:30:00+00,12121,636,3968,7998,585,1782,2206,386,0,58,29740,207,14757,12551,8583,12757
2021-10-07 06:00:00+00,13973,646,3967,8140,627,1600,2123,357,0,352,31785,214,14857,12734,8767,14619
2021-10-07 06:30:00+00,14782,727,3968,8249,699,1674,2123,435,37,258,32952,220,15076,12953,8985,15509
2021-10-07 07:00:00+00,14664,608,3966,8341,693,3240,2125,323,240,314,34514,213,15365,13240,9274,15272
2021-10-07 07:30:00+00,14627,614,3968,8506,669,3328,2125,198,543,202,34780,211,15811,13686,9718,15241
2021-10-07 08:00:00+00,14634,616,3966,8427,491,4130,2121,214,965,110,35674,212,15970,13849,9883,15250
2021-10-07 08:30:00+00,14505,876,3964,8480,503,4008,2100,153,1542,80,36211,212,16589,14489,10525,15381
2021-10-07 09:00:00+00,14787,938,3965,8648,449,3356,2080,201,1927,0,36351,212,17069,14989,11024,15725
2021-10-07 09:30:00+00,14779,940,3965,8740,330,3246,2080,185,2370,0,36635,209,17485,15405,11440,15719
2021-10-07 10:00:00+00,14717,939,3967,9299,269,2968,2076,77,2487,0,36799,208,18098,16022,12055,15656
2021-10-07 10:30:00+00,14137,909,3967,9782,266,2952,2079,75,2975,0,37142,199,19069,16990,13023,15046
2021-10-07 11:00:00+00,14442,708,3962,10113,283,2530,2077,79,3145,0,37339,196,19580,17503,13541,15150
2021-10-07 11:30:00+00,13964,691,3962,10326,292,2468,2030,74,2955,0,36762,194,19565,17535,13573,14655
2021-10-07 12:00:00+00,14250,728,3964,10531,293,1736,2031,75,2903,0,36511,196,19722,17691,13727,14978
2021-10-07 12:30:00+00,14144,699,3963,10493,287,1704,2030,77,2765,0,36162,196,19538,17508,13545,14843
2021-10-07 13:00:00+00,14456,687,3968,10556,283,1380,2025,75,2517,0,35947,198,19349,17324,13356,15143
2021-10-07 13:30:00+00,14362,780,3966,10432,283,1398,2104,76,2009,0,35410,203,18794,16690,12724,15142
2021-10-07 14:00:00+00,14549,933,3972,10312,360,1424,2123,78,1887,0,35638,204,18654,16531,12559,15482
2021-10-07 14:30:00+00,15046,953,3972,10126,385,1450,2129,125,1391,108,35685,210,18003,15874,11902,15999
2021-10-07 15:00:00+00,15475,946,3969,9813,471,2002,2130,255,949,68,36078,212,17332,15202,11233,16421
2021-10-07 15:30:00+00,15662,944,3970,9858,565,2180,2123,339,678,136,36455,215,17194,15071,11101,16606
2021-10-07 16:00:00+00,15658,867,3970,9994,511,3008,2088,366,498,538,37498,209,17061,14973,11003,16525
2021-10-07 16:30:00+00,16152,861,3963,9861,529,3038,2032,307,162,890,37795,211,16547,14515,10552,17013
2021-10-07 17:00:00+00,16115,805,3967,9923,532,3154,2107,341,9,1038,37991,212,16538,14431,10464,16920
2021-10-07 17:30:00+00,16442,926,3963,9565,626,3154,2079,577,0,1170,38502,217,16233,14154,10191,17368
2021-10-07 18:00:00+00,16398,833,3964,9198,586,3692,2071,447,0,850,38039,223,15819,13748,9784,17231
2021-10-07 18:30:00+00,16193,685,3960,8933,553,3560,2071,297,0,716,36968,221,15517,13446,9486,16878
2021-10-07 19:00:00+00,15511,680,3964,9012,581,3190,2070,340,0,286,35634,218,15627,13557,9593,16191
2021-10-07 19:30:00+00,14890,688,3965,8823,564,2938,2064,135,0,68,34135,215,15416,13352,9387,15578
2021-10-07 20:00:00+00,13857,602,3970,8526,443,3276,2060,84,0,8,32826,212,14999,12939,8969,14459
2021-10-07 20:30:00+00,12297,417,3970,8288,426,3336,2055,113,0,4,30906,201,14740,12684,8714,12714
2021-10-07 21:00:00+00,11290,253,3970,7906,424,3022,2051,75,0,200,29191,196,14351,12300,8330,11543
2021-10-07 21:30:00+00,9986,251,3973,7640,431,3162,2059,80,0,14,27596,190,14103,12044,8071,10237
2021-10-07 22:00:00+00,8522,232,3975,7465,423,4048,2035,75,0,0,26775,175,13898,11863,7888,8754
2021-10-07 22:30:00+00,7422,232,3974,7487,413,3808,2089,74,0,0,25499,162,13963,11874,7900,7654
2021-10-07 23:00:00+00,7167,240,3971,7207,373,3718,2153,74,0,0,24903,161,13704,11551,7580,7407
2021-10-07 23:30:00+00,7140,232,3971,7122,355,3722,2217,73,0,0,24832,161,13665,11448,7477,7372
2021-10-08 00:00:00+00,6921,241,3969,7110,312,3688,2229,77,0,0,24547,158,13620,11391,7422,7162
2021-10-08 00:30:00+00,7024,244,3968,7060,309,3686,2237,77,0,0,24605,160,13574,11337,7369,7268
2021-10-08 01:00:00+00,6824,249,3963,6729,307,3720,2239,83,0,0,24114,160,13238,10999,7036,7073
2021-10-08 01:30:00+00,6638,232,3966,6189,304,3722,2233,82,0,0,23366,161,12692,10459,6493,6870
2021-10-08 02:00:00+00,6899,246,3964,5930,324,3496,2245,81,0,0,23185,167,12463,10218,6254,7145
2021-10-08 02:30:00+00,7139,235,3965,5875,330,3488,2235,80,0,0,23347,169,12405,10170,6205,7374
2021-10-08 03:00:00+00,7571,236,3966,5554,326,3114,2197,80,0,0,23044,176,12043,9846,5880,7807
2021-10-08 03:30:00+00,8014,232,3966,5303,321,3102,2192,81,0,0,23211,182,11782,9590,5624,8246
2021-10-08 04:00:00+00,9750,286,3965,5071,321,1370,2209,77,0,0,23049,206,11566,9357,5392,10036
2021-10-08 04:30:00+00,10449,319,3966,4905,324,1382,2212,74,0,18,23649,214,11407,9195,5229,10768
2021-10-08 05:00:00+00,13596,348,3966,4730,383,994,2212,74,0,182,26485,231,11291,9079,5113,13944
2021-10-08 05:30:00+00,15931,345,3966,4721,384,1080,2206,75,0,248,28956,244,11277,9071,5105,16276
2021-10-08 06:00:00+00,17607,366,3965,4712,411,2042,2205,125,0,120,31553,257,11293,9088,5123,17973
2021-10-08 06:30:00+00,18712,457,3966,4593,416,2252,2204,149,41,354,33144,264,11220,9016,5050,19169
2021-10-08 07:00:00+00,18840,410,3966,4568,414,2772,2205,391,234,198,33998,260,11387,9182,5216,19250
2021-10-08 07:30:00+00,18934,400,3965,4571,413,2688,2209,439,503,570,34692,255,11661,9452,5487,19334
2021-10-08 08:00:00+00,18610,399,3965,4493,413,3604,2205,361,800,732,35582,248,11876,9671,5706,19009
2021-10-08 08:30:00+00,18895,400,3965,4405,414,3634,2205,360,1110,430,35818,250,12099,9894,5929,19295
2021-10-08 09:00:00+00,19047,413,3964,4319,368,3688,2204,381,1428,80,35892,251,12283,10079,6115,19460
2021-10-08 09:30:00+00,19059,401,3963,4398,359,3608,2196,342,1680,0,36006,248,12596,10400,6437,19460
2021-10-08 10:00:00+00,18429,403,3968,4727,343,3638,2203,316,2059,0,36086,242,13300,11097,7129,18832
2021-10-08 10:30:00+00,18007,402,3965,4875,338,3960,2202,239,2448,0,36436,236,13828,11626,7661,18409
2021-10-08 11:00:00+00,18230,400,3967,4824,316,3912,2200,140,2695,70,36754,235,14002,11802,7835,18630
2021-10-08 11:30:00+00,18234,400,3961,4896,309,3818,2202,92,2264,0,36176,236,13632,11430,7469,18634
2021-10-08 12:00:00+00,17585,302,3964,4979,311,3928,2195,74,2134,84,35556,232,13583,11388,7424,17887
2021-10-08 12:30:00+00,17503,232,3959,4972,310,3842,2201,73,2135,34,35261,230,13577,11376,7417,17735
2021-10-08 13:00:00+00,17505,231,3963,4850,328,3658,2193,73,2107,94,35002,230,13441,11248,7285,17736
2021-10-08 13:30:00+00,17509,229,3966,4711,351,3700,2198,74,1900,0,34638,233,13126,10928,6962,17738
2021-10-08 14:00:00+00,17349,316,3971,4770,368,3470,2201,73,1701,0,34218,235,13010,10810,6838,17665
2021-10-08 14:30:00+00,17662,562,3968,4494,369,3608,2198,74,1487,0,34422,246,12516,10318,6350,18224
2021-10-08 15:00:00+00,18192,761,3971,4424,424,3524,2200,84,1067,114,34761,254,12086,9886,5915,18953
2021-10-08 15:30:00+00,18256,808,3974,4276,498,3630,2206,417,750,138,34953,259,11704,9498,5524,19064
2021-10-08 16:00:00+00,17939,858,3970,4378,678,3912,2247,624,343,256,35205,259,11616,9369,5399,18797
2021-10-08 16:30:00+00,18357,760,3969,4514,701,4012,2275,571,81,760,36000,256,11540,9265,5296,19117
2021-10-08 17:00:00+00,18427,721,3968,4487,774,4104,2293,522,1,1170,36467,252,11523,9230,5262,19148
2021-10-08 17:30:00+00,18687,729,3965,4657,733,4322,2297,477,0,1170,37037,253,11652,9355,5390,19416
2021-10-08 18:00:00+00,18427,741,3964,4824,575,4318,2304,546,0,770,36469,255,11667,9363,5399,19168
2021-10-08 18:30:00+00,17972,648,3964,4760,542,4118,2319,425,0,678,35426,252,11585,9266,5302,18620
2021-10-08 19:00:00+00,17828,595,3964,4848,499,4092,2324,165,0,6,34321,254,11635,9311,5347,18423
2021-10-08 19:30:00+00,16719,652,3962,5054,491,3894,2326,137,0,0,33235,248,11833,9507,5545,17371
2021-10-08 20:00:00+00,15573,318,3966,5180,426,4038,2331,134,0,0,31966,237,11903,9572,5606,15891
2021-10-08 20:30:00+00,14258,6,3964,5365,413,4116,2333,98,0,0,30553,222,12075,9742,5778,14264
2021-10-08 21:00:00+00,12843,3,3964,5562,402,3940,2337,74,0,0,29125,210,12265,9928,5964,12846
2021-10-08 21:30:00+00,11296,0,3966,5546,417,4022,2334,74,0,0,27655,200,12263,9929,5963,11296
2021-10-08 22:00:00+00,9516,0,3968,5729,343,4238,2336,74,0,0,26204,188,12376,10040,6072,9516
2021-10-08 22:30:00+00,8589,0,3969,5689,337,4162,2321,73,0,0,25140,180,12316,9995,6026,8589
2021-10-08 23:00:00+00,8227,0,3968,5651,317,4186,2318,73,0,0,24740,178,12254,9936,5968,8227
2021-10-08 23:30:00+00,7670,0,3969,5771,316,4120,2320,72,0,0,24238,171,12376,10056,6087,7670
2021-10-09 00:00:00+00,7715,0,3969,5664,313,3918,2307,72,0,0,23958,174,12253,9946,5977,7715
2021-10-09 00:30:00+00,7669,0,3968,5593,310,4012,2324,73,0,0,23949,176,12195,9871,5903,7669
2021-10-09 01:00:00+00,7347,0,3967,5529,293,4052,2326,73,0,0,23587,172,12115,9789,5822,7347
2021-10-09 01:30:00+00,7240,0,3964,5223,292,3990,2318,73,0,0,23100,172,11797,9479,5515,7240
2021-10-09 02:00:00+00,7331,0,3960,5149,293,3556,2328,75,0,0,22692,177,11730,9402,5442,7331
2021-10-09 02:30:00+00,7467,0,3961,5027,294,3524,2328,74,0,0,22675,179,11610,9282,5321,7467
2021-10-09 03:00:00+00,7383,0,3962,4899,293,3714,2327,74,0,0,22652,178,11481,9154,5192,7383
2021-10-09 03:30:00+00,7605,0,3962,4589,293,3688,2025,73,0,0,22235,183,10869,8844,4882,7605
2021-10-09 04:00:00+00,7900,0,3963,4344,286,3926,1743,76,0,0,22238,186,10336,8593,4630,7900
2021-10-09 04:30:00+00,8346,0,3963,4119,279,4026,1746,76,0,0,22555,193,10107,8361,4398,8346
2021-10-09 05:00:00+00,9114,0,3965,4153,337,3992,1637,73,0,0,23271,197,10092,8455,4490,9114
2021-10-09 05:30:00+00,10115,0,3965,4479,338,3926,1484,73,0,0,24380,203,10266,8782,4817,10115
2021-10-09 06:00:00+00,11682,0,3965,4577,360,3410,1662,73,0,0,25729,212,10564,8902,4937,11682
2021-10-09 06:30:00+00,13116,0,3967,4322,366,3392,1744,80,108,0,27095,222,10507,8763,4796,13116
2021-10-09 07:00:00+00,14089,0,3969,4308,384,3722,1732,106,516,0,28826,224,10909,9177,5208,14089
2021-10-09 07:30:00+00,14697,0,3968,4447,387,3744,1741,97,1112,0,30193,222,11655,9914,5946,14697
2021-10-09 08:00:00+00,14767,0,3970,4574,531,3836,1735,93,1774,0,31280,216,12584,10849,6879,14767
2021-10-09 08:30:00+00,14784,0,3970,4559,535,3786,1728,86,2513,0,31961,211,13305,11577,7607,14784
2021-10-09 09:00:00+00,14724,0,3964,4348,553,3722,1716,88,3288,0,32403,206,13869,12153,8189,14724
2021-10-09 09:30:00+00,14632,0,3963,4357,409,3722,1687,88,3922,0,32780,203,14338,12651,8688,14632
2021-10-09 10:00:00+00,14312,0,3963,4431,325,3602,1651,78,4326,0,32688,199,14696,13045,9082,14312
2021-10-09 10:30:00+00,14149,0,3960,4444,323,3604,1621,81,4496,0,32678,197,14844,13222,9262,14149
2021-10-09 11:00:00+00,14291,0,3960,4403,312,3714,1599,80,4469,0,32828,198,14743,13144,9184,14291
2021-10-09 11:30:00+00,14110,0,3960,4372,310,3722,1597,77,4497,0,32645,197,14736,13139,9179,14110
2021-10-09 12:00:00+00,13997,0,3958,4294,309,3722,1597,77,4696,0,32650,195,14854,13257,9299,13997
2021-10-09 12:30:00+00,13831,0,3958,3961,308,3722,1596,74,4405,0,31855,198,14228,12632,8674,13831
2021-10-09 13:00:00+00,13923,0,3957,3581,307,3722,1596,81,4113,0,31280,203,13554,11958,8001,13923
2021-10-09 13:30:00+00,14163,0,3957,3410,304,3722,1597,80,3804,0,31037,208,13072,11475,7518,14163
2021-10-09 14:00:00+00,14555,0,3957,3160,303,3722,1596,77,3261,12,30643,215,12277,10681,6724,14555
2021-10-09 14:30:00+00,15229,72,3956,2940,305,3722,1599,75,2585,0,30483,227,11385,9786,5830,15301
2021-10-09 15:00:00+00,16380,210,3956,2741,354,3742,1599,77,1892,2,30953,243,10542,8943,4987,16590
2021-10-09 15:30:00+00,16871,301,3959,2750,359,3742,1600,143,1241,238,31204,250,9909,8309,4350,17172
2021-10-09 16:00:00+00,17385,476,3961,2442,531,3742,1812,395,619,586,31949,259,9365,7553,3592,17861
2021-10-09 16:30:00+00,17482,430,3966,2337,631,3812,2068,425,162,902,32215,259,9164,7096,3130,17912
2021-10-09 17:00:00+00,17832,439,3966,2201,639,3658,2209,501,7,1256,32708,258,9022,6813,2847,18271
2021-10-09 17:30:00+00,18359,447,3964,2053,655,3732,2227,507,0,1326,33270,262,8899,6672,2708,18806
2021-10-09 18:00:00+00,18318,405,3962,2009,714,3390,2237,435,0,1362,32832,257,8922,6685,2723,18723
2021-10-09 18:30:00+00,17854,301,3961,1983,755,3364,2217,440,0,912,31787,257,8916,6699,2738,18155
2021-10-09 19:00:00+00,17848,302,3960,2038,726,3368,2236,282,0,570,31330,259,8960,6724,2764,18150
2021-10-09 19:30:00+00,17345,307,3962,2466,525,3236,2229,237,0,234,30541,257,9182,6953,2991,17652
2021-10-09 20:00:00+00,16553,415,3961,2719,456,2922,2241,180,0,0,29447,253,9377,7136,3175,16968
2021-10-09 20:30:00+00,15748,381,3964,2864,429,3010,2239,116,0,0,28750,248,9496,7256,3292,16129
2021-10-09 21:00:00+00,14156,294,3964,2972,417,3444,2223,80,0,0,27550,241,9576,7353,3389,14450
2021-10-09 21:30:00+00,13304,7,3964,3003,416,3284,2213,77,0,0,26268,227,9596,7383,3419,13311
2021-10-09 22:00:00+00,12142,0,3965,2950,355,2998,2214,79,0,0,24703,216,9484,7270,3305,12142
2021-10-09 22:30:00+00,11015,0,3967,3143,348,2996,2209,80,0,0,23758,206,9667,7458,3491,11015
2021-10-09 23:00:00+00,9891,0,3965,3383,301,3128,2215,81,0,0,22964,197,9864,7649,3684,9891
2021-10-09 23:30:00+00,9138,0,3964,3697,301,3136,2215,81,0,0,22532,188,10177,7962,3998,9138
2021-10-10 00:00:00+00,8271,0,3965,4022,301,3536,2215,85,0,0,22395,183,10503,8288,4323,8271
2021-10-10 00:30:00+00,8372,0,3960,3778,300,3544,2214,85,0,0,22252,186,10252,8038,4078,8372
2021-10-10 01:00:00+00,8596,0,3959,3367,289,3716,2207,79,0,0,22213,194,9822,7615,3656,8596
2021-10-10 01:30:00+00,8418,0,3951,3484,277,3718,2203,75,0,0,22126,192,9915,7712,3761,8418
2021-10-10 02:00:00+00,8120,0,3955,3540,277,3714,2214,75,0,0,21895,188,9986,7772,3817,8120
2021-10-10 02:30:00+00,7907,0,3955,3573,276,3714,2213,73,0,0,21711,186,10017,7804,3849,7907
2021-10-10 03:00:00+00,7394,0,3960,3781,292,3720,2211,73,0,0,21431,179,10244,8033,4073,7394
2021-10-10 03:30:00+00,7343,0,3955,3857,292,3720,2192,74,0,0,21433,178,10296,8104,4149,7343
2021-10-10 04:00:00+00,7525,0,3958,3871,293,3714,2232,75,0,0,21668,180,10354,8122,4164,7525
2021-10-10 04:30:00+00,7626,0,3958,3897,290,3714,2209,73,0,0,21767,181,10354,8145,4187,7626
2021-10-10 05:00:00+00,8178,0,3961,4182,331,3374,2228,75,0,0,22329,184,10702,8474,4513,8178
2021-10-10 05:30:00+00,8449,0,3962,4448,337,3374,2232,75,0,0,22877,185,10979,8747,4785,8449
2021-10-10 06:00:00+00,8283,0,3963,4733,401,3708,2233,73,0,0,23394,179,11330,9097,5134,8283
2021-10-10 06:30:00+00,8595,0,3966,5152,432,3718,2233,81,45,0,24222,178,11828,9595,5629,8595
2021-10-10 07:00:00+00,9576,0,3969,5578,547,3660,2217,78,378,2,26005,181,12689,10472,6503,9576
2021-10-10 07:30:00+00,10795,0,3963,5421,559,3660,2220,79,974,0,27671,187,13137,10917,6954,10795
2021-10-10 08:00:00+00,11639,0,3968,5223,561,3710,2225,79,1585,0,28990,190,13562,11337,7369,11639
2021-10-10 08:30:00+00,11496,0,3968,5621,562,3708,2242,85,2264,4,29950,182,14657,12415,8447,11496
2021-10-10 09:00:00+00,11364,0,3968,6358,554,3718,2232,87,3118,0,31399,172,16230,13998,10030,11364
2021-10-10 09:30:00+00,10925,0,3966,6679,540,3720,2221,85,3814,0,31950,164,17220,14999,11033,10925
2021-10-10 10:00:00+00,10576,0,3964,7125,391,3718,2219,76,4333,0,32402,157,18032,15813,11849,10576
2021-10-10 10:30:00+00,10531,0,3964,7382,381,3720,2218,76,4842,0,33114,153,18787,16569,12605,10531
2021-10-10 11:00:00+00,10682,0,3964,7160,370,3720,2218,76,5187,0,33377,154,18899,16681,12717,10682
2021-10-10 11:30:00+00,10712,0,3962,7147,363,3720,2213,76,5351,0,33544,154,19036,16823,12861,10712
2021-10-10 12:00:00+00,10310,0,3963,7184,312,3718,2211,75,5555,0,33328,150,19225,17014,13051,10310
2021-10-10 12:30:00+00,9915,0,3965,7438,313,3718,2160,74,5517,0,33100,146,19393,17233,13268,9915
2021-10-10 13:00:00+00,9337,0,3962,7772,312,3720,2144,74,5145,0,32466,142,19335,17191,13229,9337
2021-10-10 13:30:00+00,8862,0,3960,8173,312,3720,2149,74,4813,0,32063,138,19407,17258,13298,8862
2021-10-10 14:00:00+00,8922,0,3961,8550,324,3722,2151,74,4225,0,31929,139,19211,17060,13099,8922
2021-10-10 14:30:00+00,9686,0,3957,8509,349,3720,2155,82,3597,0,32055,148,18567,16412,12455,9686
2021-10-10 15:00:00+00,11188,0,3961,8465,380,3536,2157,75,2832,0,32594,163,17795,15638,11677,11188
2021-10-10 15:30:00+00,12779,0,3958,8576,388,3526,2161,76,2115,0,33579,177,17198,15037,11079,12779
2021-10-10 16:00:00+00,14812,0,3959,8147,421,3144,2194,132,1078,234,34121,195,15799,13605,9646,14812
2021-10-10 16:30:00+00,15403,0,3960,7862,402,3138,2205,358,337,460,34125,204,14766,12561,8601,15403
2021-10-10 17:00:00+00,15424,0,3963,7827,511,3176,2202,333,13,680,34129,202,14516,12314,8351,15424
2021-10-10 17:30:00+00,15793,0,3959,7439,529,3186,2277,378,0,1116,34677,204,14204,11927,7968,15793
2021-10-10 18:00:00+00,15434,0,3959,7384,550,3286,2289,488,0,1138,34528,200,14182,11893,7934,15434
2021-10-10 18:30:00+00,14810,0,3957,7340,531,3282,2282,462,0,1040,33704,197,14110,11828,7871,14810
2021-10-10 19:00:00+00,14940,0,3959,7252,476,2920,2278,311,0,528,32664,198,13965,11687,7728,14940
2021-10-10 19:30:00+00,14676,0,3958,7413,462,2914,2279,151,0,150,32003,197,14112,11833,7875,14676
2021-10-10 20:00:00+00,13354,0,3957,7745,447,2954,2284,122,0,0,30863,188,14433,12149,8192,13354
2021-10-10 20:30:00+00,11500,0,3962,8008,445,2954,2281,137,0,0,29287,174,14696,12415,8453,11500
2021-10-10 21:00:00+00,9690,0,3966,8278,354,3062,2281,133,0,0,27764,160,14879,12598,8632,9690
2021-10-10 21:30:00+00,8476,0,3968,8099,360,3080,2282,87,0,0,26352,150,14709,12427,8459,8476
2021-10-10 22:00:00+00,6631,0,3966,7905,348,3702,2280,82,0,0,24914,142,14499,12219,8253,6631
2021-10-10 22:30:00+00,5695,0,3966,7922,347,3714,2280,76,0,0,24000,133,14515,12235,8269,5695
2021-10-10 23:00:00+00,4922,0,3969,8185,329,3442,2280,74,0,0,23201,121,14763,12483,8514,4922
2021-10-10 23:30:00+00,4476,0,3972,8270,327,3436,2257,78,0,0,22816,115,14826,12569,8597,4476
2021-10-11 00:00:00+00,4318,0,3972,8250,288,3712,1924,80,0,0,22544,113,14434,12510,8538,4318
2021-10-11 00:30:00+00,4586,0,3968,8025,285,3720,1984,81,0,0,22649,118,14262,12278,8310,4586
2021-10-11 01:00:00+00,4843,0,3971,7506,266,3410,2140,78,0,0,22214,124,13883,11743,7772,4843
2021-10-11 01:30:00+00,4980,0,3969,7382,262,3404,2177,74,0,0,22248,126,13790,11613,7644,4980
2021-10-11 02:00:00+00,5248,0,3966,6916,261,3474,2188,73,0,0,22126,133,13331,11143,7177,5248
2021-10-11 02:30:00+00,5561,0,3967,6513,261,3472,2188,73,0,0,22035,139,12929,10741,6774,5561
2021-10-11 03:00:00+00,5897,0,3961,6401,260,3470,2189,74,0,0,22251,143,12811,10622,6661,5897
2021-10-11 03:30:00+00,6131,0,3959,6449,262,3448,2115,73,0,0,22437,146,12785,10670,6711,6131
2021-10-11 04:00:00+00,6609,0,3962,6390,280,2698,2115,75,0,0,22129,152,12747,10632,6670,6609
2021-10-11 04:30:00+00,7115,0,3960,6151,281,2676,2176,77,0,0,22436,160,12568,10392,6432,7115
2021-10-11 05:00:00+00,8069,0,3962,5991,315,2042,2282,103,0,212,22976,167,12550,10268,6306,8069
2021-10-11 05:30:00+00,9190,0,3965,6052,338,2042,2283,150,0,324,24344,176,12638,10355,6390,9190
2021-10-11 06:00:00+00,10737,79,3959,6037,408,2812,2283,173,0,228,26716,188,12687,10404,6445,10816
2021-10-11 06:30:00+00,12131,268,3962,5859,614,2838,2287,221,119,314,28613,202,12841,10554,6592,12399
2021-10-11 07:00:00+00,13401,441,3962,6043,782,3360,2286,227,649,492,31643,205,13722,11436,7474,13842
2021-10-11 07:30:00+00,14224,464,3965,5667,821,3382,2293,200,1457,630,33104,206,14203,11910,7945,14688
2021-10-11 08:00:00+00,14859,460,3965,5465,804,3372,2289,205,2187,304,33911,208,14710,12421,8456,15319
2021-10-11 08:30:00+00,15344,465,3966,5384,671,3372,2277,184,3002,298,34963,207,15300,13023,9057,15809
2021-10-11 09:00:00+00,15758,476,3963,5255,650,3198,2276,142,3826,212,35756,206,15970,13694,9731,16234
2021-10-11 09:30:00+00,16048,467,3968,5266,644,3164,2282,102,4265,132,36339,205,16425,14143,10175,16515
2021-10-11 10:00:00+00,16331,602,3969,5208,605,2178,2288,111,4608,88,35987,208,16678,14390,10421,16933
2021-10-11 10:30:00+00,16575,607,3967,5526,390,2162,2283,101,4670,0,36281,209,16836,14553,10586,17182
2021-10-11 11:00:00+00,16870,474,3963,5644,367,2480,2274,100,5072,172,37416,203,17320,15046,11083,17344
2021-10-11 11:30:00+00,17079,461,3967,5930,347,2508,2273,99,5425,0,38089,201,17942,15669,11702,17540
2021-10-11 12:00:00+00,16202,460,3964,6037,331,2810,2277,105,5537,0,37723,195,18146,15869,11905,16662
2021-10-11 12:30:00+00,15681,458,3962,5884,332,2818,2273,102,5432,0,36942,193,17883,15610,11648,16139
2021-10-11 13:00:00+00,15567,459,3970,6001,330,2666,2278,99,5250,0,36620,193,17829,15551,11581,16026
2021-10-11 13:30:00+00,15492,458,3962,6168,332,2668,2273,99,4777,0,36229,194,17512,15239,11277,15950
2021-10-11 14:00:00+00,15427,459,3965,6107,336,2938,2265,79,4174,0,35750,198,16847,14582,10617,15886
2021-10-11 14:30:00+00,16457,484,3965,6045,336,2948,2273,80,3323,16,35927,209,15942,13669,9704,16941
2021-10-11 15:00:00+00,17608,691,3968,6054,360,3194,2269,85,2487,36,36752,226,15138,12869,8901,18299
2021-10-11 15:30:00+00,18401,907,3967,6159,560,3200,2270,129,1696,80,37369,236,14652,12382,8415,19308
2021-10-11 16:00:00+00,18732,951,3972,5988,760,3438,2256,304,949,648,37998,239,13925,11669,7697,19683
2021-10-11 16:30:00+00,19004,886,3969,5988,773,3442,2198,525,326,1124,38235,241,13254,11056,7087,19890
2021-10-11 17:00:00+00,19123,882,3972,6189,774,3394,2204,638,9,896,38081,243,13148,10944,6972,20005
2021-10-11 17:30:00+00,19560,726,3966,6291,776,3394,2217,640,0,1488,39058,238,13250,11033,7067,20286
2021-10-11 18:00:00+00,19633,787,3969,5951,774,3442,2209,657,0,1580,39002,241,12903,10694,6725,20420
2021-10-11 18:30:00+00,19009,987,3969,6018,716,3442,2210,602,0,618,37571,248,12913,10703,6734,19996
2021-10-11 19:00:00+00,18616,919,3964,6251,422,3216,2214,361,0,370,36333,246,12851,10637,6673,19535
2021-10-11 19:30:00+00,17912,514,3962,6465,420,3218,2204,92,0,76,34863,235,13051,10847,6885,18426
2021-10-11 20:00:00+00,16340,223,3964,6312,393,3510,2201,73,0,0,33016,225,12870,10669,6705,16563
2021-10-11 20:30:00+00,14106,1,3961,6696,372,3508,2201,72,0,0,30917,205,13230,11029,7068,14107
2021-10-11 21:00:00+00,11679,0,3960,7425,371,3268,2259,77,0,20,29059,185,14015,11756,7796,11679
2021-10-11 21:30:00+00,10135,0,3960,7646,385,3266,2274,75,0,2,27743,172,14265,11991,8031,10135
2021-10-11 22:00:00+00,8554,0,3961,7530,355,3194,2279,76,0,44,25993,155,14125,11846,7885,8554
2021-10-11 22:30:00+00,7297,0,3964,7722,346,3192,2143,73,0,0,24737,142,14175,12032,8068,7297
2021-10-11 23:00:00+00,6680,0,3966,8285,316,3120,1875,73,0,0,24315,135,14442,12567,8601,6680
2021-10-11 23:30:00+00,6270,0,3967,8898,318,3112,1748,73,0,0,24386,128,14931,13183,9216,6270
2021-10-12 00:00:00+00,5958,0,3972,9026,319,3202,2010,82,0,0,24569,129,15327,13317,9345,5958
2021-10-12 00:30:00+00,5830,0,3968,8756,318,3194,2151,83,0,0,24300,129,15193,13042,9074,5830
2021-10-12 01:00:00+00,5599,0,3971,8731,286,3680,2263,86,0,0,24616,125,15251,12988,9017,5599
2021-10-12 01:30:00+00,5514,0,3967,8710,285,3698,2273,86,0,0,24533,124,15235,12962,8995,5514
2021-10-12 02:00:00+00,5216,0,3971,8783,284,3562,2199,78,0,0,24093,120,15237,13038,9067,5216
2021-10-12 02:30:00+00,5234,0,3969,8680,283,3550,2108,79,0,0,23903,121,15040,12932,8963,5234
2021-10-12 03:00:00+00,5475,0,3970,8558,281,3252,2264,78,0,0,23878,125,15073,12809,8839,5475
2021-10-12 03:30:00+00,5520,0,3966,8545,280,3244,2209,78,0,0,23842,126,15000,12791,8825,5520
2021-10-12 04:00:00+00,5923,0,3968,8348,279,2618,2285,74,0,0,23495,132,14880,12595,8627,5923
2021-10-12 04:30:00+00,6958,40,3969,8353,309,2570,2281,74,0,0,24554,144,14912,12631,8662,6998
2021-10-12 05:00:00+00,9082,259,3967,8209,363,2522,2278,76,0,206,26962,172,14817,12539,8572,9341
2021-10-12 05:30:00+00,11846,607,3968,8081,357,2526,2275,75,0,28,29763,203,14681,12406,8438,12453
2021-10-12 06:00:00+00,14999,730,3970,8058,415,2412,2280,77,0,38,32979,224,14723,12443,8473,15729
2021-10-12 06:30:00+00,16940,738,3970,7600,432,2436,2287,90,59,22,34574,236,14348,12061,8091,17678
2021-10-12 07:00:00+00,17777,759,3968,6813,577,2710,2286,87,343,96,35416,240,13987,11701,7733,18536
2021-10-12 07:30:00+00,17817,955,3970,6340,570,2740,2284,174,765,192,35807,244,13929,11645,7675,18772
2021-10-12 08:00:00+00,17825,908,3969,6260,570,3410,2270,231,1343,86,36872,237,14412,12142,8173,18733
2021-10-12 08:30:00+00,17874,909,3973,6443,569,3442,2281,224,2089,0,37804,232,15355,13074,9101,18783
2021-10-12 09:00:00+00,18013,975,3966,6173,603,3290,2292,84,2421,0,37817,232,15455,13163,9197,18988
2021-10-12 09:30:00+00,17710,919,3972,6290,640,3286,2277,74,3267,0,38435,223,16446,14169,10197,18629
2021-10-12 10:00:00+00,17657,937,3969,6094,356,3158,2271,74,3844,0,38360,223,16534,14263,10294,18594
2021-10-12 10:30:00+00,17949,971,3969,5512,354,3150,2277,79,3801,0,38062,229,15913,13636,9667,18920
2021-10-12 11:00:00+00,18350,1007,3968,5184,328,3164,2277,79,3683,214,38254,233,15440,13164,9196,19357
2021-10-12 11:30:00+00,18698,1077,3968,4763,307,3176,2288,79,3656,58,38070,240,14982,12694,8726,19775
2021-10-12 12:00:00+00,18622,950,3967,4350,313,3500,2294,79,3462,116,37653,239,14386,12092,8125,19572
2021-10-12 12:30:00+00,18271,903,3971,4217,316,3516,2368,144,3101,0,36807,241,13973,11605,7634,19174
2021-10-12 13:00:00+00,18159,941,3968,4330,316,3602,2374,139,2775,0,36604,243,13763,11389,7421,19100
2021-10-12 13:30:00+00,18439,984,3973,4394,341,3602,2379,131,2207,14,36464,248,13294,10915,6942,19423
2021-10-12 14:00:00+00,18228,1008,3968,4592,373,3720,2371,183,1898,384,36725,248,13202,10831,6863,19236
2021-10-12 14:30:00+00,18138,1068,3969,4856,490,3720,2345,204,1626,646,37062,246,13286,10941,6972,19206
2021-10-12 15:00:00+00,17813,1156,3967,4864,524,3742,2355,307,1199,1158,37085,245,12909,10554,6587,18969
2021-10-12 15:30:00+00,18639,1093,3971,4676,524,3742,2358,479,716,1346,37544,251,12245,9887,5916,19732
2021-10-12 16:00:00+00,19169,906,3970,4673,788,3742,2390,592,334,1888,38452,248,12155,9765,5795,20075
2021-10-12 16:30:00+00,19857,862,3974,4379,812,3742,2409,599,76,1976,38686,253,11650,9241,5267,20719
2021-10-12 17:00:00+00,20202,1165,3973,3944,829,3742,2415,762,0,1622,38654,265,11161,8746,4773,21367
2021-10-12 17:30:00+00,20374,1220,3975,3918,829,3742,2422,884,0,1590,38954,268,11144,8722,4747,21594
2021-10-12 18:00:00+00,19881,1210,3973,3796,831,3742,2394,805,0,1764,38396,265,10994,8600,4627,21091
2021-10-12 18:30:00+00,19617,991,3972,3672,829,3740,2390,645,0,1814,37670,260,10863,8473,4501,20608
2021-10-12 19:00:00+00,19269,993,3974,3600,574,3742,2397,524,0,1026,36099,266,10545,8148,4174,20262
2021-10-12 19:30:00+00,18631,991,3970,3619,573,3742,2410,339,0,478,34753,267,10572,8162,4192,19622
2021-10-12 20:00:00+00,18027,793,3968,3462,573,3722,2410,285,0,136,33376,265,10413,8003,4035,18820
2021-10-12 20:30:00+00,17010,729,3966,3392,471,3722,2416,236,0,160,32102,260,10245,7829,3863,17739
2021-10-12 21:00:00+00,15797,404,3968,3507,520,3604,2407,121,0,0,30328,246,10402,7995,4027,16201
2021-10-12 21:30:00+00,14700,59,3965,3300,545,3602,2406,88,0,0,28665,233,10216,7810,3845,14759
2021-10-12 22:00:00+00,12857,0,3963,3309,460,3612,2411,85,0,0,26697,221,10143,7732,3769,12857
2021-10-12 22:30:00+00,11570,0,3964,3297,437,3614,2406,80,0,0,25368,213,10104,7698,3734,11570
2021-10-12 23:00:00+00,10756,0,3961,3458,439,3670,2411,79,0,0,24774,207,10269,7858,3897,10756
2021-10-12 23:30:00+00,10419,0,3960,3552,439,3668,2411,81,0,0,24530,204,10362,7951,3991,10419
2021-10-13 00:00:00+00,10430,0,3964,3787,438,3626,2403,83,0,0,24731,204,10592,8189,4225,10430
2021-10-13 00:30:00+00,10302,0,3965,4069,435,3628,2399,85,0,0,24883,201,10868,8469,4504,10302
2021-10-13 01:00:00+00,9894,0,3963,4315,418,3716,2401,90,0,0,24797,196,11097,8696,4733,9894
2021-10-13 01:30:00+00,9582,0,3969,4498,418,3718,2398,92,0,0,24675,192,11283,8885,4916,9582
2021-10-13 02:00:00+00,9438,0,3968,4624,419,3576,2400,89,0,0,24514,188,11411,9011,5043,9438
2021-10-13 02:30:00+00,9443,0,3971,4734,419,3566,2405,89,0,0,24627,188,11529,9124,5153,9443
2021-10-13 03:00:00+00,9400,0,3973,4872,419,3436,2394,89,0,0,24583,188,11658,9264,5291,9400
2021-10-13 03:30:00+00,9258,0,3970,4955,407,3426,2409,89,0,0,24514,186,11741,9332,5362,9258
2021-10-13 04:00:00+00,9694,0,3967,5038,397,2586,2401,79,0,0,24162,192,11803,9402,5435,9694
2021-10-13 04:30:00+00,10565,0,3970,4952,421,2532,2409,79,0,0,24928,200,11752,9343,5373,10565
2021-10-13 05:00:00+00,13769,4,3969,5087,463,1720,2406,81,0,0,27499,222,11925,9519,5550,13773
2021-10-13 05:30:00+00,15838,164,3973,5302,462,1700,2396,184,0,0,30019,236,12133,9737,5764,16002
2021-10-13 06:00:00+00,17096,410,3971,5217,479,3112,2402,158,0,0,32845,240,12069,9667,5696,17506
2021-10-13 06:30:00+00,17846,615,3970,5166,519,3172,2385,288,35,0,33996,248,12075,9690,5720,18461
2021-10-13 07:00:00+00,17973,501,3973,5235,525,3446,2411,373,362,382,35181,240,12506,10095,6122,18474
2021-10-13 07:30:00+00,17662,459,3970,5609,492,3452,2408,372,1077,542,36043,230,13556,11148,7178,18121
2021-10-13 08:00:00+00,17943,462,3971,5806,515,3352,2410,358,1607,292,36716,228,14309,11899,7928,18405
2021-10-13 08:30:00+00,17823,462,3974,5977,538,3352,2404,305,2007,288,37130,223,14900,12496,8522,18285
2021-10-13 09:00:00+00,17735,459,3971,6187,527,3714,2407,194,2584,6,37784,222,15676,13269,9298,18194
2021-10-13 09:30:00+00,17384,459,3974,6404,525,3722,2407,97,3087,0,38059,216,16397,13990,10016,17843
2021-10-13 10:00:00+00,16926,465,3970,6585,439,3706,2401,82,3607,20,38201,211,17002,14601,10631,17391
2021-10-13 10:30:00+00,16568,459,3973,6803,391,3704,2383,87,3916,0,38284,206,17466,15083,11110,17027
2021-10-13 11:00:00+00,17072,420,3967,6531,349,3630,2380,83,3823,12,38267,210,17050,14670,10703,17492
2021-10-13 11:30:00+00,17404,237,3968,6372,348,3632,2375,83,3848,18,38285,209,16911,14536,10568,17641
2021-10-13 12:00:00+00,17172,234,3966,6314,336,3520,2362,99,3435,0,37438,212,16413,14051,10085,17406
2021-10-13 12:30:00+00,16776,242,3962,6310,337,3514,2402,100,3248,22,36913,211,16259,13857,9895,17018
2021-10-13 13:00:00+00,17455,238,3960,6216,337,3322,2394,93,3030,76,37121,212,15937,13543,9583,17693
2021-10-13 13:30:00+00,17042,230,3963,6502,337,3320,2405,109,2532,0,36440,211,15739,13334,9371,17272
2021-10-13 14:00:00+00,17793,236,3959,6526,355,3360,2413,95,2000,0,36737,218,15253,12840,8881,18029
2021-10-13 14:30:00+00,18158,246,3962,6370,450,3360,2413,210,1397,72,36638,224,14592,12179,8217,18404
2021-10-13 15:00:00+00,18368,304,3960,6584,513,3324,2416,338,1074,376,37257,224,14547,12131,8171,18672
2021-10-13 15:30:00+00,18520,369,3961,6811,576,3324,2413,329,660,472,37435,227,14421,12008,8047,18889
2021-10-13 16:00:00+00,18863,474,3960,6525,816,3334,2439,340,296,1564,38611,226,14036,11597,7637,19337
2021-10-13 16:30:00+00,19307,493,3967,6309,861,3336,2454,513,92,1222,38554,234,13683,11229,7262,19800
2021-10-13 17:00:00+00,19459,492,3966,6092,864,3342,2452,665,0,1374,38706,236,13374,10922,6956,19951
2021-10-13 17:30:00+00,19474,497,3968,6166,865,3348,2452,707,0,1614,39091,234,13451,10999,7031,19971
2021-10-13 18:00:00+00,19365,498,3969,6250,861,3732,2432,588,0,1252,38947,237,13512,11080,7111,19863
2021-10-13 18:30:00+00,18754,494,3971,6769,677,3740,2417,504,0,836,38162,234,13834,11417,7446,19248
2021-10-13 19:00:00+00,18497,499,3967,6801,515,3732,2417,188,0,386,37002,236,13700,11283,7316,18996
2021-10-13 19:30:00+00,17157,384,3970,7064,495,3718,2414,92,0,0,35294,228,13943,11529,7559,17541
2021-10-13 20:00:00+00,16055,232,3969,7282,468,3032,2417,83,0,8,33546,216,14136,11719,7750,16287
2021-10-13 20:30:00+00,14303,0,3966,7635,467,3014,2417,104,0,0,31906,198,14485,12068,8102,14303
2021-10-13 21:00:00+00,13123,0,3968,7630,467,2510,2404,124,0,0,30226,190,14469,12065,8097,13123
2021-10-13 21:30:00+00,11428,0,3964,7557,446,2504,2405,129,0,0,28433,178,14372,11967,8003,11428
2021-10-13 22:00:00+00,8618,0,3966,7578,446,3734,2401,125,0,0,26868,163,14391,11990,8024,8618
2021-10-13 22:30:00+00,7034,0,3965,7456,446,3854,2420,124,0,0,25299,150,14287,11867,7902,7034
2021-10-13 23:00:00+00,6551,0,3969,7293,436,3718,2416,126,0,0,24509,146,14114,11698,7729,6551
2021-10-13 23:30:00+00,6182,0,3966,7487,436,3640,2414,126,0,0,24251,140,14303,11889,7923,6182
2021-10-14 00:00:00+00,6198,0,3970,7570,436,3906,2402,124,0,0,24606,141,14378,11976,8006,6198
2021-10-14 00:30:00+00,6079,0,3967,7630,436,3984,2414,126,0,0,24636,140,14447,12033,8066,6079
2021-10-14 01:00:00+00,6058,0,3973,7619,416,3934,2401,125,0,0,24526,139,14409,12008,8035,6058
2021-10-14 01:30:00+00,5942,0,3972,7680,416,3804,2388,124,0,0,24326,136,14456,12068,8096,5942
2021-10-14 02:00:00+00,5923,0,3971,7754,415,3646,2403,126,0,0,24238,134,14543,12140,8169,5923
2021-10-14 02:30:00+00,5357,0,3974,8167,413,3636,2398,129,0,0,24074,126,14952,12554,8580,5357
2021-10-14 03:00:00+00,5406,0,3972,8391,413,3172,2409,126,0,0,23889,126,15185,12776,8804,5406
2021-10-14 03:30:00+00,5328,0,3971,8546,390,3136,2410,129,0,0,23910,124,15317,12907,8936,5328
2021-10-14 04:00:00+00,6168,0,3970,8458,383,2558,2392,123,0,0,24052,139,15203,12811,8841,6168
2021-10-14 04:30:00+00,6733,0,3970,8707,395,2806,2381,123,0,0,25115,147,15453,13072,9102,6733
2021-10-14 05:00:00+00,8502,0,3967,9284,518,2404,2369,122,0,0,27166,160,16138,13769,9802,8502
2021-10-14 05:30:00+00,10634,0,3967,9692,518,2350,2380,127,0,26,29694,174,16557,14177,10210,10634
2021-10-14 06:00:00+00,12133,0,3967,9830,467,3490,2342,137,0,0,32366,177,16606,14264,10297,12133
2021-10-14 06:30:00+00,13397,0,3968,9753,543,3526,2292,171,30,172,33852,183,16586,14294,10326,13397
2021-10-14 07:00:00+00,13889,0,3970,9933,544,3650,2259,315,275,72,34907,184,16981,14722,10752,13889
2021-10-14 07:30:00+00,14063,0,3970,10065,536,3660,2270,336,704,0,35604,182,17545,15275,11305,14063
2021-10-14 08:00:00+00,13957,0,3969,10433,519,3532,2319,270,1379,16,36394,175,18619,16300,12331,13957
2021-10-14 08:30:00+00,13522,0,3964,10847,476,3530,2325,216,1867,0,36747,169,19479,17154,13190,13522
2021-10-14 09:00:00+00,12912,0,3961,11401,457,3584,2341,133,2414,0,37203,161,20574,18233,14272,12912
2021-10-14 09:30:00+00,12238,0,3966,11890,446,3584,2349,123,2750,0,37346,154,21401,19052,15086,12238
2021-10-14 10:00:00+00,11755,0,3965,12050,387,3054,2351,124,3080,20,36786,150,21833,19482,15517,11755
2021-10-14 10:30:00+00,11093,0,3965,13008,360,3052,2363,119,3201,0,37161,141,22897,20534,16569,11093
2021-10-14 11:00:00+00,10949,0,3967,13130,313,3390,2348,124,3393,0,37614,139,23151,20803,16836,10949
2021-10-14 11:30:00+00,10595,0,3965,13408,305,3400,2361,124,3319,0,37477,135,23358,20997,17032,10595
2021-10-14 12:00:00+00,9998,0,3969,13649,305,3610,2353,124,3185,0,37193,131,23461,21108,17139,9998
2021-10-14 12:30:00+00,9391,0,3969,14082,316,3608,2350,125,3115,0,36956,125,23832,21482,17513,9391
2021-10-14 13:00:00+00,9205,0,3964,14239,317,3470,2362,128,2940,134,36759,122,23822,21460,17496,9205
2021-10-14 13:30:00+00,9330,0,3968,14529,307,3472,2319,125,2708,0,36758,123,23831,21512,17544,9330
2021-10-14 14:00:00+00,9631,0,3964,14624,301,3228,2343,130,2085,0,36306,127,23317,20974,17010,9631
2021-10-14 14:30:00+00,10182,0,3963,14452,360,3224,2355,132,1663,0,36331,133,22793,20438,16475,10182
2021-10-14 15:00:00+00,11321,0,3960,14347,407,2972,2367,174,1232,0,36780,144,22313,19946,15986,11321
2021-10-14 15:30:00+00,12636,0,3955,14312,453,2962,2369,305,797,0,37789,155,21886,19517,15562,12636
2021-10-14 16:00:00+00,13462,0,3960,14174,644,2954,2365,384,357,0,38300,160,21500,19135,15175,13462
2021-10-14 16:30:00+00,14089,0,3953,13807,655,2968,2370,315,68,464,38689,164,20853,18483,14530,14089
2021-10-14 17:00:00+00,13994,0,3959,13815,635,3402,2368,249,0,644,39066,162,20777,18409,14450,13994
2021-10-14 17:30:00+00,13877,0,3959,13591,630,3414,2365,386,0,1050,39272,161,20545,18180,14221,13877
2021-10-14 18:00:00+00,13991,0,3965,13104,631,3160,2370,411,0,982,38614,164,20070,17700,13735,13991
2021-10-14 18:30:00+00,13893,0,3970,12920,624,3160,2376,295,0,650,37888,165,19890,17514,13544,13893
2021-10-14 19:00:00+00,13452,0,3967,13088,537,3230,2377,158,0,0,36809,165,19969,17592,13625,13452
2021-10-14 19:30:00+00,12270,0,3966,12725,536,3230,2377,124,0,200,35428,158,19604,17227,13261,12270
2021-10-14 20:00:00+00,11142,0,3967,12759,450,3176,2370,124,0,0,33988,152,19546,17176,13209,11142
2021-10-14 20:30:00+00,9696,0,3969,12632,433,3134,2367,122,0,0,32353,142,19401,17034,13065,9696
2021-10-14 21:00:00+00,8373,0,3966,12751,397,2474,2362,121,0,0,30444,133,19476,17114,13148,8373
2021-10-14 21:30:00+00,6649,0,3962,12996,382,2470,2355,121,0,0,28935,117,19695,17340,13378,6649
2021-10-14 22:00:00+00,5169,0,3964,12960,364,3022,2362,122,0,0,27963,97,19650,17288,13324,5169
2021-10-14 22:30:00+00,4193,0,3963,12830,349,3066,2335,124,0,0,26860,86,19477,17142,13179,4193
2021-10-14 23:00:00+00,3583,0,3965,12485,319,3122,2343,123,0,0,25940,85,19112,16769,12804,3583
2021-10-14 23:30:00+00,3508,0,3964,12359,320,3122,2105,121,0,0,25499,84,18748,16643,12679,3508
2021-10-15 00:00:00+00,3476,0,3965,12019,320,3434,2096,121,0,0,25431,88,18400,16304,12339,3476
2021-10-15 00:30:00+00,3728,0,3965,11526,318,3442,2131,123,0,0,25233,93,17940,15809,11844,3728
2021-10-15 01:00:00+00,3768,0,3968,11267,282,3522,2263,128,0,0,25198,95,17780,15517,11549,3768
2021-10-15 01:30:00+00,3737,0,3969,10941,281,3526,2162,130,0,0,24746,95,17353,15191,11222,3737
2021-10-15 02:00:00+00,3670,0,3969,10149,280,3528,2282,129,0,0,24007,98,16680,14398,10429,3670
2021-10-15 02:30:00+00,4152,0,3970,9611,279,3526,2309,131,0,0,23978,106,16169,13860,9890,4152
2021-10-15 03:00:00+00,4637,1,3971,9135,280,3286,2381,131,0,0,23822,111,15767,13386,9415,4638
2021-10-15 03:30:00+00,4979,76,3972,8857,292,3286,2312,131,0,0,23905,119,15433,13121,9149,5055
2021-10-15 04:00:00+00,4857,322,3969,8407,325,3154,2269,122,0,0,23425,128,14970,12701,8732,5179
2021-10-15 04:30:00+00,5585,629,3971,8106,324,3152,2346,123,0,0,24236,148,14747,12401,8430,6214
2021-10-15 05:00:00+00,9060,899,3967,7634,363,2260,2394,122,0,0,26699,191,14358,11964,7997,9959
2021-10-15 05:30:00+00,12403,1195,3964,7229,391,2260,2374,120,0,8,29944,223,13958,11584,7620,13598
2021-10-15 06:00:00+00,15992,1218,3963,6652,440,2330,2386,123,0,356,33460,245,13441,11055,7092,17210
2021-10-15 06:30:00+00,17784,1394,3961,6224,472,2330,2398,134,14,282,34993,259,13069,10671,6710,19178
2021-10-15 07:00:00+00,17864,1483,3961,5999,504,3034,2401,138,256,210,35850,255,13121,10720,6759,19347
2021-10-15 07:30:00+00,18105,1495,3962,5735,543,3158,2404,163,959,142,36666,253,13603,11199,7237,19600
2021-10-15 08:00:00+00,18623,1495,3962,5381,547,3472,2402,245,1807,142,38076,252,14099,11697,7735,20118
2021-10-15 08:30:00+00,18846,1493,3961,4839,546,3474,2373,360,2499,34,38425,253,14218,11845,7884,20339
2021-10-15 09:00:00+00,18970,1492,3964,4638,460,2876,2382,429,3243,0,38454,253,14687,12305,8341,20462
2021-10-15 09:30:00+00,18840,1441,3962,4175,433,2838,2393,420,3888,0,38390,251,14851,12458,8496,20281
2021-10-15 10:00:00+00,18687,1178,3965,3872,386,3052,2399,393,4338,0,38270,245,14960,12561,8596,19865
2021-10-15 10:30:00+00,18588,1343,3968,3633,377,3024,2402,169,4774,0,38278,246,15154,12752,8784,19931
2021-10-15 11:00:00+00,18887,1497,3966,3511,363,2514,2400,177,4894,0,38209,251,15134,12734,8768,20384
2021-10-15 11:30:00+00,18974,1387,3966,3328,359,2496,2402,214,4826,0,37952,251,14881,12479,8513,20361
2021-10-15 12:00:00+00,18459,1229,3966,3180,343,2952,2394,157,4805,0,37485,245,14688,12294,8328,19688
2021-10-15 12:30:00+00,18144,1233,3966,3041,347,2976,2376,121,4475,0,36679,247,14205,11829,7863,19377
2021-10-15 13:00:00+00,17996,1233,3965,3035,349,3148,2376,118,3971,0,36191,248,13696,11320,7355,19229
2021-10-15 13:30:00+00,17893,1228,3964,2879,359,3186,2395,117,3279,0,35300,253,12876,10481,6517,19121
2021-10-15 14:00:00+00,17894,1072,3966,2929,380,3462,2391,116,2766,0,34976,254,12432,10041,6075,18966
2021-10-15 14:30:00+00,18230,1050,3963,2853,396,3474,2396,129,2558,0,35049,256,12166,9770,5807,19280
2021-10-15 15:00:00+00,18554,1046,3963,2716,615,3412,2398,358,1984,254,35300,260,11676,9278,5315,19600
2021-10-15 15:30:00+00,18966,1041,3966,2583,702,3416,2398,460,1312,812,35656,262,10961,8563,4597,20007
2021-10-15 16:00:00+00,19170,1036,3966,2249,938,3586,2402,627,593,1600,36167,264,10148,7746,3780,20206
2021-10-15 16:30:00+00,19863,1012,3968,2053,951,3588,2401,687,108,1668,36299,273,9481,7080,3112,20875
2021-10-15 17:00:00+00,20160,997,3966,1987,950,3734,2401,1005,0,1594,36794,276,9304,6903,2937,21157
2021-10-15 17:30:00+00,20399,1016,3969,1856,948,3738,2390,1168,0,1908,37392,276,9163,6773,2804,21415
2021-10-15 18:00:00+00,20388,1009,3967,1860,940,3736,2397,1034,0,1886,37217,276,9164,6767,2800,21397
2021-10-15 18:30:00+00,20327,1004,3969,1912,829,3738,2397,602,0,1386,36164,280,9107,6710,2741,21331
2021-10-15 19:00:00+00,19800,1110,3973,1898,714,3738,2396,325,0,966,34920,284,8981,6585,2612,20910
2021-10-15 19:30:00+00,19256,1130,3969,1870,736,3738,2399,345,0,250,33693,286,8974,6575,2606,20386
2021-10-15 20:00:00+00,19267,842,3969,1917,536,3714,2399,165,0,48,32857,284,8821,6422,2453,20109
2021-10-15 20:30:00+00,18374,454,3966,1825,482,3696,2396,114,0,64,31371,274,8669,6273,2307,18828
2021-10-15 21:00:00+00,17721,240,3967,1834,441,2848,2393,115,0,0,29559,270,8635,6242,2275,17961
2021-10-15 21:30:00+00,16445,0,3962,1866,422,2858,2397,128,0,0,28078,258,8647,6250,2288,16445
2021-10-15 22:00:00+00,14232,0,3960,1845,383,3542,2397,119,0,0,26478,245,8585,6188,2228,14232
2021-10-15 22:30:00+00,13204,0,3962,1766,362,3562,2396,119,0,0,25371,240,8486,6090,2128,13204
2021-10-15 23:00:00+00,12533,0,3959,1714,302,3532,2356,117,0,0,24513,237,8331,5975,2016,12533
2021-10-15 23:30:00+00,11912,0,3990,1729,296,3534,2356,115,0,0,23932,232,8371,6015,2025,11912
2021-10-16 00:00:00+00,11426,0,3994,1665,296,3652,2354,118,0,0,23505,234,8309,5955,1961,11426
2021-10-16 00:30:00+00,11407,0,3994,1747,291,3654,2354,114,0,0,23561,233,8386,6032,2038,11407
2021-10-16 01:00:00+00,11139,0,4000,1813,256,3600,2358,115,0,0,23281,231,8427,6069,2069,11139
2021-10-16 01:30:00+00,10867,0,4017,1692,255,3598,2357,126,0,0,22912,230,8321,5964,1947,10867
2021-10-16 02:00:00+00,10719,0,4025,1691,252,3566,2331,125,0,0,22709,229,8299,5968,1943,10719
2021-10-16 02:30:00+00,10733,0,4028,1801,252,3581,2046,125,0,0,22565,230,8127,6081,2053,10733
2021-10-16 03:00:00+00,10581,0,4029,1897,251,3521,1710,126,0,0,22115,227,7887,6177,2148,10581
2021-10-16 03:30:00+00,10489,0,4053,2004,251,3534,1708,116,0,0,22155,225,8016,6308,2255,10489
2021-10-16 04:00:00+00,10546,0,4076,2002,280,3469,1711,102,0,0,22185,224,8069,6358,2282,10546
2021-10-16 04:30:00+00,11029,0,4073,2042,293,3479,1711,90,0,0,22717,228,8119,6408,2335,11029
2021-10-16 05:00:00+00,12288,0,4075,2074,363,3280,1749,82,0,0,23911,236,8261,6512,2437,12288
2021-10-16 05:30:00+00,13334,0,4072,2186,365,3288,1753,78,0,0,25076,242,8376,6623,2551,13334
2021-10-16 06:00:00+00,14833,0,4070,2318,402,3135,1753,88,0,102,26701,249,8543,6790,2720,14833
2021-10-16 06:30:00+00,15922,0,4070,2524,436,3086,1751,177,14,0,27980,253,8795,7044,2974,15922
2021-10-16 07:00:00+00,17032,0,4068,2715,445,3310,1753,90,177,126,29716,253,9158,7405,3337,17032
2021-10-16 07:30:00+00,17546,7,4088,2840,449,3320,1753,90,569,426,31088,249,9699,7946,3858,17553
2021-10-16 08:00:00+00,17899,14,4091,2903,583,3544,1743,110,1256,212,32355,247,10576,8833,4742,17913
2021-10-16 08:30:00+00,17760,194,4087,2984,608,3588,1755,121,1669,232,32998,246,11103,9348,5261,17954
2021-10-16 09:00:00+00,17816,281,4111,3068,590,3594,1752,111,2078,252,33653,244,11599,9847,5736,18097
2021-10-16 09:30:00+00,17662,234,4124,3186,581,3564,1752,93,2574,140,33910,239,12217,10465,6341,17896
2021-10-16 10:00:00+00,17506,247,4124,3338,442,3710,1751,86,2991,0,34195,235,12646,10895,6771,17753
2021-10-16 10:30:00+00,16965,234,4124,3426,426,3748,1751,85,3330,42,34131,230,13057,11306,7182,17199
2021-10-16 11:00:00+00,17093,282,4125,3096,329,3718,1750,87,3741,82,34303,231,13041,11291,7166,17375
2021-10-16 11:30:00+00,17129,330,4128,2870,314,3718,1749,82,3704,24,34048,234,12765,11016,6888,17459
2021-10-16 12:00:00+00,16705,235,4132,2796,275,3718,1746,83,3841,0,33531,230,12790,11044,6912,16940
2021-10-16 12:30:00+00,16380,232,4130,2586,258,3716,1745,79,3909,0,33035,230,12628,10883,6753,16612
2021-10-16 13:00:00+00,16089,233,4129,2452,256,3718,1746,90,3383,0,32096,233,11966,10220,6091,16322
2021-10-16 13:30:00+00,16060,240,4128,2417,259,3716,1748,106,3088,0,31762,235,11640,9892,5764,16300
2021-10-16 14:00:00+00,16280,308,4125,2364,304,3560,1748,137,2705,196,31727,238,11246,9498,5373,16588
2021-10-16 14:30:00+00,16461,497,4174,2131,401,3620,1749,183,1995,170,31381,250,10450,8701,4527,16958
2021-10-16 15:00:00+00,17214,677,4204,2039,592,3286,1748,189,1490,200,31639,262,10073,8325,4121,17891
2021-10-16 15:30:00+00,17540,1000,4207,2058,652,3494,1749,196,937,514,32347,273,9603,7854,3647,18540
2021-10-16 16:00:00+00,17269,1294,4209,2232,735,4206,1746,270,480,1000,33441,275,9402,7656,3447,18563
2021-10-16 16:30:00+00,17468,1472,4210,2415,738,4218,1742,411,93,1262,34029,279,9198,7456,3246,18940
2021-10-16 17:00:00+00,17927,1490,4213,2570,738,4218,1856,561,0,1458,35031,279,9377,7521,3308,19417
2021-10-16 17:30:00+00,17907,1488,4214,2765,786,4216,2065,604,0,1446,35491,276,9830,7765,3551,19395
2021-10-16 18:00:00+00,17921,1489,4211,3047,761,4012,2116,512,0,892,34961,276,10135,8019,3808,19410
2021-10-16 18:30:00+00,17393,1444,4212,3444,755,3888,2195,163,0,274,33768,274,10606,8411,4199,18837
2021-10-16 19:00:00+00,16409,1149,4215,4098,672,3718,2292,85,0,0,32638,263,11277,8985,4770,17558
2021-10-16 19:30:00+00,15760,875,4212,4548,563,3004,2387,83,0,116,31548,255,11710,9323,5111,16635
2021-10-16 20:00:00+00,14489,841,4219,4931,418,3152,2394,79,0,0,30523,247,11962,9568,5349,15330
2021-10-16 20:30:00+00,13445,487,4213,5179,414,3184,2391,84,0,0,29397,232,12197,9806,5593,13932
2021-10-16 21:00:00+00,12697,125,4221,5881,365,2182,2389,104,0,0,27964,215,12856,10467,6246,12822
2021-10-16 21:30:00+00,11209,0,4219,6246,363,2190,2380,114,0,0,26721,199,13208,10828,6609,11209
2021-10-16 22:00:00+00,8587,0,4216,6410,361,3304,2310,119,0,0,25307,178,13297,10987,6771,8587
2021-10-16 22:30:00+00,7142,0,4218,6470,346,3358,2285,120,0,0,23939,165,13319,11034,6816,7142
2021-10-16 23:00:00+00,6004,0,4214,6417,302,3844,2172,116,0,0,23069,152,13105,10933,6719,6004
2021-10-16 23:30:00+00,5365,0,4213,6539,300,4042,2134,117,0,0,22710,143,13186,11052,6839,5365
2021-10-17 00:00:00+00,5197,0,4208,6624,298,4178,2179,117,0,0,22801,140,13309,11130,6922,5197
2021-10-17 00:30:00+00,5257,0,4202,6682,295,4194,2198,159,0,0,22987,141,13377,11179,6977,5257
2021-10-17 01:00:00+00,5237,0,4205,6851,293,4012,2050,162,0,0,22810,139,13399,11349,7144,5237
2021-10-17 01:30:00+00,5072,0,4217,7040,292,3890,1910,127,0,0,22548,134,13459,11549,7332,5072
2021-10-17 02:00:00+00,4817,0,4260,7168,289,3574,1944,123,0,0,22175,127,13661,11717,7457,4817
2021-10-17 02:30:00+00,4739,0,4289,7100,287,3460,2061,122,0,0,22058,125,13737,11676,7387,4739
2021-10-17 03:00:00+00,4868,0,4314,7228,286,2944,2127,122,0,0,21889,121,13955,11828,7514,4868
2021-10-17 03:30:00+00,4695,0,4311,7277,285,2934,2086,122,0,0,21710,118,13959,11873,7562,4695
2021-10-17 04:00:00+00,4916,0,4307,7126,286,2790,2162,120,0,0,21707,119,13881,11719,7412,4916
2021-10-17 04:30:00+00,5058,0,4316,7070,303,2792,2184,119,0,0,21842,121,13873,11689,7373,5058
2021-10-17 05:00:00+00,5233,0,4309,7113,319,3134,2244,117,0,0,22469,126,13985,11741,7432,5233
2021-10-17 05:30:00+00,5763,0,4312,7215,329,3360,2189,122,0,0,23290,135,14045,11856,7544,5763
2021-10-17 06:00:00+00,5609,0,4310,7569,385,3762,2054,118,0,0,23807,132,14318,12264,7954,5609
2021-10-17 06:30:00+00,6118,0,4307,7624,388,3718,2187,116,5,0,24463,136,14511,12324,8017,6118
2021-10-17 07:00:00+00,7447,0,4309,7813,416,3530,2354,115,62,0,26046,148,14954,12600,8291,7447
2021-10-17 07:30:00+00,8846,0,4306,7797,417,3524,2335,118,208,16,27567,160,15063,12728,8422,8846
2021-10-17 08:00:00+00,10341,0,4307,7897,474,3610,2335,117,407,20,29508,168,15420,13085,8778,10341
2021-10-17 08:30:00+00,10977,0,4307,8074,497,3616,2337,117,613,68,30606,170,15828,13491,9184,10977
2021-10-17 09:00:00+00,11563,0,4307,8252,475,3616,2336,117,918,92,31676,172,16288,13952,9645,11563
2021-10-17 09:30:00+00,11800,0,4306,8392,501,3616,2281,117,1262,0,32275,171,16742,14461,10155,11800
2021-10-17 10:00:00+00,12247,0,4306,8248,541,3310,2275,121,1694,24,32766,169,17064,14789,10483,12247
2021-10-17 10:30:00+00,12170,0,4308,8244,524,3306,2308,126,2350,0,33336,166,17734,15426,11118,12170
2021-10-17 11:00:00+00,11995,0,4308,8116,647,3498,2339,130,2648,0,33681,165,18058,15719,11411,11995
2021-10-17 11:30:00+00,11901,0,4314,8175,654,3498,2346,129,2843,0,33860,163,18332,15986,11672,11901
2021-10-17 12:00:00+00,11306,0,4311,8181,610,3574,2350,124,2929,0,33385,159,18381,16031,11720,11306
2021-10-17 12:30:00+00,11140,0,4316,7883,612,3574,2349,122,2949,0,32945,159,18109,15760,11444,11140
2021-10-17 13:00:00+00,11433,0,4315,7713,571,3574,2345,120,2919,0,32990,163,17863,15518,11203,11433
2021-10-17 13:30:00+00,11195,0,4318,7810,571,3574,2339,120,2853,0,32780,161,17891,15552,11234,11195
2021-10-17 14:00:00+00,11608,0,4316,7837,572,3574,2347,122,2450,0,32826,166,17522,15175,10859,11608
2021-10-17 14:30:00+00,12405,82,4312,7582,577,3572,2343,116,2082,0,33071,176,16896,14553,10241,12487
2021-10-17 15:00:00+00,13613,300,4307,7251,675,3538,2350,124,1646,0,33804,192,16229,13879,9572,13913
2021-10-17 15:30:00+00,14759,683,4307,7068,676,3536,2349,124,1102,0,34604,211,15502,13153,8846,15442
2021-10-17 16:00:00+00,15539,1160,4308,6820,753,3534,2347,183,478,0,35122,230,14706,12359,8051,16699
2021-10-17 16:30:00+00,15610,1099,4310,6654,771,3534,2355,292,53,698,35376,228,14143,11788,7478,16709
2021-10-17 17:00:00+00,15794,915,4306,6724,768,3478,2366,501,0,1066,35918,223,14164,11798,7492,16709
2021-10-17 17:30:00+00,15392,910,4304,6842,766,3478,2384,525,0,1586,36187,217,14296,11912,7608,16302
2021-10-17 18:00:00+00,15199,1209,4305,6676,757,3442,2385,424,0,1002,35399,226,14123,11738,7433,16408
2021-10-17 18:30:00+00,15192,1216,4307,6439,770,3440,2389,426,0,368,34547,232,13905,11516,7209,16408
2021-10-17 19:00:00+00,15394,1200,4306,6088,696,3318,2385,181,0,10,33578,237,13475,11090,6784,16594
2021-10-17 19:30:00+00,14431,1054,4309,6199,627,3316,2379,121,0,0,32436,229,13514,11135,6826,15485
2021-10-17 20:00:00+00,12992,972,4307,6401,562,3122,2376,117,0,52,30901,220,13646,11270,6963,13964
2021-10-17 20:30:00+00,11410,597,4330,6377,557,3118,2385,127,0,58,28959,201,13649,11264,6934,12007
2021-10-17 21:00:00+00,10109,260,4405,6326,502,3332,2386,128,0,64,27512,183,13619,11233,6828,10369
2021-10-17 21:30:00+00,9037,0,4407,6304,532,3334,2374,128,0,18,26134,167,13617,11243,6836,9037
2021-10-17 22:00:00+00,7430,0,4414,6537,529,3406,2385,118,0,0,24819,149,13865,11480,7066,7430
2021-10-17 22:30:00+00,6367,0,4409,6900,512,3634,2255,116,0,0,24193,139,14076,11821,7412,6367
2021-10-17 23:00:00+00,6098,0,4402,6861,431,3838,1849,83,0,0,23562,141,13543,11694,7292,6098
2021-10-17 23:30:00+00,5729,0,4447,6870,427,3864,1840,79,0,0,23256,137,13584,11744,7297,5729
2021-10-18 00:00:00+00,5375,0,4501,6848,427,3974,1935,85,0,0,23145,139,13711,11776,7275,5375
2021-10-18 00:30:00+00,5301,0,4506,6703,426,4096,1965,103,0,0,23100,140,13600,11635,7129,5301
2021-10-18 01:00:00+00,5220,0,4507,6608,393,4372,2056,119,0,0,23275,139,13564,11508,7001,5220
2021-10-18 01:30:00+00,5155,0,4504,6373,325,4396,2083,131,0,0,22967,141,13285,11202,6698,5155
2021-10-18 02:00:00+00,5224,0,4523,6166,324,4318,2116,134,0,0,22805,144,13129,11013,6490,5224
2021-10-18 02:30:00+00,5266,0,4546,6293,322,4212,1896,132,0,0,22667,143,13057,11161,6615,5266
2021-10-18 03:00:00+00,5886,0,4547,6308,320,3356,1984,133,0,0,22534,152,13159,11175,6628,5886
2021-10-18 03:30:00+00,5872,0,4549,6567,308,3324,2152,122,0,0,22894,150,13576,11424,6875,5872
2021-10-18 04:00:00+00,6772,0,4545,6814,389,2380,1964,119,0,0,22983,155,13712,11748,7203,6772
2021-10-18 04:30:00+00,7317,0,4548,6819,416,2360,2066,116,0,0,23642,160,13849,11783,7235,7317
2021-10-18 05:00:00+00,9393,0,4548,7004,562,2168,2376,357,0,0,26408,174,14490,12114,7566,9393
2021-10-18 05:30:00+00,10804,0,4547,7436,607,2088,2405,585,0,0,28472,182,14995,12590,8043,10804
2021-10-18 06:00:00+00,12479,0,4546,7805,603,2852,2395,571,0,452,31703,190,15349,12954,8408,12479
2021-10-18 06:30:00+00,13216,0,4551,8187,656,2954,2403,582,6,0,32555,194,15803,13400,8849,13216
2021-10-18 07:00:00+00,13952,0,4544,8730,676,4102,2415,515,82,222,35238,191,16447,14032,9488,13952
2021-10-18 07:30:00+00,14329,0,4547,9054,676,4148,2418,469,224,116,35981,191,16919,14501,9954,14329
2021-10-18 08:00:00+00,14709,0,4547,9849,712,3778,2418,473,441,4,36931,186,17967,15549,11002,14709
2021-10-18 08:30:00+00,14288,0,4547,10641,691,3620,2415,454,667,0,37323,177,18961,16546,11999,14288
2021-10-18 09:00:00+00,14345,0,4548,11116,745,3418,2413,213,884,96,37778,175,19706,17293,12745,14345
2021-10-18 09:30:00+00,14478,0,4551,11528,624,3290,2413,119,1008,0,38011,173,20124,17711,13160,14478
2021-10-18 10:00:00+00,13943,0,4551,11850,579,3594,2390,116,1222,12,38257,168,20592,18202,13651,13943
2021-10-18 10:30:00+00,13474,0,4548,12303,585,3718,2404,131,1440,0,38603,163,21280,18876,14328,13474
2021-10-18 11:00:00+00,13371,0,4543,12648,519,3778,2416,136,1335,38,38784,161,21461,19045,14502,13371
2021-10-18 11:30:00+00,13150,0,4544,12899,516,3680,2415,134,1554,28,38920,157,21928,19513,14969,13150
2021-10-18 12:00:00+00,13256,0,4534,12702,503,3402,2410,136,1200,212,38355,160,21349,18939,14405,13256
2021-10-18 12:30:00+00,13175,0,4542,12738,509,3396,2397,136,894,222,38009,160,21080,18683,14141,13175
2021-10-18 13:00:00+00,13224,0,4548,12780,510,3386,2407,137,709,0,37701,162,20954,18547,13999,13224
2021-10-18 13:30:00+00,13414,0,4553,12372,505,3360,2411,136,628,128,37507,165,20469,18058,13505,13414
2021-10-18 14:00:00+00,14169,0,4557,12128,430,2720,2401,137,539,148,37229,172,20055,17654,13097,14169
2021-10-18 14:30:00+00,14611,0,4558,12154,437,2728,2397,143,425,172,37625,175,19971,17574,13016,14611
2021-10-18 15:00:00+00,15128,0,4562,12200,506,2914,2401,146,306,224,38387,172,19975,17574,13012,15128
2021-10-18 15:30:00+00,15191,0,4557,12244,552,2938,2406,162,192,496,38738,171,19951,17545,12988,15191
2021-10-18 16:00:00+00,15331,0,4559,12180,749,3180,2400,220,80,1038,39737,170,19968,17568,13009,15331
2021-10-18 16:30:00+00,15552,0,4556,12078,751,3190,2408,319,20,1106,39980,172,19813,17405,12849,15552
2021-10-18 17:00:00+00,15771,0,4557,12159,750,3052,2409,418,0,1194,40310,172,19875,17466,12909,15771
2021-10-18 17:30:00+00,15746,0,4555,12017,748,3006,2409,501,0,1168,40150,172,19729,17320,12765,15746
2021-10-18 18:00:00+00,15432,0,4554,12065,749,3082,2412,346,0,610,39250,173,19780,17368,12814,15432
2021-10-18 18:30:00+00,15200,0,4553,11985,747,3082,2387,228,0,196,38378,173,19672,17285,12732,15200
2021-10-18 19:00:00+00,14413,0,4553,11695,706,3150,2404,189,0,4,37114,173,19358,16954,12401,14413
2021-10-18 19:30:00+00,12994,0,4557,11468,589,3155,2410,126,0,0,35299,166,19024,16614,12057,12994
2021-10-18 20:00:00+00,10485,0,4560,11707,514,3482,2409,123,0,0,33280,152,19190,16781,12221,10485
2021-10-18 20:30:00+00,9119,0,4560,11578,490,3472,2334,122,0,0,31675,142,18962,16628,12068,9119
2021-10-18 21:00:00+00,7971,0,4562,11156,428,3616,2169,121,0,8,30031,134,18315,16146,11584,7971
2021-10-18 21:30:00+00,6887,0,4556,10823,400,3620,2107,133,0,0,28526,126,17886,15779,11223,6887
2021-10-18 22:00:00+00,5449,0,4557,10355,380,3772,2002,122,0,30,26667,114,17294,15292,10735,5449
2021-10-18 22:30:00+00,4478,0,4562,10071,376,3904,1868,120,0,0,25379,107,16877,15009,10447,4478
2021-10-18 23:00:00+00,4435,0,4560,9584,349,3790,1934,121,0,0,24773,107,16427,14493,9933,4435
2021-10-18 23:30:00+00,3963,0,4563,9450,348,3796,2122,121,0,0,24363,102,16483,14361,9798,3963
2021-10-19 00:00:00+00,3915,0,4564,9393,358,3910,1863,123,0,0,24126,100,16178,14315,9751,3915
2021-10-19 00:30:00+00,4148,0,4558,8906,347,3974,1963,126,0,0,24022,106,15774,13811,9253,4148
2021-10-19 01:00:00+00,3930,0,4561,8687,334,4140,2030,124,0,0,23806,108,15612,13582,9021,3930
2021-10-19 01:30:00+00,3969,0,4561,8274,333,4092,2050,135,0,0,23414,110,15218,13168,8607,3969
2021-10-19 02:00:00+00,3859,0,4563,8272,333,3944,2169,130,0,0,23270,111,15337,13168,8605,3859
2021-10-19 02:30:00+00,3871,0,4562,8406,332,3862,2029,131,0,0,23193,110,15329,13300,8738,3871
2021-10-19 03:00:00+00,3858,0,4562,8239,329,3886,1985,131,0,0,22990,111,15115,13130,8568,3858
2021-10-19 03:30:00+00,3866,0,4555,8046,331,3850,1989,131,0,0,22768,111,14921,12932,8377,3866
2021-10-19 04:00:00+00,4523,0,4558,8004,403,3498,1910,124,0,0,23020,119,14875,12965,8407,4523
2021-10-19 04:30:00+00,5090,0,4550,8235,423,3514,2155,117,0,0,24084,125,15363,13208,8658,5090
2021-10-19 05:00:00+00,6802,0,4553,8643,729,3096,2348,120,0,188,26479,142,16273,13925,9372,6802
2021-10-19 05:30:00+00,8546,0,4551,9398,754,3028,2409,123,0,534,29343,150,17112,14703,10152,8546
2021-10-19 06:00:00+00,10371,0,4551,9651,794,4130,2306,153,0,224,32180,160,17302,14996,10445,10371
2021-10-19 06:30:00+00,11258,0,4550,9902,837,4190,2316,286,0,704,34043,163,17605,15289,10739,11258
2021-10-19 07:00:00+00,11908,0,4554,10165,830,4044,2389,472,51,522,34935,166,17989,15600,11046,11908
2021-10-19 07:30:00+00,11188,0,4553,11122,839,4048,2411,371,202,588,35322,155,19127,16716,12163,11188
2021-10-19 08:00:00+00,11728,0,4547,11468,822,3952,2419,220,375,432,35963,156,19631,17212,12665,11728
2021-10-19 08:30:00+00,11692,0,4549,11813,772,3878,2416,189,625,510,36444,152,20175,17759,13210,11692
2021-10-19 09:00:00+00,12046,0,4545,12329,639,3520,2386,121,779,0,36365,153,20678,18292,13747,12046
2021-10-19 09:30:00+00,11515,0,4541,12959,641,3388,2350,114,1019,32,36559,145,21510,19160,14619,11515
2021-10-19 10:00:00+00,10856,0,4533,13501,487,3648,2332,109,1498,0,36964,142,22351,20019,15486,10856
2021-10-19 10:30:00+00,10304,0,4531,13797,476,3736,2282,111,1806,144,37187,136,22892,20610,16079,10304
2021-10-19 11:00:00+00,10123,0,4541,14102,424,3632,2276,112,1989,0,37199,132,23332,21056,16515,10123
2021-10-19 11:30:00+00,9601,0,4535,14407,525,3632,2298,113,2107,0,37218,126,23872,21574,17039,9601
2021-10-19 12:00:00+00,8617,0,4542,14826,505,4024,2300,114,2174,0,37102,118,24347,22047,17505,8617
2021-10-19 12:30:00+00,8446,0,4545,14881,411,3940,2251,114,2177,74,36839,116,24265,22014,17469,8446
2021-10-19 13:00:00+00,8586,0,4553,14973,411,3796,2227,120,1585,0,36251,118,23749,21522,16969,8586
2021-10-19 13:30:00+00,8043,0,4554,15344,412,3773,2256,122,1063,0,35568,114,23629,21373,16819,8043
2021-10-19 14:00:00+00,8472,0,4550,15615,412,3243,2330,122,767,0,35511,118,23674,21344,16794,8472
2021-10-19 14:30:00+00,8728,0,4553,15636,428,3462,2388,109,526,0,35830,123,23531,21143,16590,8728
2021-10-19 15:00:00+00,9524,0,4555,15689,641,3522,2357,129,348,0,36765,130,23590,21233,16678,9524
2021-10-19 15:30:00+00,10499,0,4557,15533,627,3486,2351,139,190,188,37570,137,23258,20907,16350,10499
2021-10-19 16:00:00+00,11626,0,4555,15202,777,2732,2314,140,62,924,38332,145,22910,20596,16041,11626
2021-10-19 16:30:00+00,11948,0,4555,15213,776,2728,2289,147,3,1280,38939,146,22836,20547,15992,11948
2021-10-19 17:00:00+00,11816,0,4552,15403,723,2732,2311,186,0,1878,39601,143,22989,20678,16126,11816
2021-10-19 17:30:00+00,11662,0,4554,15515,688,2650,2376,266,0,1772,39483,141,23133,20757,16203,11662
2021-10-19 18:00:00+00,10809,0,4554,15324,673,3112,2413,179,0,1320,38384,134,22964,20551,15997,10809
2021-10-19 18:30:00+00,10215,0,4555,15395,671,3044,2366,132,0,790,37168,130,22987,20621,16066,10215
2021-10-19 19:00:00+00,8731,0,4555,15478,679,3734,2354,129,0,10,35670,120,23066,20712,16157,8731
2021-10-19 19:30:00+00,6969,0,4556,15930,689,3738,2258,127,0,0,34267,104,23433,21175,16619,6969
2021-10-19 20:00:00+00,5567,0,4555,15939,477,3806,2234,123,0,0,32701,93,23205,20971,16416,5567
2021-10-19 20:30:00+00,4286,0,4558,15537,454,3804,2138,125,0,56,30958,82,22687,20549,15991,4286
2021-10-19 21:00:00+00,3364,0,4557,15537,398,3748,2163,122,0,0,29889,72,22655,20492,15935,3364
2021-10-19 21:30:00+00,3103,0,4554,15462,382,3568,1838,122,0,0,29029,68,22236,20398,15844,3103
2021-10-19 22:00:00+00,3493,0,4548,15234,383,1390,1965,122,0,0,27135,65,22130,20165,15617,3493
2021-10-19 22:30:00+00,3348,0,4546,14378,376,1326,2107,120,0,0,26201,65,21407,19300,14754,3348
2021-10-19 23:00:00+00,3622,0,4551,14266,339,1206,2099,125,0,0,26208,75,21255,19156,14605,3622
2021-10-19 23:30:00+00,3071,0,4554,14871,335,1130,1961,125,0,0,26047,66,21721,19760,15206,3071
2021-10-20 00:00:00+00,2920,0,4548,14727,302,774,1929,128,0,0,25328,57,21506,19577,15029,2920
2021-10-20 00:30:00+00,3137,0,4546,14622,298,786,1980,128,0,0,25497,60,21446,19466,14920,3137
2021-10-20 01:00:00+00,3149,0,4546,14207,297,1424,1899,127,0,0,25649,68,20949,19050,14504,3149
2021-10-20 01:30:00+00,3183,0,4552,13702,297,1516,1818,126,0,0,25194,70,20369,18551,13999,3183
2021-10-20 02:00:00+00,3722,0,4548,13283,298,772,1798,122,0,0,24543,75,19927,18129,13581,3722
2021-10-20 02:30:00+00,4095,0,4552,12850,296,758,1860,125,0,0,24536,82,19558,17698,13146,4095
2021-10-20 03:00:00+00,4083,0,4550,12726,306,1272,1863,114,0,0,24914,82,19445,17582,13032,4083
2021-10-20 03:30:00+00,3838,0,4548,12696,329,1312,2016,118,0,0,24857,80,19589,17573,13025,3838
2021-10-20 04:00:00+00,3426,0,4549,12234,389,1518,2301,112,0,0,24529,72,19473,17172,12623,3426
2021-10-20 04:30:00+00,4145,0,4550,11742,407,1584,2338,112,0,0,24878,83,19037,16699,12149,4145
2021-10-20 05:00:00+00,5751,0,4564,11468,723,2282,2340,112,0,0,27240,102,19095,16755,12191,5751
2021-10-20 05:30:00+00,8111,0,4568,11319,695,2298,2337,114,0,34,29476,126,18919,16582,12014,8111
2021-10-20 06:00:00+00,10658,0,4567,10947,761,3498,2309,119,0,188,33047,148,18584,16275,11708,10658
2021-10-20 06:30:00+00,11942,0,4565,10668,755,3544,2365,170,4,784,34797,156,18357,15992,11427,11942
2021-10-20 07:00:00+00,12719,0,4567,10361,774,3686,2373,255,148,1166,36049,160,18223,15850,11283,12719
2021-10-20 07:30:00+00,12803,0,4571,10418,782,3692,2367,328,439,1198,36598,159,18577,16210,11639,12803
2021-10-20 08:00:00+00,12861,0,4570,10397,769,3684,2365,417,700,1186,36949,159,18801,16436,11866,12861
2021-10-20 08:30:00+00,12855,0,4573,10313,763,3684,2361,369,1494,986,37398,157,19504,17143,12570,12855
2021-10-20 09:00:00+00,12686,0,4578,10573,713,3638,2353,294,2219,608,37662,153,20436,18083,13505,12686
2021-10-20 09:30:00+00,11649,0,4573,11411,714,3638,2336,280,3175,392,38168,140,22209,19873,15300,11649
2021-10-20 10:00:00+00,10927,0,4574,11912,715,3728,2323,249,3742,0,38170,133,23266,20943,16369,10927
2021-10-20 10:30:00+00,10279,0,4567,12543,605,3728,2321,208,4051,0,38302,125,24087,21766,17199,10279
2021-10-20 11:00:00+00,10474,0,4567,12843,493,3700,2331,200,4187,0,38795,125,24421,22090,17523,10474
2021-10-20 11:30:00+00,9170,0,4572,13755,468,3802,2279,197,4442,0,38685,112,25516,23237,18665,9170
2021-10-20 12:00:00+00,8133,0,4569,14334,467,3580,2291,201,4566,16,38157,102,26227,23936,19367,8133
2021-10-20 12:30:00+00,7820,0,4567,14327,471,3568,2290,171,4017,114,37345,101,25672,23382,18815,7820
2021-10-20 13:00:00+00,7886,0,4575,13873,472,3534,2286,125,4385,226,37362,101,25591,23305,18730,7886
2021-10-20 13:30:00+00,8283,0,4577,13765,482,3558,2276,127,4047,0,37115,106,25147,22871,18294,8283
2021-10-20 14:00:00+00,8495,0,4580,13881,497,3582,2330,130,3352,22,36869,109,24640,22310,17730,8495
2021-10-20 14:30:00+00,9514,0,4575,13709,495,3568,2341,124,2603,140,37069,119,23723,21382,16807,9514
2021-10-20 15:00:00+00,10896,0,4574,13372,545,3646,2337,218,1817,274,37679,133,22645,20308,15734,10896
2021-10-20 15:30:00+00,11617,0,4575,13457,720,3648,2337,505,910,298,38067,141,21999,19662,15087,11617
2021-10-20 16:00:00+00,12615,0,4575,13040,867,3698,2376,493,223,936,38823,149,21081,18705,14130,12615
2021-10-20 16:30:00+00,13017,0,4572,12738,874,3698,2420,466,9,1406,39200,152,20613,18193,13621,13017
2021-10-20 17:00:00+00,13555,0,4572,11956,891,3808,2422,557,0,1980,39741,157,19841,17419,12847,13555
2021-10-20 17:30:00+00,14059,0,4569,11021,885,3874,2420,551,0,2092,39471,164,18895,16475,11906,14059
2021-10-20 18:00:00+00,14019,0,4571,10519,884,3802,2362,523,0,1754,38434,167,18336,15974,11403,14019
2021-10-20 18:30:00+00,13764,0,4570,9602,884,3800,2362,519,0,1352,36853,172,17418,15056,10486,13764
2021-10-20 19:00:00+00,13621,0,4569,9245,859,3762,2361,326,0,818,35561,174,17034,14673,10104,13621
2021-10-20 19:30:00+00,13015,0,4568,9288,831,3646,2371,302,0,136,34157,172,17058,14687,10119,13015
2021-10-20 20:00:00+00,12211,0,4567,9137,772,3582,2368,200,0,340,33177,166,16844,14476,9909,12211
2021-10-20 20:30:00+00,10958,0,4570,9061,745,3718,2359,198,0,62,31671,160,16735,14376,9806,10958
2021-10-20 21:00:00+00,8982,0,4574,9439,602,3828,2371,138,0,20,29954,145,16986,14615,10041,8982
2021-10-20 21:30:00+00,6710,0,4580,10250,541,3768,2343,127,0,0,28319,121,17714,15371,10791,6710
2021-10-20 22:00:00+00,4528,0,4578,10906,502,3792,2224,119,0,0,26649,90,18210,15986,11408,4528
2021-10-20 22:30:00+00,3626,0,4584,11191,496,3714,1950,115,0,0,25676,78,18221,16271,11687,3626
2021-10-20 23:00:00+00,3816,0,4577,11940,484,2524,2028,117,0,0,25486,73,19029,17001,12424,3816
2021-10-20 23:30:00+00,3726,0,4577,12337,451,2362,1803,118,0,0,25374,70,19168,17365,12788,3726
2021-10-21 00:00:00+00,4136,0,4577,13113,409,1184,1833,120,0,0,25372,77,19932,18099,13522,4136
2021-10-21 00:30:00+00,3804,0,4569,13806,389,1122,1845,121,0,0,25656,71,20609,18764,14195,3804
2021-10-21 01:00:00+00,4330,0,4569,14087,362,420,2015,122,0,0,25905,78,21033,19018,14449,4330
2021-10-21 01:30:00+00,4128,0,4569,14595,359,408,2096,122,0,0,26277,74,21619,19523,14954,4128
2021-10-21 02:00:00+00,3833,0,4573,14871,348,408,2062,123,0,0,26218,69,21854,19792,15219,3833
2021-10-21 02:30:00+00,3848,0,4569,15207,351,408,2072,122,0,0,26577,69,22199,20127,15558,3848
2021-10-21 03:00:00+00,3947,0,4574,15264,333,224,2029,121,0,0,26492,70,22200,20171,15597,3947
2021-10-21 03:30:00+00,3963,0,4574,15397,331,222,2030,122,0,0,26639,70,22332,20302,15728,3963
2021-10-21 04:00:00+00,3287,0,4571,15297,410,200,1866,123,0,0,25754,61,22144,20278,15707,3287
2021-10-21 04:30:00+00,3557,0,4567,15298,445,232,1908,120,0,0,26127,64,22218,20310,15743,3557
2021-10-21 05:00:00+00,3249,0,4571,15068,466,2596,1830,114,0,0,27894,67,21935,20105,15534,3249
2021-10-21 05:30:00+00,4454,0,4567,15010,604,2964,1880,115,0,0,29594,83,22061,20181,15614,4454
2021-10-21 06:00:00+00,6706,0,4568,14614,779,3320,2129,126,0,268,32510,103,22090,19961,15393,6706
2021-10-21 06:30:00+00,8287,0,4567,14614,777,3342,2359,184,0,364,34494,117,22317,19958,15391,8287
2021-10-21 07:00:00+00,9127,0,4566,14652,765,3246,2347,396,205,750,36054,119,22535,20188,15622,9127
2021-10-21 07:30:00+00,9638,0,4569,14710,774,3250,2357,444,983,426,37151,121,23393,21036,16467,9638
2021-10-21 08:00:00+00,9485,0,4573,14053,776,3712,2365,307,2064,854,38189,116,23831,21466,16893,9485
2021-10-21 08:30:00+00,9411,0,4583,13754,778,3724,2361,308,3140,594,38653,114,24616,22255,17672,9411
2021-10-21 09:00:00+00,8937,0,4584,13658,766,4018,2345,185,4182,316,38991,107,25535,23190,18606,8937
2021-10-21 09:30:00+00,8668,0,4581,13670,753,4020,2317,146,5242,300,39697,102,26563,24246,19665,8668
2021-10-21 10:00:00+00,8421,0,4587,13672,700,3644,2296,144,6019,374,39857,99,27274,24978,20391,8421
2021-10-21 10:30:00+00,8430,0,4590,13656,682,3638,2340,142,6429,32,39939,99,27697,25357,20767,8430
2021-10-21 11:00:00+00,8457,0,4589,13582,479,3474,2359,133,6726,30,39829,100,27735,25376,20787,8457
2021-10-21 11:30:00+00,8235,0,4590,13335,452,3348,2356,122,6905,36,39379,98,27638,25282,20692,8235
2021-10-21 12:00:00+00,7593,0,4585,13436,453,3278,2358,125,6734,0,38562,93,27566,25208,20623,7593
2021-10-21 12:30:00+00,7038,0,4580,13664,456,3278,2361,125,6462,26,37990,89,27523,25162,20582,7038
2021-10-21 13:00:00+00,6664,0,4580,13917,455,3562,2423,124,6009,0,37734,86,27384,24961,20381,6664
2021-10-21 13:30:00+00,6477,0,4587,14187,516,3582,2412,126,5386,0,37273,85,27088,24676,20089,6477
2021-10-21 14:00:00+00,6719,0,4584,14061,536,3652,2425,127,4618,0,36722,90,26224,23799,19215,6719
2021-10-21 14:30:00+00,8085,0,4580,13814,515,3654,2430,121,3634,20,36853,104,24973,22543,17963,8085
2021-10-21 15:00:00+00,9429,0,4591,14002,740,3688,2408,129,2560,0,37547,115,24301,21893,17302,9429
2021-10-21 15:30:00+00,10740,0,4588,14057,780,3690,2426,137,1512,118,38048,127,23363,20937,16349,10740
2021-10-21 16:00:00+00,11693,0,4588,13718,828,3320,2422,368,515,1366,38818,136,22071,19649,15061,11693
2021-10-21 16:30:00+00,12334,0,4591,13964,837,3306,2400,433,42,1286,39193,142,21834,19434,14843,12334
2021-10-21 17:00:00+00,12511,0,4585,14343,838,3740,2404,535,0,1250,40206,142,22170,19766,15181,12511
2021-10-21 17:30:00+00,12643,0,4578,14800,838,3764,2409,510,0,1362,40904,140,22625,20216,15638,12643
2021-10-21 18:00:00+00,12239,0,4573,15003,842,3670,2427,350,0,1324,40428,137,22845,20418,15845,12239
2021-10-21 18:30:00+00,11545,0,4575,15046,840,3670,2419,195,0,1196,39486,131,22880,20461,15886,11545
2021-10-21 19:00:00+00,11291,0,4575,15027,838,2696,2424,132,0,714,37697,132,22864,20440,15865,11291
2021-10-21 19:30:00+00,10320,0,4577,14908,810,2658,2400,119,0,488,36280,126,22695,20295,15718,10320
2021-10-21 20:00:00+00,9409,0,4577,14889,687,2420,2410,116,0,22,34530,123,22563,20153,15576,9409
2021-10-21 20:30:00+00,7734,0,4583,14846,491,2408,2408,127,0,0,32597,110,22328,19920,15337,7734
2021-10-21 21:00:00+00,7094,0,4586,14777,420,1666,2400,119,0,18,31080,104,22183,19783,15197,7094
2021-10-21 21:30:00+00,5455,0,4585,14938,402,1432,2368,115,0,0,29295,86,22293,19925,15340,5455
2021-10-21 22:00:00+00,4696,0,4590,14681,401,1802,2322,118,0,0,28610,81,21994,19672,15082,4696
2021-10-21 22:30:00+00,4227,0,4594,14727,363,1810,2289,115,0,0,28125,76,21973,19684,15090,4227
2021-10-21 23:00:00+00,4339,0,4587,14712,298,1314,2304,120,0,0,27674,76,21901,19597,15010,4339
2021-10-21 23:30:00+00,3925,0,4588,14755,295,1306,2312,120,0,0,27301,71,21950,19638,15050,3925
2021-10-22 00:00:00+00,3278,0,4593,14812,286,1666,2304,125,0,0,27064,66,21995,19691,15098,3278
2021-10-22 00:30:00+00,3327,0,4601,14823,284,1677,2308,127,0,0,27147,67,22016,19708,15107,3327
2021-10-22 01:00:00+00,3486,0,4599,14808,279,1556,2303,128,0,0,27158,72,21989,19686,15087,3486
2021-10-22 01:30:00+00,3340,0,4600,14809,277,1438,2285,132,0,0,26881,69,21971,19686,15086,3340
2021-10-22 02:00:00+00,3960,0,4596,15012,284,683,2303,126,0,0,26964,70,22195,19892,15296,3960
2021-10-22 02:30:00+00,3889,0,4595,14964,284,686,2271,126,0,0,26815,69,22114,19843,15248,3889
2021-10-22 03:00:00+00,3432,0,4595,14998,300,807,2343,125,0,0,26599,65,22236,19893,15298,3432
2021-10-22 03:30:00+00,3406,0,4595,15005,305,816,2375,115,0,0,26616,64,22280,19905,15310,3406
2021-10-22 04:00:00+00,3218,0,4598,15019,335,820,2369,114,0,0,26474,62,22321,19952,15354,3218
2021-10-22 04:30:00+00,3984,0,4593,15063,338,821,2316,115,0,0,27231,71,22310,19994,15401,3984
2021-10-22 05:00:00+00,4706,0,4597,14951,402,2198,2314,114,0,0,29282,85,22264,19950,15353,4706
2021-10-22 05:30:00+00,6468,0,4592,14891,413,2380,2214,116,0,0,31074,104,22110,19896,15304,6468
2021-10-22 06:00:00+00,10128,0,4594,14590,666,1869,2374,126,0,166,34513,133,22224,19850,15256,10128
2021-10-22 06:30:00+00,11610,0,4591,14663,738,1852,2416,133,0,212,36215,143,22408,19992,15401,11610
2021-10-22 07:00:00+00,11906,0,4591,14660,744,2226,2359,139,185,188,36998,143,22539,20180,15589,11906
2021-10-22 07:30:00+00,12257,0,4592,14530,745,2240,2323,142,718,154,37701,144,22908,20585,15993,12257
2021-10-22 08:00:00+00,12228,0,4591,14112,845,2398,2385,150,1352,416,38477,142,23285,20900,16309,12228
2021-10-22 08:30:00+00,12295,0,4596,13689,896,2402,2388,490,2196,322,39274,142,23765,21377,16781,12295
2021-10-22 09:00:00+00,12748,0,4601,13403,858,2348,2390,492,2887,140,39867,145,24139,21749,17148,12748
2021-10-22 09:30:00+00,12393,0,4601,13153,835,2348,2315,495,3509,268,39917,141,24413,22098,17497,12393
2021-10-22 10:00:00+00,11813,0,4596,13128,791,2702,2145,229,4096,352,39852,134,24756,22611,18015,11813
2021-10-22 10:30:00+00,12019,0,4599,12485,778,2766,2120,168,4098,196,39229,138,24080,21960,17361,12019
2021-10-22 11:00:00+00,12616,0,4602,12274,639,3180,2145,168,4480,12,40116,141,24140,21995,17393,12616
2021-10-22 11:30:00+00,13007,0,4601,11797,625,3192,2145,141,4244,0,39752,145,23412,21267,16666,13007
2021-10-22 12:00:00+00,12874,0,4599,11112,626,3610,2145,121,3784,78,38949,147,22266,20121,15522,12874
2021-10-22 12:30:00+00,13033,0,4603,10478,628,3636,2167,126,3573,142,38386,151,21449,19282,14679,13033
2021-10-22 13:00:00+00,13523,0,4600,9729,639,3758,2173,126,3044,82,37674,159,20185,18012,13412,13523
2021-10-22 13:30:00+00,14163,0,4597,9450,640,3766,2173,129,2577,10,37505,167,19437,17264,12667,14163
2021-10-22 14:00:00+00,15325,0,4599,8472,647,3756,2289,127,2151,180,37546,179,18158,15869,11270,15325
2021-10-22 14:30:00+00,16786,16,4603,7199,780,3756,2353,263,1625,22,37403,197,16560,14207,9604,16802
2021-10-22 15:00:00+00,17268,51,4612,6508,887,3886,2352,447,1088,224,37323,206,15447,13095,8483,17319
2021-10-22 15:30:00+00,18566,170,4604,5842,903,3890,2352,463,674,290,37754,221,14375,12023,7419,18736
2021-10-22 16:00:00+00,18961,384,4607,5044,916,3958,2353,544,217,928,37912,231,13137,10784,6177,19345
2021-10-22 16:30:00+00,18988,672,4602,4624,937,3958,2353,588,12,1478,38212,237,12528,10175,5573,19660
2021-10-22 17:00:00+00,19577,919,4603,4098,963,3958,2353,808,0,1724,39003,245,12017,9664,5061,20496
2021-10-22 17:30:00+00,20013,994,4607,3806,964,3958,2353,836,0,1368,38899,253,11730,9377,4770,21007
2021-10-22 18:00:00+00,19518,931,4601,3410,965,3818,2354,662,0,1792,38051,250,11330,8976,4375,20449
2021-10-22 18:30:00+00,19468,910,4602,3240,956,3816,2351,552,0,1712,37607,251,11149,8798,4196,20378
2021-10-22 19:00:00+00,18970,997,4597,3161,957,3792,2353,233,0,780,35840,256,11068,8715,4118,19967
2021-10-22 19:30:00+00,18646,940,4595,2886,956,3774,2353,145,0,286,34581,259,10790,8437,3842,19586
2021-10-22 20:00:00+00,18941,872,4597,2428,892,2968,2354,122,0,350,33524,264,10271,7917,3320,19813
2021-10-22 20:30:00+00,18406,743,4597,2252,874,2942,2352,116,0,66,32348,263,10075,7723,3126,19149
2021-10-22 21:00:00+00,17166,397,4597,2158,815,2812,2351,116,0,42,30454,255,9921,7570,2973,17563
2021-10-22 21:30:00+00,15772,49,4599,2223,808,2898,2352,121,0,0,28822,241,9982,7630,3031,15821
2021-10-22 22:00:00+00,14306,0,4595,2333,798,2750,2341,117,0,0,27240,230,10067,7726,3131,14306
2021-10-22 22:30:00+00,13121,0,4599,2328,793,2810,2350,143,0,0,26144,223,10070,7720,3121,13121
2021-10-22 23:00:00+00,11631,0,4599,2148,701,3342,2351,123,0,28,24923,213,9799,7448,2849,11631
2021-10-22 23:30:00+00,10901,0,4600,2104,698,3360,2350,114,0,40,24167,208,9752,7402,2802,10901
2021-10-23 00:00:00+00,10464,0,4606,2211,700,3636,2349,116,0,0,24082,208,9866,7517,2911,10464
2021-10-23 00:30:00+00,10514,0,4605,2630,672,3740,2308,116,0,0,24585,206,10215,7907,3302,10514
2021-10-23 01:00:00+00,9757,0,4606,3034,657,3946,2339,118,0,0,24457,198,10636,8297,3691,9757
2021-10-23 01:30:00+00,9155,0,4608,3391,655,3906,2351,117,0,0,24183,190,11005,8654,4046,9155
2021-10-23 02:00:00+00,8856,0,4609,3819,655,3814,2333,118,0,0,24204,188,11416,9083,4474,8856
2021-10-23 02:30:00+00,8525,0,4608,4390,653,3772,2132,119,0,0,24199,181,11783,9651,5043,8525
2021-10-23 03:00:00+00,8552,0,4606,5046,652,3282,1767,119,0,0,24024,178,12071,10304,5698,8552
2021-10-23 03:30:00+00,7902,0,4610,5534,652,3270,1771,119,0,0,23858,168,12567,10796,6186,7902
2021-10-23 04:00:00+00,8183,0,4602,5835,652,2656,1772,119,0,0,23819,176,12861,11089,6487,8183
2021-10-23 04:30:00+00,8138,0,4610,6514,652,2634,1767,121,0,0,24436,171,13543,11776,7166,8138
2021-10-23 05:00:00+00,8924,0,4603,6796,743,2268,1775,130,0,0,25239,170,13917,12142,7539,8924
2021-10-23 05:30:00+00,9807,0,4604,6952,774,2146,1776,130,0,0,26189,175,14106,12330,7726,9807
2021-10-23 06:00:00+00,10306,0,4600,7206,748,2474,1774,136,0,32,27276,173,14328,12554,7954,10306
2021-10-23 06:30:00+00,11335,0,4610,7321,672,2524,1776,138,0,44,28420,180,14379,12603,7993,11335
2021-10-23 07:00:00+00,12065,0,4604,7418,674,2780,1774,156,64,360,29895,180,14534,12760,8156,12065
2021-10-23 07:30:00+00,12491,0,4605,7598,676,2784,1775,247,283,476,30935,181,14937,13162,8557,12491
2021-10-23 08:00:00+00,12351,0,4607,8237,723,3552,1776,213,558,158,32175,174,15901,14125,9518,12351
2021-10-23 08:30:00+00,12446,0,4605,8836,619,3574,1742,155,819,168,32964,170,16621,14879,10274,12446
2021-10-23 09:00:00+00,12572,0,4608,9414,559,3293,1742,291,1086,156,33721,167,17409,15667,11059,12572
2021-10-23 09:30:00+00,12165,0,4613,9956,559,3180,1743,183,1388,0,33787,160,18259,16516,11903,12165
2021-10-23 10:00:00+00,11273,0,4611,10294,512,3786,1741,118,1752,20,34107,152,18910,17169,12558,11273
2021-10-23 10:30:00+00,10851,0,4608,10533,512,3812,1742,120,2091,60,34329,147,19486,17744,13136,10851
2021-10-23 11:00:00+00,10529,0,4606,10777,464,3852,1743,121,2334,98,34524,143,19924,18181,13575,10529
2021-10-23 11:30:00+00,10049,0,4607,11017,458,3852,1740,119,2293,178,34313,138,20115,18375,13768,10049
2021-10-23 12:00:00+00,9595,0,4608,11463,423,3880,1743,118,1720,0,33550,136,19957,18214,13606,9595
2021-10-23 12:30:00+00,8913,0,4610,11756,421,3882,1740,123,1716,0,33161,130,20243,18503,13893,8913
2021-10-23 13:00:00+00,8757,0,4605,11942,420,3736,1739,121,1548,0,32868,132,20254,18515,13910,8757
2021-10-23 13:30:00+00,8540,0,4611,12114,425,3722,1745,122,1354,0,32633,130,20249,18504,13893,8540
2021-10-23 14:00:00+00,9235,0,4597,11939,433,3120,1748,124,1010,68,32274,139,19727,17979,13382,9235
2021-10-23 14:30:00+00,9590,0,4599,12123,439,3090,1744,125,685,0,32395,143,19590,17846,13247,9590
2021-10-23 15:00:00+00,10325,0,4599,12173,544,2688,1716,363,448,168,33024,151,19480,17764,13165,10325
2021-10-23 15:30:00+00,11146,0,4603,12324,558,2698,1713,451,217,224,33934,158,19415,17702,13099,11146
2021-10-23 16:00:00+00,11494,0,4603,12210,587,3442,1713,486,47,398,34980,160,19160,17447,12844,11494
2021-10-23 16:30:00+00,11752,0,4607,12507,587,3472,1714,481,1,748,35869,158,19416,17702,13095,11752
2021-10-23 17:00:00+00,11749,0,4612,12865,698,3694,1855,506,0,772,36751,153,20030,18175,13563,11749
2021-10-23 17:30:00+00,11338,0,4611,12997,637,3708,2055,470,0,736,36552,150,20300,18245,13634,11338
2021-10-23 18:00:00+00,11333,0,4615,12881,590,3530,2145,399,0,310,35803,151,20231,18086,13471,11333
2021-10-23 18:30:00+00,10337,0,4610,12773,554,3522,2237,195,0,136,34364,145,20174,17937,13327,10337
2021-10-23 19:00:00+00,9555,0,4608,12862,563,2944,2255,122,0,110,33019,146,20288,18033,13425,9555
2021-10-23 19:30:00+00,8359,0,4608,13192,558,2966,2258,120,0,0,32061,136,20616,18358,13750,8359
2021-10-23 20:00:00+00,6759,0,4606,13437,531,3112,2282,119,0,0,30846,121,20856,18574,13968,6759
2021-10-23 20:30:00+00,5733,0,4609,13321,510,3076,2288,119,0,0,29656,113,20728,18440,13831,5733
2021-10-23 21:00:00+00,5761,0,4613,13254,489,2302,2292,119,0,76,28906,113,20648,18356,13743,5761
2021-10-23 21:30:00+00,4716,0,4613,13061,463,2264,2285,116,0,4,27522,103,20422,18137,13524,4716
2021-10-23 22:00:00+00,4213,0,4606,12888,464,2118,2290,119,0,0,26698,97,20248,17958,13352,4213
2021-10-23 22:30:00+00,3625,0,4610,12860,457,2210,2186,116,0,0,26064,92,20113,17927,13317,3625
2021-10-23 23:00:00+00,3573,0,4611,13044,429,1864,2087,106,0,0,25714,88,20171,18084,13473,3573
2021-10-23 23:30:00+00,3078,0,4614,13453,389,1594,2126,78,0,0,25332,76,20582,18456,13842,3078
2021-10-24 00:00:00+00,2868,0,4606,13729,367,1380,1959,79,0,0,24988,69,20661,18702,14096,2868
2021-10-24 00:30:00+00,2987,0,4602,13918,345,1402,1692,90,0,0,25036,70,20557,18865,14263,2987
2021-10-24 01:00:00+00,3130,0,4610,13911,335,1260,2014,119,0,0,25379,72,20870,18856,14246,3130
2021-10-24 01:30:00+00,3059,0,4603,13904,333,1120,1977,124,0,0,25120,69,20817,18840,14237,3059
2021-10-24 02:00:00+00,3270,0,4610,14413,336,364,1854,123,0,0,24970,63,21213,19359,14749,3270
2021-10-24 02:30:00+00,3074,0,4604,14516,350,298,1865,122,0,0,24829,59,21335,19470,14866,3074
2021-10-24 03:00:00+00,3223,0,4605,14690,374,186,1829,123,0,0,25030,61,21498,19668,15064,3223
2021-10-24 03:30:00+00,3219,0,4608,14640,390,158,1902,123,0,0,25040,61,21540,19638,15030,3219
2021-10-24 04:00:00+00,3226,0,4606,14628,419,174,1681,123,0,0,24856,61,21334,19652,15046,3226
2021-10-24 04:30:00+00,3284,0,4605,14498,426,206,1780,124,0,0,24923,62,21309,19529,14924,3284
2021-10-24 05:00:00+00,3219,0,4604,14372,504,622,1709,114,0,0,25144,63,21189,19480,14876,3219
2021-10-24 05:30:00+00,3285,0,4608,14195,508,932,2342,117,0,0,25987,70,21653,19311,14703,3285
2021-10-24 06:00:00+00,3103,0,4603,13989,520,1672,2420,117,0,0,26424,77,21532,19112,14509,3103
2021-10-24 06:30:00+00,3298,0,4601,13758,531,1806,2424,120,0,0,26538,81,21314,18890,14289,3298
2021-10-24 07:00:00+00,3241,0,4605,13722,581,2586,2329,117,131,0,27312,80,21368,19039,14434,3241
2021-10-24 07:30:00+00,3881,0,4603,13785,680,2692,2390,116,437,0,28584,86,21895,19505,14902,3881
2021-10-24 08:00:00+00,3581,0,4607,13706,673,3726,2138,112,731,0,29274,79,21855,19717,15110,3581
2021-10-24 08:30:00+00,3752,0,4602,13686,666,3986,2170,118,1308,0,30288,82,22432,20262,15660,3752
2021-10-24 09:00:00+00,3632,0,4608,13707,654,4568,2087,119,1839,14,31228,80,22895,20808,16200,3632
2021-10-24 09:30:00+00,3812,0,4609,13716,651,4640,2147,118,2669,0,32362,81,23792,21645,17036,3812
2021-10-24 10:00:00+00,4200,0,4608,13676,603,4486,2164,119,3168,24,33048,81,24219,22055,17447,4200
2021-10-24 10:30:00+00,4150,0,4616,13951,599,4512,2160,119,3176,0,33283,81,24502,22342,17726,4150
2021-10-24 11:00:00+00,4479,0,4605,13966,599,4584,2176,114,3267,0,33790,84,24613,22437,17832,4479
2021-10-24 11:30:00+00,4440,0,4610,13913,599,4630,2162,119,3694,0,34167,83,24978,22816,18206,4440
2021-10-24 12:00:00+00,4090,0,4606,13893,540,4826,2091,121,3262,42,33471,83,24392,22301,17695,4090
2021-10-24 12:30:00+00,4524,0,4607,13530,561,4848,1913,127,2966,134,33210,89,23577,21664,17057,4524
2021-10-24 13:00:00+00,4684,0,4609,13438,576,4868,2122,126,2668,46,33137,92,23413,21291,16682,4684
2021-10-24 13:30:00+00,4723,0,4610,13364,579,4832,2176,121,2460,0,32865,93,23189,21013,16403,4723
2021-10-24 14:00:00+00,4985,0,4606,13698,591,4648,2106,131,2098,2,32865,93,23099,20993,16387,4985
2021-10-24 14:30:00+00,5896,0,4602,13754,590,4514,2148,124,1573,18,33219,101,22667,20519,15917,5896
2021-10-24 15:00:00+00,7111,0,4604,13576,590,4518,2257,130,997,0,33783,114,22024,19767,15163,7111
2021-10-24 15:30:00+00,7981,0,4607,13273,609,4746,2273,131,544,0,34164,126,21306,19033,14426,7981
2021-10-24 16:00:00+00,8393,0,4606,13221,784,4668,2375,162,221,462,34892,128,21207,18832,14226,8393
2021-10-24 16:30:00+00,8476,0,4606,13602,785,4686,2405,169,7,846,35582,127,21405,19000,14394,8476
2021-10-24 17:00:00+00,8758,0,4609,13815,804,4198,2419,372,0,1242,36217,123,21647,19228,14619,8758
2021-10-24 17:30:00+00,8750,0,4611,14160,806,4188,2411,333,0,952,36211,122,21988,19577,14966,8750
2021-10-24 18:00:00+00,8267,0,4606,14339,806,4402,2397,148,0,688,35653,122,22148,19751,15145,8267
2021-10-24 18:30:00+00,7670,0,4609,14352,806,4180,2390,113,0,34,34154,118,22157,19767,15158,7670
2021-10-24 19:00:00+00,7985,0,4606,14434,800,2926,2415,111,0,0,33277,124,22255,19840,15234,7985
2021-10-24 19:30:00+00,7111,0,4604,14337,838,2744,2418,106,0,0,32158,115,22197,19779,15175,7111
2021-10-24 20:00:00+00,5489,0,4607,14307,796,2922,2328,87,0,0,30536,100,22038,19710,15103,5489
2021-10-24 20:30:00+00,4796,0,4603,13888,780,2880,2068,103,0,20,29138,94,21339,19271,14668,4796
2021-10-24 21:00:00+00,4938,0,4607,13366,651,2698,2244,106,0,146,28756,99,20868,18624,14017,4938
2021-10-24 21:30:00+00,3818,0,4610,13513,621,2596,2280,112,0,34,27584,86,21024,18744,14134,3818
2021-10-24 22:00:00+00,3001,0,4609,13408,610,2680,1938,121,0,0,26367,78,20565,18627,14018,3001
2021-10-24 22:30:00+00,2788,0,4608,13200,520,2698,1830,124,0,0,25768,76,20158,18328,13720,2788
2021-10-24 23:00:00+00,2841,0,4607,13058,450,2416,1871,124,0,0,25367,79,19986,18115,13508,2841
2021-10-24 23:30:00+00,2984,0,4605,12549,457,2330,1690,126,0,0,24741,80,19301,17611,13006,2984
2021-10-25 00:00:00+00,2989,0,4607,11922,484,2862,1678,126,0,0,24668,85,18691,17013,12406,2989
2021-10-25 00:30:00+00,3102,0,4606,11777,454,2910,1844,126,0,0,24819,88,18681,16837,12231,3102
2021-10-25 01:00:00+00,2960,0,4609,12007,491,2298,2217,122,0,0,24704,80,19324,17107,12498,2960
2021-10-25 01:30:00+00,2838,0,4614,11937,478,2260,2287,114,0,0,24528,78,19316,17029,12415,2838
2021-10-25 02:00:00+00,3281,0,4609,11794,492,1475,2405,117,0,0,24173,77,19300,16895,12286,3281
2021-10-25 02:30:00+00,3275,0,4612,11814,458,1419,2421,107,0,0,24105,76,19305,16884,12272,3275
2021-10-25 03:00:00+00,3014,0,4613,11551,461,2002,2404,122,0,0,24167,79,19029,16625,12012,3014
2021-10-25 03:30:00+00,3026,0,4614,11305,463,2046,2343,118,0,0,23915,81,18725,16382,11768,3026
2021-10-25 04:00:00+00,3245,0,4611,11074,485,2126,2095,121,0,0,23757,94,18265,16170,11559,3245
2021-10-25 04:30:00+00,4184,0,4608,10830,505,2112,2127,115,0,0,24481,106,18070,15943,11335,4184
2021-10-25 05:00:00+00,6227,0,4609,10392,613,2082,2275,116,0,0,26314,127,17889,15614,11005,6227
2021-10-25 05:30:00+00,8030,0,4607,10582,621,2328,2341,115,0,0,28624,146,18151,15810,11203,8030
2021-10-25 06:00:00+00,10803,0,4606,10824,722,1682,2353,116,0,370,31476,158,18505,16152,11546,10803
2021-10-25 06:30:00+00,12647,0,4603,10724,710,1868,2366,127,0,632,33677,172,18403,16037,11434,12647
2021-10-25 07:00:00+00,13558,0,4595,10551,823,1688,2368,347,185,736,34851,177,18522,16154,11559,13558
2021-10-25 07:30:00+00,13846,0,4605,10522,826,1694,2369,526,785,1068,36241,175,19107,16738,12133,13846
2021-10-25 08:00:00+00,14080,0,4603,10342,789,2346,2367,531,1715,368,37141,172,19816,17449,12846,14080
2021-10-25 08:30:00+00,14105,0,4608,10300,746,2276,2357,486,2403,318,37599,169,20414,18057,13449,14105
2021-10-25 09:00:00+00,13840,0,4609,10611,624,1826,2357,525,3236,194,37822,166,21437,19080,14471,13840
2021-10-25 09:30:00+00,13532,0,4610,10781,610,1828,2364,408,3833,134,38100,161,22198,19834,15224,13532
2021-10-25 10:00:00+00,13115,0,4609,11097,586,1972,2361,285,4098,8,38131,155,22751,20390,15781,13115
2021-10-25 10:30:00+00,12708,0,4639,11426,585,1966,2362,135,4114,0,37935,150,23126,20764,16125,12708
2021-10-25 11:00:00+00,13145,0,4645,11615,590,1460,2369,123,3970,348,38265,150,23189,20820,16175,13145
2021-10-25 11:30:00+00,13004,0,4648,11692,591,1452,2369,282,3930,188,38156,151,23230,20861,16213,13004
2021-10-25 12:00:00+00,12376,0,4641,11474,562,2084,2370,194,3982,154,37837,151,23029,20659,16018,12376
2021-10-25 12:30:00+00,12263,62,4642,11233,560,2090,2366,189,4236,152,37793,151,23037,20671,16029,12325
2021-10-25 13:00:00+00,12525,223,4640,11100,557,1902,2368,188,4524,0,38027,157,23189,20821,16181,12748
2021-10-25 13:30:00+00,12695,268,4645,10828,555,2026,2360,189,3772,0,37338,164,22160,19800,15155,12963
2021-10-25 14:00:00+00,12885,337,4652,10758,598,2004,2361,196,2941,0,36732,172,21310,18949,14297,13222
2021-10-25 14:30:00+00,13461,548,4686,10421,616,2226,2368,193,2424,0,36943,185,20515,18147,13461,14009
2021-10-25 15:00:00+00,14490,846,4704,9905,652,2218,2372,230,1697,0,37114,203,19330,16958,12254,15336
2021-10-25 15:30:00+00,15171,895,4705,9484,790,2186,2372,366,911,924,37804,208,18262,15890,11185,16066
2021-10-25 16:00:00+00,15471,869,4711,9102,817,3042,2356,412,263,886,37929,211,17249,14893,10182,16340
2021-10-25 16:30:00+00,16650,898,4727,9082,822,3242,2362,482,6,886,39157,219,16999,14637,9910,17548
2021-10-25 17:00:00+00,17107,905,4736,9050,843,3606,2376,571,0,1186,40380,216,17005,14629,9893,18012
2021-10-25 17:30:00+00,16792,993,4736,8975,839,3616,2372,623,0,1412,40358,216,16922,14550,9814,17785
2021-10-25 18:00:00+00,16581,989,4736,8963,838,3568,2368,400,0,1000,39443,214,16905,14537,9801,17570
2021-10-25 18:30:00+00,16821,821,4732,8459,850,3456,2373,234,0,518,38264,217,16414,14041,9309,17642
2021-10-25 19:00:00+00,16188,834,4733,8509,795,3002,2362,197,0,276,36896,219,16399,14037,9304,17022
2021-10-25 19:30:00+00,15495,408,4729,8477,817,2944,2370,196,0,0,35436,209,16393,14023,9294,15903
2021-10-25 20:00:00+00,13594,32,4728,8440,816,3622,2372,186,0,0,33790,189,16356,13984,9256,13626
2021-10-25 20:30:00+00,12447,0,4741,8131,798,3660,2329,123,0,62,32291,183,15999,13670,8929,12447
2021-10-25 21:00:00+00,11513,0,4751,8210,781,2868,2353,124,0,6,30606,183,16095,13742,8991,11513
2021-10-25 21:30:00+00,9649,0,4735,8372,761,2656,2361,137,0,0,28671,166,16229,13868,9133,9649
2021-10-25 22:00:00+00,6713,0,4745,8531,685,3704,2361,124,0,62,26925,135,16322,13961,9216,6713
2021-10-25 22:30:00+00,5425,0,4796,8473,672,3678,2359,124,0,92,25619,121,16300,13941,9145,5425
2021-10-25 23:00:00+00,4539,0,4804,8231,610,3774,2335,125,0,56,24474,112,15980,13645,8841,4539
2021-10-25 23:30:00+00,4260,0,4810,7888,608,3906,2291,125,0,0,23888,113,15597,13306,8496,4260
2021-10-26 00:00:00+00,4292,0,4809,7823,619,3562,2359,123,0,0,23587,116,15610,13251,8442,4292
2021-10-26 00:30:00+00,4454,0,4810,8053,648,3786,2356,122,0,0,24229,120,15867,13511,8701,4454
2021-10-26 01:00:00+00,4440,0,4840,7781,573,4046,2372,118,0,0,24170,125,15566,13194,8354,4440
2021-10-26 01:30:00+00,4291,0,4861,7699,539,4086,2373,122,0,0,23970,125,15472,13099,8238,4291
2021-10-26 02:00:00+00,4276,0,4862,7765,551,3164,2374,118,0,0,23110,126,15552,13178,8316,4276
2021-10-26 02:30:00+00,4312,0,4875,7905,593,3144,2375,122,0,0,23326,125,15748,13373,8498,4312
2021-10-26 03:00:00+00,4361,0,4888,8479,588,2818,2326,123,0,0,23583,121,16281,13955,9067,4361
2021-10-26 03:30:00+00,4317,0,4887,8510,573,2810,2131,125,0,0,23353,120,16101,13970,9083,4317
2021-10-26 04:00:00+00,4548,0,4893,9219,639,2988,1948,122,0,0,24356,120,16699,14751,9858,4548
2021-10-26 04:30:00+00,4819,0,4890,9436,609,3010,1890,121,0,0,24776,122,16825,14935,10045,4819
2021-10-26 05:00:00+00,5529,0,4891,9188,614,1782,2270,162,0,48,24484,122,16963,14693,9802,5529
2021-10-26 05:30:00+00,6397,0,4894,9298,597,1674,2322,223,0,96,25502,130,17112,14790,9896,6397
2021-10-26 06:00:00+00,7689,0,4891,9699,641,2128,2329,265,0,388,28031,142,17560,15231,10340,7689
2021-10-26 06:30:00+00,8816,0,4891,10022,633,2174,2316,264,0,856,29973,148,17862,15546,10655,8816
2021-10-26 07:00:00+00,9823,0,4887,10385,646,2406,2340,293,67,1170,32017,147,18325,15985,11098,9823
2021-10-26 07:30:00+00,10406,0,4888,11057,750,2358,2341,474,306,878,33458,149,19342,17001,12113,10406
2021-10-26 08:00:00+00,10719,0,4886,12014,763,2938,2331,502,516,586,35256,152,20510,18180,13294,10719
2021-10-26 08:30:00+00,10835,0,4885,12240,719,2960,2296,264,856,464,35519,150,20996,18700,13815,10835
2021-10-26 09:00:00+00,10968,0,4888,12634,701,2892,2338,148,1311,414,36294,148,21872,19534,14646,10968
2021-10-26 09:30:00+00,11000,0,4887,13194,577,2764,2335,133,1472,160,36522,145,22465,20130,15243,11000
2021-10-26 10:00:00+00,11065,0,4889,13902,531,3106,2330,129,1835,0,37787,144,23487,21157,16268,11065
2021-10-26 10:30:00+00,11131,0,4887,14269,495,3150,2332,128,2311,20,38723,141,24294,21962,17075,11131
2021-10-26 11:00:00+00,11272,0,4882,14527,497,3234,2303,128,2308,102,39253,142,24517,22214,17332,11272
2021-10-26 11:30:00+00,10916,0,4884,14768,497,3218,2333,133,2032,26,38807,140,24514,22181,17297,10916
2021-10-26 12:00:00+00,10454,0,4889,15370,478,3326,2331,127,1873,0,38848,136,24941,22610,17721,10454
2021-10-26 12:30:00+00,9712,0,4887,15786,468,3250,2301,133,1728,18,38283,129,25170,22869,17982,9712
2021-10-26 13:00:00+00,9514,0,4930,15894,452,2852,2293,126,1767,68,37896,128,25336,23043,18113,9514
2021-10-26 13:30:00+00,9514,0,4934,15990,453,2800,2300,126,1742,14,37873,128,25419,23119,18185,9514
2021-10-26 14:00:00+00,10557,0,4929,16234,450,1966,2300,141,1542,28,38147,130,25455,23155,18226,10557
2021-10-26 14:30:00+00,10906,0,4932,16466,436,1944,2330,143,1024,0,38181,134,25188,22858,17926,10906
2021-10-26 15:00:00+00,11206,0,4937,16576,406,2354,2316,146,662,6,38609,140,24897,22581,17644,11206
2021-10-26 15:30:00+00,12171,0,4931,16366,434,2358,2318,140,322,98,39138,148,24371,22053,17122,12171
2021-10-26 16:00:00+00,12703,0,4937,16341,462,2556,2322,154,71,308,39854,152,24133,21811,16874,12703
2021-10-26 16:30:00+00,12962,0,4963,16498,500,2602,2333,187,0,654,40699,152,24294,21961,16998,12962
2021-10-26 17:00:00+00,12950,0,4969,16542,552,2862,2353,189,0,884,41301,150,24416,22063,17094,12950
2021-10-26 17:30:00+00,12559,0,4967,16605,579,2822,2364,182,0,842,40920,147,24515,22151,17184,12559
2021-10-26 18:00:00+00,12663,0,4971,16478,615,2776,2361,147,0,316,40327,150,24425,22064,17093,12663
2021-10-26 18:30:00+00,11724,0,4970,16403,632,2732,2355,133,0,0,38949,145,24360,22005,17035,11724
2021-10-26 19:00:00+00,9357,0,4966,16429,641,3330,2352,131,0,64,37270,130,24388,22036,17070,9357
2021-10-26 19:30:00+00,8025,0,4972,16287,657,3370,2343,130,0,0,35784,121,24259,21916,16944,8025
2021-10-26 20:00:00+00,6755,0,4970,16180,657,3082,2358,129,0,24,34155,112,24165,21807,16837,6755
2021-10-26 20:30:00+00,5354,0,4991,16028,654,3052,2339,125,0,0,32543,100,24012,21673,16682,5354
2021-10-26 21:00:00+00,4663,0,4987,15783,659,2354,2350,124,0,0,30920,93,23779,21429,16442,4663
2021-10-26 21:30:00+00,3800,0,4991,15404,652,2396,2357,126,0,0,29726,87,23404,21047,16056,3800
2021-10-26 22:00:00+00,3676,0,4990,15340,652,1846,2360,128,0,0,28992,79,23342,20982,15992,3676
2021-10-26 22:30:00+00,3298,0,4988,15189,651,1514,2054,128,0,0,27822,70,22882,20828,15840,3298
2021-10-26 23:00:00+00,3660,0,4988,15090,651,1024,1718,127,0,0,27258,67,22447,20729,15741,3660
2021-10-26 23:30:00+00,3259,0,4985,15067,649,918,2016,132,0,0,27026,62,22717,20701,15716,3259
2021-10-27 00:00:00+00,2904,0,4984,15001,663,966,2107,137,0,0,26762,58,22755,20648,15664,2904
2021-10-27 00:30:00+00,3029,0,4981,14826,661,1026,2134,139,0,0,26796,62,22602,20468,15487,3029
2021-10-27 01:00:00+00,2776,0,4983,14869,658,960,2062,139,0,0,26447,60,22572,20510,15527,2776
2021-10-27 01:30:00+00,2752,0,4982,14799,655,934,1857,140,0,0,26119,59,22293,20436,15454,2752
2021-10-27 02:00:00+00,2716,0,4983,14994,636,868,1652,139,0,0,25988,62,22265,20613,15630,2716
2021-10-27 02:30:00+00,2616,0,4981,14920,633,752,1632,136,0,0,25670,59,22166,20534,15553,2616
2021-10-27 03:00:00+00,2645,0,4985,14640,628,854,1628,126,0,0,25506,57,21881,20253,15268,2645
2021-10-27 03:30:00+00,2734,0,5013,14416,628,870,1647,124,0,0,25432,58,21704,20057,15044,2734
2021-10-27 04:00:00+00,2652,0,5049,14639,632,1116,1651,126,0,0,25865,57,21971,20320,15271,2652
2021-10-27 04:30:00+00,2947,0,5064,14902,617,1306,1688,126,0,0,26650,63,22271,20583,15519,2947
2021-10-27 05:00:00+00,3910,0,5064,15117,631,1476,1698,127,0,0,28023,76,22510,20812,15748,3910
2021-10-27 05:30:00+00,4824,0,5067,15590,646,1382,2030,127,0,0,29666,84,23333,21303,16236,4824
2021-10-27 06:00:00+00,7480,0,5064,15695,711,946,2151,139,0,0,32186,105,23621,21470,16406,7480
2021-10-27 06:30:00+00,8921,0,5064,15994,707,868,2224,148,0,64,33990,115,23989,21765,16701,8921
2021-10-27 07:00:00+00,9867,0,5061,16084,732,872,2231,155,62,212,35276,121,24170,21939,16878,9867
2021-10-27 07:30:00+00,10430,0,5062,16146,818,876,2240,152,192,210,36126,125,24458,22218,17156,10430
2021-10-27 08:00:00+00,10134,0,5056,16274,844,1944,2246,155,374,0,37027,125,24794,22548,17492,10134
2021-10-27 08:30:00+00,10476,0,5057,16332,734,1976,2240,148,666,40,37669,126,25029,22789,17732,10476
2021-10-27 09:00:00+00,10259,0,5060,16439,743,2296,2219,138,904,0,38058,125,25365,23146,18086,10259
2021-10-27 09:30:00+00,10297,0,5060,16459,709,2302,2220,130,1078,0,38255,125,25526,23306,18246,10297
2021-10-27 10:00:00+00,10484,0,5061,16465,682,1990,2214,128,1604,202,38830,122,26026,23812,18751,10484
2021-10-27 10:30:00+00,10433,0,5065,16294,682,1992,2195,129,1620,236,38646,122,25856,23661,18596,10433
2021-10-27 11:00:00+00,10504,0,5064,16292,691,2344,2091,129,2055,222,39392,124,26193,24102,19038,10504
2021-10-27 11:30:00+00,10313,0,5064,16423,681,2350,2101,117,1964,164,39177,123,26233,24132,19068,10313
2021-10-27 12:00:00+00,9827,0,5059,16299,644,2416,2123,118,1730,0,38216,121,25855,23732,18673,9827
2021-10-27 12:30:00+00,9651,0,5063,16324,641,2416,2171,118,1610,0,37994,120,25809,23638,18575,9651
2021-10-27 13:00:00+00,10572,0,5062,16292,667,1522,2174,136,1691,106,38222,124,25886,23712,18650,10572
2021-10-27 13:30:00+00,10481,0,5061,16380,661,1508,2175,118,1615,0,37999,124,25892,23717,18656,10481
2021-10-27 14:00:00+00,10162,0,5061,16382,716,1762,2162,119,1413,0,37777,124,25734,23572,18511,10162
2021-10-27 14:30:00+00,10411,0,5059,16442,731,1764,2139,121,1098,22,37787,127,25469,23330,18271,10411
2021-10-27 15:00:00+00,11373,0,5062,16230,762,1574,2205,136,631,226,38199,135,24890,22685,17623,11373
2021-10-27 15:30:00+00,11936,0,5056,15939,879,1572,2279,141,287,528,38617,139,24440,22161,17105,11936
2021-10-27 16:00:00+00,12005,0,5056,15757,907,1906,2321,192,81,1142,39367,139,24122,21801,16745,12005
2021-10-27 16:30:00+00,12094,0,5054,15610,941,1914,2335,237,0,1424,39609,139,23940,21605,16551,12094
2021-10-27 17:00:00+00,12175,0,5055,15326,944,2266,2340,298,0,1486,39890,141,23665,21325,16270,12175
2021-10-27 17:30:00+00,12300,0,5055,14803,943,2298,2336,326,0,1472,39533,144,23137,20801,15746,12300
2021-10-27 18:00:00+00,12078,0,5060,14554,943,2366,2337,211,0,1166,38715,144,22894,20557,15497,12078
2021-10-27 18:30:00+00,11804,0,5061,14297,822,2336,2288,153,0,858,37619,144,22468,20180,15119,11804
2021-10-27 19:00:00+00,11863,0,5064,14225,821,2000,2288,137,0,432,36830,147,22398,20110,15046,11863
2021-10-27 19:30:00+00,10745,0,5079,14243,821,1988,2299,128,0,0,35303,141,22442,20143,15064,10745
2021-10-27 20:00:00+00,9014,0,5078,13987,801,2049,2311,127,0,0,33367,129,22177,19866,14788,9014
2021-10-27 20:30:00+00,7587,0,5084,13798,748,2060,2316,126,0,0,31720,118,21946,19630,14546,7587
2021-10-27 21:00:00+00,6047,0,5083,13626,724,1904,2310,128,0,78,29900,105,21743,19433,14350,6047
2021-10-27 21:30:00+00,4926,0,5109,13471,724,1899,2256,126,0,0,28511,94,21560,19304,14195,4926
2021-10-27 22:00:00+00,3772,0,5110,13314,700,1332,2143,122,0,0,26493,73,21267,19124,14014,3772
2021-10-27 22:30:00+00,2820,0,5141,13238,674,1260,2030,121,0,0,25284,60,21083,19053,13912,2820
2021-10-27 23:00:00+00,2385,0,5166,13448,599,1444,1948,120,0,0,25110,55,21161,19213,14047,2385
2021-10-27 23:30:00+00,2277,0,5167,13300,552,1432,1945,120,0,0,24793,53,20964,19019,13852,2277
2021-10-28 00:00:00+00,2208,0,5171,13009,551,1380,1918,126,0,0,24363,49,20649,18731,13560,2208
2021-10-28 00:30:00+00,2563,0,5185,13023,624,1382,2094,126,0,0,24997,54,20926,18832,13647,2563
2021-10-28 01:00:00+00,2700,0,5188,12934,628,1510,2188,128,0,0,25276,57,20938,18750,13562,2700
2021-10-28 01:30:00+00,2462,0,5194,12880,608,1510,2147,134,0,0,24935,54,20829,18682,13488,2462
2021-10-28 02:00:00+00,2446,0,5204,13158,512,1422,2081,133,0,0,24956,53,20955,18874,13670,2446
2021-10-28 02:30:00+00,2451,0,5210,13139,510,1422,2119,126,0,0,24977,53,20978,18859,13649,2451
2021-10-28 03:00:00+00,2481,0,5219,13192,508,1372,2232,126,0,0,25130,53,21152,18920,13700,2481
2021-10-28 03:30:00+00,2473,0,5219,13035,508,1362,2123,126,0,0,24846,53,20885,18762,13543,2473
2021-10-28 04:00:00+00,2539,70,5230,12985,502,1204,2024,121,0,0,24675,61,20741,18717,13487,2609
2021-10-28 04:30:00+00,3059,201,5235,12926,506,1212,2010,120,0,0,25269,72,20677,18667,13432,3260
2021-10-28 05:00:00+00,4829,238,5238,12887,574,1050,2099,126,0,0,27041,95,20798,18699,13461,5067
2021-10-28 05:30:00+00,6421,279,5237,12870,577,1050,2231,124,0,88,28877,113,20915,18684,13447,6700
2021-10-28 06:00:00+00,8971,404,5236,12346,826,868,2299,127,0,186,31263,138,20707,18408,13172,9375
2021-10-28 06:30:00+00,10663,501,5237,11887,865,882,2305,169,0,428,32937,154,20294,17989,12752,11164
2021-10-28 07:00:00+00,10646,498,5238,11610,942,2628,2310,279,58,208,34417,158,20158,17848,12610,11144
2021-10-28 07:30:00+00,11224,465,5239,11192,928,2788,2310,141,236,538,35061,160,19905,17595,12356,11689
2021-10-28 08:00:00+00,10919,445,5242,11187,813,4532,2293,127,514,50,36122,156,20049,17756,12514,11364
2021-10-28 08:30:00+00,11046,428,5238,11194,822,4578,2305,129,822,0,36562,156,20381,18076,12838,11474
2021-10-28 09:00:00+00,11161,488,5241,11176,838,4234,2310,128,967,242,36785,157,20532,18222,12981,11649
2021-10-28 09:30:00+00,11177,498,5241,10926,824,4224,2310,198,1129,484,37011,157,20430,18120,12879,11675
2021-10-28 10:00:00+00,11118,500,5248,11116,746,4320,2301,189,1452,170,37160,156,20863,18562,13314,11618
2021-10-28 10:30:00+00,11000,500,5250,11383,697,4328,2308,121,1732,168,37487,153,21370,19062,13812,11500
2021-10-28 11:00:00+00,10999,501,5247,11519,801,4722,2220,122,1913,0,38044,151,21700,19480,14233,11500
2021-10-28 11:30:00+00,10780,500,5251,11512,813,4736,2221,119,2086,0,38018,149,21883,19662,14411,11280
2021-10-28 12:00:00+00,10736,479,5251,11494,791,4732,2196,120,2206,0,38005,148,21938,19742,14491,11215
2021-10-28 12:30:00+00,10548,373,5246,11607,703,4734,2223,121,2106,0,37661,144,21885,19662,14416,10921
2021-10-28 13:00:00+00,10499,370,5251,11658,707,4734,2246,125,1806,0,37396,145,21668,19422,14171,10869
2021-10-28 13:30:00+00,10595,238,5247,11563,680,4734,2260,126,1531,0,36974,144,21281,19021,13774,10833
2021-10-28 14:00:00+00,10659,310,5253,11690,665,4508,2318,120,1268,0,36791,146,21194,18876,13623,10969
2021-10-28 14:30:00+00,11219,334,5245,11538,667,4506,2320,121,940,0,36890,152,20710,18390,13145,11553
2021-10-28 15:00:00+00,12293,328,5236,11065,687,4634,2321,136,563,14,37277,163,19872,17551,12315,12621
2021-10-28 15:30:00+00,12746,431,5238,10665,687,4638,2326,177,171,542,37621,169,19087,16761,11523,13177
2021-10-28 16:00:00+00,13302,358,5241,10511,879,4750,2342,315,18,808,38524,171,18991,16649,11408,13660
2021-10-28 16:30:00+00,13409,350,5232,10385,885,4752,2344,476,0,1530,39363,169,18846,16502,11270,13759
2021-10-28 17:00:00+00,14083,398,5236,10192,895,4496,2334,652,0,1760,40046,174,18657,16323,11087,14481
2021-10-28 17:30:00+00,13736,344,5253,10146,893,4494,2306,565,0,1718,39455,171,18598,16292,11039,14080
2021-10-28 18:00:00+00,13579,301,5292,10057,894,4606,2342,423,0,1292,38786,170,18585,16243,10951,13880
2021-10-28 18:30:00+00,13157,333,5338,10031,789,4608,2313,205,0,1284,38058,168,18471,16158,10820,13490
2021-10-28 19:00:00+00,12852,344,5375,10040,758,4678,2288,134,0,124,36593,172,18461,16173,10798,13196
2021-10-28 19:30:00+00,12007,301,5376,10259,625,4678,2274,123,0,0,35643,166,18534,16260,10884,12308
2021-10-28 20:00:00+00,10266,321,5378,10751,585,4580,2285,119,0,0,34285,152,18999,16714,11336,10587
2021-10-28 20:30:00+00,8350,346,5378,10957,560,4580,2279,119,0,0,32569,138,19174,16895,11517,8696
2021-10-28 21:00:00+00,6959,43,5378,10966,466,4734,2079,119,0,24,30768,120,18889,16810,11432,7002
2021-10-28 21:30:00+00,5763,0,5378,10956,454,4732,1925,124,0,66,29398,108,18713,16788,11410,5763
2021-10-28 22:00:00+00,4395,0,5376,10697,424,4730,1999,121,0,0,27742,95,18496,16497,11121,4395
2021-10-28 22:30:00+00,3463,0,5375,10514,422,4728,1967,119,0,0,26588,85,18278,16311,10936,3463
2021-10-28 23:00:00+00,3055,0,5379,10403,367,4440,1808,124,0,0,25576,81,17957,16149,10770,3055
2021-10-28 23:30:00+00,2898,0,5376,10131,371,4432,1721,125,0,0,25054,80,17599,15878,10502,2898
2021-10-29 00:00:00+00,3131,0,5375,9771,384,4534,1858,135,0,0,25188,81,17388,15530,10155,3131
2021-10-29 00:30:00+00,3089,0,5379,9704,385,4540,2026,135,0,0,25258,80,17494,15468,10089,3089
2021-10-29 01:00:00+00,3051,0,5373,9626,371,4726,1869,128,0,0,25144,80,17239,15370,9997,3051
2021-10-29 01:30:00+00,2772,0,5375,9431,364,4736,1588,128,0,0,24394,77,16758,15170,9795,2772
2021-10-29 02:00:00+00,2634,0,5370,9377,377,4734,1357,130,0,0,23979,74,16481,15124,9754,2634
2021-10-29 02:30:00+00,2552,0,5383,9385,380,4734,1349,124,0,0,23906,73,16497,15148,9765,2552
2021-10-29 03:00:00+00,2487,0,5421,9468,370,4350,1528,128,0,0,23752,73,16787,15259,9838,2487
2021-10-29 03:30:00+00,2340,0,5440,9579,372,4322,1405,128,0,0,23586,70,16796,15391,9951,2340
2021-10-29 04:00:00+00,2471,0,5433,9453,401,3554,1481,121,0,0,22913,69,16768,15287,9854,2471
2021-10-29 04:30:00+00,2658,140,5432,9261,460,3502,1469,121,0,0,23043,78,16622,15153,9721,2798
2021-10-29 05:00:00+00,3306,329,5434,9197,587,3068,1620,121,0,0,23662,98,16838,15218,9784,3635
2021-10-29 05:30:00+00,4119,405,5437,9426,610,3046,1641,120,0,0,24804,109,17114,15473,10036,4524
2021-10-29 06:00:00+00,5358,279,5433,9715,623,2368,1648,122,0,0,25546,119,17419,15771,10338,5637
2021-10-29 06:30:00+00,6435,261,5432,10150,672,2378,1645,152,0,0,27125,127,17899,16254,10822,6696
2021-10-29 07:00:00+00,7393,272,5430,10457,916,4164,1648,152,24,0,30456,129,18475,16827,11397,7665
2021-10-29 07:30:00+00,7919,283,5433,10700,918,4248,1637,175,135,0,31447,132,18823,17186,11753,8202
2021-10-29 08:00:00+00,8266,258,5429,11017,915,4562,1644,209,457,0,32757,131,19462,17818,12389,8524
2021-10-29 08:30:00+00,8481,271,5436,11175,905,4576,1654,178,814,0,33490,131,19984,18330,12894,8752
2021-10-29 09:00:00+00,8641,264,5445,11404,683,4548,1651,148,1462,24,34270,129,20645,18994,13549,8905
2021-10-29 09:30:00+00,8685,295,5469,11786,274,4546,1657,130,1837,14,34693,129,21023,19366,13897,8980
2021-10-29 10:00:00+00,8710,229,5503,11940,425,4586,1647,121,1994,30,35185,126,21509,19862,14359,8939
2021-10-29 10:30:00+00,8684,66,5519,12518,577,4588,1645,121,2161,38,35917,119,22420,20775,15256,8750
2021-10-29 11:00:00+00,8708,0,5522,13237,535,4566,1647,123,2436,0,36774,114,23377,21730,16208,8708
2021-10-29 11:30:00+00,8645,0,5534,13492,535,4572,1639,124,2521,0,37062,113,23721,22082,16548,8645
2021-10-29 12:00:00+00,8599,0,5546,13570,540,4720,1621,133,2610,0,37339,112,23887,22266,16720,8599
2021-10-29 12:30:00+00,8242,0,5570,13529,546,4722,1518,135,3017,0,37279,108,24180,22662,17092,8242
2021-10-29 13:00:00+00,8155,0,5593,13835,549,4240,1562,134,2962,0,37030,107,24501,22939,17346,8155
2021-10-29 13:30:00+00,8168,0,5600,14111,505,4166,1456,135,2786,0,36927,107,24458,23002,17402,8168
2021-10-29 14:00:00+00,9529,0,5593,13886,505,2672,1651,146,2288,0,36270,123,23923,22272,16679,9529
2021-10-29 14:30:00+00,9951,0,5594,14051,508,2606,1648,143,1798,0,36299,127,23599,21951,16357,9951
2021-10-29 15:00:00+00,10622,0,5598,14725,582,1966,1653,143,1257,0,36546,125,23815,22162,16564,10622
2021-10-29 15:30:00+00,12049,0,5603,14253,586,1962,1656,157,695,270,37231,138,22793,21137,15534,12049
2021-10-29 16:00:00+00,12491,0,5606,13552,596,2980,1655,201,155,924,38160,144,21564,19909,14303,12491
2021-10-29 16:30:00+00,13518,0,5620,12920,601,3004,1654,210,0,1414,38941,152,20795,19141,13521,13518
2021-10-29 17:00:00+00,14112,0,5639,12862,666,2928,1651,415,0,1344,39617,157,20818,19167,13528,14112
2021-10-29 17:30:00+00,14025,0,5638,13000,701,2922,1655,413,0,1210,39564,157,20994,19339,13701,14025
2021-10-29 18:00:00+00,13953,0,5651,12779,718,3300,1657,157,0,716,38931,156,20805,19148,13497,13953
2021-10-29 18:30:00+00,13039,0,5652,12768,707,3316,1656,136,0,550,37824,151,20783,19127,13475,13039
2021-10-29 19:00:00+00,13235,0,5661,12131,653,2610,1657,128,0,14,36089,158,20102,18445,12784,13235
2021-10-29 19:30:00+00,12202,0,5661,11757,635,2610,1658,130,0,40,34693,153,19711,18053,12392,12202
2021-10-29 20:00:00+00,10988,0,5670,11070,624,3284,1638,126,0,4,33404,145,19002,17364,11694,10988
2021-10-29 20:30:00+00,9591,0,5671,10879,571,3314,1658,126,0,0,31810,135,18779,17121,11450,9591
2021-10-29 21:00:00+00,8218,0,5673,10678,573,3252,1581,125,0,20,30120,123,18505,16924,11251,8218
2021-10-29 21:30:00+00,6776,0,5670,10597,567,3284,1591,127,0,74,28686,110,18425,16834,11164,6776
2021-10-29 22:00:00+00,4588,0,5681,10607,502,4516,1479,128,0,0,27501,93,18269,16790,11109,4588
2021-10-29 22:30:00+00,3128,0,5695,11058,454,4522,1341,126,0,0,26324,75,18548,17207,11512,3128
2021-10-29 23:00:00+00,3005,0,5695,11360,436,3216,1370,125,0,0,25207,71,18861,17491,11796,3005
2021-10-29 23:30:00+00,2601,0,5697,11812,437,3172,1254,123,0,0,25096,65,19200,17946,12249,2601
2021-10-30 00:00:00+00,2864,0,5698,11787,454,2636,1381,126,0,0,24946,62,19320,17939,12241,2864
2021-10-30 00:30:00+00,3132,0,5698,11767,452,2624,1631,125,0,0,25429,66,19548,17917,12219,3132
2021-10-30 01:00:00+00,3271,0,5695,12105,436,2174,1654,124,0,0,25459,67,19890,18236,12541,3271
2021-10-30 01:30:00+00,3117,0,5699,12169,412,2170,1617,132,0,0,25316,65,19897,18280,12581,3117
2021-10-30 02:00:00+00,3855,0,5693,12043,409,1776,1648,142,0,0,25566,71,19793,18145,12452,3855
2021-10-30 02:30:00+00,3437,0,5697,12609,409,1738,1576,133,0,0,25599,64,20291,18715,13018,3437
2021-10-30 03:00:00+00,3093,0,5728,13474,409,1496,1403,132,0,0,25735,58,21014,19611,13883,3093
2021-10-30 03:30:00+00,2955,0,5769,13455,407,1494,1414,138,0,0,25632,56,21045,19631,13862,2955
2021-10-30 04:00:00+00,2839,0,5780,13343,420,1396,1404,141,0,0,25323,54,20947,19543,13763,2839
2021-10-30 04:30:00+00,3176,0,5781,13164,420,1396,1626,138,0,0,25701,60,20991,19365,13584,3176
2021-10-30 05:00:00+00,3868,0,5783,12937,434,1444,1644,131,0,0,26241,70,20798,19154,13371,3868
2021-10-30 05:30:00+00,4475,0,5806,12461,449,1466,1658,134,0,0,26449,79,20374,18716,12910,4475
2021-10-30 06:00:00+00,4117,0,5853,12406,462,3052,1656,134,0,0,27680,79,20377,18721,12868,4117
2021-10-30 06:30:00+00,5271,0,5856,12091,462,3188,1658,131,0,86,28743,93,20067,18409,12553,5271
2021-10-30 07:00:00+00,6010,0,5855,11558,490,4208,1658,145,3,58,29985,100,19564,17906,12051,6010
2021-10-30 07:30:00+00,7202,0,5858,11264,486,4248,1659,152,76,236,31181,112,19343,17684,11826,7202
2021-10-30 08:00:00+00,8674,0,5860,10943,485,4206,1659,151,311,650,32939,124,19258,17599,11739,8674
2021-10-30 08:30:00+00,9197,0,5865,10940,485,4206,1659,153,842,584,33931,127,19791,18132,12267,9197
2021-10-30 09:00:00+00,9046,0,5874,10968,485,4280,1659,150,1468,612,34542,125,20454,18795,12921,9046
2021-10-30 09:30:00+00,8596,0,5882,11449,485,4286,1651,136,2184,408,35077,118,21651,20000,14118,8596
2021-10-30 10:00:00+00,7794,0,5885,11685,487,4674,1572,122,3620,122,35961,106,23249,21677,15792,7794
2021-10-30 10:30:00+00,7196,0,5880,11727,520,4684,1406,117,4436,0,35966,98,23969,22563,16683,7196
2021-10-30 11:00:00+00,6838,0,5893,12077,470,3946,1449,128,4741,0,35542,91,24630,23181,17288,6838
2021-10-30 11:30:00+00,6487,0,5908,12008,471,3936,1419,137,4880,0,35246,88,24686,23267,17359,6487
2021-10-30 12:00:00+00,6492,0,5937,11881,458,3364,1403,138,4896,156,34725,88,24575,23172,17235,6492
2021-10-30 12:30:00+00,6458,0,5950,11576,458,3346,1462,136,4468,142,33996,89,23914,22452,16502,6458
2021-10-30 13:00:00+00,7015,0,5961,11086,459,2940,1653,138,4168,28,33448,104,23327,21674,15713,7015
2021-10-30 13:30:00+00,7251,0,5990,10684,458,2930,1654,137,3440,182,32726,109,22226,20572,14582,7251
2021-10-30 14:00:00+00,7436,0,6013,10667,461,3146,1651,137,2927,332,32770,108,21719,20068,14055,7436
2021-10-30 14:30:00+00,8126,0,6029,10503,473,3150,1648,137,2113,342,32521,117,20766,19118,13089,8126
2021-10-30 15:00:00+00,9311,0,6025,10144,564,2880,1658,145,1396,912,33035,123,19787,18129,12104,9311
2021-10-30 15:30:00+00,10756,0,6030,9586,771,2876,1657,149,632,1092,33549,138,18676,17019,10989,10756
2021-10-30 16:00:00+00,11808,0,6032,9027,816,3566,1659,224,150,1724,35006,146,17684,16025,9993,11808
2021-10-30 16:30:00+00,12450,0,6042,8781,934,3582,1656,508,0,1896,35849,152,17413,15757,9715,12450
2021-10-30 17:00:00+00,13065,0,6061,8807,937,3440,1703,649,0,1956,36618,156,17508,15805,9744,13065
2021-10-30 17:30:00+00,12460,0,6075,9168,936,3440,1713,752,0,1732,36276,152,17892,16179,10104,12460
2021-10-30 18:00:00+00,11321,0,6067,9584,829,3658,1755,587,0,1512,35313,145,18235,16480,10413,11321
2021-10-30 18:30:00+00,10674,0,6065,9464,740,3658,1811,242,0,1760,34414,138,18080,16269,10204,10674
2021-10-30 19:00:00+00,10902,0,6070,9694,647,3363,2035,159,0,782,33652,143,18446,16411,10341,10902
2021-10-30 19:30:00+00,9899,0,6070,10162,623,3142,2212,158,0,224,32490,133,19067,16855,10785,9899
2021-10-30 20:00:00+00,8428,0,6066,10190,603,3756,2068,145,0,0,31256,122,18927,16859,10793,8428
2021-10-30 20:30:00+00,7413,0,6070,9790,569,3884,2205,126,0,24,30081,116,18634,16429,10359,7413
2021-10-30 21:00:00+00,6188,0,6071,9694,538,4010,2224,123,0,32,28880,109,18527,16303,10232,6188
2021-10-30 21:30:00+00,5259,0,6076,9475,483,4026,1972,129,0,0,27420,101,18006,16034,9958,5259
2021-10-30 22:00:00+00,4161,0,6070,9028,660,4004,1698,131,0,514,26266,94,17456,15758,9688,4161
2021-10-30 22:30:00+00,3397,0,6086,8694,689,3950,1820,128,0,536,25300,85,17289,15469,9383,3397
2021-10-30 23:00:00+00,3722,0,6081,8503,571,2820,2195,127,0,210,24229,92,17350,15155,9074,3722
2021-10-30 23:30:00+00,3680,0,6078,8644,502,2714,2044,127,0,0,23789,91,17268,15224,9146,3680
2021-10-31 00:00:00+00,3180,0,6071,8982,494,2786,2012,126,0,0,23651,81,17559,15547,9476,3180
2021-10-31 00:30:00+00,3245,0,6082,9029,496,2772,2022,127,0,0,23773,82,17629,15607,9525,3245
2021-10-31 01:00:00+00,3667,0,6091,8976,399,1996,2128,126,0,0,23383,89,17594,15466,9375,3667
2021-10-31 01:30:00+00,3413,0,6094,9108,396,1888,2065,125,0,0,23089,84,17663,15598,9504,3413
2021-10-31 02:00:00+00,2946,0,6092,9398,394,1746,1971,128,0,0,22675,67,17855,15884,9792,2946
2021-10-31 02:30:00+00,2781,0,6097,9907,392,1678,1865,126,0,0,22846,63,18261,16396,10299,2781
2021-10-31 03:00:00+00,4309,0,6095,10702,390,434,2036,149,0,0,24115,85,19223,17187,11092,4309
2021-10-31 03:30:00+00,3913,0,6102,11444,389,344,2046,144,0,0,24382,77,19981,17935,11833,3913
2021-10-31 04:00:00+00,3855,0,6103,11978,404,58,2058,144,0,0,24600,74,20543,18485,12382,3855
2021-10-31 04:30:00+00,3290,0,6110,12794,405,50,2043,132,0,0,24824,64,21352,19309,13199,3290
2021-10-31 05:00:00+00,2624,0,6107,13441,429,122,1677,132,0,0,24532,52,21654,19977,13870,2624
2021-10-31 05:30:00+00,2621,0,6042,14080,445,134,1551,133,0,0,25006,51,22118,20567,14525,2621
2021-10-31 06:00:00+00,2481,0,6024,14939,589,316,1542,132,0,0,26023,47,23094,21552,15528,2481
2021-10-31 06:30:00+00,2602,0,6032,15654,659,336,1847,130,0,0,27260,48,24192,22345,16313,2602
2021-10-31 07:00:00+00,2508,0,6039,16197,639,786,2049,123,0,0,28341,45,24924,22875,16836,2508
2021-10-31 07:30:00+00,2944,0,6030,16485,628,1058,2078,123,9,0,29355,50,25230,23152,17122,2944
2021-10-31 08:00:00+00,3075,0,6035,16803,662,1894,2190,132,63,0,30854,51,25753,23563,17528,3075
2021-10-31 08:30:00+00,4132,0,6032,16997,654,1994,2304,127,205,0,32445,62,26192,23888,17856,4132
2021-10-31 09:00:00+00,3656,0,6030,16976,599,2856,2268,132,603,0,33120,55,26476,24208,18178,3656
2021-10-31 09:30:00+00,3931,0,6037,16677,600,2892,2247,131,995,224,33734,57,26556,24309,18272,3931
2021-10-31 10:00:00+00,4474,0,6034,16711,557,2358,2274,164,1713,446,34731,62,27289,25015,18981,4474
2021-10-31 10:30:00+00,4564,0,6038,16842,595,2330,2268,382,2296,110,35425,63,28039,25771,19733,4564
2021-10-31 11:00:00+00,4736,0,6036,16888,564,2104,2253,448,3380,0,36409,65,29121,26868,20832,4736
2021-10-31 11:30:00+00,4883,0,6035,16770,543,2092,2267,291,3990,46,36917,64,29605,27338,21303,4883
2021-10-31 12:00:00+00,5087,0,6037,16223,543,2470,2279,172,4230,204,37245,67,29312,27033,20996,5087
2021-10-31 12:30:00+00,4915,0,6040,16354,518,2484,2147,179,4275,0,36912,65,29334,27187,21147,4915
2021-10-31 13:00:00+00,4765,0,6051,16159,467,2870,2054,114,4094,24,36598,61,28825,26771,20720,4765
2021-10-31 13:30:00+00,4950,0,6052,15420,484,2920,2062,126,3532,0,35546,65,27550,25488,19436,4950
2021-10-31 14:00:00+00,4900,0,6063,15290,489,3190,2054,135,2686,0,34807,66,26582,24528,18465,4900
2021-10-31 14:30:00+00,5051,0,6062,15227,516,3224,2049,133,2066,70,34398,68,25920,23871,17809,5051
2021-10-31 15:00:00+00,5371,0,6071,14909,555,3778,1924,134,1212,184,34138,73,24671,22747,16676,5371
2021-10-31 15:30:00+00,6220,0,6071,14833,527,3796,1861,132,597,286,34323,82,23889,22028,15957,6220
2021-10-31 16:00:00+00,6743,0,6085,14722,532,4464,1768,146,96,700,35256,93,23203,21435,15350,6743
2021-10-31 16:30:00+00,7771,0,6092,14511,654,4704,1820,169,0,1048,36769,103,23077,21257,15165,7771
2021-10-31 17:00:00+00,8166,0,6099,14535,653,4336,2055,300,0,1762,37906,102,23342,21287,15188,8166
2021-10-31 17:30:00+00,7922,0,6105,14415,655,4308,2025,296,0,1922,37648,100,23200,21175,15070,7922
2021-10-31 18:00:00+00,7746,0,6106,14310,660,4144,2045,258,0,2036,37305,97,23121,21076,14970,7746
2021-10-31 18:30:00+00,6903,0,6116,14105,665,4144,2193,212,0,1972,36310,90,23079,20886,14770,6903
2021-10-31 19:00:00+00,6666,0,6116,13863,555,4324,2121,142,0,1480,35267,91,22655,20534,14418,6666
2021-10-31 19:30:00+00,6278,0,6120,13734,558,4298,1932,142,0,990,34052,90,22344,20412,14292,6278
2021-10-31 20:00:00+00,6907,0,6119,13100,725,3428,1875,139,0,762,33055,99,21819,19944,13825,6907
2021-10-31 20:30:00+00,5804,0,6125,12826,692,3410,1776,132,0,976,31741,89,21419,19643,13518,5804
2021-10-31 21:00:00+00,4267,0,6129,13221,518,4316,1719,129,0,230,30529,76,21587,19868,13739,4267
2021-10-31 21:30:00+00,3258,0,6117,13259,505,4236,1713,130,0,0,29218,65,21594,19881,13764,3258
2021-10-31 22:00:00+00,3034,0,5997,13468,515,3434,1703,129,0,0,28280,68,21683,19980,13983,3034
2021-10-31 22:30:00+00,2694,0,5879,13561,518,3208,1623,130,0,0,27613,62,21581,19958,14079,2694
2021-10-31 23:00:00+00,3272,0,5591,13878,520,1796,1303,140,0,0,26500,62,21292,19989,14398,3272
2021-10-31 23:30:00+00,3082,0,5584,13890,475,1718,1175,138,0,0,26062,58,21124,19949,14365,3082
2021-11-01 00:00:00+00,2697,0,5584,13809,476,1760,1133,140,0,0,25599,56,21002,19869,14285,2697
2021-11-01 00:30:00+00,2837,0,5580,13877,478,1720,1134,162,0,0,25788,58,21069,19935,14355,2837
2021-11-01 01:00:00+00,2895,0,5583,13810,481,1370,1135,152,0,0,25426,57,21009,19874,14291,2895
2021-11-01 01:30:00+00,2683,0,5587,13514,494,1452,1135,142,0,0,25007,56,20730,19595,14008,2683
2021-11-01 02:00:00+00,2875,0,5592,13493,499,798,1138,144,0,0,24539,57,20722,19584,13992,2875
2021-11-01 02:30:00+00,2703,0,5599,13428,500,744,1135,133,0,0,24242,55,20662,19527,13928,2703
2021-11-01 03:00:00+00,3825,0,5600,13769,519,78,1207,144,0,0,25142,68,21095,19888,14288,3825
2021-11-01 03:30:00+00,3544,0,5601,13904,519,150,1133,139,0,0,24990,65,21157,20024,14423,3544
2021-11-01 04:00:00+00,4029,0,5596,14085,519,8,1104,141,0,0,25482,69,21304,20200,14604,4029
2021-11-01 04:30:00+00,4112,0,5599,14323,518,6,1103,141,0,0,25802,70,21543,20440,14841,4112
2021-11-01 05:00:00+00,2912,0,5601,14611,518,362,1106,135,0,0,25245,53,21836,20730,15129,2912
2021-11-01 05:30:00+00,3200,0,5606,15134,596,398,1092,143,0,0,26170,55,22428,21336,15730,3200
2021-11-01 06:00:00+00,2958,0,5600,14942,634,2718,1074,144,0,0,28070,51,22250,21176,15576,2958
2021-11-01 06:30:00+00,4034,0,5597,15552,618,2872,1439,182,0,0,30294,63,23206,21767,16170,4034
2021-11-01 07:00:00+00,4630,0,5599,15698,679,4468,1726,170,31,0,33001,75,23733,22007,16408,4630
2021-11-01 07:30:00+00,5729,0,5598,15610,684,4726,1961,139,385,0,34832,86,24238,22277,16679,5729
2021-11-01 08:00:00+00,6302,0,5599,15722,679,4734,1969,137,1174,2,36318,89,25143,23174,17575,6302
2021-11-01 08:30:00+00,6447,0,5593,15667,678,4734,1972,144,2126,48,37409,88,26036,24064,18471,6447
2021-11-01 09:00:00+00,6644,0,5591,15942,677,4734,1989,151,2946,74,38748,87,27145,25156,19565,6644
2021-11-01 09:30:00+00,6616,0,5601,16184,685,4734,1987,131,3546,48,39532,85,28003,26016,20415,6616
2021-11-01 10:00:00+00,6698,0,5600,16123,716,4734,1989,132,3961,0,39953,85,28389,26400,20800,6698
2021-11-01 10:30:00+00,6390,0,5602,16476,731,4734,1989,130,4109,68,40229,81,28907,26918,21316,6390
2021-11-01 11:00:00+00,6496,0,5620,16533,685,4734,1981,129,4048,42,40268,82,28867,26886,21266,6496
2021-11-01 11:30:00+00,6463,0,5608,16718,686,4734,1984,125,4244,86,40648,81,29240,27256,21648,6463
2021-11-01 12:00:00+00,6696,0,5602,16603,692,4734,2098,133,3813,216,40587,84,28808,26710,21108,6696
2021-11-01 12:30:00+00,6814,0,5604,16455,705,4736,2153,132,3677,132,40408,85,28594,26441,20837,6814
2021-11-01 13:00:00+00,7171,0,5608,16143,680,4734,2139,126,3352,384,40337,89,27922,25783,20175,7171
2021-11-01 13:30:00+00,7398,0,5610,15740,666,4734,2073,130,2935,402,39688,92,27024,24951,19341,7398
2021-11-01 14:00:00+00,7700,0,5608,15674,680,4684,2041,132,2423,292,39234,96,26426,24385,18777,7700
2021-11-01 14:30:00+00,8352,0,5606,15527,726,4680,2041,150,1943,246,39271,102,25843,23802,18196,8352
2021-11-01 15:00:00+00,9449,0,5610,15192,805,4424,2042,378,1204,334,39438,112,24853,22811,17201,9449
2021-11-01 15:30:00+00,10869,0,5611,15043,916,4418,2042,459,489,356,40203,125,24101,22059,16448,10869
2021-11-01 16:00:00+00,12394,0,5612,14496,943,4512,2042,462,72,622,41155,138,23165,21123,15511,12394
2021-11-01 16:30:00+00,14321,0,5607,14119,944,4512,2042,512,0,912,42969,150,22712,20670,15063,14321
2021-11-01 17:00:00+00,15773,0,5605,13607,960,4654,2045,545,0,1284,44473,159,22217,20172,14567,15773
2021-11-01 17:30:00+00,16130,0,5604,13098,960,4656,2045,593,0,1462,44548,162,21707,19662,14058,16130
2021-11-01 18:00:00+00,15893,0,5607,12651,975,4756,2043,620,0,1318,43863,164,21276,19233,13626,15893
2021-11-01 18:30:00+00,15347,0,5606,12360,986,4758,2046,576,0,1204,42883,162,20998,18952,13346,15347
2021-11-01 19:00:00+00,15015,0,5603,11832,1008,4756,2046,503,0,938,41701,163,20489,18443,12840,15015
2021-11-01 19:30:00+00,14691,0,5600,11327,1005,4756,2045,271,0,658,40353,163,19977,17932,12332,14691
2021-11-01 20:00:00+00,14176,0,5599,10640,970,4756,2046,226,0,186,38599,165,19255,17209,11610,14176
2021-11-01 20:30:00+00,13349,0,5602,9794,977,4756,2045,186,0,338,37047,163,18418,16373,10771,13349
2021-11-01 21:00:00+00,12674,0,5605,9239,937,4736,2044,160,0,248,35643,161,17825,15781,10176,12674
2021-11-01 21:30:00+00,11692,0,5608,9090,806,4708,2038,154,0,0,34096,157,17542,15504,9896,11692
2021-11-01 22:00:00+00,11106,0,5607,8783,768,3678,2102,143,0,8,32195,157,17260,15158,9551,11106
2021-11-01 22:30:00+00,10091,0,5608,8175,693,3674,2112,148,0,16,30517,153,16588,14476,8868,10091
2021-11-01 23:00:00+00,8423,0,5606,7441,692,4684,2114,153,0,0,29113,140,15853,13739,8133,8423
2021-11-01 23:30:00+00,8287,0,5614,6809,692,4712,2105,142,0,0,28361,142,15220,13115,7501,8287
2021-11-02 00:00:00+00,7988,0,5611,6374,692,4736,2109,147,0,0,27657,152,14786,12677,7066,7988
2021-11-02 00:30:00+00,8246,0,5608,5993,694,4736,2050,170,0,0,27497,157,14345,12295,6687,8246
2021-11-02 01:00:00+00,8384,0,5614,5669,712,4736,1899,146,0,0,27160,160,13894,11995,6381,8384
2021-11-02 01:30:00+00,8296,0,5610,5275,742,4738,1898,143,0,0,26702,161,13525,11627,6017,8296
2021-11-02 02:00:00+00,8073,0,5614,5269,717,4736,1917,165,0,0,26491,159,13517,11600,5986,8073
2021-11-02 02:30:00+00,7862,0,5613,5196,715,4736,1874,160,0,0,26156,158,13398,11524,5911,7862
2021-11-02 03:00:00+00,7927,0,5610,4973,689,4736,1856,151,0,0,25942,160,13128,11272,5662,7927
2021-11-02 03:30:00+00,8058,8,5609,4858,690,4738,1764,148,0,0,25873,162,12921,11157,5548,8066
2021-11-02 04:00:00+00,8340,15,5611,4579,703,4272,1803,136,0,0,25459,165,12696,10893,5282,8355
2021-11-02 04:30:00+00,8544,46,5610,4282,716,4180,1964,134,0,0,25476,170,12572,10608,4998,8590
2021-11-02 05:00:00+00,10808,137,5611,4162,732,1642,2206,135,0,0,25433,192,12711,10505,4894,10945
2021-11-02 05:30:00+00,12166,369,5612,3999,706,1510,2217,132,0,0,26711,211,12534,10317,4705,12535
2021-11-02 06:00:00+00,16029,605,5611,3712,838,694,2226,148,0,84,29947,240,12387,10161,4550,16634
2021-11-02 06:30:00+00,18618,1017,5617,3465,921,694,2235,157,0,200,32924,261,12238,10003,4386,19635
2021-11-02 07:00:00+00,19664,1365,5614,3198,1016,1308,2237,258,26,444,35130,268,12091,9854,4240,21029
2021-11-02 07:30:00+00,20407,1484,5612,2861,1027,1372,2246,322,431,626,36388,271,12177,9931,4319,21891
2021-11-02 08:00:00+00,20712,1441,5616,2581,1036,2638,2235,268,1280,352,38159,265,12748,10513,4897,22153
2021-11-02 08:30:00+00,21079,1370,5615,2335,1030,2682,2239,269,2086,206,38911,262,13305,11066,5451,22449
2021-11-02 09:00:00+00,21097,1151,5610,2010,977,3202,2221,207,2802,520,39797,250,13620,11399,5789,22248
2021-11-02 09:30:00+00,21316,1166,5609,1886,985,3200,2224,163,3708,60,40317,249,14412,12188,6579,22482
2021-11-02 10:00:00+00,21110,1193,5610,1843,986,2348,2225,191,4408,68,39982,250,15072,12847,7237,22303
2021-11-02 10:30:00+00,20928,995,5605,1831,996,2314,2236,222,4773,96,39996,243,15441,13205,7600,21923
2021-11-02 11:00:00+00,20822,954,5611,1780,990,2318,2234,184,5079,104,40076,239,15694,13460,7849,21776
2021-11-02 11:30:00+00,20965,1017,5610,1820,978,2326,2235,190,4860,0,40001,243,15503,13268,7658,21982
2021-11-02 12:00:00+00,20939,1248,5607,1942,945,2180,2236,163,4606,54,39920,248,15336,13100,7493,22187
2021-11-02 12:30:00+00,20160,1234,5608,1849,932,2278,2234,195,4127,238,38855,248,14750,12516,6908,21394
2021-11-02 13:00:00+00,19322,937,5606,1768,930,3678,2109,269,3773,276,38668,238,14186,12077,6471,20259
2021-11-02 13:30:00+00,19987,893,5611,1705,930,3748,2023,308,3566,0,38771,243,13835,11812,6201,20880
2021-11-02 14:00:00+00,20052,946,5617,1695,930,4084,2017,266,3031,0,38638,248,13290,11273,5656,20998
2021-11-02 14:30:00+00,19444,1084,5616,1654,966,4094,2108,296,2183,0,37445,254,12527,10419,4803,20528
2021-11-02 15:00:00+00,19881,1292,5613,1592,978,3668,2253,338,1298,740,37653,263,11734,9481,3868,21173
2021-11-02 15:30:00+00,20307,1598,5612,1525,985,3668,2253,337,455,1276,38016,273,10830,8577,2965,21905
2021-11-02 16:00:00+00,20512,1922,5617,1497,1078,4012,2219,432,69,1272,38630,279,10480,8261,2644,22434
2021-11-02 16:30:00+00,21659,1950,5610,1526,1095,4070,2286,517,0,1722,40435,282,10517,8231,2621,23609
2021-11-02 17:00:00+00,22994,2034,5609,1606,1102,3972,2291,756,0,1948,42312,284,10608,8317,2708,25028
2021-11-02 17:30:00+00,23423,2067,5609,1697,1102,3972,2292,891,0,1606,42659,288,10700,8408,2799,25490
2021-11-02 18:00:00+00,22745,1875,5602,1708,1108,4268,2294,799,0,1866,42265,281,10712,8418,2816,24620
2021-11-02 18:30:00+00,21992,1535,5604,1760,1108,4274,2294,716,0,1850,41133,274,10766,8472,2868,23527
2021-11-02 19:00:00+00,21803,1238,5608,1796,1097,4088,2293,682,0,1752,40357,268,10794,8501,2893,23041
2021-11-02 19:30:00+00,21137,1413,5606,1782,1081,4088,2277,665,0,1598,39647,269,10746,8469,2863,22550
2021-11-02 20:00:00+00,20659,1487,5604,1891,1058,4098,2273,390,0,882,38342,272,10826,8553,2949,22146
2021-11-02 20:30:00+00,20118,1310,5605,2026,1052,4046,2272,240,0,380,37049,269,10955,8683,3078,21428
2021-11-02 21:00:00+00,19583,1121,5603,2111,978,3382,2236,182,0,24,35220,269,10928,8692,3089,20704
2021-11-02 21:30:00+00,18739,774,5605,2135,828,3320,2182,140,0,0,33723,260,10750,8568,2963,19513
2021-11-02 22:00:00+00,17338,342,5608,2163,699,3156,2185,138,0,28,31657,245,10655,8470,2862,17680
2021-11-02 22:30:00+00,15649,34,5607,2229,705,3150,2187,132,0,0,29693,230,10728,8541,2934,15683
2021-11-02 23:00:00+00,15392,0,5610,2344,683,1828,2193,142,0,0,28192,240,10830,8637,3027,15392
2021-11-02 23:30:00+00,14802,0,5609,2343,678,1802,2133,128,0,0,27495,236,10763,8630,3021,14802
2021-11-03 00:00:00+00,13737,0,5611,2371,595,3372,1977,138,0,0,27801,224,10554,8577,2966,13737
2021-11-03 00:30:00+00,13685,0,5614,2469,595,3420,1991,138,0,0,27912,223,10669,8678,3064,13685
2021-11-03 01:00:00+00,13860,0,5617,2576,595,2966,1987,132,0,0,27733,224,10775,8788,3171,13860
2021-11-03 01:30:00+00,13538,0,5610,2771,595,2956,1989,134,0,0,27593,221,10965,8976,3366,13538
2021-11-03 02:00:00+00,12866,0,5618,3031,566,3252,1991,133,0,0,27457,218,11206,9215,3597,12866
2021-11-03 02:30:00+00,12314,0,5613,3232,552,3222,1993,132,0,0,27058,213,11390,9397,3784,12314
2021-11-03 03:00:00+00,12953,0,5613,3226,551,2248,1990,132,0,0,26713,216,11380,9390,3777,12953
2021-11-03 03:30:00+00,12730,0,5617,3486,550,2234,1977,131,0,0,26725,213,11630,9653,4036,12730
2021-11-03 04:00:00+00,13092,0,5608,3845,549,1490,1993,132,0,0,26709,207,11995,10002,4394,13092
2021-11-03 04:30:00+00,12910,0,5611,4168,553,1390,1994,145,0,0,26771,203,12326,10332,4721,12910
2021-11-03 05:00:00+00,15028,144,5612,4148,554,694,2147,291,0,0,28618,225,12461,10314,4702,15172
2021-11-03 05:30:00+00,15837,462,5612,4079,543,684,2193,214,0,24,29648,237,12427,10234,4622,16299
2021-11-03 06:00:00+00,17497,888,5618,4334,672,654,2192,163,0,50,32068,251,12816,10624,5006,18385
2021-11-03 06:30:00+00,19189,1052,5616,4541,725,830,2185,151,0,290,34579,259,13067,10882,5266,20241
2021-11-03 07:00:00+00,19828,1407,5616,4832,863,666,2165,280,16,760,36433,263,13492,11327,5711,21235
2021-11-03 07:30:00+00,20940,1494,5620,4797,929,672,2090,457,294,668,37961,270,13730,11640,6020,22434
2021-11-03 08:00:00+00,21446,1498,5614,4829,923,280,2109,493,752,164,38108,272,14227,12118,6504,22944
2021-11-03 08:30:00+00,21555,1499,5621,4799,900,275,2101,467,1485,202,38904,267,14906,12805,7184,23054
2021-11-03 09:00:00+00,21641,1493,5619,4855,922,620,1994,476,2237,356,40213,262,15627,13633,8014,23134
2021-11-03 09:30:00+00,21632,1491,5619,5148,953,648,1935,484,2979,62,40951,257,16634,14699,9080,23123
2021-11-03 10:00:00+00,21739,1496,5613,5404,971,220,1929,532,3579,252,41736,251,17496,15568,9954,23235
2021-11-03 10:30:00+00,21722,1496,5616,5489,954,184,1931,537,3905,122,41956,250,17895,15964,10348,23218
2021-11-03 11:00:00+00,21766,1494,5616,5848,781,606,1930,529,3554,0,42124,254,17729,15799,10183,23260
2021-11-03 11:30:00+00,21858,1499,5612,5938,772,618,1927,531,3429,252,42436,253,17678,15751,10139,23357
2021-11-03 12:00:00+00,21855,1496,5616,6217,732,638,1957,303,2922,352,42088,254,17444,15487,9871,23351
2021-11-03 12:30:00+00,21777,1495,5612,6288,712,636,2005,301,2500,192,41518,257,17117,15112,9500,23272
2021-11-03 13:00:00+00,22039,1497,5613,6700,712,492,2002,311,2258,226,41850,256,17285,15283,9670,23536
2021-11-03 13:30:00+00,21814,1321,5616,7714,695,148,2002,308,1739,90,41447,248,17766,15764,10148,23135
2021-11-03 14:00:00+00,21303,1106,5622,8741,672,202,2004,268,1424,0,41342,240,18463,16459,10837,22409
2021-11-03 14:30:00+00,21261,963,5618,9094,671,224,2003,315,1129,32,41310,237,18515,16512,10894,22224
2021-11-03 15:00:00+00,20532,963,5622,9155,600,516,2002,261,571,292,40514,234,17950,15948,10326,21495
2021-11-03 15:30:00+00,20623,935,5615,9456,622,716,2006,279,212,602,41066,233,17911,15905,10290,21558
2021-11-03 16:00:00+00,20360,682,5617,9606,663,1368,2062,347,32,834,41571,222,17980,15918,10301,21042
2021-11-03 16:30:00+00,21066,501,5612,9793,798,1298,2105,455,0,1310,42938,219,18308,16203,10591,21567
2021-11-03 17:00:00+00,21328,502,5616,10051,827,1354,2107,602,0,1364,43751,221,18601,16494,10878,21830
2021-11-03 17:30:00+00,20731,379,5611,10348,826,1740,2108,568,0,1380,43691,212,18893,16785,11174,21110
2021-11-03 18:00:00+00,20162,325,5613,10560,826,1544,2108,438,0,1038,42614,208,19107,16999,11386,20487
2021-11-03 18:30:00+00,19398,323,5609,10790,829,1580,2106,353,0,1030,42018,203,19334,17228,11619,19721
2021-11-03 19:00:00+00,18578,459,5611,10862,801,1780,2106,218,0,230,40645,205,19380,17274,11663,19037
2021-11-03 19:30:00+00,17618,457,5615,11173,767,1732,2106,189,0,0,39657,200,19661,17555,11940,18075
2021-11-03 20:00:00+00,16653,283,5613,11880,775,1660,2108,149,0,0,39122,185,20376,18268,12655,16936
2021-11-03 20:30:00+00,15462,23,5608,12030,770,1654,2107,130,0,0,37783,172,20515,18408,12800,15485
2021-11-03 21:00:00+00,14256,12,5605,12150,740,1056,2099,126,0,24,36067,165,20594,18495,12890,14268
2021-11-03 21:30:00+00,12666,0,5546,12266,628,1074,2087,118,0,0,34385,154,20528,18440,12894,12666
2021-11-03 22:00:00+00,11127,0,5491,12541,524,2256,2087,162,0,0,34188,143,20643,18556,13065,11127
2021-11-03 22:30:00+00,9686,0,5489,12451,495,2396,2085,129,0,42,32774,133,20520,18435,12946,9686
2021-11-03 23:00:00+00,8502,0,5494,12566,501,4194,2084,131,0,0,33472,131,20645,18561,13067,8502
2021-11-03 23:30:00+00,7599,0,5494,12582,484,4254,2005,119,0,0,32537,124,20565,18560,13066,7599
2021-11-04 00:00:00+00,7115,0,5496,12726,486,3906,1782,124,0,0,31635,116,20490,18708,13212,7115
2021-11-04 00:30:00+00,6732,0,5493,12760,485,3990,1805,142,0,0,31407,114,20543,18738,13245,6732
2021-11-04 01:00:00+00,6179,0,5500,12648,449,3824,1788,124,0,0,30512,110,20385,18597,13097,6179
2021-11-04 01:30:00+00,5491,0,5500,12663,448,3564,1522,125,0,0,29314,100,20133,18611,13111,5491
2021-11-04 02:00:00+00,4938,0,5500,12570,433,3262,1467,128,0,0,28298,96,19970,18503,13003,4938
2021-11-04 02:30:00+00,4439,0,5490,12678,433,3229,1503,137,0,0,27909,90,20104,18601,13111,4439
2021-11-04 03:00:00+00,3986,0,5497,12610,431,3271,1505,138,0,0,27438,85,20043,18538,13041,3986
2021-11-04 03:30:00+00,3467,0,5501,12595,430,3254,1571,157,0,0,26975,79,20097,18526,13025,3467
2021-11-04 04:00:00+00,3226,0,5499,12596,449,2808,1593,133,0,0,26304,78,20137,18544,13045,3226
2021-11-04 04:30:00+00,3035,0,5496,12780,451,2778,1590,150,0,0,26280,75,20317,18727,13231,3035
2021-11-04 05:00:00+00,4900,0,5493,12646,540,2166,1311,139,0,0,27195,94,19990,18679,13186,4900
2021-11-04 05:30:00+00,6073,0,5486,12853,560,2070,1452,148,0,0,28642,105,20351,18899,13413,6073
2021-11-04 06:00:00+00,9902,0,5409,13066,605,872,1581,468,0,94,31997,135,20661,19080,13671,9902
2021-11-04 06:30:00+00,13461,0,5399,12825,679,870,1592,255,0,0,35081,161,20495,18903,13504,13461
2021-11-04 07:00:00+00,15065,0,5395,12619,720,980,1592,153,9,244,36777,170,20335,18743,13348,15065
2021-11-04 07:30:00+00,16875,0,5399,12407,789,980,1596,170,237,114,38567,181,20428,18832,13433,16875
2021-11-04 08:00:00+00,17322,0,5400,12113,825,1604,1612,201,804,414,40295,184,20754,19142,13742,17322
2021-11-04 08:30:00+00,17780,0,5403,12037,802,1686,1619,264,1638,0,41229,185,21499,19880,14477,17780
2021-11-04 09:00:00+00,18082,0,5403,11918,845,1450,1619,201,2456,0,41974,184,22241,20622,15219,18082
2021-11-04 09:30:00+00,17760,0,5402,11800,845,1450,1788,144,3092,18,42299,179,22927,21139,15737,17760
2021-11-04 10:00:00+00,16920,0,5400,11757,848,1708,1981,90,3632,0,42336,174,23618,21637,16237,16920
2021-11-04 10:30:00+00,16755,0,5397,11700,852,1716,2004,94,3889,0,42407,172,23842,21838,16441,16755
2021-11-04 11:00:00+00,16091,0,5400,11650,661,2196,1999,88,3828,0,41913,170,23538,21539,16139,16091
2021-11-04 11:30:00+00,16199,0,5391,11498,667,2210,1997,88,4355,26,42431,168,23908,21911,16520,16199
2021-11-04 12:00:00+00,16031,0,5397,11551,551,2744,2002,82,4061,0,42419,168,23562,21560,16163,16031
2021-11-04 12:30:00+00,16105,0,5402,11300,545,2788,2150,112,3726,52,42180,170,23123,20973,15571,16105
2021-11-04 13:00:00+00,15689,0,5396,11182,530,3516,2270,107,3155,0,41845,169,22533,20263,14867,15689
2021-11-04 13:30:00+00,15486,0,5396,11119,529,3568,2268,108,2648,0,41122,171,21960,19692,14296,15486
2021-11-04 14:00:00+00,15524,0,5348,10815,546,4064,2261,114,2291,0,40963,173,21261,19000,13652,15524
2021-11-04 14:30:00+00,16005,56,5273,10583,552,4082,2253,102,1449,0,40355,181,20110,17857,12584,16061
2021-11-04 15:00:00+00,16815,270,5275,10569,581,3614,2277,85,923,120,40529,192,19625,17348,12073,17085
2021-11-04 15:30:00+00,17571,577,5271,10527,588,3600,2288,88,349,118,40977,204,19023,16735,11464,18148
2021-11-04 16:00:00+00,17735,912,5369,10721,661,4248,2291,109,35,666,42747,206,19077,16786,11417,18647
2021-11-04 16:30:00+00,18097,1117,5481,10658,935,4268,2292,169,0,1460,44477,206,19366,17074,11593,19214
2021-11-04 17:00:00+00,18249,1400,5505,10911,969,4614,2304,309,0,1406,45667,210,19689,17385,11880,19649
2021-11-04 17:30:00+00,18056,1491,5495,10933,989,4618,2305,299,0,1410,45596,211,19722,17417,11922,19547
2021-11-04 18:00:00+00,18176,1445,5494,10827,989,4202,2292,341,0,1520,45286,211,19602,17310,11816,19621
2021-11-04 18:30:00+00,18201,1384,5493,10626,989,4200,2260,250,0,1298,44701,212,19368,17108,11615,19585
2021-11-04 19:00:00+00,18307,1496,5491,10619,988,3386,2205,106,0,644,43242,221,19303,17098,11607,19803
2021-11-04 19:30:00+00,17363,1495,5492,10822,984,3370,2211,95,0,182,42014,218,19509,17298,11806,18858
2021-11-04 20:00:00+00,16024,1152,5492,11329,870,3610,2242,83,0,0,40802,203,19933,17691,12199,17176
2021-11-04 20:30:00+00,14536,819,5493,11583,857,3644,2286,93,0,0,39311,188,20219,17933,12440,15355
2021-11-04 21:00:00+00,12141,614,5490,11684,815,4600,2279,89,0,0,37712,169,20268,17989,12499,12755
2021-11-04 21:30:00+00,11017,310,5487,11259,760,4602,2254,84,0,8,35781,158,19760,17506,12019,11327
2021-11-04 22:00:00+00,10338,6,5491,10851,662,3978,2250,89,0,6,33671,149,19254,17004,11513,10344
2021-11-04 22:30:00+00,8755,0,5487,10444,610,3974,2245,118,0,68,31701,138,18786,16541,11054,8755
2021-11-04 23:00:00+00,7087,0,5496,10182,582,4362,2252,106,0,0,30067,126,18512,16260,10764,7087
2021-11-04 23:30:00+00,5954,0,5495,10263,559,4374,2253,87,0,0,28985,115,18570,16317,10822,5954
2021-11-05 00:00:00+00,5479,0,5493,10119,499,4438,2276,87,0,0,28391,111,18387,16111,10618,5479
2021-11-05 00:30:00+00,5992,0,5492,10152,496,4442,2286,91,0,0,28951,116,18426,16140,10648,5992
2021-11-05 01:00:00+00,5631,0,5498,10240,484,4620,2285,98,0,0,28856,112,18507,16222,10724,5631
2021-11-05 01:30:00+00,5204,0,5421,10283,485,4626,2216,82,0,0,28317,108,18405,16189,10768,5204
2021-11-05 02:00:00+00,5317,0,5285,9872,483,4662,2248,90,0,0,27957,112,17888,15640,10355,5317
2021-11-05 02:30:00+00,5475,0,5273,9750,473,4662,2288,90,0,0,28011,114,17784,15496,10223,5475
2021-11-05 03:00:00+00,5554,0,5272,9512,470,4284,2288,231,0,0,27611,115,17542,15254,9982,5554
2021-11-05 03:30:00+00,5640,0,5265,9187,470,4272,2287,290,0,0,27411,118,17209,14922,9657,5640
2021-11-05 04:00:00+00,5730,0,5264,8718,469,4126,2324,242,0,0,26873,121,16775,14451,9187,5730
2021-11-05 04:30:00+00,5979,68,5269,8493,479,4098,2327,239,0,0,26952,127,16568,14241,8972,6047
2021-11-05 05:00:00+00,6396,136,5264,8276,533,3546,2325,184,0,0,26660,135,16398,14073,8809,6532
2021-11-05 05:30:00+00,7357,515,5268,8320,567,3474,2351,89,0,0,27941,155,16506,14155,8887,7872
2021-11-05 06:00:00+00,11094,980,5264,8485,853,1600,2382,89,0,166,30913,195,16984,14602,9338,12074
2021-11-05 06:30:00+00,14189,1376,5267,7943,861,1544,2367,109,0,220,33876,223,16438,14071,8804,15565
2021-11-05 07:00:00+00,16564,1494,5270,7618,854,2034,2363,211,8,288,36704,239,16113,13750,8480,18058
2021-11-05 07:30:00+00,17508,1501,5269,7614,743,2050,2359,490,275,424,38233,241,16260,13901,8632,19009
2021-11-05 08:00:00+00,17421,1493,5274,7512,747,3634,2361,361,975,458,40236,230,16869,14508,9234,18914
2021-11-05 08:30:00+00,17669,1495,5333,7209,852,3814,2363,324,1828,334,41221,227,17585,15222,9889,19164
2021-11-05 09:00:00+00,17424,1372,5452,7056,863,4520,2355,139,2617,132,41930,219,18343,15988,10536,18796
2021-11-05 09:30:00+00,17590,1443,5495,6857,859,4538,2363,117,3301,94,42657,219,18875,16512,11017,19033
2021-11-05 10:00:00+00,17501,1311,5500,6645,849,4648,2349,116,3799,52,42770,215,19142,16793,11293,18812
2021-11-05 10:30:00+00,17462,1113,5493,6528,853,4638,2344,116,3821,52,42420,212,19039,16695,11202,18575
2021-11-05 11:00:00+00,18049,980,5486,6337,837,4112,2347,130,4103,46,42427,213,19110,16763,11277,19029
2021-11-05 11:30:00+00,18051,987,5491,6065,824,4092,2359,126,4058,92,42145,215,18797,16438,10947,19038
2021-11-05 12:00:00+00,17973,993,5489,6128,781,4174,2213,132,3745,0,41628,216,18356,16143,10654,18966
2021-11-05 12:30:00+00,18111,991,5487,6376,710,4188,2333,125,3395,68,41784,217,18301,15968,10481,19102
2021-11-05 13:00:00+00,17907,805,5491,6849,710,4358,2337,134,2683,0,41274,214,18070,15733,10242,18712
2021-11-05 13:30:00+00,17641,663,5486,6977,723,4350,2336,131,2223,30,40560,212,17745,15409,9923,18304
2021-11-05 14:00:00+00,18024,612,5488,7224,723,3988,2334,120,1956,0,40469,214,17725,15391,9903,18636
2021-11-05 14:30:00+00,18247,579,5461,7353,723,3972,2334,124,1300,28,40121,217,17171,14837,9376,18826
2021-11-05 15:00:00+00,18773,767,5305,7622,741,3510,2336,117,583,40,39794,227,16587,14251,8946,19540
2021-11-05 15:30:00+00,19451,836,5263,7538,759,3532,2339,172,166,282,40338,232,16065,13726,8463,20287
2021-11-05 16:00:00+00,19707,861,5256,7460,856,4504,2338,242,12,326,41562,231,15922,13584,8328,20568
2021-11-05 16:30:00+00,19958,913,5256,7655,962,4532,2343,394,0,648,42661,230,16216,13873,8617,20871
2021-11-05 17:00:00+00,20133,891,5261,7774,1032,4718,2349,607,0,1578,44343,225,16416,14067,8806,21024
2021-11-05 17:30:00+00,20035,814,5345,7765,1058,4720,2355,511,0,1680,44283,222,16523,14168,8823,20849
2021-11-05 18:00:00+00,19859,911,5380,7942,884,3884,2341,318,0,1450,42969,226,16547,14206,8826,20770
2021-11-05 18:30:00+00,19183,803,5377,8002,883,3864,2336,249,0,1238,41935,222,16598,14262,8885,19986
2021-11-05 19:00:00+00,19949,697,5380,7930,882,2984,2335,165,0,148,40470,233,16527,14192,8812,20646
2021-11-05 19:30:00+00,19079,692,5374,7902,878,2908,2322,156,0,8,39319,231,16476,14154,8780,19771
2021-11-05 20:00:00+00,18600,708,5371,7948,762,2250,2337,121,0,148,38245,230,16418,14081,8710,19308
2021-11-05 20:30:00+00,17332,376,5373,8155,753,2252,2338,118,0,132,36829,217,16619,14281,8908,17708
2021-11-05 21:00:00+00,15258,38,5372,8253,726,2524,2339,115,0,40,34665,199,16690,14351,8979,15296
2021-11-05 21:30:00+00,13591,0,5281,8619,713,2512,2339,126,0,0,33181,187,16952,14613,9332,13591
2021-11-05 22:00:00+00,12286,0,5270,8976,715,2060,2340,116,0,0,31763,178,17301,14961,9691,12286
2021-11-05 22:30:00+00,10291,0,5271,9333,693,2094,2276,89,0,18,30065,162,17573,15297,10026,10291
2021-11-05 23:00:00+00,6684,0,5270,9656,666,3836,2244,83,0,0,28439,125,17836,15592,10322,6684
2021-11-05 23:30:00+00,5275,0,5272,9646,692,3944,2220,83,0,0,27132,110,17830,15610,10338,5275
2021-11-06 00:00:00+00,4331,0,5280,9870,591,4236,2202,92,0,0,26602,93,17943,15741,10461,4331
2021-11-06 00:30:00+00,3747,0,5359,10302,558,4328,2216,87,0,0,26597,86,18435,16219,10860,3747
2021-11-06 01:00:00+00,3291,0,5479,10357,540,4190,2161,83,0,0,26101,81,18537,16376,10897,3291
2021-11-06 01:30:00+00,2849,0,5489,10300,535,4228,1912,96,0,0,25409,76,18236,16324,10835,2849
2021-11-06 02:00:00+00,2829,0,5493,10323,511,3948,1767,89,0,0,24960,78,18094,16327,10834,2829
2021-11-06 02:30:00+00,2870,0,5493,10311,509,3850,1728,85,0,0,24846,78,18041,16313,10820,2870
2021-11-06 03:00:00+00,2785,0,5496,10625,506,3616,1645,95,0,0,24768,77,18272,16627,11131,2785
2021-11-06 03:30:00+00,2803,0,5492,10506,490,3542,1499,83,0,0,24415,77,17987,16488,10996,2803
2021-11-06 04:00:00+00,2813,0,5488,10834,488,3132,1221,85,0,0,24061,78,18031,16810,11322,2813
2021-11-06 04:30:00+00,2617,0,5491,11179,487,3134,1142,96,0,0,24146,75,18299,17157,11666,2617
2021-11-06 05:00:00+00,2593,0,5491,11945,502,2630,1287,91,0,0,24539,75,19225,17938,12447,2593
2021-11-06 05:30:00+00,2649,0,5489,12312,539,2720,1303,77,0,0,25089,75,19643,18340,12851,2649
2021-11-06 06:00:00+00,2886,0,5482,12759,606,2572,1404,89,0,0,25798,75,20251,18847,13365,2886
2021-11-06 06:30:00+00,3423,0,5484,13027,610,2714,1556,111,0,0,26925,83,20677,19121,13637,3423
2021-11-06 07:00:00+00,3570,0,5485,13160,615,3212,1489,86,0,60,27677,80,20749,19260,13775,3570
2021-11-06 07:30:00+00,4114,0,5489,13563,613,3276,1572,107,102,0,28836,85,21339,19767,14278,4114
2021-11-06 08:00:00+00,5322,0,5488,13798,581,3512,1570,84,302,26,30683,98,21739,20169,14681,5322
2021-11-06 08:30:00+00,6128,0,5489,14230,581,3518,1577,85,555,0,32163,104,22432,20855,15366,6128
2021-11-06 09:00:00+00,5911,0,5410,15012,573,4132,1591,111,824,14,33578,97,23410,21819,16409,5911
2021-11-06 09:30:00+00,5741,0,5288,15537,578,4150,1588,128,1330,0,34340,93,24321,22733,17445,5741
2021-11-06 10:00:00+00,5744,0,5273,15618,580,4276,1567,108,1711,28,34905,93,24749,23182,17909,5744
2021-11-06 10:30:00+00,5824,0,5276,15805,579,4180,1561,82,1883,0,35190,91,25104,23543,18267,5824
2021-11-06 11:00:00+00,6004,0,5271,16080,579,3822,1562,95,1851,64,35328,90,25343,23781,18510,6004
2021-11-06 11:30:00+00,5840,0,5278,16408,579,3804,1558,80,1676,0,35223,88,25499,23941,18663,5840
2021-11-06 12:00:00+00,6567,0,5304,16829,557,3062,1560,84,1746,24,35733,91,25996,24436,19132,6567
2021-11-06 12:30:00+00,6271,0,5352,17123,557,3012,1558,79,1618,0,35570,88,26208,24650,19298,6271
2021-11-06 13:00:00+00,5733,0,5448,17094,559,3092,1557,88,1584,62,35217,86,26242,24685,19237,5733
2021-11-06 13:30:00+00,5714,0,5466,17077,563,3094,1560,79,1213,0,34766,86,25879,24319,18853,5714
2021-11-06 14:00:00+00,5821,0,5471,17051,565,3140,1560,78,953,0,34639,89,25600,24040,18569,5821
2021-11-06 14:30:00+00,5973,0,5459,17030,566,3098,1561,89,631,24,34431,91,25247,23686,18227,5973
2021-11-06 15:00:00+00,6603,0,5519,17032,576,3080,1558,78,326,74,34846,99,25011,23453,17934,6603
2021-11-06 15:30:00+00,6859,0,5550,17107,575,3008,1581,79,106,0,34865,102,24919,23338,17788,6859
2021-11-06 16:00:00+00,7488,0,5569,17183,596,3140,1574,74,3,0,35627,98,24925,23351,17782,7488
2021-11-06 16:30:00+00,8712,0,5589,17584,593,3334,1585,90,0,288,37775,107,25351,23766,18177,8712
2021-11-06 17:00:00+00,8639,0,5631,17705,576,3834,1586,158,0,668,38797,108,25498,23912,18281,8639
2021-11-06 17:30:00+00,8070,0,5674,17941,567,3754,1582,144,0,1010,38742,101,25764,24182,18508,8070
2021-11-06 18:00:00+00,8075,0,5686,17868,566,3458,1584,125,0,1008,38370,97,25704,24120,18434,8075
2021-11-06 18:30:00+00,7370,0,5700,17852,568,3432,1570,117,0,722,37331,92,25690,24120,18420,7370
2021-11-06 19:00:00+00,7196,0,5716,17688,567,3088,1563,75,0,4,35897,98,25534,23971,18255,7196
2021-11-06 19:30:00+00,6413,0,5708,17546,566,3068,1563,75,0,0,34939,91,25383,23820,18112,6413
2021-11-06 20:00:00+00,5675,0,5708,17263,579,2842,1564,77,0,0,33708,86,25114,23550,17842,5675
2021-11-06 20:30:00+00,5061,0,5708,17032,571,2834,1562,78,0,0,32846,81,24873,23311,17603,5061
2021-11-06 21:00:00+00,4732,0,5750,16582,568,2716,1560,75,0,0,31983,78,24460,22900,17150,4732
2021-11-06 21:30:00+00,3866,0,5779,16369,570,2704,1559,74,0,0,30921,70,24277,22718,16939,3866
2021-11-06 22:00:00+00,4268,0,5790,16020,570,2174,1612,75,0,0,30509,71,23992,22380,16590,4268
2021-11-06 22:30:00+00,4110,0,5791,15515,553,2104,1371,81,0,0,29525,70,23230,21859,16068,4110
2021-11-06 23:00:00+00,4029,0,5786,15713,549,1068,1002,94,0,0,28241,68,23050,22048,16262,4029
2021-11-06 23:30:00+00,3833,0,5788,15835,533,988,1036,80,0,0,28093,66,23192,22156,16368,3833
2021-11-07 00:00:00+00,3821,0,5797,15808,527,826,1042,82,0,0,27903,65,23174,22132,16335,3821
2021-11-07 00:30:00+00,3959,0,5812,15714,525,802,1261,93,0,0,28166,68,23312,22051,16239,3959
2021-11-07 01:00:00+00,3589,0,5822,15933,525,572,1469,83,0,0,27993,64,23749,22280,16458,3589
2021-11-07 01:30:00+00,3219,0,5852,16011,495,572,1447,82,0,0,27678,59,23805,22358,16506,3219
2021-11-07 02:00:00+00,3126,0,5862,15949,485,814,1229,81,0,0,27546,59,23525,22296,16434,3126
2021-11-07 02:30:00+00,3055,0,5872,15897,489,816,1229,83,0,0,27441,59,23487,22258,16386,3055
2021-11-07 03:00:00+00,2978,0,5874,15826,482,850,1196,102,0,0,27308,59,23378,22182,16308,2978
2021-11-07 03:30:00+00,2878,0,5880,15650,443,850,1127,94,0,0,26922,58,23100,21973,16093,2878
2021-11-07 04:00:00+00,2771,0,5885,15589,444,666,1154,106,0,0,26615,55,23072,21918,16033,2771
2021-11-07 04:30:00+00,2733,0,5890,15516,444,664,1156,92,0,0,26495,55,23006,21850,15960,2733
2021-11-07 05:00:00+00,2721,0,5896,15614,446,710,1148,83,0,0,26618,54,23104,21956,16060,2721
2021-11-07 05:30:00+00,2790,0,5894,15832,461,706,1177,86,0,0,26946,55,23364,22187,16293,2790
2021-11-07 06:00:00+00,3484,0,5894,15696,481,426,1452,80,0,0,27513,62,23523,22071,16177,3484
2021-11-07 06:30:00+00,3862,0,5891,15525,539,424,1487,96,0,0,27824,67,23442,21955,16064,3862
2021-11-07 07:00:00+00,3718,0,5891,15637,547,588,1480,77,3,0,27941,65,23558,22078,16187,3718
2021-11-07 07:30:00+00,4081,0,5895,15927,547,592,1565,76,232,0,28915,68,24166,22601,16706,4081
2021-11-07 08:00:00+00,4305,0,5895,15915,585,1648,1577,86,794,0,30805,72,24766,23189,17294,4305
2021-11-07 08:30:00+00,4880,0,5887,15925,581,1726,1573,87,1474,0,32133,76,25440,23867,17980,4880
2021-11-07 09:00:00+00,4457,0,5887,16087,597,2082,1576,78,2100,0,32864,69,26247,24671,18784,4457
2021-11-07 09:30:00+00,4590,0,5889,16155,565,2134,1555,86,2989,0,33963,68,27153,25598,19709,4590
2021-11-07 10:00:00+00,3932,0,5897,16402,592,2342,1559,88,3559,0,34371,60,28009,26450,20553,3932
2021-11-07 10:30:00+00,3469,0,5897,16601,606,2352,1563,79,4076,0,34643,54,28743,27180,21283,3469
2021-11-07 11:00:00+00,3393,0,5895,16521,589,2586,1582,80,4459,24,35129,54,29046,27464,21569,3393
2021-11-07 11:30:00+00,3583,0,5923,16773,601,2566,1582,78,4756,0,35862,55,29635,28053,22130,3583
2021-11-07 12:00:00+00,3698,0,5907,16970,618,2586,1582,100,4525,74,36060,56,29602,28020,22113,3698
2021-11-07 12:30:00+00,4001,0,5919,17162,619,2578,1581,81,4341,0,36282,59,29622,28041,22122,4001
2021-11-07 13:00:00+00,3120,0,5924,16932,612,4060,1377,90,3731,172,36018,53,28576,27199,21275,3120
2021-11-07 13:30:00+00,3444,0,5930,16679,598,4134,1562,79,3006,0,35432,58,27775,26213,20283,3444
2021-11-07 14:00:00+00,3636,0,5928,16202,596,4606,1502,102,2418,46,35036,61,26646,25144,19216,3636
2021-11-07 14:30:00+00,4644,0,5944,15828,597,4650,1589,88,1747,4,35091,72,25705,24116,18172,4644
2021-11-07 15:00:00+00,6204,0,5954,15681,590,4660,1582,79,973,0,35723,88,24780,23198,17244,6204
2021-11-07 15:30:00+00,7677,0,5956,15616,642,4672,1588,100,379,0,36630,102,24181,22593,16637,7677
2021-11-07 16:00:00+00,9174,0,5959,14984,783,4726,1594,85,21,242,37568,115,23341,21747,15788,9174
2021-11-07 16:30:00+00,11356,0,5963,14381,755,4718,1583,202,0,670,39628,132,22682,21099,15136,11356
2021-11-07 17:00:00+00,12492,0,5967,13867,783,4214,1581,588,0,1570,41062,139,22198,20617,14650,12492
2021-11-07 17:30:00+00,12386,0,5977,13789,785,4206,1566,653,0,1564,40926,139,22117,20551,14574,12386
2021-11-07 18:00:00+00,11801,0,5978,13766,761,4170,1570,587,0,1460,40093,136,22075,20505,14527,11801
2021-11-07 18:30:00+00,11149,0,5984,13627,759,4168,1576,415,0,1178,38856,132,21946,20370,14386,11149
2021-11-07 19:00:00+00,10937,0,5981,13388,760,4146,1586,391,0,714,37903,133,21715,20129,14148,10937
2021-11-07 19:30:00+00,10326,0,5986,13336,767,4146,1585,327,0,610,37083,129,21674,20089,14103,10326
2021-11-07 20:00:00+00,10203,0,5987,12789,810,4146,1581,206,0,330,36052,130,21167,19586,13599,10203
2021-11-07 20:30:00+00,9876,0,5986,11928,959,4150,1573,148,0,194,34814,131,20446,18873,12887,9876
2021-11-07 21:00:00+00,8746,0,5983,11147,828,4396,1580,184,0,320,33184,124,19538,17958,11975,8746
2021-11-07 21:30:00+00,8211,0,5987,10368,822,4394,1578,140,0,134,31634,123,18755,17177,11190,8211
2021-11-07 22:00:00+00,7606,0,5993,9507,819,4060,1587,145,0,132,29849,122,17906,16319,10326,7606
2021-11-07 22:30:00+00,6865,0,6002,8763,819,4056,1630,137,0,130,28402,118,17214,15584,9582,6865
2021-11-07 23:00:00+00,7610,0,6014,7950,772,2768,1634,129,0,132,27009,128,16370,14736,8722,7610
2021-11-07 23:30:00+00,7630,0,6016,7131,728,2758,1651,153,0,0,26067,134,15526,13875,7859,7630
2021-11-08 00:00:00+00,7096,0,6009,6600,541,3722,1738,152,0,0,25858,138,14888,13150,7141,7096
2021-11-08 00:30:00+00,7550,0,6014,5915,540,3825,1966,163,0,0,25973,148,14435,12469,6455,7550
2021-11-08 01:00:00+00,7582,0,6014,5216,538,4069,2140,151,0,0,25710,155,13908,11768,5754,7582
2021-11-08 01:30:00+00,7599,0,6017,4704,534,4078,2165,102,0,0,25199,159,13420,11255,5238,7599
2021-11-08 02:00:00+00,7795,0,6021,4227,524,4079,2183,91,0,0,24920,164,12955,10772,4751,7795
2021-11-08 02:30:00+00,7938,0,6019,3899,516,4085,2196,89,0,0,24742,168,12630,10434,4415,7938
2021-11-08 03:00:00+00,7615,0,6022,3587,497,4390,2232,91,0,0,24434,170,12338,10106,4084,7615
2021-11-08 03:30:00+00,7543,0,6022,3697,495,4290,2273,97,0,0,24416,168,12487,10214,4192,7543
2021-11-08 04:00:00+00,7201,85,6025,3681,490,3996,2272,96,0,0,23846,168,12468,10196,4171,7286
2021-11-08 04:30:00+00,7390,267,6027,3619,491,3864,2270,99,0,0,24027,175,12407,10137,4110,7657
2021-11-08 05:00:00+00,9063,659,6032,3656,514,3024,2265,90,0,0,25303,208,12467,10202,4170,9722
2021-11-08 05:30:00+00,10520,771,6040,3712,526,2907,2266,94,0,0,26836,221,12544,10278,4238,11291
2021-11-08 06:00:00+00,13475,1021,6033,3592,835,2376,2281,100,0,0,29713,239,12741,10460,4427,14496
2021-11-08 06:30:00+00,15913,1423,6035,3574,886,2333,2292,109,0,202,32767,258,12787,10495,4460,17336
2021-11-08 07:00:00+00,18755,1492,6034,3590,900,1561,2308,301,0,346,35287,267,12832,10524,4490,20247
2021-11-08 07:30:00+00,19701,1494,6030,3787,890,1540,2305,460,160,400,36767,268,13172,10867,4837,21195
2021-11-08 08:00:00+00,19955,1498,6030,4221,889,1927,2306,600,537,454,38417,263,13983,11677,5647,21453
2021-11-08 08:30:00+00,19647,1497,6030,4831,886,1863,2297,581,970,492,39094,255,15014,12717,6687,21144
2021-11-08 09:00:00+00,20074,1498,6034,5309,683,1665,2286,544,1225,576,39894,250,15537,13251,7217,21572
2021-11-08 09:30:00+00,20324,1497,6039,5875,682,1568,2285,447,1574,192,40483,248,16455,14170,8131,21821
2021-11-08 10:00:00+00,20546,1496,6050,6354,689,1742,2285,457,2014,0,41633,246,17392,15107,9057,22042
2021-11-08 10:30:00+00,20338,1500,6058,6507,692,1704,2289,448,2533,0,42069,241,18079,15790,9732,21838
2021-11-08 11:00:00+00,20052,1496,6056,6586,567,1872,2290,459,2873,0,42251,241,18372,16082,10026,21548
2021-11-08 11:30:00+00,19544,1498,6050,6783,559,2048,2291,357,3181,0,42311,237,18864,16573,10523,21042
2021-11-08 12:00:00+00,19794,1495,6049,7051,493,2108,2293,89,3018,166,42556,237,18904,16611,10562,21289
2021-11-08 12:30:00+00,19903,1498,6045,7326,491,2100,2277,105,2603,0,42348,240,18742,16465,10420,21401
2021-11-08 13:00:00+00,19720,1356,6046,7715,497,1984,2196,99,2175,0,41788,237,18629,16433,10387,21076
2021-11-08 13:30:00+00,19635,1197,6049,7956,497,1998,2207,99,1964,0,41602,234,18673,16466,10417,20832
2021-11-08 14:00:00+00,19647,1211,6048,8056,508,1984,2211,104,1272,0,41041,236,18095,15884,9836,20858
2021-11-08 14:30:00+00,19852,1321,6050,8038,512,2056,2217,96,724,0,40866,243,17541,15324,9274,21173
2021-11-08 15:00:00+00,20399,1484,6051,7774,511,1684,2219,90,356,0,40568,250,16911,14692,8641,21883
2021-11-08 15:30:00+00,20855,1492,6043,7699,544,1670,2219,101,100,228,40951,252,16605,14386,8343,22347
2021-11-08 16:00:00+00,21364,1462,6045,7430,693,1648,2219,194,4,740,41799,252,16391,14172,8127,22826
2021-11-08 16:30:00+00,21649,1499,6052,7851,805,1744,2220,426,0,1482,43728,247,16928,14708,8656,23148
2021-11-08 17:00:00+00,21804,1503,6060,8570,851,1908,2217,601,0,1638,45152,243,17698,15481,9421,23307
2021-11-08 17:30:00+00,21447,1413,6057,9265,719,1868,2212,578,0,1760,45319,237,18253,16041,9984,22860
2021-11-08 18:00:00+00,21198,1502,6074,9760,575,1548,2220,527,0,1492,44896,235,18629,16409,10335,22700
2021-11-08 18:30:00+00,21323,1498,6078,9553,576,1358,2223,537,0,648,43794,240,18430,16207,10129,22821
2021-11-08 19:00:00+00,21603,1502,6078,9955,545,1192,2224,360,0,70,43529,242,18802,16578,10500,23105
2021-11-08 19:30:00+00,20713,1407,6078,9690,529,1094,2229,200,0,0,41940,238,18526,16297,10219,22120
2021-11-08 20:00:00+00,19715,1011,6078,9701,521,1098,2226,107,0,56,40513,227,18526,16300,10222,20726
2021-11-08 20:30:00+00,18420,423,6079,9805,504,1148,2218,100,0,94,38791,210,18606,16388,10309,18843
2021-11-08 21:00:00+00,16086,253,6078,9760,499,1496,2212,100,0,96,36580,196,18549,16337,10259,16339
2021-11-08 21:30:00+00,14238,35,6078,9502,503,1672,2195,99,0,204,34526,182,18278,16083,10005,14273
2021-11-08 22:00:00+00,12727,0,6078,9395,466,1610,2176,100,0,122,32674,173,18115,15939,9861,12727
2021-11-08 22:30:00+00,10991,0,6072,9250,467,1558,2118,122,0,114,30692,161,17907,15789,9717,10991
2021-11-08 23:00:00+00,7938,0,6083,9092,452,2336,2088,116,0,0,28105,141,17715,15627,9544,7938
2021-11-08 23:30:00+00,6825,0,6090,9056,445,2242,2087,111,0,0,26856,130,17678,15591,9501,6825
2021-11-09 00:00:00+00,6983,0,6091,8983,440,2374,2091,115,0,0,27077,131,17605,15514,9423,6983
2021-11-09 00:30:00+00,7071,0,6091,9055,440,2374,2087,119,0,0,27237,131,17673,15586,9495,7071
2021-11-09 01:00:00+00,6861,0,6090,9128,428,2402,2089,113,0,0,27111,130,17735,15646,9556,6861
2021-11-09 01:30:00+00,5897,0,6093,9417,428,2368,2138,112,0,0,26453,118,18076,15938,9845,5897
2021-11-09 02:00:00+00,5159,0,6100,9279,413,2704,2167,116,0,0,25938,111,17959,15792,9692,5159
2021-11-09 02:30:00+00,4388,0,6106,9852,413,2710,2169,116,0,0,25754,101,18540,16371,10265,4388
2021-11-09 03:00:00+00,4296,0,6109,10019,435,2682,2171,116,0,0,25828,98,18734,16563,10454,4296
2021-11-09 03:30:00+00,4214,0,6106,9814,482,2666,1987,116,0,0,25385,98,18389,16402,10296,4214
2021-11-09 04:00:00+00,4225,15,6115,9864,480,2610,1736,120,0,0,25165,98,18195,16459,10344,4240
2021-11-09 04:30:00+00,4473,30,6119,9824,462,2598,1583,119,0,0,25208,102,17988,16405,10286,4503
2021-11-09 05:00:00+00,5202,301,6110,9847,496,1564,1625,132,0,0,25277,116,18078,16453,10343,5503
2021-11-09 05:30:00+00,5829,738,6111,9660,491,1544,1635,116,0,0,26124,136,17897,16262,10151,6567
2021-11-09 06:00:00+00,9627,1213,6107,9426,573,694,2089,124,0,184,30037,174,18195,16106,9999,10840
2021-11-09 06:30:00+00,12803,1448,6109,8874,572,694,2206,112,0,52,32870,204,17761,15555,9446,14251
2021-11-09 07:00:00+00,15416,1496,6107,8735,722,1064,2218,112,0,120,35990,220,17782,15564,9457,16912
2021-11-09 07:30:00+00,16868,1497,6106,8762,706,1106,2202,113,128,52,37540,227,17904,15702,9596,18365
2021-11-09 08:00:00+00,17140,1497,6105,8919,702,1550,2208,132,657,0,38910,226,18591,16383,10278,18637
2021-11-09 08:30:00+00,17010,1462,6102,9117,687,1562,2211,128,1277,0,39556,221,19394,17183,11081,18472
2021-11-09 09:00:00+00,16452,1313,6101,9322,686,1556,2214,102,2094,0,39840,208,20417,18203,12102,17765
2021-11-09 09:30:00+00,15725,1427,6106,9721,671,1552,2195,101,2745,0,40243,201,21438,19243,13137,17152
2021-11-09 10:00:00+00,15295,1249,6103,10028,678,1222,2197,96,3213,0,40081,191,22219,20022,13919,16544
2021-11-09 10:30:00+00,14642,1274,6097,10438,661,1218,2210,101,3493,0,40134,185,22899,20689,14592,15916
2021-11-09 11:00:00+00,14901,1414,6086,10702,497,1068,2227,105,3413,216,40629,187,22925,20698,14612,16315
2021-11-09 11:30:00+00,15039,1407,6097,11117,514,1068,2243,108,2956,0,40549,188,22927,20684,14587,16446
2021-11-09 12:00:00+00,14663,1345,6102,11325,503,1236,2245,113,2459,0,39991,187,22634,20389,14287,16008
2021-11-09 12:30:00+00,14946,1399,6112,11265,487,1240,2220,105,1913,0,39687,192,21997,19777,13665,16345
2021-11-09 13:00:00+00,15330,1313,6112,11067,485,1424,2240,110,1505,0,39586,195,21409,19169,13057,16643
2021-11-09 13:30:00+00,15304,1289,6109,10953,493,1434,2337,109,1223,0,39251,197,21115,18778,12669,16593
2021-11-09 14:00:00+00,15779,1371,6108,10474,496,1982,2355,105,945,0,39615,207,20378,18023,11915,17150
2021-11-09 14:30:00+00,16442,1474,6113,10039,521,1984,2368,105,601,0,39647,215,19642,17274,11161,17916
2021-11-09 15:00:00+00,16484,1271,6115,9865,555,1264,2359,103,301,0,38317,213,19195,16836,10721,17755
2021-11-09 15:30:00+00,17596,1201,6111,9647,573,1280,2352,108,88,140,39096,218,18771,16419,10308,18797
2021-11-09 16:00:00+00,18113,1345,6113,9266,712,1780,2368,217,2,710,40626,219,18461,16093,9980,19458
2021-11-09 16:30:00+00,18865,1491,6115,9234,834,1810,2376,296,0,1352,42373,221,18559,16183,10068,20356
2021-11-09 17:00:00+00,19229,1494,6113,9401,887,2506,2373,646,0,1324,43973,219,18774,16401,10288,20723
2021-11-09 17:30:00+00,19581,1494,6115,9317,888,1896,2391,564,0,1528,43774,222,18711,16320,10205,21075
2021-11-09 18:00:00+00,20338,1490,6126,9226,888,332,2390,584,0,1290,42664,234,18630,16240,10114,21828
2021-11-09 18:30:00+00,20105,1491,6127,9179,819,270,2388,368,0,1148,41895,234,18513,16125,9998,21596
2021-11-09 19:00:00+00,19813,1493,6127,9226,788,1372,2393,136,0,404,41752,237,18534,16141,10014,21306
2021-11-09 19:30:00+00,19367,1481,6127,9376,779,1410,2379,109,0,64,41092,236,18661,16282,10155,20848
2021-11-09 20:00:00+00,18700,1252,6123,9298,779,1604,2373,106,0,34,40269,232,18573,16200,10077,19952
2021-11-09 20:30:00+00,17545,816,6127,9439,766,1610,2365,100,0,0,38768,219,18697,16332,10205,18361
2021-11-09 21:00:00+00,15634,401,6127,9668,731,1576,2355,134,0,14,36640,200,18881,16526,10399,16035
2021-11-09 21:30:00+00,14216,37,6129,9613,605,1574,2362,103,0,0,34639,186,18709,16347,10218,14253
2021-11-09 22:00:00+00,12869,0,6123,9338,667,1482,2366,95,0,94,33034,177,18494,16128,10005,12869
2021-11-09 22:30:00+00,11227,0,6130,9432,588,1480,2361,100,0,0,31318,166,18511,16150,10020,11227
2021-11-09 23:00:00+00,9853,0,6125,9792,571,1360,2361,111,0,0,30173,155,18849,16488,10363,9853
2021-11-09 23:30:00+00,9323,0,6126,9704,561,1360,2361,97,0,0,29532,151,18752,16391,10265,9323
2021-11-10 00:00:00+00,8966,0,6124,9486,500,1464,2287,98,0,0,28925,151,18397,16110,9986,8966
2021-11-10 00:30:00+00,9173,0,6124,9492,505,1464,2368,103,0,0,29229,152,18489,16121,9997,9173
2021-11-10 01:00:00+00,8877,0,6115,9182,476,1354,2369,108,0,0,28481,150,18142,15773,9658,8877
2021-11-10 01:30:00+00,8738,0,6130,8722,474,1352,2372,109,0,0,27897,152,17698,15326,9196,8738
2021-11-10 02:00:00+00,9078,0,6130,8033,467,1350,2374,107,0,0,27539,158,17004,14630,8500,9078
2021-11-10 02:30:00+00,9294,0,6122,7591,466,1340,2376,107,0,0,27296,162,16555,14179,8057,9294
2021-11-10 03:00:00+00,9857,0,6123,6913,458,734,2373,104,0,0,26562,167,15867,13494,7371,9857
2021-11-10 03:30:00+00,10529,0,6122,6097,457,726,2367,100,0,0,26398,178,15043,12676,6554,10529
2021-11-10 04:00:00+00,10745,0,6121,5501,456,878,2352,96,0,0,26149,185,14430,12078,5957,10745
2021-11-10 04:30:00+00,11242,140,6126,5063,461,870,2343,86,0,0,26331,196,13993,11650,5524,11382
2021-11-10 05:00:00+00,12349,563,6127,4902,492,160,2330,80,0,0,27003,214,13851,11521,5394,12912
2021-11-10 05:30:00+00,13384,1047,6124,4606,526,150,2303,90,0,0,28230,235,13559,11256,5132,14431
2021-11-10 06:00:00+00,15814,1367,6125,4373,544,168,2314,89,0,128,30922,255,13356,11042,4917,17181
2021-11-10 06:30:00+00,18534,1491,6118,4128,544,174,2315,159,0,136,33599,271,13105,10790,4672,20025
2021-11-10 07:00:00+00,20072,1498,6116,3875,744,1090,2317,179,0,170,36061,276,13052,10735,4619,21570
2021-11-10 07:30:00+00,20929,1498,6118,3640,786,1142,2334,412,40,228,37127,280,12918,10584,4466,22427
2021-11-10 08:00:00+00,21001,1500,6119,3531,727,1682,2339,455,172,486,38012,278,12888,10549,4430,22501
2021-11-10 08:30:00+00,21501,1498,6116,3274,727,1692,2351,505,390,522,38576,280,12858,10507,4391,22999
2021-11-10 09:00:00+00,22130,1497,6114,3181,723,1270,2351,520,673,422,38881,280,13042,10691,4577,23627
2021-11-10 09:30:00+00,22401,1498,6113,3154,711,1280,2355,522,885,172,39091,281,13218,10863,4750,23899
2021-11-10 10:00:00+00,22509,1500,6114,3040,605,1420,2372,492,1094,46,39192,283,13225,10853,4739,24009
2021-11-10 10:30:00+00,22535,1502,6116,2712,592,1442,2378,463,1276,480,39496,281,13074,10696,4580,24037
2021-11-10 11:00:00+00,22230,1499,6121,2725,534,1702,2385,384,1343,442,39365,279,13108,10723,4602,23729
2021-11-10 11:30:00+00,22157,1451,6120,3011,526,1751,2390,307,1461,438,39611,275,13508,11118,4998,23608
2021-11-10 12:00:00+00,22103,1424,6113,3145,490,2498,2371,258,1424,530,40356,269,13543,11172,5059,23527
2021-11-10 12:30:00+00,22150,1490,6120,3256,536,2517,2371,265,1247,250,40202,273,13530,11159,5039,23640
2021-11-10 13:00:00+00,22350,1419,6124,3222,624,1863,2364,351,1029,0,39346,279,13363,10999,4875,23769
2021-11-10 13:30:00+00,22102,1347,6124,2908,613,1869,2363,295,839,38,38498,281,12847,10484,4360,23449
2021-11-10 14:00:00+00,21943,1193,6119,2536,593,2931,2365,279,713,334,39007,275,12326,9961,3842,23136
2021-11-10 14:30:00+00,22148,960,6122,2588,621,2992,2365,359,454,38,38646,275,12150,9785,3663,23108
2021-11-10 15:00:00+00,21875,984,6121,2882,657,1612,2371,289,209,906,37906,274,12240,9869,3748,22859
2021-11-10 15:30:00+00,21983,1002,6125,3057,697,1690,2371,326,50,1192,38493,272,12300,9929,3804,22985
2021-11-10 16:00:00+00,21826,917,6128,3123,768,3866,2374,406,0,1340,40748,259,12393,10019,3891,22743
2021-11-10 16:30:00+00,22666,970,6121,3192,776,4028,2409,457,0,2152,42772,258,12498,10089,3968,23636
2021-11-10 17:00:00+00,22949,998,6122,3357,794,4374,2450,601,0,2122,43766,257,12723,10273,4151,23947
2021-11-10 17:30:00+00,23023,1086,6118,3354,795,4444,2391,587,0,2332,44130,257,12658,10267,4149,24109
2021-11-10 18:00:00+00,22981,1129,6124,3273,805,3709,2402,594,0,2274,43291,261,12604,10202,4078,24110
2021-11-10 18:30:00+00,22530,974,6128,3271,808,3729,2383,355,0,2222,42399,256,12590,10207,4079,23504
2021-11-10 19:00:00+00,22364,1067,6134,3322,774,3209,2376,333,0,1536,41115,265,12606,10230,4096,23431
2021-11-10 19:30:00+00,22070,982,6134,3463,755,3163,2374,274,0,760,39975,266,12726,10352,4218,23052
2021-11-10 20:00:00+00,21958,1022,6131,3569,584,2144,2342,232,0,672,38654,271,12626,10284,4153,22980
2021-11-10 20:30:00+00,21504,812,6126,3821,580,2129,2331,145,0,54,37502,269,12858,10527,4401,22316
2021-11-10 21:00:00+00,20768,617,6130,4124,535,1682,2332,127,0,236,36551,261,13121,10789,4659,21385
2021-11-10 21:30:00+00,19061,367,6133,4122,531,1680,2330,126,0,86,34436,250,13116,10786,4653,19428
2021-11-10 22:00:00+00,17823,237,6134,4166,506,1488,2331,157,0,184,33026,240,13137,10806,4672,18060
2021-11-10 22:30:00+00,15872,286,6128,4290,478,1542,2329,102,0,24,31051,232,13225,10896,4768,16158
2021-11-10 23:00:00+00,14097,302,6130,4021,471,1692,2327,113,0,0,29153,221,12949,10622,4492,14399
2021-11-10 23:30:00+00,13650,159,6132,4092,464,1680,2323,108,0,0,28608,214,13011,10688,4556,13809
2021-11-11 00:00:00+00,13462,0,6132,4291,455,1662,2323,106,0,0,28431,209,13201,10878,4746,13462
2021-11-11 00:30:00+00,13514,0,6127,4095,457,1666,2327,115,0,0,28301,211,13006,10679,4552,13514
2021-11-11 01:00:00+00,13025,0,6123,4023,458,1864,2329,113,0,0,27935,211,12933,10604,4481,13025
2021-11-11 01:30:00+00,12488,0,6129,4113,460,1868,2330,110,0,0,27498,207,13032,10702,4573,12488
2021-11-11 02:00:00+00,12332,0,6125,4242,447,1758,2331,118,0,0,27353,205,13145,10814,4689,12332
2021-11-11 02:30:00+00,12272,0,6125,4034,436,1758,2331,108,0,0,27064,207,12926,10595,4470,12272
2021-11-11 03:00:00+00,11879,0,6130,3971,443,2014,2331,109,0,0,26877,204,12875,10544,4414,11879
2021-11-11 03:30:00+00,11599,0,6124,3927,456,2018,2331,111,0,0,26566,202,12838,10507,4383,11599
2021-11-11 04:00:00+00,11853,0,6124,3840,456,1654,2332,113,0,0,26372,203,12752,10420,4296,11853
2021-11-11 04:30:00+00,12253,0,6130,3607,455,1678,2331,107,0,0,26561,208,12523,10192,4062,12253
2021-11-11 05:00:00+00,12883,0,6121,3436,476,1626,2322,109,0,0,26973,216,12355,10033,3912,12883
2021-11-11 05:30:00+00,13585,0,6129,3269,487,1726,2327,115,0,0,27638,222,12212,9885,3756,13585
2021-11-11 06:00:00+00,15972,137,6126,3084,532,1468,2330,141,0,524,30314,234,12072,9742,3616,16109
2021-11-11 06:30:00+00,18592,384,6125,2718,577,1488,2338,138,0,482,32842,255,11758,9420,3295,18976
2021-11-11 07:00:00+00,20378,496,6124,2468,926,1748,2343,177,0,198,34858,263,11861,9518,3394,20874
2021-11-11 07:30:00+00,20889,655,6125,2247,948,1836,2343,298,86,384,35811,268,11749,9406,3281,21544
2021-11-11 08:00:00+00,20753,657,6127,2098,942,3008,2340,183,341,410,36859,258,11848,9508,3381,21410
2021-11-11 08:30:00+00,20871,678,6129,2064,924,3226,2338,167,846,316,37559,256,12301,9963,3834,21549
2021-11-11 09:00:00+00,20906,714,6073,1984,937,3896,2330,134,1306,136,38416,255,12630,10300,4227,21620
2021-11-11 09:30:00+00,20930,809,6001,1923,937,3916,2257,154,1552,166,38645,256,12670,10413,4412,21739
2021-11-11 10:00:00+00,20890,914,6004,1933,920,3410,2094,233,1798,178,38374,261,12749,10655,4651,21804
2021-11-11 10:30:00+00,20937,787,5998,1959,910,3378,2095,141,2042,174,38421,257,13004,10909,4911,21724
2021-11-11 11:00:00+00,20975,804,6000,2191,782,2970,2100,176,2221,300,38519,256,13294,11194,5194,21779
2021-11-11 11:30:00+00,21067,835,6012,2528,728,3128,2103,234,2383,0,39018,257,13754,11651,5639,21902
2021-11-11 12:00:00+00,21135,729,6008,2858,630,3710,2119,121,2110,52,39472,253,13725,11606,5598,21864
2021-11-11 12:30:00+00,20929,646,6009,3256,646,3848,2120,125,1583,66,39228,252,13614,11494,5485,21575
2021-11-11 13:00:00+00,20964,619,6011,3872,603,3520,2110,118,1221,0,39038,254,13817,11707,5696,21583
2021-11-11 13:30:00+00,20200,645,6010,4554,601,3506,2110,126,980,0,38732,249,14255,12145,6135,20845
2021-11-11 14:00:00+00,20530,823,6018,5023,646,2556,2125,343,692,32,38788,252,14504,12379,6361,21353
2021-11-11 14:30:00+00,20240,745,6019,5455,640,2544,2145,251,427,0,38466,249,14686,12541,6522,20985
2021-11-11 15:00:00+00,20450,785,6008,5706,667,1884,2169,143,208,32,38052,251,14758,12589,6581,21235
2021-11-11 15:30:00+00,20482,954,6008,6360,696,1834,2199,218,52,4,38807,251,15315,13116,7108,21436
2021-11-11 16:00:00+00,20016,936,6018,7063,833,2426,2345,325,0,542,40504,243,16259,13914,7896,20952
2021-11-11 16:30:00+00,20500,890,6015,7924,806,2480,2411,309,0,598,41933,239,17156,14745,8730,21390
2021-11-11 17:00:00+00,20163,1263,6011,8622,689,2216,2433,513,0,976,42886,240,17755,15322,9311,21426
2021-11-11 17:30:00+00,19768,1378,5974,9008,576,2214,2465,642,0,1032,43057,239,18023,15558,9584,21146
2021-11-11 18:00:00+00,20115,1388,5913,9636,576,1960,2469,629,0,864,43550,236,18594,16125,10212,21503
2021-11-11 18:30:00+00,19952,1141,5917,10240,577,1892,2455,450,0,334,42958,231,19189,16734,10817,21093
2021-11-11 19:00:00+00,19557,852,5910,10374,557,1846,2482,323,0,128,42029,224,19323,16841,10931,20409
2021-11-11 19:30:00+00,18627,467,5917,10785,536,1836,2477,116,0,0,40761,212,19715,17238,11321,19094
2021-11-11 20:00:00+00,16612,427,5916,11384,492,2214,2473,129,0,0,39647,201,20265,17792,11876,17039
2021-11-11 20:30:00+00,14761,272,5920,11742,487,2232,2481,106,0,0,38001,187,20630,18149,12229,15033
2021-11-11 21:00:00+00,12879,232,5917,11798,486,2692,2472,104,0,0,36580,175,20673,18201,12284,13111
2021-11-11 21:30:00+00,11186,182,5919,11720,486,2686,2436,109,0,10,34734,164,20561,18125,12206,11368
2021-11-11 22:00:00+00,10194,0,5919,11649,477,2118,2474,104,0,0,32935,152,20519,18045,12126,10194
2021-11-11 22:30:00+00,8411,0,5916,11503,474,1970,2480,107,0,0,30861,137,20373,17893,11977,8411
2021-11-11 23:00:00+00,5797,0,5918,11759,476,2296,2475,124,0,0,28845,116,20628,18153,12235,5797
2021-11-11 23:30:00+00,4632,0,5923,12164,459,2430,2468,104,0,0,28180,105,21014,18546,12623,4632
2021-11-12 00:00:00+00,4218,0,5919,12168,462,2418,2470,115,0,0,27770,99,21019,18549,12630,4218
2021-11-12 00:30:00+00,3955,0,5919,12447,439,2418,2466,126,0,0,27770,95,21271,18805,12886,3955
2021-11-12 01:00:00+00,3698,0,5923,12931,430,2370,2448,126,0,0,27926,90,21732,19284,13361,3698
2021-11-12 01:30:00+00,3284,0,5921,13035,447,2370,2281,137,0,0,27475,85,21684,19403,13482,3284
2021-11-12 02:00:00+00,3167,0,5857,13488,440,2296,2284,122,0,0,27654,82,22069,19785,13928,3167
2021-11-12 02:30:00+00,3126,0,5822,13766,455,2296,2088,122,0,0,27675,80,22131,20043,14221,3126
2021-11-12 03:00:00+00,3137,0,5820,13943,458,2152,1849,123,0,0,27482,78,22070,20221,14401,3137
2021-11-12 03:30:00+00,3097,0,5827,13991,455,2152,1722,128,0,0,27372,77,21995,20273,14446,3097
2021-11-12 04:00:00+00,3107,0,5823,13906,458,1838,1690,121,0,0,26943,73,21877,20187,14364,3107
2021-11-12 04:30:00+00,3055,0,5828,13911,463,1812,1758,130,0,0,26957,72,21960,20202,14374,3055
2021-11-12 05:00:00+00,3235,0,5820,13886,582,1641,2297,159,0,0,27620,73,22585,20288,14468,3235
2021-11-12 05:30:00+00,3766,0,5822,14049,605,1470,2461,146,0,0,28319,77,22937,20476,14654,3766
2021-11-12 06:00:00+00,4988,0,5824,14453,623,1470,2465,153,0,0,29976,89,23365,20900,15076,4988
2021-11-12 06:30:00+00,7279,0,5826,15029,611,1470,2463,122,0,0,32800,108,23929,21466,15640,7279
2021-11-12 07:00:00+00,9939,0,5821,14985,621,1814,2480,135,0,102,35897,132,23907,21427,15606,9939
2021-11-12 07:30:00+00,10643,0,5825,15086,630,1714,2478,122,18,102,36618,136,24037,21559,15734,10643
2021-11-12 08:00:00+00,11347,0,5822,15235,577,2272,2496,128,156,0,38033,144,24286,21790,15968,11347
2021-11-12 08:30:00+00,10978,0,5803,15774,516,2306,2583,128,390,128,38606,139,25066,22483,16680,10978
2021-11-12 09:00:00+00,10862,0,5792,16404,489,2536,2627,126,717,32,39585,134,26029,23402,17610,10862
2021-11-12 09:30:00+00,10558,0,5798,16515,531,2488,2633,136,1007,0,39666,131,26484,23851,18053,10558
2021-11-12 10:00:00+00,10320,0,5641,16556,549,2630,2634,123,1527,0,39980,127,26907,24273,18632,10320
2021-11-12 10:30:00+00,10431,0,5632,16716,547,2566,2637,129,1992,0,40650,125,27524,24887,19255,10431
2021-11-12 11:00:00+00,10399,0,5633,16735,535,2632,2614,134,2059,58,40799,125,27576,24962,19329,10399
2021-11-12 11:30:00+00,10174,0,5639,16806,525,2646,2690,124,2217,0,40821,123,27877,25187,19548,10174
2021-11-12 12:00:00+00,9748,0,5636,16813,513,2808,2776,126,1843,82,40345,121,27581,24805,19169,9748
2021-11-12 12:30:00+00,9654,0,5644,16673,512,2834,2728,125,1750,0,39920,121,27307,24579,18935,9654
2021-11-12 13:00:00+00,9458,0,5636,16346,553,3050,2673,119,1620,10,39465,121,26828,24155,18519,9458
2021-11-12 13:30:00+00,9195,25,5638,16038,614,3080,2596,130,1384,0,38700,122,26270,23674,18036,9220
2021-11-12 14:00:00+00,9477,192,5639,15760,779,2912,2631,128,1025,0,38543,129,25834,23203,17564,9669
2021-11-12 14:30:00+00,9466,443,5637,15528,811,2894,2719,131,691,0,38320,135,25386,22667,17030,9909
2021-11-12 15:00:00+00,9326,566,5636,15194,829,2550,2740,145,305,0,37291,137,24704,21964,16328,9892
2021-11-12 15:30:00+00,9903,637,5631,15061,838,2582,2752,120,63,0,37587,144,24345,21593,15962,10540
2021-11-12 16:00:00+00,10437,645,5637,14869,1006,2618,2763,172,0,274,38421,147,24275,21512,15875,11082
2021-11-12 16:30:00+00,11493,704,5634,14642,1018,2610,2807,295,0,1034,40237,153,24101,21294,15660,12197
2021-11-12 17:00:00+00,11123,854,5636,14582,1023,3548,2821,311,0,1058,40956,152,24062,21241,15605,11977
2021-11-12 17:30:00+00,11176,869,5634,14437,1026,3596,2830,366,0,936,40870,154,23927,21097,15463,12045
2021-11-12 18:00:00+00,11018,960,5630,14631,1013,2908,2831,342,0,1156,40489,154,24105,21274,15644,11978
2021-11-12 18:30:00+00,10944,749,5632,14808,1008,2904,2784,281,0,936,40046,150,24232,21448,15816,11693
2021-11-12 19:00:00+00,11015,665,5633,14936,1014,2636,2738,144,0,76,38857,151,24321,21583,15950,11680
2021-11-12 19:30:00+00,10120,539,5637,14984,1009,2604,2770,141,0,0,37804,143,24400,21630,15993,10659
2021-11-12 20:00:00+00,9789,552,5630,14893,886,2712,2789,118,0,72,37441,141,24198,21409,15779,10341
2021-11-12 20:30:00+00,9014,480,5637,14836,878,2716,2783,163,0,218,36725,134,24134,21351,15714,9494
2021-11-12 21:00:00+00,8169,485,5638,14734,849,2626,2779,162,0,22,35464,129,24000,21221,15583,8654
2021-11-12 21:30:00+00,6904,410,5638,14518,813,2624,2776,121,0,0,33804,118,23745,20969,15331,7314
2021-11-12 22:00:00+00,5591,356,5640,14330,629,2484,2806,116,0,40,31992,107,23405,20599,14959,5947
2021-11-12 22:30:00+00,4767,261,5636,14030,604,2482,2765,120,0,50,30715,98,23035,20270,14634,5028
2021-11-12 23:00:00+00,3455,321,5639,13646,602,2366,2527,138,0,50,28744,88,22414,19887,14248,3776
2021-11-12 23:30:00+00,2713,313,5640,13404,596,2362,2187,140,0,0,27355,80,21827,19640,14000,3026
2021-11-13 00:00:00+00,2728,350,5633,12876,539,2084,2177,129,0,2,26518,83,21225,19048,13415,3078
2021-11-13 00:30:00+00,2990,379,5635,12499,539,2084,2186,122,0,78,26512,88,20859,18673,13038,3369
2021-11-13 01:00:00+00,2815,349,5633,12211,540,2360,2184,116,0,0,26208,87,20568,18384,12751,3164
2021-11-13 01:30:00+00,2834,286,5636,11875,541,2362,2184,114,0,0,25832,86,20236,18052,12416,3120
2021-11-13 02:00:00+00,3127,333,5633,11615,528,2410,2183,114,0,0,25943,92,19959,17776,12143,3460
2021-11-13 02:30:00+00,3079,375,5626,11498,527,2404,2207,115,0,0,25831,93,19858,17651,12025,3454
2021-11-13 03:00:00+00,3321,405,5625,11383,530,1924,2232,115,0,0,25535,92,19770,17538,11913,3726
2021-11-13 03:30:00+00,3091,450,5623,11404,554,1918,2204,120,0,0,25364,90,19785,17581,11958,3541
2021-11-13 04:00:00+00,2990,450,5625,11096,553,2272,2175,121,0,0,25282,92,19449,17274,11649,3440
2021-11-13 04:30:00+00,3387,447,5622,10630,555,2276,2102,121,0,0,25140,98,18909,16807,11185,3834
2021-11-13 05:00:00+00,2829,268,5636,10644,522,2324,2166,124,0,0,24513,88,18968,16802,11166,3097
2021-11-13 05:30:00+00,3147,245,5631,10273,520,2374,2111,121,0,0,24422,92,18535,16424,10793,3392
2021-11-13 06:00:00+00,3565,357,5635,9903,544,3354,1963,122,0,0,25443,101,18045,16082,10447,3922
2021-11-13 06:30:00+00,4500,622,5633,9600,543,3404,2000,166,0,0,26468,121,17776,15776,10143,5122
2021-11-13 07:00:00+00,6212,1069,5638,9233,589,2634,2067,128,0,108,27678,152,17527,15460,9822,7281
2021-11-13 07:30:00+00,7584,1417,5635,8755,591,2626,2106,114,36,120,28984,175,17123,15017,9382,9001
2021-11-13 08:00:00+00,10053,1493,5639,8070,610,2462,2115,115,243,322,31122,197,16677,14562,8923,11546
2021-11-13 08:30:00+00,11306,1497,5631,7466,893,2460,2125,255,563,318,32514,205,16678,14553,8922,12803
2021-11-13 09:00:00+00,12372,1495,5635,6753,977,2264,2129,420,919,396,33360,211,16413,14284,8649,13867
2021-11-13 09:30:00+00,13107,1496,5632,6344,976,2266,2129,398,1199,374,33921,216,16280,14151,8519,14603
2021-11-13 10:00:00+00,12990,1497,5631,6048,821,3700,2114,287,1599,370,35057,212,16213,14099,8468,14487
2021-11-13 10:30:00+00,13679,1494,5632,5788,813,3750,2112,315,1855,70,35508,218,16200,14088,8456,15173
2021-11-13 11:00:00+00,14375,1496,5630,5512,751,3400,2115,289,2030,52,35650,225,16038,13923,8293,15871
2021-11-13 11:30:00+00,14744,1495,5628,5359,749,3400,2113,280,2214,0,35982,227,16063,13950,8322,16239
2021-11-13 12:00:00+00,14594,1493,5627,5172,723,3966,2112,280,2064,106,36137,226,15698,13586,7959,16087
2021-11-13 12:30:00+00,14960,1493,5629,4873,720,3968,2108,125,1802,176,35854,229,15132,13024,7395,16453
2021-11-13 13:00:00+00,15417,1497,5634,4827,741,3428,2106,124,1529,22,35325,235,14837,12731,7097,16914
2021-11-13 13:30:00+00,15172,1498,5635,4866,743,3414,2108,129,1172,0,34737,236,14524,12416,6781,16670
2021-11-13 14:00:00+00,15165,1496,5634,4688,744,3250,2116,119,908,46,34166,239,14090,11974,6340,16661
2021-11-13 14:30:00+00,15513,1497,5632,4717,756,3246,2110,119,550,28,34168,243,13765,11655,6023,17010
2021-11-13 15:00:00+00,15784,1497,5638,4770,799,3218,2104,116,337,126,34389,245,13648,11544,5906,17281
2021-11-13 15:30:00+00,16212,1496,5631,4654,836,3240,2106,118,79,234,34606,249,13306,11200,5569,17708
2021-11-13 16:00:00+00,16568,1494,5632,4594,920,4130,2109,224,0,486,36157,246,13255,11146,5514,18062
2021-11-13 16:30:00+00,17297,1499,5637,4599,1015,4146,2164,378,0,548,37283,248,13415,11251,5614,18796
2021-11-13 17:00:00+00,17789,1490,5636,4702,1009,4180,2214,475,0,1152,38647,245,13561,11347,5711,19279
2021-11-13 17:30:00+00,17784,1490,5630,4595,897,4190,2239,533,0,1468,38826,244,13361,11122,5492,19274
2021-11-13 18:00:00+00,17396,1493,5636,4419,897,4252,2228,525,0,1590,38436,243,13180,10952,5316,18889
2021-11-13 18:30:00+00,17305,1496,5636,4156,965,4222,2208,334,0,1114,37436,247,12965,10757,5121,18801
2021-11-13 19:00:00+00,17282,1497,5631,4190,1002,3072,2240,331,0,558,35803,254,13063,10823,5192,18779
2021-11-13 19:30:00+00,16985,1500,5630,4369,881,3050,2246,278,0,224,35163,255,13126,10880,5250,18485
2021-11-13 20:00:00+00,16456,1499,5634,4317,846,2904,2251,181,0,18,34106,253,13048,10797,5163,17955
2021-11-13 20:30:00+00,15318,1496,5636,4381,841,2910,2257,147,0,0,32986,247,13115,10858,5222,16814
2021-11-13 21:00:00+00,13808,1454,5636,4658,798,2942,2250,131,0,0,31678,239,13342,11092,5456,15262
2021-11-13 21:30:00+00,12539,1285,5636,4776,781,2942,2252,115,0,34,30360,227,13445,11193,5557,13824
2021-11-13 22:00:00+00,11357,1093,5636,4723,769,3150,2250,114,0,0,29092,216,13378,11128,5492,12450
2021-11-13 22:30:00+00,10092,841,5636,4697,769,3292,2250,120,0,56,27753,202,13352,11102,5466,10933
2021-11-13 23:00:00+00,8013,385,5634,4793,746,4654,2133,133,0,84,26575,171,13306,11173,5539,8398
2021-11-13 23:30:00+00,7391,117,5637,4929,748,4570,2241,125,0,12,25770,156,13555,11314,5677,7508
2021-11-14 00:00:00+00,7270,0,5634,5206,526,4526,2220,118,0,0,25500,154,13586,11366,5732,7270
2021-11-14 00:30:00+00,7284,0,5634,5398,524,4562,2182,117,0,0,25701,153,13738,11556,5922,7284
2021-11-14 01:00:00+00,6939,0,5624,5357,504,4582,2181,115,0,0,25302,149,13666,11485,5861,6939
2021-11-14 01:30:00+00,6397,0,5638,5477,491,4570,2171,114,0,0,24858,143,13777,11606,5968,6397
2021-11-14 02:00:00+00,5875,0,5631,5610,487,4422,2171,113,0,0,24309,134,13899,11728,6097,5875
2021-11-14 02:30:00+00,5855,0,5633,5707,486,4414,2170,113,0,0,24378,133,13996,11826,6193,5855
2021-11-14 03:00:00+00,5980,0,5633,5752,474,3974,2173,114,0,0,24100,132,14032,11859,6226,5980
2021-11-14 03:30:00+00,5767,0,5628,5813,479,3944,2188,107,0,0,23926,129,14108,11920,6292,5767
2021-11-14 04:00:00+00,6272,0,5631,5972,457,2818,2217,108,0,0,23475,134,14277,12060,6429,6272
2021-11-14 04:30:00+00,6016,0,5628,5934,455,2764,2280,113,0,0,23190,131,14297,12017,6389,6016
2021-11-14 05:00:00+00,6234,27,5627,5799,454,3376,2294,104,0,0,23915,130,14174,11880,6253,6261
2021-11-14 05:30:00+00,6099,231,5639,6070,458,3248,2295,113,0,0,24153,132,14462,12167,6528,6330
2021-11-14 06:00:00+00,6199,321,5641,6355,483,3502,2195,105,0,0,24801,138,14674,12479,6838,6520
2021-11-14 06:30:00+00,6668,474,5635,6083,491,3490,2306,104,0,0,25251,150,14515,12209,6574,7142
2021-11-14 07:00:00+00,8122,493,5638,5979,535,2404,2302,102,0,0,25575,165,14454,12152,6514,8615
2021-11-14 07:30:00+00,8922,511,5640,6080,554,2374,2322,105,20,0,26528,172,14616,12294,6654,9433
2021-11-14 08:00:00+00,9615,596,5637,5933,576,3232,2329,110,212,0,28240,183,14687,12358,6721,10211
2021-11-14 08:30:00+00,10930,609,5639,6009,577,3328,2314,111,559,0,30076,190,15098,12784,7145,11539
2021-11-14 09:00:00+00,11975,700,5635,6062,577,3422,2300,110,986,0,31767,199,15560,13260,7625,12675
2021-11-14 09:30:00+00,12502,882,5635,6085,577,3412,2306,110,1417,62,32988,203,16020,13714,8079,13384
2021-11-14 10:00:00+00,12611,1270,5638,6205,576,3470,2337,103,1733,0,33943,209,16489,14152,8514,13881
2021-11-14 10:30:00+00,12600,1482,5634,6113,559,3498,2353,106,1836,0,34181,213,16495,14142,8508,14082
2021-11-14 11:00:00+00,12301,1493,5636,6099,546,3658,2352,121,1874,200,34280,206,16507,14155,8519,13794
2021-11-14 11:30:00+00,13242,1472,5627,5848,543,3670,2335,120,1793,0,34650,214,16146,13811,8184,14714
2021-11-14 12:00:00+00,13916,1446,5633,5712,545,3316,2419,116,1676,230,35009,220,15985,13566,7933,15362
2021-11-14 12:30:00+00,14392,1487,5635,5614,545,3306,2459,194,1538,10,35180,226,15791,13332,7697,15879
2021-11-14 13:00:00+00,14699,1497,5640,5556,567,3650,2500,173,1393,0,35675,229,15656,13156,7516,16196
2021-11-14 13:30:00+00,14606,1493,5637,5527,554,3672,2576,105,1172,0,35342,230,15466,12890,7253,16099
2021-11-14 14:00:00+00,14499,1239,5640,5390,556,4066,2800,104,804,0,35098,227,15190,12390,6750,15738
2021-11-14 14:30:00+00,14924,1101,5636,5103,576,4078,2978,133,522,0,35051,229,14815,11837,6201,16025
2021-11-14 15:00:00+00,15372,1193,5641,5202,647,4246,3099,174,281,0,35855,232,14870,11771,6130,16565
2021-11-14 15:30:00+00,16222,1260,5634,5216,661,4244,3088,134,66,0,36525,238,14665,11577,5943,17482
2021-11-14 16:00:00+00,17252,1458,5638,5357,665,4222,3048,206,0,424,38270,243,14708,11660,6022,18710
2021-11-14 16:30:00+00,17665,1495,5638,5587,822,4220,3069,465,0,842,39803,241,15116,12047,6409,19160
2021-11-14 17:00:00+00,17546,1384,5639,5630,888,4646,3106,526,0,1264,40629,234,15263,12157,6518,18930
2021-11-14 17:30:00+00,17947,1114,5638,5767,918,4654,3105,422,0,1320,40885,230,15428,12323,6685,19061
2021-11-14 18:00:00+00,17894,1198,5641,5428,972,4362,3108,391,0,1192,40186,234,15149,12041,6400,19092
2021-11-14 18:30:00+00,17408,1209,5639,5408,885,4354,3117,157,0,884,39061,234,15049,11932,6293,18617
2021-11-14 19:00:00+00,16796,1384,5639,5672,871,4018,3110,147,0,136,37773,239,15292,12182,6543,18180
2021-11-14 19:30:00+00,15825,1312,5631,5738,813,3984,3104,114,0,0,36521,235,15286,12182,6551,17137
2021-11-14 20:00:00+00,15988,1395,5637,5750,727,2834,3093,122,0,18,35564,242,15207,12114,6477,17383
2021-11-14 20:30:00+00,14564,1427,5632,5699,690,2812,3096,114,0,40,34074,237,15117,12021,6389,15991
2021-11-14 21:00:00+00,13163,1498,5630,5467,663,2974,3100,144,0,68,32707,233,14860,11760,6130,14661
2021-11-14 21:30:00+00,12163,1374,5634,5319,606,2948,3105,151,0,54,31354,227,14664,11559,5925,13537
2021-11-14 22:00:00+00,11757,1065,5639,5244,532,2552,3095,153,0,0,30037,222,14510,11415,5776,12822
2021-11-14 22:30:00+00,10837,824,5634,5043,520,2520,3092,182,0,0,28652,212,14289,11197,5563,11661
2021-11-14 23:00:00+00,11483,1058,5634,5001,519,1366,3092,174,0,0,28327,221,14246,11154,5520,12541
2021-11-14 23:30:00+00,10542,1157,5635,5042,524,1346,3086,161,0,0,27493,218,14287,11201,5566,11699
2021-11-15 00:00:00+00,9526,982,5635,5025,524,1804,3058,161,0,0,26715,207,14242,11184,5549,10508
2021-11-15 00:30:00+00,9926,1029,5638,4637,523,1830,3043,166,0,0,26792,214,13841,10798,5160,10955
2021-11-15 01:00:00+00,10323,1250,5635,4285,484,1826,3007,171,0,0,26981,228,13411,10404,4769,11573
2021-11-15 01:30:00+00,10548,1187,5630,3727,474,1854,3011,171,0,0,26602,233,12842,9831,4201,11735
2021-11-15 02:00:00+00,10479,777,5635,3340,455,2596,3016,176,0,0,26474,223,12446,9430,3795,11256
2021-11-15 02:30:00+00,10625,690,5632,3020,457,2604,3016,173,0,0,26217,225,12125,9109,3477,11315
2021-11-15 03:00:00+00,10548,691,5635,2811,457,2000,3025,162,0,0,25329,227,11928,8903,3268,11239
2021-11-15 03:30:00+00,10361,719,5630,2651,454,1980,3041,160,0,0,24996,228,11776,8735,3105,11080
2021-11-15 04:00:00+00,10804,921,5633,2380,451,1922,3089,162,0,0,25362,238,11553,8464,2831,11725
2021-11-15 04:30:00+00,11186,928,5624,2172,453,1916,3087,160,0,0,25526,243,11336,8249,2625,12114
2021-11-15 05:00:00+00,12613,1218,5633,2111,455,1234,3061,156,0,0,26481,256,11260,8199,2566,13831
2021-11-15 05:30:00+00,13650,1458,5635,1872,456,932,3095,156,0,0,27254,267,11058,7963,2328,15108
2021-11-15 06:00:00+00,14944,1496,5634,1761,469,1168,3096,154,0,0,28722,276,10960,7864,2230,16440
2021-11-15 06:30:00+00,17700,1499,5641,1737,506,1044,3093,166,0,0,31386,286,10977,7884,2243,19199
2021-11-15 07:00:00+00,19109,1500,5635,1637,681,1872,3068,187,0,196,33885,281,11021,7953,2318,20609
2021-11-15 07:30:00+00,20121,1501,5641,1690,737,1968,3084,264,10,148,35164,284,11162,8078,2437,21622
2021-11-15 08:00:00+00,20379,1497,5638,1667,773,2750,3083,248,148,150,36333,281,11309,8226,2588,21876
2021-11-15 08:30:00+00,20857,1497,5636,1581,768,2766,2967,293,356,234,36955,281,11308,8341,2705,22354
2021-11-15 09:00:00+00,21675,1494,5635,1436,727,3162,3064,294,566,326,38379,284,11428,8364,2729,23169
2021-11-15 09:30:00+00,21869,1497,5635,1409,805,3152,3094,334,852,142,38789,284,11795,8701,3066,23366
2021-11-15 10:00:00+00,22064,1497,5640,1332,743,2196,3100,406,1041,522,38541,284,11856,8756,3116,23561
2021-11-15 10:30:00+00,22250,1498,5633,1284,743,2178,3088,382,1363,592,39011,282,12111,9023,3390,23748
2021-11-15 11:00:00+00,22152,1499,5636,1238,727,2428,3107,296,1952,670,39705,277,12660,9553,3917,23651
2021-11-15 11:30:00+00,22101,1501,5634,1367,726,2424,3102,292,2166,586,39899,275,12995,9893,4259,23602
2021-11-15 12:00:00+00,22053,1374,5633,1536,736,2188,3094,281,2182,730,39807,271,13181,10087,4454,23427
2021-11-15 12:30:00+00,21777,1120,5632,1665,759,2186,3099,286,2063,888,39475,264,13218,10119,4487,22897
2021-11-15 13:00:00+00,20847,960,5634,1825,740,3750,3097,323,1604,440,39220,259,12900,9803,4169,21807
2021-11-15 13:30:00+00,20444,958,5641,1932,739,3792,3098,433,1362,246,38645,259,12772,9674,4033,21402
2021-11-15 14:00:00+00,20607,940,5638,2000,775,3522,3098,556,961,380,38477,263,12472,9374,3736,21547
2021-11-15 14:30:00+00,20656,795,5643,2135,768,3516,3092,505,605,500,38215,261,12243,9151,3508,21451
2021-11-15 15:00:00+00,20884,846,5640,2283,708,2984,3128,572,314,896,38255,261,12073,8945,3305,21730
2021-11-15 15:30:00+00,21115,945,5641,2375,705,3026,3099,632,72,1324,38934,261,11892,8793,3152,22060
2021-11-15 16:00:00+00,21274,965,5642,2576,768,4398,3100,600,0,996,40319,264,12086,8986,3344,22239
2021-11-15 16:30:00+00,21952,966,5639,2856,785,4458,3093,593,0,1746,42088,260,12373,9280,3641,22918
2021-11-15 17:00:00+00,21800,968,5642,3034,810,4756,3125,926,0,1672,42733,258,12611,9486,3844,22768
2021-11-15 17:30:00+00,21258,939,5634,3034,811,4762,3138,963,0,2124,42663,253,12617,9479,3845,22197
2021-11-15 18:00:00+00,21144,966,5637,3111,811,4760,3130,898,0,2052,42509,254,12689,9559,3922,22110
2021-11-15 18:30:00+00,20898,962,5640,3181,758,4758,3122,704,0,1730,41753,255,12701,9579,3939,21860
2021-11-15 19:00:00+00,20581,969,5643,3149,580,4760,3081,592,0,810,40165,261,12453,9372,3729,21550
2021-11-15 19:30:00+00,20023,925,5631,3209,582,4752,3081,482,0,452,39137,260,12503,9422,3791,20948
2021-11-15 20:00:00+00,19484,731,5632,3265,583,4154,3034,376,0,558,37817,256,12514,9480,3848,20215
2021-11-15 20:30:00+00,18875,563,5631,3321,576,4112,3027,242,0,230,36577,252,12555,9528,3897,19438
2021-11-15 21:00:00+00,18373,500,5632,3468,505,3030,3035,155,0,46,34744,251,12640,9605,3973,18873
2021-11-15 21:30:00+00,17022,501,5630,3432,472,2906,3022,200,0,52,33237,246,12556,9534,3904,17523
2021-11-15 22:00:00+00,16514,500,5635,3588,462,1912,3002,169,0,0,31782,249,12687,9685,4050,17014
2021-11-15 22:30:00+00,14384,499,5632,3726,473,1928,3018,168,0,54,29882,237,12849,9831,4199,14883
2021-11-15 23:00:00+00,12088,376,5636,3667,474,2526,3031,166,0,0,27964,219,12808,9777,4141,12464
2021-11-15 23:30:00+00,11727,44,5634,3688,478,2548,2947,160,0,0,27226,208,12747,9800,4166,11771
2021-11-16 00:00:00+00,12027,0,5632,3803,475,2314,2915,153,0,0,27319,209,12825,9910,4278,12027
2021-11-16 00:30:00+00,12112,0,5638,3815,467,2384,2924,152,0,0,27492,210,12844,9920,4282,12112
2021-11-16 01:00:00+00,11892,0,5637,3872,441,2664,2926,149,0,0,27581,209,12876,9950,4313,11892
2021-11-16 01:30:00+00,11448,0,5634,3998,439,2674,2925,149,0,0,27267,205,12996,10071,4437,11448
2021-11-16 02:00:00+00,11346,0,5636,4142,425,2676,2926,149,0,0,27300,202,13129,10203,4567,11346
2021-11-16 02:30:00+00,10693,0,5637,4261,424,2650,2875,146,0,0,26686,196,13197,10322,4685,10693
2021-11-16 03:00:00+00,10864,0,5636,4444,421,2208,2913,148,0,0,26634,199,13414,10501,4865,10864
2021-11-16 03:30:00+00,10377,0,5634,4698,410,2130,2930,148,0,0,26327,194,13672,10742,5108,10377
2021-11-16 04:00:00+00,11306,0,5638,4640,408,2038,2930,146,0,0,27106,202,13616,10686,5048,11306
2021-11-16 04:30:00+00,11694,3,5635,4706,416,1966,2929,154,0,0,27503,203,13686,10757,5122,11697
2021-11-16 05:00:00+00,13094,167,5631,4740,427,1482,2932,163,0,0,28636,212,13730,10798,5167,13261
2021-11-16 05:30:00+00,13367,611,5634,4874,435,1540,2922,175,0,0,29558,224,13865,10943,5309,13978
2021-11-16 06:00:00+00,15201,1050,5633,5054,495,1532,2936,160,0,0,32061,242,14118,11182,5549,16251
2021-11-16 06:30:00+00,17286,1336,5634,5530,534,1374,2956,145,0,0,34795,252,14654,11698,6064,18622
2021-11-16 07:00:00+00,19274,1453,5638,5859,577,1134,2949,152,0,0,37036,258,15023,12074,6436,20727
2021-11-16 07:30:00+00,19652,1489,5638,6560,568,1266,2906,205,36,218,38538,255,15708,12802,7164,21141
2021-11-16 08:00:00+00,19997,1492,5638,6609,486,1388,2861,345,315,488,39619,254,15909,13048,7410,21489
2021-11-16 08:30:00+00,19677,1497,5639,6990,465,1436,2862,256,800,714,40336,246,16756,13894,8255,21174
2021-11-16 09:00:00+00,19971,1494,5639,7441,419,1378,2868,222,1315,616,41363,242,17682,14814,9175,21465
2021-11-16 09:30:00+00,19605,1497,5639,7667,402,1356,2910,183,1372,600,41231,239,17990,15080,9441,21102
2021-11-16 10:00:00+00,19169,1495,5639,7948,397,1494,2914,162,1689,324,41231,235,18587,15673,10034,20664
2021-11-16 10:30:00+00,18735,1496,5636,8447,389,1406,2916,154,1913,150,41242,230,19301,16385,10749,20231
2021-11-16 11:00:00+00,18487,998,5636,8999,395,1330,2916,147,1835,0,40743,219,19781,16865,11229,19485
2021-11-16 11:30:00+00,18310,1488,5634,9341,380,1296,2916,146,1576,0,41087,226,19847,16931,11297,19798
2021-11-16 12:00:00+00,18731,1486,5636,9538,372,1252,2919,145,1548,0,41627,226,20013,17094,11458,20217
2021-11-16 12:30:00+00,18614,1495,5632,9616,378,1252,2934,153,1476,24,41574,226,20036,17102,11470,20109
2021-11-16 13:00:00+00,18945,1499,5629,9882,374,1108,2948,152,1225,28,41790,226,20058,17110,11481,20444
2021-11-16 13:30:00+00,18899,1511,5630,10090,362,1073,2940,211,1000,0,41716,227,20022,17082,11452,20410
2021-11-16 14:00:00+00,19267,1505,5628,9867,381,954,2948,160,598,74,41382,230,19422,16474,10846,20772
2021-11-16 14:30:00+00,19275,1500,5638,10162,410,922,2913,193,380,0,41393,230,19503,16590,10952,20775
2021-11-16 15:00:00+00,19006,1494,5632,10243,406,988,2949,164,227,108,41217,228,19457,16508,10876,20500
2021-11-16 15:30:00+00,19519,1495,5634,10302,430,1218,2957,170,34,128,41887,232,19357,16400,10766,21014
2021-11-16 16:00:00+00,19685,1328,5639,10300,466,1662,2930,238,0,662,42910,225,19335,16405,10766,21013
2021-11-16 16:30:00+00,19819,1468,5637,10560,466,1540,2912,577,0,1272,44251,223,19575,16663,11026,21287
2021-11-16 17:00:00+00,19990,1494,5634,10793,474,896,2976,731,0,1738,44726,222,19877,16901,11267,21484
2021-11-16 17:30:00+00,19661,1496,5637,11161,463,810,2974,686,0,1818,44706,218,20235,17261,11624,21157
2021-11-16 18:00:00+00,18343,1496,5629,11472,477,1180,2942,508,0,1674,43721,210,20520,17578,11949,19839
2021-11-16 18:30:00+00,18125,1497,5630,11677,488,1196,2921,421,0,1496,43451,209,20716,17795,12165,19622
2021-11-16 19:00:00+00,17896,1499,5627,11545,486,1636,2936,283,0,540,42448,211,20594,17658,12031,19395
2021-11-16 19:30:00+00,17422,1497,5633,11583,484,1614,2926,213,0,0,41372,212,20626,17700,12067,18919
2021-11-16 20:00:00+00,16267,1498,5629,11744,486,1012,2886,196,0,0,39718,209,20745,17859,12230,17765
2021-11-16 20:30:00+00,14610,1498,5631,11956,487,956,2889,184,0,0,38210,201,20962,18074,12442,16108
2021-11-16 21:00:00+00,12649,1496,5622,12164,471,1408,2836,163,0,0,36809,193,21093,18257,12635,14145
2021-11-16 21:30:00+00,10747,1495,5628,12154,467,1394,2845,156,0,0,34886,182,21094,18249,12621,12242
2021-11-16 22:00:00+00,8408,1467,5626,11668,457,1794,2852,156,0,0,32428,172,20603,17751,12125,9875
2021-11-16 22:30:00+00,7049,1172,5631,11200,447,1876,2848,162,0,120,30505,158,20126,17278,11647,8221
2021-11-16 23:00:00+00,4593,712,5631,11140,416,2612,2847,165,0,0,28116,126,20034,17187,11556,5305
2021-11-16 23:30:00+00,3562,458,5640,11424,435,2736,2811,159,0,0,27225,108,20310,17499,11859,4020
2021-11-17 00:00:00+00,3444,449,5634,11276,437,2236,2825,163,0,0,26464,103,20172,17347,11713,3893
2021-11-17 00:30:00+00,3624,499,5632,11060,440,2354,2818,178,0,0,26605,109,19950,17132,11500,4123
2021-11-17 01:00:00+00,3320,497,5632,11283,451,2588,2832,168,0,0,26771,108,20198,17366,11734,3817
2021-11-17 01:30:00+00,2825,475,5636,11753,442,2496,2839,171,0,0,26637,99,20670,17831,12195,3300
2021-11-17 02:00:00+00,2925,441,5630,11223,442,2446,2838,177,0,0,26122,100,20133,17295,11665,3366
2021-11-17 02:30:00+00,3422,481,5631,10705,442,2246,2840,181,0,0,25948,106,19618,16778,11147,3903
2021-11-17 03:00:00+00,3637,476,5631,10936,434,2060,2842,176,0,0,26192,109,19843,17001,11370,4113
2021-11-17 03:30:00+00,3085,482,5627,10982,428,1972,2857,162,0,0,25595,102,19894,17037,11410,3567
2021-11-17 04:00:00+00,2908,500,5634,10860,434,1994,2878,161,0,0,25369,102,19806,16928,11294,3408
2021-11-17 04:30:00+00,2811,471,5634,10905,456,2078,2834,163,0,0,25352,100,19829,16995,11361,3282
2021-11-17 05:00:00+00,3432,452,5631,10993,476,1966,2745,168,0,124,25987,105,19845,17100,11469,3884
2021-11-17 05:30:00+00,4412,539,5632,11331,479,1930,2881,161,0,188,27553,116,20323,17442,11810,4951
2021-11-17 06:00:00+00,6684,810,5631,11828,489,1702,2895,162,0,30,30231,140,20843,17948,12317,7494
2021-11-17 06:30:00+00,8613,978,5629,12178,546,1730,2900,170,0,86,32830,157,21253,18353,12724,9591
2021-11-17 07:00:00+00,11068,907,5632,12759,667,1902,2901,167,0,6,36009,168,21959,19058,13426,11975
2021-11-17 07:30:00+00,12425,946,5635,12744,694,1806,2907,203,48,210,37618,175,22028,19120,13486,13371
2021-11-17 08:00:00+00,13622,965,5639,12385,693,1388,2899,178,484,212,38465,181,22100,19201,13562,14587
2021-11-17 08:30:00+00,13974,996,5637,12462,691,1388,2909,171,1136,0,39364,181,22835,19926,14289,14970
2021-11-17 09:00:00+00,14383,997,5637,12256,689,1760,2909,180,1837,18,40666,182,23328,20419,14782,15380
2021-11-17 09:30:00+00,14301,997,5638,12076,673,1756,2906,181,2404,2,40934,180,23697,20791,15153,15298
2021-11-17 10:00:00+00,13608,996,5639,12344,577,1382,2905,180,3045,112,40788,172,24510,21605,15966,14604
2021-11-17 10:30:00+00,13288,844,5635,12404,604,1382,2902,167,3772,78,41076,164,25317,22415,16780,14132
2021-11-17 11:00:00+00,13240,690,5633,12339,578,1582,2898,167,4011,68,41206,161,25459,22561,16928,13930
2021-11-17 11:30:00+00,12525,681,5635,12728,576,1582,2898,162,4395,80,41262,154,26232,23334,17699,13206
2021-11-17 12:00:00+00,12378,706,5636,12555,526,1586,2910,162,4471,164,41094,154,26098,23188,17552,13084
2021-11-17 12:30:00+00,12566,721,5650,12308,540,1586,2906,165,4154,152,40748,157,25558,22652,17002,13287
2021-11-17 13:00:00+00,12665,816,5631,12438,501,1914,2903,166,3629,154,40817,162,25102,22199,16568,13481
2021-11-17 13:30:00+00,12579,986,5626,12442,481,1932,2911,167,2995,114,40233,168,24455,21544,15918,13565
2021-11-17 14:00:00+00,12511,908,5627,12462,480,2120,2911,165,2243,228,39655,168,23723,20812,15185,13419
2021-11-17 14:30:00+00,12864,992,5628,12653,477,2124,2901,169,1340,118,39266,175,22999,20098,14470,13856
2021-11-17 15:00:00+00,14526,1001,5628,12520,507,1590,2910,205,538,234,39659,187,22103,19193,13565,15527
2021-11-17 15:30:00+00,15780,998,5628,12130,546,1590,2905,158,110,466,40311,196,21319,18414,12786,16778
2021-11-17 16:00:00+00,16167,1000,5627,12070,609,2166,2907,222,0,900,41668,197,21213,18306,12679,17167
2021-11-17 16:30:00+00,17059,999,5627,12042,636,2567,2908,541,0,1454,43833,198,21213,18305,12678,18058
2021-11-17 17:00:00+00,16833,1000,5632,12144,699,2816,2898,567,0,1600,44189,196,21373,18475,12843,17833
2021-11-17 17:30:00+00,16408,1002,5632,12323,730,2890,2871,567,0,1618,44041,193,21556,18685,13053,17410
2021-11-17 18:00:00+00,16146,1000,5632,12137,726,2480,2776,486,0,1754,43137,192,21271,18495,12863,17146
2021-11-17 18:30:00+00,15821,1000,5631,12285,693,2484,2781,448,0,1414,42557,191,21390,18609,12978,16821
2021-11-17 19:00:00+00,15517,1000,5624,12296,695,2910,2780,213,0,662,41697,193,21395,18615,12991,16517
2021-11-17 19:30:00+00,14948,1002,5635,12171,683,2776,2774,153,0,114,40256,193,21263,18489,12854,15950
2021-11-17 20:00:00+00,14180,1000,5632,12268,683,2855,2781,151,0,0,39550,191,21364,18583,12951,15180
2021-11-17 20:30:00+00,12473,1001,5630,12378,604,2586,2778,166,0,0,37616,185,21390,18612,12982,13474
2021-11-17 21:00:00+00,10062,1000,5631,12575,606,3042,2776,165,0,18,35875,170,21588,18812,13181,11062
2021-11-17 21:30:00+00,8255,994,5629,12508,510,3066,2755,164,0,24,33905,159,21402,18647,13018,9249
2021-11-17 22:00:00+00,6496,995,5629,12673,465,3332,2720,193,0,0,32503,149,21487,18767,13138,7491
2021-11-17 22:30:00+00,5116,992,5632,12543,448,3234,2455,169,0,0,30589,137,21078,18623,12991,6108
2021-11-17 23:00:00+00,3824,996,5632,11905,446,2804,2139,204,0,0,27950,129,20122,17983,12351,4820
2021-11-17 23:30:00+00,3136,992,5636,11862,444,2792,2133,184,0,0,27179,122,20075,17942,12306,4128
2021-11-18 00:00:00+00,3576,957,5632,11692,446,2900,2141,186,0,0,27530,125,19911,17770,12138,4533
2021-11-18 00:30:00+00,4038,999,5636,11630,439,2908,2140,204,0,0,27994,131,19845,17705,12069,5037
2021-11-18 01:00:00+00,3948,996,5636,11975,480,3146,2138,179,0,0,28498,128,20229,18091,12455,4944
2021-11-18 01:30:00+00,3732,996,5637,11746,473,3026,2135,160,0,0,27905,126,19991,17856,12219,4728
2021-11-18 02:00:00+00,4139,1001,5639,11216,434,2556,2137,162,0,0,27284,134,19426,17289,11650,5140
2021-11-18 02:30:00+00,3969,998,5639,11327,433,2538,2138,164,0,0,27206,131,19537,17399,11760,4967
2021-11-18 03:00:00+00,3904,1000,5640,11553,431,2242,2088,162,0,0,27020,127,19712,17624,11984,4904
2021-11-18 03:30:00+00,3752,1000,5637,11527,429,2146,2067,161,0,0,26719,125,19660,17593,11956,4752
2021-11-18 04:00:00+00,3754,999,5636,11492,429,2032,2093,162,0,0,26597,124,19650,17557,11921,4753
2021-11-18 04:30:00+00,3914,1000,5637,11518,446,2004,2089,160,0,0,26768,125,19690,17601,11964,4914
2021-11-18 05:00:00+00,4200,1000,5638,11373,530,2060,2096,159,0,0,27056,129,19637,17541,11903,5200
2021-11-18 05:30:00+00,4982,999,5638,11669,537,2054,2126,157,0,0,28162,135,19970,17844,12206,5981
2021-11-18 06:00:00+00,5919,995,5635,12119,518,2218,2124,157,0,0,29685,137,20396,18272,12637,6914
2021-11-18 06:30:00+00,7810,943,5632,12483,599,2192,2141,166,0,0,31966,148,20855,18714,13082,8753
2021-11-18 07:00:00+00,10158,796,5631,12778,661,1930,1867,174,0,130,34124,160,20937,19070,13439,10954
2021-11-18 07:30:00+00,12505,731,5636,13468,676,1836,1860,324,24,16,37076,171,21664,19804,14168,13236
2021-11-18 08:00:00+00,13015,735,5639,13755,572,1812,2057,217,278,294,38374,171,22301,20244,14605,13750
2021-11-18 08:30:00+00,13094,740,5639,13650,559,1804,2143,168,631,140,38568,171,22622,20479,14840,13834
2021-11-18 09:00:00+00,12741,745,5636,13957,495,2410,2138,168,1036,108,39434,166,23262,21124,15488,13486
2021-11-18 09:30:00+00,12135,792,5637,14553,493,2420,2134,164,1633,218,40179,158,24450,22316,16679,12927
2021-11-18 10:00:00+00,11571,907,5637,14960,484,2474,2138,161,2315,74,40721,153,25534,23396,17759,12478
2021-11-18 10:30:00+00,11662,946,5638,14918,485,2474,2136,160,2471,0,40890,154,25648,23512,17874,12608
2021-11-18 11:00:00+00,11564,993,5636,14917,462,2502,2129,170,2488,78,40939,154,25632,23503,17867,12557
2021-11-18 11:30:00+00,11972,990,5637,14542,452,2502,1537,175,2594,362,40763,157,24762,23225,17588,12962
2021-11-18 12:00:00+00,13608,987,5639,13313,451,2686,1201,168,2345,138,40536,173,22949,21748,16109,14595
2021-11-18 12:30:00+00,13832,988,5638,13184,415,2688,1555,169,1949,0,40418,177,22741,21186,15548,14820
2021-11-18 13:00:00+00,13481,989,5636,13238,429,2716,1993,161,1448,0,40091,177,22744,20751,15115,14470
2021-11-18 13:30:00+00,13516,992,5635,12881,433,2746,2123,171,1046,0,39543,181,22118,19995,14360,14508
2021-11-18 14:00:00+00,14228,996,5627,12638,434,2256,2139,171,762,0,39251,189,21600,19461,13834,15224
2021-11-18 14:30:00+00,14570,998,5623,12320,438,2216,2200,184,490,0,39039,194,21071,18871,13248,15568
2021-11-18 15:00:00+00,14769,998,5631,12319,499,1868,2269,220,199,0,38772,195,20917,18648,13017,15767
2021-11-18 15:30:00+00,14800,993,5629,12798,596,1806,2276,219,43,272,39432,191,21342,19066,13437,15793
2021-11-18 16:00:00+00,15743,993,5633,13775,735,1642,2267,323,0,144,41255,191,22410,20143,14510,16736
2021-11-18 16:30:00+00,16273,993,5634,13903,837,1678,2275,417,0,884,42894,190,22649,20374,14740,17266
2021-11-18 17:00:00+00,16349,988,5626,14030,837,2002,2271,508,0,1024,43635,189,22764,20493,14867,17337
2021-11-18 17:30:00+00,15953,988,5621,14158,826,2008,2271,446,0,1198,43469,186,22876,20605,14984,16941
2021-11-18 18:00:00+00,15716,995,5609,14110,766,1742,2267,434,0,1454,43093,185,22752,20485,14876,16711
2021-11-18 18:30:00+00,15601,993,5612,14066,737,1742,2257,417,0,1174,42599,186,22672,20415,14803,16594
2021-11-18 19:00:00+00,15229,995,5610,14107,712,2452,2256,240,0,222,41823,187,22685,20429,14819,16224
2021-11-18 19:30:00+00,14006,994,5606,14194,643,2480,2258,177,0,218,40576,180,22701,20443,14837,15000
2021-11-18 20:00:00+00,12609,996,5612,14169,679,2310,2268,163,0,134,38940,172,22728,20460,14848,13605
2021-11-18 20:30:00+00,11441,997,5614,14033,664,2310,2268,160,0,130,37617,166,22579,20311,14697,12438
2021-11-18 21:00:00+00,10325,863,5619,13887,581,2450,2266,165,0,36,36192,159,22353,20087,14468,11188
2021-11-18 21:30:00+00,8963,535,5615,13433,578,2564,2268,170,0,24,34150,146,21894,19626,14011,9498
2021-11-18 22:00:00+00,7285,493,5613,13136,578,2708,2266,165,0,36,32280,134,21593,19327,13714,7778
2021-11-18 22:30:00+00,5544,495,5608,12770,579,2730,2273,165,0,168,30332,120,21230,18957,13349,6039
2021-11-18 23:00:00+00,4047,486,5610,12616,578,2720,2275,178,0,0,28510,107,21079,18804,13194,4533
2021-11-18 23:30:00+00,3508,411,5615,12426,578,2768,2274,170,0,0,27750,100,20893,18619,13004,3919
2021-11-19 00:00:00+00,3730,460,5618,12001,566,2742,2243,168,0,0,27528,107,20428,18185,12567,4190
2021-11-19 00:30:00+00,3865,489,5618,12077,567,2820,2248,167,0,0,27851,110,20510,18262,12644,4354
2021-11-19 01:00:00+00,4283,492,5622,12039,569,2428,2268,168,0,0,27869,109,20498,18230,12608,4775
2021-11-19 01:30:00+00,4235,493,5618,11796,568,2378,2266,173,0,0,27527,109,20248,17982,12364,4728
2021-11-19 02:00:00+00,4302,492,5621,11691,550,2122,2264,176,0,0,27218,107,20126,17862,12241,4794
2021-11-19 02:30:00+00,4345,491,5618,11501,550,2074,2265,171,0,0,27015,108,19934,17669,12051,4836
2021-11-19 03:00:00+00,4276,394,5619,11231,525,2190,2275,172,0,0,26682,108,19650,17375,11756,4670
2021-11-19 03:30:00+00,4355,84,5616,10973,524,2182,2274,182,0,0,26190,100,19387,17113,11497,4439
2021-11-19 04:00:00+00,4481,0,5618,10899,525,1866,2273,190,0,0,25852,100,19315,17042,11424,4481
2021-11-19 04:30:00+00,4642,85,5614,10744,523,1880,2273,186,0,0,25947,105,19154,16881,11267,4727
2021-11-19 05:00:00+00,5226,170,5613,10524,548,1700,2273,181,0,0,26235,115,18958,16685,11072,5396
2021-11-19 05:30:00+00,6356,490,5617,10607,544,1636,2262,179,0,0,27691,134,19030,16768,11151,6846
2021-11-19 06:00:00+00,7499,718,5615,10983,573,1680,2272,171,0,0,29511,149,19443,17171,11556,8217
2021-11-19 06:30:00+00,9084,905,5613,11537,588,1640,2269,158,0,20,31814,163,20007,17738,12125,9989
2021-11-19 07:00:00+00,12067,984,5611,11846,600,1478,2267,143,0,0,34996,180,20324,18057,12446,13051
2021-11-19 07:30:00+00,13374,891,5608,12321,610,1332,2267,144,9,0,36556,183,20815,18548,12940,14265
2021-11-19 08:00:00+00,14407,977,5607,12841,604,1108,2273,146,171,104,38238,186,21496,19223,13616,15384
2021-11-19 08:30:00+00,15077,999,5614,12431,610,1126,2274,145,559,38,38873,190,21488,19214,13600,16076
2021-11-19 09:00:00+00,15231,999,5612,12260,581,1550,2275,150,909,112,39679,191,21637,19362,13750,16230
2021-11-19 09:30:00+00,15065,1000,5619,12528,575,1564,2263,141,1193,52,40000,188,22178,19915,14296,16065
2021-11-19 10:00:00+00,14555,1000,5617,12405,558,1910,2197,147,1691,120,40200,184,22468,20271,14654,15555
2021-11-19 10:30:00+00,14017,1001,5614,12186,562,1916,2167,140,2146,50,39799,181,22675,20508,14894,15018
2021-11-19 11:00:00+00,13748,948,5620,12446,530,2044,2207,146,2492,64,40245,177,23295,21088,15468,14696
2021-11-19 11:30:00+00,14005,819,5614,12410,536,2046,2212,158,2428,94,40322,176,23200,20988,15374,14824
2021-11-19 12:00:00+00,14730,959,5610,11854,537,1974,2193,168,2252,4,40281,187,22446,20253,14643,15689
2021-11-19 12:30:00+00,15284,1001,5615,11544,530,1974,2146,149,1810,0,40053,194,21645,19499,13884,16285
2021-11-19 13:00:00+00,15267,1000,5615,11058,590,2174,2195,166,1586,0,39651,197,21044,18849,13234,16267
2021-11-19 13:30:00+00,15438,998,5617,10592,642,2176,2207,172,1172,0,39014,202,20230,18023,12406,16436
2021-11-19 14:00:00+00,15863,1000,5617,10292,686,2002,2214,169,844,0,38687,207,19653,17439,11822,16863
2021-11-19 14:30:00+00,16314,999,5613,9554,701,2000,2212,170,531,176,38270,214,18611,16399,10786,17313
2021-11-19 15:00:00+00,17450,992,5615,9082,733,2050,2212,251,236,150,38771,224,17878,15666,10051,18442
2021-11-19 15:30:00+00,18030,996,5609,8819,760,2050,2220,262,26,130,38902,229,17434,15214,9605,19026
2021-11-19 16:00:00+00,17792,997,5614,8689,801,2334,2210,335,0,586,39358,225,17314,15104,9490,18789
2021-11-19 16:30:00+00,18371,998,5613,8764,794,2448,2208,482,0,1352,41030,223,17379,15171,9558,19369
2021-11-19 17:00:00+00,18095,1000,5613,8777,717,3184,2207,556,0,1414,41563,219,17314,15107,9494,19095
2021-11-19 17:30:00+00,18233,1000,5613,8745,689,3216,2206,557,0,1488,41747,220,17253,15047,9434,19233
2021-11-19 18:00:00+00,18514,998,5614,8504,689,2756,2209,498,0,1472,41254,224,17016,14807,9193,19512
2021-11-19 18:30:00+00,18407,998,5617,8587,687,2756,2210,322,0,1058,40642,225,17101,14891,9274,19405
2021-11-19 19:00:00+00,18415,998,5616,8516,668,2492,2212,332,0,504,39753,231,17012,14800,9184,19413
2021-11-19 19:30:00+00,17888,999,5613,8225,669,2438,2216,291,0,90,38429,232,16723,14507,8894,18887
2021-11-19 20:00:00+00,17373,1002,5612,8152,654,2454,2203,146,0,222,37818,229,16621,14418,8806,18375
2021-11-19 20:30:00+00,16234,990,5617,8195,651,2494,2215,193,0,0,36589,225,16678,14463,8846,17224
2021-11-19 21:00:00+00,14618,994,5614,8006,654,2502,2215,146,0,136,34885,218,16489,14274,8660,15612
2021-11-19 21:30:00+00,13142,996,5616,7725,651,2652,2212,142,0,170,33306,213,16204,13992,8376,14138
2021-11-19 22:00:00+00,11835,990,5617,8057,635,2810,2208,143,0,0,32295,206,16517,14309,8692,12825
2021-11-19 22:30:00+00,9885,990,5615,8375,651,2928,2170,141,0,42,30797,192,16811,14641,9026,10875
2021-11-19 23:00:00+00,8131,943,5612,8310,651,2864,2001,144,0,70,28726,179,16574,14573,8961,9074
2021-11-19 23:30:00+00,7120,729,5613,8519,649,2705,2208,142,0,0,27684,162,16989,14781,9168,7849
2021-11-20 00:00:00+00,6127,724,5617,8682,651,2777,2164,163,0,6,26911,154,17114,14950,9333,6851
2021-11-20 00:30:00+00,5790,844,5614,8545,652,2884,2214,150,0,34,26727,156,17025,14811,9197,6634
2021-11-20 01:00:00+00,5690,992,5620,8223,643,2922,2208,146,0,2,26446,163,16694,14486,8866,6682
2021-11-20 01:30:00+00,5881,997,5618,8202,609,2834,2208,153,0,0,26502,164,16637,14429,8811,6878
2021-11-20 02:00:00+00,5979,993,5621,8162,577,2784,2195,148,0,0,26459,164,16555,14360,8739,6972
2021-11-20 02:30:00+00,5895,979,5617,8307,576,2662,2212,153,0,0,26401,161,16712,14500,8883,6874
2021-11-20 03:00:00+00,5231,901,5621,8392,568,2934,2125,152,0,0,25924,154,16706,14581,8960,6132
2021-11-20 03:30:00+00,4594,996,5615,8640,547,2830,2199,149,0,0,25570,149,17001,14802,9187,5590
2021-11-20 04:00:00+00,4624,1001,5615,8600,550,2682,2213,152,0,0,25437,149,16978,14765,9150,5625
2021-11-20 04:30:00+00,4743,990,5619,8735,543,2529,2207,143,0,0,25509,147,17104,14897,9278,5733
2021-11-20 05:00:00+00,5008,995,5615,9156,550,2246,2213,142,0,0,25925,148,17534,15321,9706,6003
2021-11-20 05:30:00+00,4963,872,5614,9291,558,2322,2124,154,0,0,25898,144,17587,15463,9849,5835
2021-11-20 06:00:00+00,5214,951,5618,9107,580,2372,2144,147,0,0,26133,148,17449,15305,9687,6165
2021-11-20 06:30:00+00,5771,840,5618,9178,582,2594,2157,146,0,240,27126,151,17535,15378,9760,6611
2021-11-20 07:00:00+00,7414,950,5617,9159,588,2406,2213,143,0,246,28736,168,17577,15364,9747,8364
2021-11-20 07:30:00+00,8451,990,5611,9605,581,2538,2215,145,0,0,30136,177,18012,15797,10186,9441
2021-11-20 08:00:00+00,9589,1002,5608,9669,545,2746,2184,151,27,96,31617,183,18033,15849,10241,10591
2021-11-20 08:30:00+00,10530,1001,5610,9786,546,2724,2216,151,138,162,32864,187,18296,16080,10470,11531
2021-11-20 09:00:00+00,10888,926,5615,10278,550,2596,2216,151,312,134,33666,182,18971,16755,11140,11814
2021-11-20 09:30:00+00,11006,985,5617,10758,542,2494,2216,145,478,136,34377,179,19611,17395,11778,11991
2021-11-20 10:00:00+00,11680,999,5616,11044,538,1974,2216,146,610,136,34959,179,20024,17808,12192,12679
2021-11-20 10:30:00+00,11830,1000,5615,11080,541,1964,2217,145,703,172,35267,179,20156,17939,12324,12830
2021-11-20 11:00:00+00,11810,999,5608,11062,540,1776,2218,150,784,164,35111,181,20212,17994,12386,12809
2021-11-20 11:30:00+00,11857,1000,5616,11257,538,1774,2218,148,823,138,35369,180,20452,18234,12618,12857
2021-11-20 12:00:00+00,11696,999,5611,11217,562,2038,2218,159,843,58,35401,180,20451,18233,12622,12695
2021-11-20 12:30:00+00,11801,999,5617,11112,611,2048,2220,150,996,0,35554,180,20556,18336,12719,12800
2021-11-20 13:00:00+00,11841,1002,5611,11126,622,2162,2215,154,823,46,35602,182,20397,18182,12571,12843
2021-11-20 13:30:00+00,11928,1000,5611,11004,622,2160,2217,157,536,30,35265,185,19990,17773,12162,12928
2021-11-20 14:00:00+00,12527,1002,5614,10967,621,1748,2320,148,387,120,35454,189,19909,17589,11975,13529
2021-11-20 14:30:00+00,12971,1001,5607,10704,623,1738,2358,147,242,0,35391,194,19534,17176,11569,13972
2021-11-20 15:00:00+00,13200,999,5615,10793,622,2142,2361,184,84,0,36000,196,19475,17114,11499,14199
2021-11-20 15:30:00+00,13591,999,5604,10715,622,2189,2360,162,14,14,36270,199,19315,16955,11351,14590
2021-11-20 16:00:00+00,13774,999,5610,10850,631,2153,2361,149,0,268,36795,199,19452,17091,11481,14773
2021-11-20 16:30:00+00,14432,1000,5604,10643,652,2160,2350,173,0,694,37709,201,19249,16899,11295,15432
2021-11-20 17:00:00+00,14489,998,5613,10773,648,2240,2296,208,0,1220,38485,197,19330,17034,11421,15487
2021-11-20 17:30:00+00,14447,1000,5610,10856,616,2204,2296,221,0,1352,38602,195,19378,17082,11472,15447
2021-11-20 18:00:00+00,14674,1001,5609,10884,608,2523,2289,309,0,1008,38905,199,19390,17101,11492,15675
2021-11-20 18:30:00+00,14348,997,5608,11154,609,2522,2295,244,0,710,38487,196,19666,17371,11763,15345
2021-11-20 19:00:00+00,13830,1000,5611,11295,618,2702,2280,149,0,392,37876,195,19804,17524,11913,14830
2021-11-20 19:30:00+00,13279,1001,5615,11177,630,2613,2276,147,0,0,36738,194,19698,17422,11807,14280
2021-11-20 20:00:00+00,12347,1000,5614,11230,625,2574,2293,150,0,54,35887,189,19762,17469,11855,13347
2021-11-20 20:30:00+00,11398,1000,5609,11060,625,2488,2295,144,0,284,34903,182,19589,17294,11685,12398
2021-11-20 21:00:00+00,10525,999,5609,11209,623,2436,2296,142,0,26,33865,179,19737,17441,11832,11524
2021-11-20 21:30:00+00,9260,871,5614,11331,620,2448,2295,142,0,88,32669,167,19860,17565,11951,10131
2021-11-20 22:00:00+00,8202,532,5616,11310,599,2652,2295,140,0,178,31524,152,19820,17525,11909,8734
2021-11-20 22:30:00+00,7414,263,5616,11346,602,2454,2295,150,0,0,30140,137,19859,17564,11948,7677
2021-11-20 23:00:00+00,5883,0,5615,11481,598,2628,2293,146,0,98,28742,115,19987,17694,12079,5883
2021-11-20 23:30:00+00,4786,0,5610,11619,604,2688,2290,162,0,0,27759,104,20123,17833,12223,4786
2021-11-21 00:00:00+00,4278,0,5610,11571,575,2860,2287,145,0,42,27368,99,20043,17756,12146,4278
2021-11-21 00:30:00+00,4459,0,5610,11478,515,2910,2288,150,0,0,27410,103,19891,17603,11993,4459
2021-11-21 01:00:00+00,4131,0,5603,11341,515,2958,2288,152,0,0,26988,101,19747,17459,11856,4131
2021-11-21 01:30:00+00,3845,0,5612,11421,501,2726,2283,141,0,0,26529,94,19817,17534,11922,3845
2021-11-21 02:00:00+00,3715,0,5616,11566,502,2990,2288,145,0,0,26822,93,19972,17684,12068,3715
2021-11-21 02:30:00+00,3730,0,5615,11570,505,2884,2289,147,0,0,26740,92,19979,17690,12075,3730
2021-11-21 03:00:00+00,3454,0,5619,11733,502,2492,2285,150,0,0,26235,86,20139,17854,12235,3454
2021-11-21 03:30:00+00,2945,0,5617,11897,503,2398,2294,149,0,0,25803,78,20311,18017,12400,2945
2021-11-21 04:00:00+00,2802,0,5616,11804,505,2292,2327,149,0,0,25495,77,20252,17925,12309,2802
2021-11-21 04:30:00+00,2779,0,5618,11858,506,2292,2280,148,0,0,25481,76,20262,17982,12364,2779
2021-11-21 05:00:00+00,3100,0,5612,11808,519,2274,2208,143,0,0,25664,80,20147,17939,12327,3100
2021-11-21 05:30:00+00,3065,0,5620,12207,502,2377,2059,147,0,0,25977,80,20388,18329,12709,3065
2021-11-21 06:00:00+00,2974,0,5610,12647,499,2672,1992,154,0,0,26548,80,20748,18756,13146,2974
2021-11-21 06:30:00+00,3193,0,5612,12768,488,2808,2078,149,0,0,27096,84,20946,18868,13256,3193
2021-11-21 07:00:00+00,4299,0,5610,12751,499,2510,2227,160,0,0,28056,93,21087,18860,13250,4299
2021-11-21 07:30:00+00,5437,0,5611,12395,500,2460,2222,148,14,0,28787,105,20742,18520,12909,5437
2021-11-21 08:00:00+00,6273,0,5612,12479,568,2598,2225,146,315,0,30216,113,21199,18974,13362,6273
2021-11-21 08:30:00+00,7188,0,5607,12640,540,2592,2186,186,1147,0,32086,118,22120,19934,14327,7188
2021-11-21 09:00:00+00,7915,0,5605,12898,519,2620,2243,165,2250,0,34215,117,23515,21272,15667,7915
2021-11-21 09:30:00+00,7764,0,5608,13190,530,2602,2252,145,3074,0,35165,112,24654,22402,16794,7764
2021-11-21 10:00:00+00,7877,0,5615,13075,521,2720,2253,152,3714,0,35927,111,25178,22925,17310,7877
2021-11-21 10:30:00+00,7407,0,5617,13485,533,2722,2255,151,4048,0,36218,105,25938,23683,18066,7407
2021-11-21 11:00:00+00,7416,0,5614,13800,534,2720,2252,154,4352,0,36842,103,26552,24300,18686,7416
2021-11-21 11:30:00+00,7266,0,5611,14110,538,2800,2247,160,4390,0,37122,102,26896,24649,19038,7266
2021-11-21 12:00:00+00,8091,0,5614,14107,563,2572,2254,161,4073,0,37435,110,26611,24357,18743,8091
2021-11-21 12:30:00+00,8526,0,5609,14032,578,2700,2254,162,3441,0,37302,116,25914,23660,18051,8526
2021-11-21 13:00:00+00,8431,0,5609,13963,648,2508,2254,156,3116,0,36685,116,25590,23336,17727,8431
2021-11-21 13:30:00+00,8501,0,5614,14197,701,2512,2255,151,2315,0,36246,119,25082,22827,17213,8501
2021-11-21 14:00:00+00,8243,16,5619,14264,703,2848,2255,155,1756,4,35863,117,24597,22342,16723,8259
2021-11-21 14:30:00+00,9111,31,5623,14033,713,2786,2254,159,1163,126,36000,126,23786,21532,15909,9142
2021-11-21 15:00:00+00,10413,47,5628,13892,760,2596,2254,179,397,0,36166,139,22931,20677,15049,10460
2021-11-21 15:30:00+00,11494,342,5622,13589,903,2638,2254,171,62,138,37213,154,22430,20176,14554,11836
2021-11-21 16:00:00+00,12078,667,5620,13351,938,3594,2331,162,0,216,38957,163,22240,19909,14289,12745
2021-11-21 16:30:00+00,13523,969,5621,13274,941,3624,2388,226,0,866,41432,174,22224,19836,14215,14492
2021-11-21 17:00:00+00,13999,998,5617,12898,989,3400,2409,323,0,1214,41847,178,21913,19504,13887,14997
2021-11-21 17:30:00+00,14021,1000,5627,12574,1011,3366,2437,496,0,1160,41692,180,21649,19212,13585,15021
2021-11-21 18:00:00+00,13674,1000,5620,12512,947,2756,2487,314,0,1118,40428,180,21566,19079,13459,14674
2021-11-21 18:30:00+00,13690,1000,5625,12264,941,2752,2651,294,0,1010,40227,181,21481,18830,13205,14690
2021-11-21 19:00:00+00,13775,1001,5627,12096,926,2692,2801,166,0,186,39270,186,21450,18649,13022,14776
2021-11-21 19:30:00+00,13050,1001,5628,11766,921,2594,2910,163,0,16,38049,185,21225,18315,12687,14051
2021-11-21 20:00:00+00,13270,999,5629,11323,842,2536,2912,158,0,124,37793,188,20706,17794,12165,14269
2021-11-21 20:30:00+00,12577,993,5629,11232,697,2536,2913,159,0,18,36754,186,20471,17558,11929,13570
2021-11-21 21:00:00+00,11178,995,5626,11305,641,2492,2947,158,0,36,35378,178,20519,17572,11946,12173
2021-11-21 21:30:00+00,10004,992,5623,11049,661,2494,2891,178,0,20,33912,172,20224,17333,11710,10996
2021-11-21 22:00:00+00,8410,999,5621,10571,656,2710,2900,155,0,104,32126,163,19748,16848,11227,9409
2021-11-21 22:30:00+00,6911,994,5626,10114,654,2742,2961,156,0,238,30396,153,19355,16394,10768,7905
2021-11-21 23:00:00+00,5022,920,5627,10061,643,2730,2965,151,0,0,28119,137,19296,16331,10704,5942
2021-11-21 23:30:00+00,4523,710,5625,10116,643,2642,2951,147,0,0,27357,124,19335,16384,10759,5233
2021-11-22 00:00:00+00,4061,618,5618,9871,622,2734,2957,156,0,0,26637,121,19068,16111,10493,4679
2021-11-22 00:30:00+00,4408,678,5622,9732,621,2754,2959,155,0,0,26929,127,18934,15975,10353,5086
2021-11-22 01:00:00+00,4415,683,5622,9662,621,2822,2958,158,0,0,26941,128,18863,15905,10283,5098
2021-11-22 01:30:00+00,4204,551,5630,9712,621,2758,2938,156,0,0,26570,121,18901,15963,10333,4755
2021-11-22 02:00:00+00,3961,546,5627,9816,508,3278,2960,159,0,0,26855,117,18911,15951,10324,4507
2021-11-22 02:30:00+00,3783,628,5631,9847,506,3308,2980,161,0,0,26844,117,18964,15984,10353,4411
2021-11-22 03:00:00+00,3698,806,5628,9544,508,2766,2995,158,0,0,26103,123,18675,15680,10052,4504
2021-11-22 03:30:00+00,3744,855,5631,9644,509,2766,3007,159,0,0,26315,125,18791,15784,10153,4599
2021-11-22 04:00:00+00,4427,979,5627,9550,513,2652,3010,158,0,0,26916,138,18700,15690,10063,5406
2021-11-22 04:30:00+00,4776,989,5628,9670,514,2544,3011,157,0,0,27289,140,18823,15812,10184,5765
2021-11-22 05:00:00+00,6289,1010,5627,9632,515,1391,3000,154,0,0,27618,146,18774,15774,10147,7299
2021-11-22 05:30:00+00,7504,1109,5621,9495,515,1448,2999,160,0,0,28851,161,18630,15631,10010,8613
2021-11-22 06:00:00+00,9874,1396,5621,9730,551,1748,3006,160,0,0,32086,190,18908,15902,10281,11270
2021-11-22 06:30:00+00,12772,1480,5621,9678,555,1730,3016,164,0,0,35016,209,18870,15854,10233,14252
2021-11-22 07:00:00+00,16674,1495,5619,9506,593,1044,3014,210,0,118,38273,224,18732,15718,10099,18169
2021-11-22 07:30:00+00,18727,1500,5622,8933,614,952,3016,322,10,256,39952,236,18195,15179,9557,20227
2021-11-22 08:00:00+00,19390,1536,5626,8633,683,1562,3018,639,319,138,41544,242,18279,15261,9635,20926
2021-11-22 08:30:00+00,19815,1609,5621,8529,696,1668,3017,617,1223,130,42925,241,19086,16069,10448,21424
2021-11-22 09:00:00+00,19878,1666,5613,8154,700,2198,3011,600,2340,242,44402,238,19818,16807,11194,21544
2021-11-22 09:30:00+00,20035,1705,5621,7877,833,2112,3008,566,3388,0,45145,235,20727,17719,12098,21740
2021-11-22 10:00:00+00,20058,1752,5622,7559,855,1750,3006,450,4221,0,45273,231,21263,18257,12635,21810
2021-11-22 10:30:00+00,19746,1779,5624,7484,789,1746,3001,305,4724,24,45222,228,21622,18621,12997,21525
2021-11-22 11:00:00+00,19818,1844,5623,7305,789,1678,2954,302,5014,0,45327,228,21685,18731,13108,21662
2021-11-22 11:30:00+00,19431,1889,5625,7374,789,1678,2960,303,5108,0,45157,227,21856,18896,13271,21320
2021-11-22 12:00:00+00,19551,1970,5619,7335,742,1476,2975,225,4941,0,44834,229,21612,18637,13018,21521
2021-11-22 12:30:00+00,19307,1865,5628,7750,740,1480,2982,215,4691,0,44658,225,21791,18809,13181,21172
2021-11-22 13:00:00+00,19106,1538,5625,7668,723,1830,2986,241,4237,68,44022,221,21239,18253,12628,20644
2021-11-22 13:30:00+00,19373,1665,5631,7739,667,1836,2989,212,3558,0,43670,228,20584,17595,11964,21038
2021-11-22 14:00:00+00,19724,2013,5635,7861,698,1342,2988,229,2676,34,43200,239,19858,16870,11235,21737
2021-11-22 14:30:00+00,20123,2274,5639,7745,697,1334,2989,195,1624,16,42636,251,18694,15705,10066,22397
2021-11-22 15:00:00+00,20551,2345,5632,7990,691,1142,3014,242,621,0,42228,256,17948,14934,9302,22896
2021-11-22 15:30:00+00,20900,2314,5638,7965,690,1467,3034,370,87,494,42959,257,17414,14380,8742,23214
2021-11-22 16:00:00+00,20357,2485,5636,8042,720,2180,3040,331,0,610,43401,253,17438,14398,8762,22842
2021-11-22 16:30:00+00,21044,2623,5632,7727,888,2330,3053,469,0,1918,45684,250,17300,14247,8615,23667
2021-11-22 17:00:00+00,21799,2672,5634,7555,955,2400,3100,641,0,2042,46798,253,17244,14144,8510,24471
2021-11-22 17:30:00+00,21610,2692,5635,7586,982,2402,3102,721,0,1412,46142,256,17305,14203,8568,24302
2021-11-22 18:00:00+00,21530,2699,5638,7348,965,1804,3082,616,0,1784,45466,258,17033,13951,8313,24229
2021-11-22 18:30:00+00,21404,2686,5636,7135,963,1774,3084,519,0,1376,44577,261,16818,13734,8098,24090
2021-11-22 19:00:00+00,20875,2670,5636,7194,953,2248,3072,293,0,596,43537,263,16855,13783,8147,23545
2021-11-22 19:30:00+00,20428,2672,5639,7067,852,2274,3047,254,0,50,42283,266,16605,13558,7919,23100
2021-11-22 20:00:00+00,19606,2679,5638,6814,628,2428,3050,243,0,0,41086,273,16130,13080,7442,22285
2021-11-22 20:30:00+00,18772,2613,5642,6531,622,2438,3016,234,0,0,39868,272,15811,12795,7153,21385
2021-11-22 21:00:00+00,18495,2609,5640,6226,592,1876,2904,224,0,64,38630,275,15362,12458,6818,21104
2021-11-22 21:30:00+00,16928,2610,5639,6166,593,1856,2906,208,0,0,36906,271,15304,12398,6759,19538
2021-11-22 22:00:00+00,15279,2595,5637,6047,597,1836,2907,204,0,16,35118,266,15188,12281,6644,17874
2021-11-22 22:30:00+00,13827,2421,5629,5699,575,1744,2911,232,0,24,33062,261,14814,11903,6274,16248
2021-11-22 23:00:00+00,12905,2094,5639,5345,638,2008,2913,212,0,0,31754,252,14535,11622,5983,14999
2021-11-22 23:30:00+00,12537,2130,5637,5283,650,1958,2914,207,0,0,31316,252,14484,11570,5933,14667
2021-11-23 00:00:00+00,12521,2178,5637,5249,552,2070,2945,204,0,0,31356,255,14383,11438,5801,14699
2021-11-23 00:30:00+00,12617,2181,5633,5292,552,2204,2942,177,0,0,31598,256,14419,11477,5844,14798
2021-11-23 01:00:00+00,12634,2110,5635,5123,551,2540,2917,186,0,0,31696,255,14226,11309,5674,14744
2021-11-23 01:30:00+00,12521,1814,5632,5114,551,2412,2914,186,0,0,31144,247,14211,11297,5665,14335
2021-11-23 02:00:00+00,12014,1502,5629,5202,546,2584,2917,180,0,0,30574,237,14294,11377,5748,13516
2021-11-23 02:30:00+00,11648,1499,5638,5355,541,2612,2907,188,0,0,30388,234,14441,11534,5896,13147
2021-11-23 03:00:00+00,11346,1499,5635,5325,545,2400,2917,146,0,0,29813,232,14422,11505,5870,12845
2021-11-23 03:30:00+00,11212,1496,5638,5282,544,2366,2913,130,0,0,29581,231,14377,11464,5826,12708
2021-11-23 04:00:00+00,11437,1497,5634,5162,544,2266,2916,140,0,0,29596,235,14256,11340,5706,12934
2021-11-23 04:30:00+00,11486,1496,5637,5111,543,2288,2914,132,0,0,29607,235,14205,11291,5654,12982
2021-11-23 05:00:00+00,12785,1500,5632,5122,556,1312,2999,138,0,0,30044,238,14309,11310,5678,14285
2021-11-23 05:30:00+00,13677,1501,5635,5014,552,1198,3015,119,0,0,30712,242,14217,11202,5566,15178
2021-11-23 06:00:00+00,14993,1501,5634,4842,607,778,3034,129,0,136,31655,245,14118,11084,5449,16494
2021-11-23 06:30:00+00,16154,1499,5633,4613,623,928,3053,121,0,0,32624,254,13922,10870,5236,17653
2021-11-23 07:00:00+00,17191,1503,5635,4614,1015,812,3065,138,0,152,34125,253,14329,11263,5629,18694
2021-11-23 07:30:00+00,17869,1499,5636,4405,1041,850,3072,200,4,170,34746,258,14158,11086,5450,19368
2021-11-23 08:00:00+00,18363,1501,5633,4490,1021,924,3073,389,195,228,35817,256,14413,11339,5706,19864
2021-11-23 08:30:00+00,18908,1499,5629,4484,934,938,3075,463,755,390,37076,256,14878,11803,6173,20407
2021-11-23 09:00:00+00,19037,1500,5615,4511,854,2228,3076,425,1500,338,39085,247,15556,12480,6865,20537
2021-11-23 09:30:00+00,19135,1501,5600,4315,849,2270,3071,362,2306,422,39831,242,16141,13070,7470,20636
2021-11-23 10:00:00+00,19217,1502,5599,4338,822,2042,3069,338,2884,574,40385,238,16712,13643,8044,20719
2021-11-23 10:30:00+00,19141,242,5602,1340,137,2042,3066,58,3302,108,35038,237,13447,10381,4779,19383
2021-11-23 11:00:00+00,19255,121,5611,744,0,1924,3066,0,3572,0,34293,240,12993,9927,4316,19376
2021-11-23 11:30:00+00,19309,0,5617,755,0,2334,3063,0,3650,0,34728,240,13086,10023,4405,19309
2021-11-23 12:00:00+00,19476,743,5622,2601,396,2744,3062,99,3413,102,38257,244,15093,12031,6410,20219
2021-11-23 12:30:00+00,19548,1496,5624,4493,788,2978,3058,175,2986,134,41280,248,16949,13891,8267,21044
2021-11-23 13:00:00+00,19732,1499,5626,4539,789,2454,3056,192,2495,120,40503,255,16505,13449,7823,21231
2021-11-23 13:30:00+00,19732,1502,5627,4446,789,2456,3054,235,1847,122,39811,259,15764,12710,7082,21234
2021-11-23 14:00:00+00,19891,1407,5628,4407,790,2346,3055,261,1265,130,39179,263,15144,12090,6462,21298
2021-11-23 14:30:00+00,20135,1394,5630,4386,794,2344,3056,276,689,134,38838,268,14555,11499,5869,21529
2021-11-23 15:00:00+00,20486,1503,5632,4524,808,2628,3058,279,220,410,39548,270,14242,11184,5552,21989
2021-11-23 15:30:00+00,21093,1502,5635,4785,792,2796,3061,386,17,972,41040,267,14291,11230,5594,22595
2021-11-23 16:00:00+00,21661,1500,5637,4579,889,4408,3064,410,0,1076,43224,261,14169,11105,5468,23161
2021-11-23 16:30:00+00,22316,1501,5639,4432,908,4438,3068,495,0,2144,44941,258,14046,10979,5340,23817
2021-11-23 17:00:00+00,22664,1502,5642,4740,927,3854,3068,721,0,2026,45144,255,14377,11309,5667,24166
2021-11-23 17:30:00+00,22284,1500,5644,4907,924,3836,3066,813,0,2268,45242,251,14541,11475,5831,23784
2021-11-23 18:00:00+00,22600,1500,5641,4939,924,3812,3062,686,0,2172,45336,252,14566,11504,5863,24100
2021-11-23 18:30:00+00,22318,1503,5645,4893,906,3812,3060,487,0,1600,44224,255,14504,11444,5799,23821
2021-11-23 19:00:00+00,21702,1499,5643,5050,842,3434,3062,492,0,1380,43104,251,14597,11535,5892,23201
2021-11-23 19:30:00+00,21442,1500,5649,5121,852,3406,3062,456,0,906,42394,252,14684,11622,5973,22942
2021-11-23 20:00:00+00,21456,1499,5646,5245,745,2600,3058,440,0,244,40933,261,14694,11636,5990,22955
2021-11-23 20:30:00+00,20467,1500,5647,5660,664,2578,3035,256,0,0,39807,256,15006,11971,6324,21967
2021-11-23 21:00:00+00,20224,1500,5644,5595,633,1922,3023,190,0,314,39045,264,14895,11872,6228,21724
2021-11-23 21:30:00+00,19039,1500,5645,5640,517,1914,2999,134,0,184,37572,261,14801,11802,6157,20539
2021-11-23 22:00:00+00,17435,1500,5644,5615,510,1934,2884,121,0,46,35689,259,14653,11769,6125,18935
2021-11-23 22:30:00+00,16048,1499,5642,5530,557,1792,2886,118,0,116,34188,253,14615,11729,6087,17547
2021-11-23 23:00:00+00,15317,1499,5643,5615,583,1452,2884,127,0,0,33120,247,14725,11841,6198,16816
2021-11-23 23:30:00+00,14257,1498,5646,5791,560,1448,2883,120,0,0,32203,241,14880,11997,6351,15755
2021-11-24 00:00:00+00,14319,1498,5649,5858,472,1576,2890,117,0,0,32379,243,14869,11979,6330,15817
2021-11-24 00:30:00+00,14742,1501,5644,5881,451,1611,2888,125,0,0,32843,245,14864,11976,6332,16243
2021-11-24 01:00:00+00,14150,1499,5643,5901,450,1728,2885,122,0,0,32378,243,14879,11994,6351,15649
2021-11-24 01:30:00+00,13511,1498,5640,5887,449,1800,2886,121,0,0,31792,240,14862,11976,6336,15009
2021-11-24 02:00:00+00,13326,1500,5640,5879,445,1658,2865,121,0,0,31434,239,14829,11964,6324,14826
2021-11-24 02:30:00+00,13200,1504,5637,5765,431,1656,2881,120,0,0,31194,239,14714,11833,6196,14704
2021-11-24 03:00:00+00,13192,1502,5643,5899,429,1404,2845,122,0,0,31036,236,14816,11971,6328,14694
2021-11-24 03:30:00+00,12893,1501,5649,5797,428,1440,2756,132,0,0,30596,236,14630,11874,6225,14394
2021-11-24 04:00:00+00,12898,1501,5646,5632,428,1336,2862,136,0,0,30439,236,14568,11706,6060,14399
2021-11-24 04:30:00+00,13172,1504,5651,5567,427,1330,2886,133,0,0,30670,238,14531,11645,5994,14676
2021-11-24 05:00:00+00,13524,1457,5647,5665,466,1180,2844,133,0,0,30916,236,14622,11778,6131,14981
2021-11-24 05:30:00+00,14267,1490,5646,5734,475,1170,2824,135,0,0,31741,240,14679,11855,6209,15757
2021-11-24 06:00:00+00,15876,1502,5649,6135,518,1098,2847,137,0,12,33774,244,15149,12302,6653,17378
2021-11-24 06:30:00+00,18173,1431,5650,6640,762,1112,2849,138,0,54,36809,247,15901,13052,7402,19604
2021-11-24 07:00:00+00,19323,1136,5648,6768,956,1176,2875,139,0,108,38129,244,16247,13372,7724,20459
2021-11-24 07:30:00+00,20020,1389,5651,6843,1020,1324,2876,160,0,0,39283,251,16390,13514,7863,21409
2021-11-24 08:00:00+00,21044,1346,5646,6926,1028,1292,2879,239,51,168,40619,252,16530,13651,8005,22390
2021-11-24 08:30:00+00,21461,1483,5649,7096,968,1306,2883,356,185,424,41811,253,16781,13898,8249,22944
2021-11-24 09:00:00+00,22686,1498,5649,6601,1017,1120,2882,402,367,146,42368,260,16516,13634,7985,24184
2021-11-24 09:30:00+00,22695,1498,5644,6587,1020,1110,2880,400,569,108,42511,259,16700,13820,8176,24193
2021-11-24 10:00:00+00,22447,1498,5649,6772,925,1350,2888,332,782,108,42751,255,17016,14128,8479,23945
2021-11-24 10:30:00+00,22415,1498,5640,6723,880,1372,2889,320,898,124,42759,255,17030,14141,8501,23913
2021-11-24 11:00:00+00,22702,1500,5640,6723,914,1092,2819,294,1017,74,42775,256,17113,14294,8654,24202
2021-11-24 11:30:00+00,22823,1501,5650,6758,939,1122,2805,359,1157,0,43114,256,17309,14504,8854,24324
2021-11-24 12:00:00+00,22442,1499,5646,6593,844,1212,2808,392,1112,132,42680,257,17003,14195,8549,23941
2021-11-24 12:30:00+00,22059,1500,5644,6406,871,1212,2887,429,1008,188,42204,256,16816,13929,8285,23559
2021-11-24 13:00:00+00,22012,1500,5646,6609,845,1187,2880,460,893,374,42406,255,16873,13993,8347,23512
2021-11-24 13:30:00+00,21690,1499,5640,6860,800,1140,2874,437,876,476,42292,252,17050,14176,8536,23189
2021-11-24 14:00:00+00,21960,1529,5663,6489,849,1160,2864,355,668,602,42139,256,16533,13669,8006,23489
2021-11-24 14:30:00+00,21664,1651,5714,6103,795,1162,2870,546,351,620,41476,262,15833,12963,7249,23315
2021-11-24 15:00:00+00,21273,1723,5758,5788,793,1366,2871,533,144,1092,41341,262,15354,12483,6725,22996
2021-11-24 15:30:00+00,21484,1811,5765,5914,799,1238,2866,563,20,1346,41806,262,15364,12498,6733,23295
2021-11-24 16:00:00+00,20282,1953,5787,6405,806,3100,2887,590,0,1748,43558,247,15885,12998,7211,22235
2021-11-24 16:30:00+00,21117,2066,5789,6361,820,3248,2931,529,0,2072,44933,250,15901,12970,7181,23183
2021-11-24 17:00:00+00,20932,2064,5791,6477,838,3188,2924,700,0,2010,44924,250,16030,13106,7315,22996
2021-11-24 17:30:00+00,20553,2064,5794,6610,854,3190,2940,1035,0,2032,45072,249,16198,13258,7464,22617
2021-11-24 18:00:00+00,21163,2033,5786,6583,872,2090,2936,910,0,1186,43559,260,16177,13241,7455,23196
2021-11-24 18:30:00+00,21355,1979,5782,6418,866,2052,2839,671,0,1750,43712,257,15905,13066,7284,23334
2021-11-24 19:00:00+00,21139,2063,5787,6675,829,2102,2813,617,0,170,42195,266,16104,13291,7504,23202
2021-11-24 19:30:00+00,20448,2067,5786,6962,735,2152,2819,453,0,126,41548,262,16302,13483,7697,22515
2021-11-24 20:00:00+00,20179,2035,5792,7255,685,1982,2818,442,0,804,41992,260,16550,13732,7940,22214
2021-11-24 20:30:00+00,19364,1763,5797,7600,683,2126,2821,271,0,134,40558,256,16900,14080,8282,21127
2021-11-24 21:00:00+00,18196,1767,5796,7926,670,2208,2825,121,0,64,39573,251,17217,14392,8596,19963
2021-11-24 21:30:00+00,16703,1553,5794,8163,558,2156,2820,130,0,60,37937,240,17335,14515,8721,18256
2021-11-24 22:00:00+00,15415,926,5792,8308,649,2358,2839,135,0,100,36522,222,17588,14749,8957,16341
2021-11-24 22:30:00+00,13975,420,5796,8147,645,2496,2857,136,0,0,34472,207,17445,14588,8792,14395
2021-11-24 23:00:00+00,11954,43,5795,8007,574,2766,2837,133,0,0,32109,186,17213,14376,8581,11997
2021-11-24 23:30:00+00,10736,0,5790,8242,435,2804,2768,140,0,0,30915,176,17235,14467,8677,10736
2021-11-25 00:00:00+00,10292,0,5790,8685,436,3156,2713,137,0,0,31209,171,17624,14911,9121,10292
2021-11-25 00:30:00+00,9967,0,5796,9063,454,3158,2726,137,0,0,31301,167,18039,15313,9517,9967
2021-11-25 01:00:00+00,9424,0,5793,9380,453,3062,2710,135,0,0,30957,162,18336,15626,9833,9424
2021-11-25 01:30:00+00,9052,0,5793,9464,454,3060,2777,133,0,0,30733,159,18488,15711,9918,9052
2021-11-25 02:00:00+00,8483,0,5790,9727,449,2818,2783,130,0,0,30180,151,18749,15966,10176,8483
2021-11-25 02:30:00+00,7981,0,5789,10020,448,2788,2783,130,0,0,29939,146,19040,16257,10468,7981
2021-11-25 03:00:00+00,8565,0,5758,9905,443,2372,2778,131,0,0,29952,151,18884,16106,10348,8565
2021-11-25 03:30:00+00,8532,0,5727,10247,431,2320,2720,136,0,0,30113,149,19125,16405,10678,8532
2021-11-25 04:00:00+00,8793,0,5728,10194,420,2044,2706,129,0,0,30014,148,19048,16342,10614,8793
2021-11-25 04:30:00+00,8564,0,5729,10546,419,2038,2862,134,0,0,30292,145,19556,16694,10964,8564
2021-11-25 05:00:00+00,8405,0,5726,10675,442,2454,2866,133,0,0,30701,147,19709,16843,11117,8405
2021-11-25 05:30:00+00,9228,0,5726,10995,456,2464,2865,136,0,0,31870,152,20042,17177,11451,9228
2021-11-25 06:00:00+00,10696,78,5728,11087,483,2404,2864,138,0,0,33478,163,20162,17298,11570,10774
2021-11-25 06:30:00+00,12668,461,5735,11654,478,2392,2862,129,0,0,36379,181,20729,17867,12132,13129
2021-11-25 07:00:00+00,14973,731,5733,12370,470,2024,2858,130,0,58,39347,193,21431,18573,12840,15704
2021-11-25 07:30:00+00,15905,772,5732,12969,477,2064,2855,132,2,210,41118,195,22035,19180,13448,16677
2021-11-25 08:00:00+00,16779,900,5729,12540,596,2454,2863,121,227,236,42445,204,21955,19092,13363,17679
2021-11-25 08:30:00+00,16995,1307,5729,12066,756,2396,2789,121,1020,8,43187,210,22360,19571,13842,18302
2021-11-25 09:00:00+00,17111,1396,5732,11880,1000,2346,2809,123,2197,0,44594,206,23618,20809,15077,18507
2021-11-25 09:30:00+00,16962,1389,5731,11463,1004,2204,2851,118,3259,120,45101,201,24308,21457,15726,18351
2021-11-25 10:00:00+00,16746,1284,5735,11202,999,2014,2850,123,4004,264,45221,195,24790,21940,16205,18030
2021-11-25 10:30:00+00,16616,1098,5724,10783,996,1914,2853,133,4567,420,45104,189,24923,22070,16346,17714
2021-11-25 11:00:00+00,17070,978,5729,10614,967,1780,2845,138,4894,94,45109,189,25049,22204,16475,18048
2021-11-25 11:30:00+00,17097,958,5683,10759,862,1742,2850,139,4871,20,44981,189,25025,22175,16492,18055
2021-11-25 12:00:00+00,17568,1038,5645,10386,780,1866,2845,135,4703,62,45028,196,24359,21514,15869,18606
2021-11-25 12:30:00+00,17545,1236,5659,10549,772,1938,2768,140,4409,0,45016,201,24157,21389,15730,18781
2021-11-25 13:00:00+00,17377,1385,5654,10488,770,1982,2767,134,3851,162,44570,205,23530,20763,15109,18762
2021-11-25 13:30:00+00,17733,1335,5657,10732,788,1980,2812,129,3045,0,44211,208,23034,20222,14565,19068
2021-11-25 14:00:00+00,18506,1382,5660,10740,802,1958,2827,134,2252,24,44285,216,22281,19454,13794,19888
2021-11-25 14:30:00+00,18443,1458,5651,10349,809,1938,2843,159,1347,256,43253,222,20999,18156,12505,19901
2021-11-25 15:00:00+00,19103,1455,5664,10561,854,1598,2856,254,531,194,43070,225,20466,17610,11946,20558
2021-11-25 15:30:00+00,19313,1487,5656,10710,862,1782,2852,252,48,720,43682,227,20128,17276,11620,20800
2021-11-25 16:00:00+00,19800,1491,5666,10800,883,2448,2856,324,0,994,45262,225,20205,17349,11683,21291
2021-11-25 16:30:00+00,19953,1501,5658,10826,986,2452,2869,646,0,1516,46407,223,20339,17470,11812,21454
2021-11-25 17:00:00+00,19475,1501,5651,11320,965,2260,2850,892,0,1692,46606,219,20786,17936,12285,20976
2021-11-25 17:30:00+00,19610,1498,5653,11418,831,2262,2815,887,0,1640,46614,219,20717,17902,12249,21108
2021-11-25 18:00:00+00,20120,1497,5656,11552,798,2372,2775,646,0,1396,46812,224,20781,18006,12350,21617
2021-11-25 18:30:00+00,19136,1498,5651,11893,722,2442,2747,521,0,1760,46370,218,21013,18266,12615,20634
2021-11-25 19:00:00+00,18591,1500,5648,12306,709,3030,2735,338,0,692,45549,219,21398,18663,13015,20091
2021-11-25 19:30:00+00,17912,1503,5648,13222,640,2894,2736,209,0,118,44882,214,22246,19510,13862,19415
2021-11-25 20:00:00+00,16974,1381,5653,13722,567,2552,2699,123,0,96,43767,206,22641,19942,14289,18355
2021-11-25 20:30:00+00,16029,1078,5659,13348,546,2650,2714,118,0,18,42160,199,22267,19553,13894,17107
2021-11-25 21:00:00+00,14986,710,5635,12491,532,2748,2721,116,0,268,40207,193,21379,18658,13023,15696
2021-11-25 21:30:00+00,13915,409,5299,12170,530,3004,2712,120,0,52,38211,188,20711,17999,12700,14324
2021-11-25 22:00:00+00,11893,211,5278,12094,524,3436,2724,119,0,0,36279,173,20620,17896,12618,12104
2021-11-25 22:30:00+00,10453,0,5286,11857,522,3364,2702,115,0,0,34299,159,20367,17665,12379,10453
2021-11-25 23:00:00+00,8228,0,5342,11869,527,3204,2627,115,0,0,31912,141,20365,17738,12396,8228
2021-11-25 23:30:00+00,6766,0,5356,11776,524,3298,2605,119,0,0,30444,130,20261,17656,12300,6766
2021-11-26 00:00:00+00,5856,0,5353,12114,503,3512,2637,118,0,0,30093,120,20607,17970,12617,5856
2021-11-26 00:30:00+00,5833,0,5355,12549,483,3520,2653,129,0,86,30608,118,21040,18387,13032,5833
2021-11-26 01:00:00+00,5979,0,5351,12963,469,3418,2657,127,0,0,30964,118,21440,18783,13432,5979
2021-11-26 01:30:00+00,5573,0,5361,13081,467,3420,2657,122,0,0,30681,113,21566,18909,13548,5573
2021-11-26 02:00:00+00,5519,0,5367,13399,477,2880,2660,121,0,0,30423,112,21903,19243,13876,5519
2021-11-26 02:30:00+00,5207,0,5373,13663,476,2868,2620,124,0,0,30331,108,22132,19512,14139,5207
2021-11-26 03:00:00+00,5342,0,5385,13903,467,2420,2671,123,0,0,30311,107,22426,19755,14370,5342
2021-11-26 03:30:00+00,4669,0,5405,14255,467,2420,2718,124,0,0,30058,99,22845,20127,14722,4669
2021-11-26 04:00:00+00,4850,0,5414,14433,468,2242,2706,125,0,0,30238,98,23021,20315,14901,4850
2021-11-26 04:30:00+00,4766,0,5421,14766,477,2230,2646,122,0,0,30428,96,23310,20664,15243,4766
2021-11-26 05:00:00+00,5273,0,5422,14926,511,1730,2695,126,0,0,30683,95,23554,20859,15437,5273
2021-11-26 05:30:00+00,5443,0,5429,15101,520,1714,2720,128,0,0,31055,96,23770,21050,15621,5443
2021-11-26 06:00:00+00,6490,118,5367,15318,567,1906,2716,126,0,0,32608,110,23968,21252,15885,6608
2021-11-26 06:30:00+00,8833,397,5226,15426,539,1934,2711,130,0,0,35196,135,23902,21191,15965,9230
2021-11-26 07:00:00+00,10860,459,5230,15778,517,2574,2721,121,0,120,38380,151,24246,21525,16295,11319
2021-11-26 07:30:00+00,12470,460,5231,16114,528,2574,2727,139,0,28,40271,160,24600,21873,16642,12930
2021-11-26 08:00:00+00,12895,541,5223,16396,589,3160,2747,128,41,292,42012,163,24996,22249,17026,13436
2021-11-26 08:30:00+00,13207,872,5228,16476,586,3188,2738,227,318,0,42840,171,25346,22608,17380,14079
2021-11-26 09:00:00+00,13122,985,5220,16438,556,3504,2747,233,848,196,43849,170,25809,23062,17842,14107
2021-11-26 09:30:00+00,13216,994,5229,16582,556,3458,2683,280,1383,0,44381,169,26433,23750,18521,14210
2021-11-26 10:00:00+00,13071,850,5220,16792,552,2818,2687,305,1693,86,44074,161,26944,24257,19037,13921
2021-11-26 10:30:00+00,12717,908,5233,17229,542,2760,2709,294,2055,0,44447,157,27768,25059,19826,13625
2021-11-26 11:00:00+00,12803,658,5223,17092,542,2954,2727,157,2870,0,45026,150,28454,25727,20504,13461
2021-11-26 11:30:00+00,12682,754,5206,16854,547,2924,2709,117,2839,62,44694,151,28155,25446,20240,13436
2021-11-26 12:00:00+00,12916,986,5135,16850,558,2788,2657,113,2494,0,44497,159,27694,25037,19902,13902
2021-11-26 12:30:00+00,13137,732,5133,16573,556,2742,2659,125,2573,80,44310,156,27494,24835,19702,13869
2021-11-26 13:00:00+00,13065,524,5139,16866,550,3054,2659,123,1992,128,44100,153,27206,24547,19408,13589
2021-11-26 13:30:00+00,13207,632,5143,16759,554,3106,2664,122,1405,0,43592,159,26525,23861,18718,13839
2021-11-26 14:00:00+00,13362,714,5142,16656,561,3012,2667,122,1097,182,43515,162,26123,23456,18314,14076
2021-11-26 14:30:00+00,13774,747,5145,16538,556,3050,2584,112,730,162,43398,167,25553,22969,17824,14521
2021-11-26 15:00:00+00,13922,761,5144,16494,577,3292,2652,124,226,124,43316,172,25093,22441,17297,14683
2021-11-26 15:30:00+00,14305,948,5144,16695,578,3302,2701,136,30,126,43965,177,25148,22447,17303,15253
2021-11-26 16:00:00+00,14981,1184,5144,16399,580,3032,2726,168,0,452,44666,182,24849,22123,16979,16165
2021-11-26 16:30:00+00,15342,1222,5149,16145,570,3102,2747,299,0,1112,45688,184,24611,21864,16715,16564
2021-11-26 17:00:00+00,14652,1224,5150,16603,578,3256,2753,475,0,978,45669,180,25084,22331,17181,15876
2021-11-26 17:30:00+00,14360,1089,5150,16719,578,3100,2729,482,0,1278,45485,174,25176,22447,17297,15449
2021-11-26 18:00:00+00,13969,997,5112,16547,581,3132,2665,416,0,1052,44471,172,24905,22240,17128,14966
2021-11-26 18:30:00+00,13383,1007,5058,16728,689,3034,2682,221,0,748,43550,168,25157,22475,17417,14390
2021-11-26 19:00:00+00,13604,1055,5051,16500,794,3012,2687,139,0,292,43134,172,25032,22345,17294,14659
2021-11-26 19:30:00+00,13152,1036,5045,16212,740,3006,2479,135,0,54,41859,172,24476,21997,16952,14188
2021-11-26 20:00:00+00,12426,1039,5044,15877,612,2948,2118,122,0,40,40226,170,23651,21533,16489,13465
2021-11-26 20:30:00+00,11767,1070,5044,14756,709,2912,2109,121,0,194,38682,171,22618,20509,15465,12837
2021-11-26 21:00:00+00,10923,1126,5043,13884,565,3314,2112,117,0,190,37274,174,21604,19492,14449,12049
2021-11-26 21:30:00+00,10563,949,5048,13208,557,3350,2109,114,0,150,36048,172,20922,18813,13765,11512
2021-11-26 22:00:00+00,10169,995,5052,12231,526,3218,2070,115,0,278,34654,177,19879,17809,12757,11164
2021-11-26 22:30:00+00,10065,901,5050,11573,506,3216,2051,120,0,120,33602,178,19180,17129,12079,10966
2021-11-26 23:00:00+00,8574,679,5006,10683,488,3456,2096,120,0,108,31210,163,18273,16177,11171,9253
2021-11-26 23:30:00+00,7615,838,5011,10274,493,3524,2083,118,0,6,29962,162,17861,15778,10767,8453
2021-11-27 00:00:00+00,6691,989,5029,10090,486,4440,2079,119,0,0,29923,160,17684,15605,10576,7680
2021-11-27 00:30:00+00,7088,1001,5038,9829,458,4458,2082,118,0,0,30072,165,17407,15325,10287,8089
2021-11-27 01:00:00+00,7287,1000,4984,9794,482,4262,2082,123,0,0,30014,169,17342,15260,10276,8287
2021-11-27 01:30:00+00,7018,1001,4979,9838,492,4246,2081,116,0,0,29771,166,17390,15309,10330,8019
2021-11-27 02:00:00+00,6875,954,4992,10215,497,3938,2078,122,0,0,29671,164,17782,15704,10712,7829
2021-11-27 02:30:00+00,6774,877,4997,10125,492,3928,1976,124,0,0,29294,162,17590,15614,10617,7651
2021-11-27 03:00:00+00,6701,997,5010,10235,490,3318,1953,120,0,0,28824,166,17688,15735,10725,7698
2021-11-27 03:30:00+00,6547,1000,5025,10686,469,3318,1715,122,0,0,28882,162,17895,16180,11155,7547
2021-11-27 04:00:00+00,6659,982,5031,11748,490,3314,1377,122,0,0,29723,157,18646,17269,12238,7641
2021-11-27 04:30:00+00,6812,845,5035,12570,493,3314,1378,122,0,0,30569,150,19476,18098,13063,7657
2021-11-27 05:00:00+00,7429,832,5035,12677,499,3260,1377,123,0,0,31232,155,19588,18211,13176,8261
2021-11-27 05:30:00+00,8224,631,5042,13575,495,3260,1377,120,0,0,32724,151,20489,19112,14070,8855
2021-11-27 06:00:00+00,9446,511,5049,14469,501,3470,1460,125,0,0,35031,154,21479,20019,14970,9957
2021-11-27 06:30:00+00,10519,518,5054,14685,520,3474,1503,124,0,0,36397,160,21762,20259,15205,11037
2021-11-27 07:00:00+00,11472,694,5063,14868,519,2490,1522,123,0,0,36751,169,21972,20450,15387,12166
2021-11-27 07:30:00+00,11988,560,5073,15813,519,2452,1525,132,0,0,38062,165,22930,21405,16332,12548
2021-11-27 08:00:00+00,12324,1,5069,15950,524,2604,1526,130,85,0,38213,156,23154,21628,16559,12325
2021-11-27 08:30:00+00,12508,1,5074,16096,576,2568,1527,115,488,64,39017,154,23761,22234,17160,12509
2021-11-27 09:00:00+00,12628,1,5070,16050,581,2634,1528,143,754,136,39524,151,23983,22455,17385,12628
2021-11-27 09:30:00+00,12726,0,5078,16044,582,2546,1538,342,831,274,39961,152,24073,22535,17457,12726
2021-11-27 10:00:00+00,12714,0,5084,15682,583,2518,1539,567,1091,640,40418,150,23979,22440,17356,12714
2021-11-27 10:30:00+00,12650,0,5102,15694,579,2424,1534,593,1510,706,40792,147,24419,22885,17783,12650
2021-11-27 11:00:00+00,12542,0,5111,16329,568,2630,1538,582,1737,0,41036,145,25283,23745,18634,12542
2021-11-27 11:30:00+00,12373,0,5116,16840,566,2688,1536,435,1705,0,41259,142,25763,24227,19111,12373
2021-11-27 12:00:00+00,12257,0,5122,17206,550,3064,1527,228,1930,0,41884,138,26335,24808,19686,12257
2021-11-27 12:30:00+00,12544,0,5129,17298,557,2954,1489,129,1720,0,41820,139,26193,24704,19575,12544
2021-11-27 13:00:00+00,13389,0,5135,17365,566,2236,1453,120,1525,0,41789,145,26044,24591,19456,13389
2021-11-27 13:30:00+00,13278,30,5153,17601,567,2176,1483,130,1423,0,41841,144,26227,24744,19591,13308
2021-11-27 14:00:00+00,13461,101,5146,17358,601,1812,1512,131,1036,0,41158,147,25653,24141,18995,13562
2021-11-27 14:30:00+00,13862,100,5160,16929,601,1834,1537,128,747,0,40898,153,24974,23437,18277,13962
2021-11-27 15:00:00+00,14423,100,5180,16828,614,1474,1534,290,273,436,41152,156,24429,22895,17715,14523
2021-11-27 15:30:00+00,15057,104,5221,16961,611,1428,1524,404,23,276,41609,161,24340,22816,17595,15161
2021-11-27 16:00:00+00,15126,295,5232,16935,611,2610,1475,383,0,30,42697,169,24253,22778,17546,15421
2021-11-27 16:30:00+00,15580,497,5233,16600,630,2822,1471,387,0,728,43948,175,23934,22463,17230,16077
2021-11-27 17:00:00+00,15755,499,5240,16487,630,2800,1474,413,0,632,43930,175,23831,22357,17117,16254
2021-11-27 17:30:00+00,15818,500,5233,16299,691,2720,1489,376,0,882,44008,173,23712,22223,16990,16318
2021-11-27 18:00:00+00,15911,500,5236,16178,736,2750,1491,370,0,860,44032,174,23641,22150,16914,16411
2021-11-27 18:30:00+00,15672,480,5262,15912,737,2750,1463,333,0,520,43129,175,23374,21911,16649,16152
2021-11-27 19:00:00+00,15616,493,5263,15728,748,2664,1437,274,0,328,42551,176,23176,21739,16476,16109
2021-11-27 19:30:00+00,15259,500,5256,15461,758,2662,1443,175,0,24,41538,176,22918,21475,16219,15759
2021-11-27 20:00:00+00,14343,500,5258,15100,742,2760,1439,135,0,8,40285,173,22539,21100,15842,14843
2021-11-27 20:30:00+00,13167,368,5261,14869,739,2758,1440,138,0,0,38740,165,22309,20869,15608,13535
2021-11-27 21:00:00+00,12376,229,5259,14801,661,2532,1438,137,0,0,37433,158,22159,20721,15462,12605
2021-11-27 21:30:00+00,11491,230,5253,14463,650,2534,1489,134,0,0,36244,153,21855,20366,15113,11721
2021-11-27 22:00:00+00,10986,106,5262,14246,643,2416,1554,136,0,0,35349,148,21705,20151,14889,11092
2021-11-27 22:30:00+00,9740,53,5258,14224,643,2416,1734,134,0,0,34202,138,21859,20125,14867,9793
2021-11-27 23:00:00+00,6640,0,5261,13876,630,3210,1872,141,0,0,31630,112,21639,19767,14506,6640
2021-11-27 23:30:00+00,5543,0,5259,13693,609,3278,1901,133,0,0,30416,102,21462,19561,14302,5543
2021-11-28 00:00:00+00,5380,0,5275,13249,577,3522,1949,136,0,0,30088,100,21050,19101,13826,5380
2021-11-28 00:30:00+00,5813,0,5317,12749,609,3532,1990,147,0,0,30157,106,20665,18675,13358,5813
2021-11-28 01:00:00+00,5945,0,5336,12559,625,3844,1991,138,0,0,30438,107,20511,18520,13184,5945
2021-11-28 01:30:00+00,5801,0,5343,12123,610,3858,1985,140,0,0,29860,107,20061,18076,12733,5801
2021-11-28 02:00:00+00,5212,0,5356,11903,586,4196,2020,143,0,0,29416,102,19865,17845,12489,5212
2021-11-28 02:30:00+00,5095,0,5352,11492,551,4202,2071,141,0,0,28904,102,19466,17395,12043,5095
2021-11-28 03:00:00+00,4985,0,5359,11197,551,4364,2091,135,0,0,28682,102,19198,17107,11748,4985
2021-11-28 03:30:00+00,4995,0,5361,11074,550,4372,2077,140,0,0,28569,102,19062,16985,11624,4995
2021-11-28 04:00:00+00,4646,0,5371,10925,570,4388,2085,138,0,0,28123,99,18951,16866,11495,4646
2021-11-28 04:30:00+00,4854,0,5380,10461,571,4386,2085,137,0,0,27874,103,18497,16412,11032,4854
2021-11-28 05:00:00+00,5143,0,5388,10240,583,4610,2083,140,0,0,28187,106,18294,16211,10823,5143
2021-11-28 05:30:00+00,5431,0,5405,10097,583,4620,2079,142,0,0,28357,109,18164,16085,10680,5431
2021-11-28 06:00:00+00,5965,0,5404,9837,636,4738,2082,137,0,0,28799,115,17959,15877,10473,5965
2021-11-28 06:30:00+00,6844,0,5406,9489,636,4740,2033,138,0,0,29286,125,17564,15531,10125,6844
2021-11-28 07:00:00+00,9309,0,5407,9283,636,2808,2078,138,0,56,29715,152,17404,15326,9919,9309
2021-11-28 07:30:00+00,10194,0,5408,9116,636,2780,2092,135,0,12,30373,160,17252,15160,9752,10194
2021-11-28 08:00:00+00,10797,0,5406,9308,660,4026,2107,136,138,130,32708,158,17619,15512,10106,10797
2021-11-28 08:30:00+00,12476,0,5412,8939,668,4078,2120,149,658,176,34676,169,17797,15677,10265,12476
2021-11-28 09:00:00+00,12942,0,5410,9606,666,4398,2114,245,1500,18,36899,165,19296,17182,11772,12942
2021-11-28 09:30:00+00,13977,0,5403,9407,646,4430,2065,248,2318,30,38524,169,19839,17774,12371,13977
2021-11-28 10:00:00+00,14011,0,5398,9672,614,4753,2006,146,3030,146,39776,163,20720,18714,13316,14011
2021-11-28 10:30:00+00,14410,0,5407,9497,614,4758,1967,219,3539,116,40528,165,21024,19057,13650,14410
2021-11-28 11:00:00+00,14695,0,5412,10007,723,4106,1891,393,3812,40,41079,166,21845,19954,14542,14695
2021-11-28 11:30:00+00,14865,0,5406,9694,711,4046,1929,422,3835,150,41058,168,21575,19646,14240,14865
2021-11-28 12:00:00+00,14933,59,5410,9828,737,4451,1977,411,3324,100,41230,169,21276,19299,13889,14992
2021-11-28 12:30:00+00,14935,217,5404,10039,728,4476,2003,399,2713,246,41160,173,20887,18884,13480,15152
2021-11-28 13:00:00+00,14683,422,5409,10398,726,4530,1999,419,2102,222,40910,177,20634,18635,13226,15105
2021-11-28 13:30:00+00,14729,481,5404,10417,750,4537,1997,421,1609,560,40905,179,20177,18180,12776,15210
2021-11-28 14:00:00+00,15732,483,5407,10449,624,4340,1976,167,980,650,40808,187,19436,17460,12053,16215
2021-11-28 14:30:00+00,16931,510,5412,10533,626,4294,1969,298,464,134,41171,198,19004,17035,11623,17441
2021-11-28 15:00:00+00,17892,590,5409,10258,650,4098,1969,383,152,120,41521,208,18438,16469,11060,18482
2021-11-28 15:30:00+00,18344,741,5404,10103,677,4298,1969,441,11,260,42248,214,18164,16195,10791,19085
2021-11-28 16:00:00+00,19230,879,5405,9751,699,3882,2008,515,0,796,43165,218,17863,15855,10450,20109
2021-11-28 16:30:00+00,20241,975,5405,9641,701,4928,2017,618,0,974,45500,222,17764,15747,10342,21216
2021-11-28 17:00:00+00,20455,978,5408,9587,742,4750,2020,834,0,798,45572,223,17757,15737,10329,21433
2021-11-28 17:30:00+00,20221,979,5405,9173,814,4750,2020,743,0,1358,45463,221,17412,15392,9987,21200
2021-11-28 18:00:00+00,19911,979,5406,8876,814,4702,2056,692,0,1316,44752,221,17152,15096,9690,20890
2021-11-28 18:30:00+00,19662,982,5400,8949,813,4688,2062,669,0,842,44067,223,17224,15162,9762,20644
2021-11-28 19:00:00+00,19968,977,5401,8831,800,4180,2066,414,0,382,43019,227,17098,15032,9631,20945
2021-11-28 19:30:00+00,19633,890,5403,8756,780,4150,2049,159,0,0,41820,227,16988,14939,9536,20523
2021-11-28 20:00:00+00,19767,648,5397,8418,755,3542,2045,136,0,24,40732,228,16615,14570,9173,20415
2021-11-28 20:30:00+00,19218,599,5400,7964,744,3422,2024,135,0,0,39506,228,16132,14108,8708,19817
2021-11-28 21:00:00+00,19541,818,5396,7670,617,2186,2008,136,0,190,38562,240,15691,13683,8287,20359
2021-11-28 21:30:00+00,18822,628,5399,7361,617,2174,2012,133,0,112,37258,236,15389,13377,7978,19450
2021-11-28 22:00:00+00,18239,561,5405,7101,613,1712,2024,137,0,62,35854,236,15143,13119,7714,18800
2021-11-28 22:30:00+00,17145,470,5406,6920,605,1712,2038,143,0,0,34439,231,14969,12931,7525,17615
2021-11-28 23:00:00+00,16491,459,5413,6796,603,1804,2076,138,0,0,33780,226,14888,12812,7399,16950
2021-11-28 23:30:00+00,15707,460,5406,6666,590,1814,2085,137,0,0,32865,223,14747,12662,7256,16167
2021-11-29 00:00:00+00,14999,458,5410,6631,450,2328,2126,142,0,0,32544,221,14617,12491,7081,15457
2021-11-29 00:30:00+00,15403,460,5401,6568,449,2340,2208,140,0,0,32969,223,14626,12418,7017,15863
2021-11-29 01:00:00+00,14643,460,5406,6420,446,2656,2422,137,0,0,32590,219,14694,12272,6866,15103
2021-11-29 01:30:00+00,14483,459,5407,6225,446,2652,2608,131,0,0,32411,219,14686,12078,6671,14942
2021-11-29 02:00:00+00,14802,458,5406,6219,445,2262,2645,134,0,0,32371,221,14715,12070,6664,15260
2021-11-29 02:30:00+00,14434,459,5404,6046,446,2254,2657,135,0,0,31835,220,14553,11896,6492,14893
2021-11-29 03:00:00+00,14115,460,5405,6251,427,2482,2654,135,0,0,31929,217,14737,12083,6678,14575
2021-11-29 03:30:00+00,14095,459,5405,6110,424,2478,2655,133,0,0,31759,218,14594,11939,6534,14554
2021-11-29 04:00:00+00,14048,459,5409,6238,424,1810,2655,130,0,0,31172,219,14726,12070,6662,14507
2021-11-29 04:30:00+00,13968,521,5408,6272,424,1770,2649,129,0,0,31141,220,14753,12104,6696,14489
2021-11-29 05:00:00+00,15276,764,5407,6293,450,970,2654,133,0,0,31947,234,14804,12150,6743,16040
2021-11-29 05:30:00+00,16310,1014,5405,6385,465,918,2612,130,0,0,33239,244,14867,12255,6850,17324
2021-11-29 06:00:00+00,17836,1151,5408,6655,620,828,2684,135,0,0,35317,250,15367,12683,7275,18987
2021-11-29 06:30:00+00,19834,1665,5406,6656,620,1000,2672,129,0,0,37982,268,15354,12682,7276,21499
2021-11-29 07:00:00+00,21146,1968,5408,6490,656,2414,2668,181,0,42,40973,274,15222,12554,7146,23114
2021-11-29 07:30:00+00,22106,1979,5409,6333,811,2524,2674,460,0,124,42420,277,15227,12553,7144,24085
2021-11-29 08:00:00+00,22097,1982,5400,6321,943,2690,2613,669,140,538,43393,272,15417,12804,7404,24079
2021-11-29 08:30:00+00,21676,1979,5404,6643,977,2842,2600,719,572,1008,44420,264,16196,13596,8192,23655
2021-11-29 09:00:00+00,21916,1982,5400,6675,918,2800,2572,749,1086,1302,45400,259,16651,14079,8679,23898
2021-11-29 09:30:00+00,22154,1979,5411,6952,879,2754,2565,651,1527,1322,46194,256,17334,14769,9358,24133
2021-11-29 10:00:00+00,21943,1979,5405,6912,827,2600,2569,628,1854,1508,46225,253,17567,14998,9593,23922
2021-11-29 10:30:00+00,22037,1981,5404,6837,886,2586,2571,649,2251,1610,46812,251,17949,15378,9974,24018
2021-11-29 11:00:00+00,22714,1980,5405,6993,857,2656,2578,621,2363,672,46839,257,18196,15618,10213,24694
2021-11-29 11:30:00+00,22706,1981,5404,7070,806,2632,2574,585,2461,832,47051,255,18315,15741,10337,24687
2021-11-29 12:00:00+00,23068,1979,5405,7205,766,2520,2568,560,2355,722,47148,258,18299,15731,10326,25047
2021-11-29 12:30:00+00,23124,1978,5407,7598,764,2644,2580,379,1997,356,46827,260,18346,15766,10359,25102
2021-11-29 13:00:00+00,23161,1840,5398,7802,787,2484,2594,282,1536,362,46246,259,18117,15523,10125,25001
2021-11-29 13:30:00+00,23061,1708,5400,8142,786,2542,2645,394,1457,94,46229,257,18430,15785,10385,24769
2021-11-29 14:00:00+00,22919,1712,5403,8642,776,2466,2660,485,960,0,46023,258,18441,15781,10378,24631
2021-11-29 14:30:00+00,22429,1707,5405,9282,660,2636,2668,486,457,0,45730,257,18472,15804,10399,24136
2021-11-29 15:00:00+00,21255,1711,5403,10121,650,2659,2666,459,115,214,45253,248,18955,16289,10886,22966
2021-11-29 15:30:00+00,21245,1704,5404,10541,633,2579,2667,521,6,870,46169,242,19251,16584,11180,22949
2021-11-29 16:00:00+00,21464,1484,5402,10839,685,2738,2679,496,0,1160,46947,237,19605,16926,11524,22948
2021-11-29 16:30:00+00,21300,1482,5410,11792,761,2710,2683,628,0,1316,48082,230,20646,17963,12553,22782
2021-11-29 17:00:00+00,20054,1367,5410,12792,872,3278,2659,864,0,1452,48748,216,21733,19074,13664,21421
2021-11-29 17:30:00+00,19431,1220,5413,13595,862,3294,2665,790,0,1294,48564,208,22535,19870,14457,20651
2021-11-29 18:00:00+00,19920,1218,5424,14109,829,2278,2694,721,0,380,47573,215,23056,20362,14938,21138
2021-11-29 18:30:00+00,18848,1228,5454,14598,824,2318,2782,735,0,402,47189,209,23658,20876,15422,20076
2021-11-29 19:00:00+00,18296,1227,5468,14923,789,2566,2780,350,0,626,47025,204,23960,21180,15712,19523
2021-11-29 19:30:00+00,17457,1116,5467,15048,779,2482,2784,287,0,324,45744,199,24078,21294,15827,18573
2021-11-29 20:00:00+00,17361,838,5468,15309,623,2282,2785,129,0,252,45047,193,24185,21400,15932,18199
2021-11-29 20:30:00+00,15771,626,5469,15449,551,2358,2785,78,0,24,43111,182,24254,21469,16000,16397
2021-11-29 21:00:00+00,13619,467,5464,15406,504,2736,2782,84,0,170,41232,166,24156,21374,15910,14086
2021-11-29 21:30:00+00,11604,416,5489,15318,493,2854,2765,82,0,2,39023,155,24065,21300,15811,12020
2021-11-29 22:00:00+00,9575,232,5512,15186,498,2764,2765,90,0,0,36622,138,23961,21196,15684,9807
2021-11-29 22:30:00+00,8023,232,5510,15088,497,2562,2540,83,0,0,34535,125,23635,21095,15585,8255
2021-11-29 23:00:00+00,5939,232,5506,14947,467,2812,2296,90,0,0,32289,109,23216,20920,15414,6171
2021-11-29 23:30:00+00,5127,231,5500,14708,465,2766,2288,74,0,0,31159,101,22961,20673,15173,5358
2021-11-30 00:00:00+00,5422,231,5504,14655,453,2528,2421,72,0,0,31286,102,23033,20612,15108,5653
2021-11-30 00:30:00+00,5242,230,5506,14721,450,2678,2763,71,0,0,31661,102,23440,20677,15171,5472
2021-11-30 01:00:00+00,5142,3,5513,14550,455,3016,2780,73,0,0,31532,97,23298,20518,15005,5145
2021-11-30 01:30:00+00,4970,0,5556,14466,455,2982,2745,68,0,0,31242,95,23222,20476,14920,4970
2021-11-30 02:00:00+00,4324,0,5557,14394,458,3012,2777,74,0,0,30596,88,23186,20409,14852,4324
2021-11-30 02:30:00+00,4209,0,5553,14282,479,2966,2734,76,0,0,30299,87,23048,20314,14761,4209
2021-11-30 03:00:00+00,3986,0,5559,14610,493,2992,2688,90,0,0,30418,84,23350,20662,15103,3986
2021-11-30 03:30:00+00,3689,0,5567,14643,495,2914,2608,91,0,0,30007,80,23313,20705,15138,3689
2021-11-30 04:00:00+00,3711,0,5611,14457,495,2946,2577,92,0,0,29889,82,23140,20563,14952,3711
2021-11-30 04:30:00+00,3743,0,5611,14205,496,3002,2622,90,0,0,29769,84,22934,20312,14701,3743
2021-11-30 05:00:00+00,4084,0,5612,14013,496,2964,2690,92,0,0,29951,87,22811,20121,14509,4084
2021-11-30 05:30:00+00,5017,166,5609,13883,500,3012,2659,86,0,0,30932,102,22651,19992,14383,5183
2021-11-30 06:00:00+00,7588,229,5605,13527,639,2890,2535,97,0,40,33150,127,22306,19771,14166,7817
2021-11-30 06:30:00+00,10510,396,5606,13193,640,2690,2755,90,0,0,35880,152,22194,19439,13833,10906
2021-11-30 07:00:00+00,14250,465,5588,13023,745,2378,2777,100,0,184,39510,174,22133,19356,13768,14715
2021-11-30 07:30:00+00,16182,536,5467,12874,749,2370,2779,90,0,224,41271,187,21869,19090,13623,16718
2021-11-30 08:00:00+00,17244,480,5321,12674,818,2882,2776,97,27,130,42449,193,21616,18840,13519,17724
2021-11-30 08:30:00+00,17925,635,5186,12649,825,2984,2776,108,149,6,43243,200,21585,18809,13623,18560
2021-11-30 09:00:00+00,18275,974,4992,12603,815,2918,2761,127,355,0,43820,208,21526,18765,13773,19249
2021-11-30 09:30:00+00,18220,1238,4989,12644,818,2856,2778,129,495,0,44167,210,21724,18946,13957,19458
2021-11-30 10:00:00+00,18198,1445,5004,12767,790,2856,2734,112,746,0,44652,212,22041,19307,14303,19643
2021-11-30 10:30:00+00,18059,1469,5049,12880,789,2836,2694,112,955,0,44843,210,22367,19673,14624,19528
2021-11-30 11:00:00+00,18236,1473,5055,12851,772,2814,2620,125,1083,102,45131,210,22381,19761,14706,19709
2021-11-30 11:30:00+00,18043,1471,5066,12937,756,2834,2671,147,1298,0,45223,209,22728,20057,14991,19514
2021-11-30 12:00:00+00,18106,1471,5046,12624,747,2956,2671,132,1244,22,45019,211,22332,19661,14615,19577
2021-11-30 12:30:00+00,18270,1472,5047,12228,740,2986,2668,103,1097,0,44611,214,21780,19112,14065,19742
2021-11-30 13:00:00+00,18311,1472,5046,11944,785,3132,2670,124,936,46,44466,217,21381,18711,13665,19783
2021-11-30 13:30:00+00,18199,1471,5053,11746,804,3116,2669,215,788,0,44061,219,21060,18391,13338,19670
2021-11-30 14:00:00+00,17999,1378,5053,11653,802,2806,2671,285,560,24,43231,221,20739,18068,13015,19377
2021-11-30 14:30:00+00,17519,1379,5050,12008,795,2894,2685,266,312,58,42966,218,20850,18165,13115,18898
2021-11-30 15:00:00+00,17540,1378,5051,11740,831,3278,2690,180,118,212,43018,218,20430,17740,12689,18918
2021-11-30 15:30:00+00,18491,1429,5050,11232,833,3394,2686,102,8,124,43349,226,19809,17123,12073,19920
2021-11-30 16:00:00+00,18867,1468,5057,11068,859,3512,2681,271,0,434,44217,229,19665,16984,11927,20335
2021-11-30 16:30:00+00,18782,1473,5056,11187,861,3514,2737,491,0,1430,45531,223,19841,17104,12048,20255
2021-11-30 17:00:00+00,18923,1476,5062,11057,877,3506,2740,648,0,1956,46245,222,19736,16996,11934,20399
2021-11-30 17:30:00+00,18788,1478,5066,11393,878,3506,2736,633,0,1614,46092,221,20073,17337,12271,20266
2021-11-30 18:00:00+00,18538,1356,5075,12120,878,3516,2740,550,0,968,45741,218,20813,18073,12998,19894
2021-11-30 18:30:00+00,18292,1226,5100,12496,878,3442,2807,467,0,730,45438,213,21281,18474,13374,19518
2021-11-30 19:00:00+00,17881,1268,5102,12999,862,3510,2827,242,0,0,44691,213,21790,18963,13861,19149
2021-11-30 19:30:00+00,16846,868,5101,13190,856,3348,2817,204,0,0,43230,200,21964,19147,14046,17714
2021-11-30 20:00:00+00,15168,520,5101,13618,804,3512,2829,203,0,0,41755,185,22352,19523,14422,15688
2021-11-30 20:30:00+00,12760,346,5101,14143,794,3538,2829,202,0,194,39907,166,22867,20038,14937,13106
2021-11-30 21:00:00+00,10229,23,5103,14649,720,3506,2828,196,0,0,37254,143,23300,20472,15369,10252
2021-11-30 21:30:00+00,7672,0,5104,15568,719,3400,2750,127,0,16,35356,119,24141,21391,16287,7672
2021-11-30 22:00:00+00,6441,0,5103,16241,581,3186,2811,92,0,62,34517,108,24736,21925,16822,6441
2021-11-30 22:30:00+00,4694,0,5102,16217,538,3018,2742,94,0,88,32493,92,24599,21857,16755,4694
2021-11-30 23:00:00+00,2942,0,5108,15855,536,2622,2298,77,0,0,29438,76,23797,21499,16391,2942
2021-11-30 23:30:00+00,2388,0,5105,15531,537,2740,2169,79,0,0,28549,72,23342,21173,16068,2388
2021-12-01 00:00:00+00,2470,0,5102,15576,531,2824,2340,81,0,0,28924,74,23549,21209,16107,2470
2021-12-01 00:30:00+00,2437,0,5098,16107,536,2824,2362,84,0,0,29448,72,24103,21741,16643,2437
2021-12-01 01:00:00+00,2343,0,5102,16507,538,2812,2328,99,0,0,29729,70,24475,22147,17045,2343
2021-12-01 01:30:00+00,2304,0,5101,16549,541,2798,2284,98,0,0,29675,69,24475,22191,17090,2304
2021-12-01 02:00:00+00,2393,0,5100,16751,551,1842,2411,93,0,0,29141,65,24813,22402,17302,2393
2021-12-01 02:30:00+00,2293,0,5102,16816,545,1782,2277,85,0,0,28900,63,24740,22463,17361,2293
2021-12-01 03:00:00+00,2407,0,5098,16970,531,1640,2459,83,0,0,29188,66,25058,22599,17501,2407
2021-12-01 03:30:00+00,2516,0,5061,16887,548,1642,2436,86,0,0,29176,67,24932,22496,17435,2516
2021-12-01 04:00:00+00,2630,0,5046,16884,566,1480,2505,84,0,0,29195,65,25001,22496,17450,2630
2021-12-01 04:30:00+00,2814,0,5012,16619,569,1460,2752,83,0,0,29309,68,24952,22200,17188,2814
2021-12-01 05:00:00+00,2422,0,4980,16760,577,2258,2666,75,0,0,29738,67,24983,22317,17337,2422
2021-12-01 05:30:00+00,3020,0,4979,16787,574,2270,2626,75,0,0,30331,73,24966,22340,17361,3020
2021-12-01 06:00:00+00,4969,0,4991,16777,655,2774,2625,75,0,0,32866,96,25048,22423,17432,4969
2021-12-01 06:30:00+00,7735,0,5077,16595,609,2760,2713,75,0,0,35564,119,24994,22281,17204,7735
2021-12-01 07:00:00+00,11331,129,5106,16628,587,2220,2810,79,0,58,38948,148,25131,22321,17215,11460
2021-12-01 07:30:00+00,12963,371,5108,16446,587,2216,2829,75,0,0,40595,163,24970,22141,17033,13334
2021-12-01 08:00:00+00,13599,478,5105,16297,654,2612,2822,84,58,80,41789,166,24936,22114,17009,14077
2021-12-01 08:30:00+00,13876,537,5116,16447,685,2658,2822,75,365,0,42581,168,25435,22613,17497,14413
2021-12-01 09:00:00+00,13734,701,5111,16945,639,2406,2837,99,829,0,43301,166,26361,23524,18413,14435
2021-12-01 09:30:00+00,13622,886,5113,16877,591,2334,2833,102,1559,0,43917,166,26973,24140,19027,14508
2021-12-01 10:00:00+00,13503,987,5116,16893,553,2322,2834,143,2027,0,44378,164,27423,24589,19473,14490
2021-12-01 10:30:00+00,13450,992,5119,16994,605,2248,2834,142,2480,0,44864,161,28032,25198,20079,14442
2021-12-01 11:00:00+00,13542,934,5121,16924,606,2186,2834,143,2423,0,44713,162,27908,25074,19953,14476
2021-12-01 11:30:00+00,13798,858,5118,16856,605,2296,2832,124,2158,0,44645,164,27569,24737,19619,14656
2021-12-01 12:00:00+00,14126,978,5119,16802,594,2356,2833,129,1799,156,44892,170,27147,24314,19195,15104
2021-12-01 12:30:00+00,14366,977,5117,16796,592,2306,2834,126,1962,0,45076,171,27301,24467,19350,15343
2021-12-01 13:00:00+00,14214,997,5110,16756,602,2540,2830,129,1549,164,44891,171,26847,24017,18907,15211
2021-12-01 13:30:00+00,14066,996,5113,17053,608,2524,2825,110,1274,46,44615,170,26873,24048,18935,15062
2021-12-01 14:00:00+00,14458,955,5109,16873,659,2444,2801,86,978,86,44449,172,26420,23619,18510,15413
2021-12-01 14:30:00+00,15027,938,5108,16597,662,2316,2823,87,627,44,44229,177,25817,22994,17886,15965
2021-12-01 15:00:00+00,15802,1075,5109,16424,678,1970,2827,129,218,20,44252,184,25256,22429,17320,16877
2021-12-01 15:30:00+00,16673,1176,5108,16362,677,1974,2866,166,16,30,45048,190,25029,22163,17055,17849
2021-12-01 16:00:00+00,17500,1050,5110,15963,756,2204,2880,369,0,682,46514,192,24709,21829,16719,18550
2021-12-01 16:30:00+00,18083,977,5118,15243,756,2238,2920,567,0,1718,47620,193,24037,21117,15999,19060
2021-12-01 17:00:00+00,18284,976,5119,14806,775,2658,2934,758,0,1722,48032,194,23634,20700,15581,19260
2021-12-01 17:30:00+00,18318,973,5116,14906,776,2602,2950,682,0,1560,47883,194,23748,20798,15682,19291
2021-12-01 18:00:00+00,18242,972,5115,14812,777,2756,2976,637,0,1612,47899,192,23680,20704,15589,19214
2021-12-01 18:30:00+00,18266,973,5123,14590,774,2762,2945,581,0,1008,47022,195,23432,20487,15364,19239
2021-12-01 19:00:00+00,18195,977,5119,14508,752,2834,2963,578,0,178,46104,199,23342,20379,15260,19172
2021-12-01 19:30:00+00,17522,905,5120,14790,723,2784,2962,419,0,32,45257,194,23595,20633,15513,18427
2021-12-01 20:00:00+00,16691,779,5118,14744,619,2744,2957,82,0,164,43898,186,23438,20481,15363,17470
2021-12-01 20:30:00+00,15746,390,5120,14654,613,2742,2965,73,0,22,42325,176,23352,20387,15267,16136
2021-12-01 21:00:00+00,14471,30,5121,14515,597,2428,2974,75,0,292,40503,161,23207,20233,15112,14501
2021-12-01 21:30:00+00,12740,0,5120,14494,585,2428,2977,74,0,246,38664,150,23176,20199,15079,12740
2021-12-01 22:00:00+00,10648,0,5119,14513,559,2740,2980,76,0,324,36959,137,23171,20191,15072,10648
2021-12-01 22:30:00+00,9293,0,5118,14309,558,2742,2984,76,0,296,35376,128,22969,19985,14867,9293
2021-12-01 23:00:00+00,7413,0,5120,14397,516,2610,2993,74,0,184,33307,114,23026,20033,14913,7413
2021-12-01 23:30:00+00,6463,0,5120,14406,495,2610,3000,74,0,0,32168,106,23021,20021,14901,6463
2021-12-02 00:00:00+00,5680,0,5116,14476,473,2722,3004,74,0,0,31545,102,23069,20065,14949,5680
2021-12-02 00:30:00+00,5879,0,5117,14903,452,2742,3002,73,0,0,32168,103,23474,20472,15355,5879
2021-12-02 01:00:00+00,5674,0,5117,14926,452,2772,3004,71,0,0,32016,101,23499,20495,15378,5674
2021-12-02 01:30:00+00,5592,0,5111,15034,450,2732,2995,71,0,0,31985,99,23590,20595,15484,5592
2021-12-02 02:00:00+00,4677,0,5111,15311,451,2740,3002,74,0,0,31366,90,23875,20873,15762,4677
2021-12-02 02:30:00+00,4301,0,5112,15325,451,2742,3000,73,0,0,31004,86,23888,20888,15776,4301
2021-12-02 03:00:00+00,3834,0,5115,15526,467,2696,2975,71,0,0,30684,81,24083,21108,15993,3834
2021-12-02 03:30:00+00,3805,0,5114,15636,468,2696,2674,71,0,0,30464,80,23892,21218,16104,3805
2021-12-02 04:00:00+00,3795,0,5118,15473,469,2732,2696,72,0,0,30355,80,23756,21060,15942,3795
2021-12-02 04:30:00+00,3977,0,5113,15157,487,2732,2745,74,0,0,30285,83,23502,20757,15644,3977
2021-12-02 05:00:00+00,5259,74,5115,14960,512,2156,2989,75,0,0,31140,97,23576,20587,15472,5333
2021-12-02 05:30:00+00,6029,217,5115,15021,512,2154,2998,75,0,0,32121,108,23646,20648,15533,6246
2021-12-02 06:00:00+00,8407,457,5117,14926,555,2070,3002,75,0,0,34609,134,23600,20598,15481,8864
2021-12-02 06:30:00+00,10736,691,5111,14803,572,2158,3012,90,0,0,37173,157,23498,20486,15375,11427
2021-12-02 07:00:00+00,14623,764,5111,14601,655,1830,3009,96,0,10,40699,181,23376,20367,15256,15387
2021-12-02 07:30:00+00,16258,1207,5111,14237,583,1688,3001,108,0,368,42561,196,22932,19931,14820,17465
2021-12-02 08:00:00+00,17687,1407,5117,13217,746,2000,2990,147,83,296,43690,209,22153,19163,14046,19094
2021-12-02 08:30:00+00,18432,1497,5118,13076,883,2014,2984,261,640,10,44915,212,22701,19717,14599,19929
2021-12-02 09:00:00+00,19205,1451,5113,12516,878,2408,2975,227,1599,412,46784,212,23081,20106,14993,20656
2021-12-02 09:30:00+00,19538,1448,5117,11799,875,2420,2969,224,2628,468,47486,211,23388,20419,15302,20986
2021-12-02 10:00:00+00,19693,1451,5115,11413,867,2238,2976,223,3586,248,47810,211,23957,20981,15866,21144
2021-12-02 10:30:00+00,19824,1447,5113,10629,866,2238,2994,208,4191,220,47730,212,23793,20799,15686,21271
2021-12-02 11:00:00+00,19692,1506,5114,9924,811,2596,2993,145,4561,154,47496,214,23403,20410,15296,21198
2021-12-02 11:30:00+00,19811,1711,5116,9173,820,2604,3023,114,4622,120,47114,221,22754,19731,14615,21522
2021-12-02 12:00:00+00,19665,1879,5119,9164,814,2740,3024,100,4403,0,46908,224,22524,19500,14381,21544
2021-12-02 12:30:00+00,19565,1904,5120,9158,808,2742,3024,148,3901,0,46370,226,22011,18987,13867,21469
2021-12-02 13:00:00+00,19119,1908,5117,8735,824,2742,3023,229,3451,278,45426,228,21150,18127,13010,21027
2021-12-02 13:30:00+00,19501,1927,5118,8625,826,2736,3027,203,2955,0,44918,234,20551,17524,12406,21428
2021-12-02 14:00:00+00,19369,1873,5117,8480,819,2534,3029,164,1954,134,43473,237,19399,16370,11253,21242
2021-12-02 14:30:00+00,19770,1895,5118,8091,850,2570,3028,203,1239,266,43030,244,18326,15298,10180,21665
2021-12-02 15:00:00+00,19692,1924,5115,7890,890,3140,3028,245,381,434,42739,247,17304,14276,9161,21616
2021-12-02 15:30:00+00,19884,1927,5117,8001,891,3168,3030,230,23,1100,43371,246,17062,14032,8915,21811
2021-12-02 16:00:00+00,20458,1863,5112,7784,924,4342,3029,237,0,1980,45729,239,16849,13820,8708,22321
2021-12-02 16:30:00+00,21332,1927,5118,7561,1083,4392,3049,372,0,1926,46760,244,16811,13762,8644,23259
2021-12-02 17:00:00+00,21132,1963,5115,7304,1122,4382,3048,739,0,2112,46917,244,16589,13541,8426,23095
2021-12-02 17:30:00+00,21074,1970,5121,7280,1111,4382,3050,869,0,1796,46653,246,16562,13512,8391,23044
2021-12-02 18:00:00+00,20924,1899,5110,7282,990,4508,3047,547,0,2092,46399,244,16429,13382,8272,22823
2021-12-02 18:30:00+00,20753,1704,5113,7249,943,4602,3048,413,0,2046,45871,240,16353,13305,8192,22457
2021-12-02 19:00:00+00,20915,1801,5116,7198,782,4906,3040,416,0,832,45006,253,16136,13096,7980,22716
2021-12-02 19:30:00+00,20280,1978,5117,7361,773,5116,3008,281,0,202,44116,257,16259,13251,8134,22258
2021-12-02 20:00:00+00,19835,1957,5116,7498,724,3880,2983,240,0,698,42931,258,16321,13338,8222,21792
2021-12-02 20:30:00+00,19655,1619,5119,7379,722,3766,2985,130,0,216,41591,256,16205,13220,8101,21274
2021-12-02 21:00:00+00,19830,1675,5113,7424,671,3286,2984,176,0,258,41417,260,16192,13208,8095,21505
2021-12-02 21:30:00+00,19000,1116,5111,7799,639,3212,2984,92,0,28,39981,246,16533,13549,8438,20116
2021-12-02 22:00:00+00,17411,599,5104,8363,589,3192,2973,87,0,0,38318,228,17029,14056,8952,18010
2021-12-02 22:30:00+00,15482,188,5091,8670,519,3178,2932,89,0,0,36149,210,17212,14280,9189,15670
2021-12-02 23:00:00+00,13980,0,5084,8944,528,2468,2828,99,0,12,33943,196,17384,14556,9472,13980
2021-12-02 23:30:00+00,12830,0,5073,8895,546,2370,2804,92,0,0,32610,189,17318,14514,9441,12830
2021-12-03 00:00:00+00,12582,0,5068,9339,452,2530,2768,90,0,0,32829,185,17627,14859,9791,12582
2021-12-03 00:30:00+00,12437,0,5060,9640,452,2538,2780,93,0,0,33000,183,17932,15152,10092,12437
2021-12-03 01:00:00+00,11889,0,5060,10275,350,2952,2768,87,0,0,33381,176,18453,15685,10625,11889
2021-12-03 01:30:00+00,11088,0,5047,10917,350,2702,2793,87,0,0,32984,165,19107,16314,11267,11088
2021-12-03 02:00:00+00,10242,0,5037,11574,358,2528,2761,86,0,0,32586,155,19730,16969,11932,10242
2021-12-03 02:30:00+00,9707,0,5026,12253,359,2338,2718,92,0,0,32493,147,20356,17638,12612,9707
2021-12-03 03:00:00+00,8678,0,5027,13413,343,1914,2773,72,0,0,32220,131,21556,18783,13756,8678
2021-12-03 03:30:00+00,8261,0,5025,13492,342,1864,2742,69,0,0,31795,127,21601,18859,13834,8261
2021-12-03 04:00:00+00,8209,0,5025,14133,340,1354,2722,71,0,0,31854,125,22220,19498,14473,8209
2021-12-03 04:30:00+00,8033,1,5027,14625,341,1308,2756,73,0,0,32164,122,22749,19993,14966,8034
2021-12-03 05:00:00+00,9036,161,5020,14629,370,942,2756,77,0,0,32991,132,22775,20019,14999,9197
2021-12-03 05:30:00+00,10064,230,5027,14673,370,926,2761,77,0,0,34128,142,22831,20070,15043,10294
2021-12-03 06:00:00+00,12027,402,5037,14763,436,790,2760,77,0,0,36292,158,22996,20236,15199,12429
2021-12-03 06:30:00+00,14124,622,5044,14522,441,780,2765,82,0,0,38380,177,22772,20007,14963,14746
2021-12-03 07:00:00+00,16732,752,5050,14305,517,1012,2760,82,0,0,41210,194,22632,19872,14822,17484
2021-12-03 07:30:00+00,18322,851,5056,13709,606,1034,2783,155,0,254,42770,205,22154,19371,14315,19173
2021-12-03 08:00:00+00,18601,928,5060,13276,842,2026,2783,152,4,120,43792,207,21965,19182,14122,19529
2021-12-03 08:30:00+00,19187,1140,5062,13365,888,2118,2792,161,105,172,44990,212,22212,19420,14358,20327
2021-12-03 09:00:00+00,19892,1183,5071,13312,892,2548,2795,216,395,6,46310,214,22465,19670,14599,21075
2021-12-03 09:30:00+00,20002,1192,5082,13535,786,2560,2790,215,793,0,46955,212,22986,20196,15114,21194
2021-12-03 10:00:00+00,19978,1301,5091,13107,696,2618,2799,111,1072,36,46809,214,22765,19966,14875,21279
2021-12-03 10:30:00+00,20009,1535,5102,12850,661,2452,2798,145,1180,64,46796,218,22591,19793,14691,21544
2021-12-03 11:00:00+00,20396,1693,5104,12360,571,1694,2822,330,1189,182,46341,221,22046,19224,14120,22089
2021-12-03 11:30:00+00,20523,1748,5106,11951,559,1694,2811,419,1100,42,45953,225,21527,18716,13610,22271
2021-12-03 12:00:00+00,20876,1746,5118,11701,560,1694,2794,461,963,50,45963,228,21136,18342,13224,22622
2021-12-03 12:30:00+00,20767,1823,5116,10997,622,1694,2794,450,829,196,45288,232,20358,17564,12448,22590
2021-12-03 13:00:00+00,19813,1841,5120,9837,628,2750,2794,311,696,142,43932,239,19075,16281,11161,21654
2021-12-03 13:30:00+00,19686,1950,5121,8790,631,2992,2788,304,497,248,43007,247,17827,15039,9918,21636
2021-12-03 14:00:00+00,19613,1509,5122,7709,634,4002,2787,387,321,164,42248,243,16573,13786,8664,21122
2021-12-03 14:30:00+00,19697,1628,5124,6536,646,4046,2783,350,169,314,41293,252,15258,12475,7351,21325
2021-12-03 15:00:00+00,19230,1633,5125,5681,712,4724,2788,420,32,1070,41415,250,14338,11550,6425,20863
2021-12-03 15:30:00+00,20078,1797,5126,5003,890,4768,2795,403,0,1338,42198,257,13814,11019,5893,21875
2021-12-03 16:00:00+00,20610,1868,5124,4517,1062,4872,2796,360,0,1856,43065,259,13499,10703,5579,22478
2021-12-03 16:30:00+00,21251,1966,5126,4265,1093,4836,2797,475,0,2040,43849,263,13281,10484,5358,23217
2021-12-03 17:00:00+00,21059,1971,5126,4286,1100,4776,2875,908,0,1944,44045,264,13387,10512,5386,23030
2021-12-03 17:30:00+00,20623,1967,5123,4406,1111,4772,2874,947,0,2110,43933,261,13514,10640,5517,22590
2021-12-03 18:00:00+00,20626,1966,5118,4346,1094,4742,2831,648,0,2322,43693,261,13389,10558,5440,22592
2021-12-03 18:30:00+00,20268,1966,5117,4539,940,4852,2795,443,0,1926,42846,263,13391,10596,5479,22234
2021-12-03 19:00:00+00,19879,1969,5119,4663,905,4594,2795,512,0,1042,41478,269,13482,10687,5568,21848
2021-12-03 19:30:00+00,19701,1971,5117,4792,864,4578,2793,345,0,304,40466,273,13566,10774,5656,21672
2021-12-03 20:00:00+00,19045,1973,5115,5141,804,4254,2796,218,0,286,39632,268,13856,11060,5945,21018
2021-12-03 20:30:00+00,18098,1867,5117,5379,740,4200,2794,129,0,46,38370,263,14030,11236,6119,19965
2021-12-03 21:00:00+00,18146,1819,5115,5512,621,3106,2795,97,0,120,37331,265,14043,11248,6133,19965
2021-12-03 21:30:00+00,17032,1532,5114,5488,611,2820,2793,98,0,20,35508,258,14006,11213,6099,18564
2021-12-03 22:00:00+00,15971,1262,5116,5534,593,2890,2794,96,0,0,34256,249,14037,11243,6127,17233
2021-12-03 22:30:00+00,14213,821,5112,6164,587,2890,2601,103,0,0,32491,228,14464,11863,6751,15034
2021-12-03 23:00:00+00,11149,563,5111,6372,571,4634,2116,98,0,0,30614,197,14170,12054,6943,11712
2021-12-03 23:30:00+00,9975,269,5110,6428,561,4796,2269,96,0,0,29504,180,14368,12099,6989,10244
2021-12-04 00:00:00+00,9445,237,5110,6646,511,4886,2293,95,0,0,29223,174,14560,12267,7157,9682
2021-12-04 00:30:00+00,9449,270,5110,6543,434,4746,2295,98,0,104,29049,176,14382,12087,6977,9719
2021-12-04 01:00:00+00,8758,251,5111,7222,374,4880,2296,94,0,0,28986,167,15003,12707,7596,9009
2021-12-04 01:30:00+00,7920,234,5112,7436,377,4870,2289,94,0,0,28332,159,15214,12925,7813,8154
2021-12-04 02:00:00+00,7845,236,5110,7532,387,4732,2289,95,0,0,28226,158,15318,13029,7919,8081
2021-12-04 02:30:00+00,7475,230,5115,7481,390,4718,2293,92,0,0,27794,155,15279,12986,7871,7705
2021-12-04 03:00:00+00,7364,230,5111,7620,391,4686,2292,92,0,0,27786,152,15414,13122,8011,7594
2021-12-04 03:30:00+00,7072,230,5115,7756,391,4698,2088,91,0,0,27441,149,15350,13262,8147,7302
2021-12-04 04:00:00+00,7158,231,5115,7910,393,3922,1740,93,0,0,26562,152,15158,13418,8303,7389
2021-12-04 04:30:00+00,7013,229,5118,8032,386,3888,1735,92,0,0,26493,150,15271,13536,8418,7242
2021-12-04 05:00:00+00,6944,231,5118,8468,384,3568,1736,92,0,0,26541,145,15706,13970,8852,7175
2021-12-04 05:30:00+00,6686,230,5122,9184,402,3568,1691,94,0,0,26977,139,16399,14708,9586,6916
2021-12-04 06:00:00+00,7940,230,5120,9970,402,2484,1730,95,0,0,27971,149,17222,15492,10372,8170
2021-12-04 06:30:00+00,8971,228,5120,10093,406,2474,1732,94,0,0,29118,157,17351,15619,10499,9199
2021-12-04 07:00:00+00,9919,230,5122,10473,486,2626,1730,97,0,0,30683,162,17811,16081,10959,10149
2021-12-04 07:30:00+00,10160,228,5121,11240,491,2628,1729,133,0,0,31730,160,18581,16852,11731,10388
2021-12-04 08:00:00+00,11652,4,5118,11546,669,2630,1732,104,29,102,33586,162,19094,17362,12244,11656
2021-12-04 08:30:00+00,12593,0,5121,12326,689,2626,1735,101,389,0,35580,163,20260,18525,13404,12593
2021-12-04 09:00:00+00,12712,0,5120,12634,704,2746,1738,98,1301,0,37053,159,21497,19759,14639,12712
2021-12-04 09:30:00+00,12398,0,5118,13058,663,2750,1735,99,2053,0,37874,152,22628,20892,15774,12398
2021-12-04 10:00:00+00,12310,0,5121,13471,631,2354,1735,114,2854,0,38590,147,23812,22077,16956,12310
2021-12-04 10:30:00+00,11635,0,5119,14170,623,2256,1737,87,3568,0,39195,137,25217,23480,18361,11635
2021-12-04 11:00:00+00,11435,0,5119,14822,567,2322,1738,75,3753,18,39849,131,25999,24261,19142,11435
2021-12-04 11:30:00+00,10955,0,5118,15311,570,2392,1735,73,3601,0,39755,127,26335,24600,19482,10955
2021-12-04 12:00:00+00,10442,0,5113,15765,542,2474,1734,85,3276,16,39447,124,26430,24696,19583,10442
2021-12-04 12:30:00+00,10427,0,5116,16098,524,2476,1739,78,2869,0,39327,124,26346,24607,19491,10427
2021-12-04 13:00:00+00,9977,0,5119,16676,469,2642,1733,86,2592,0,39294,122,26589,24856,19737,9977
2021-12-04 13:30:00+00,10131,0,5114,16856,435,2650,1735,85,2201,0,39208,124,26342,24606,19492,10131
2021-12-04 14:00:00+00,10733,0,5123,16894,432,2016,1736,83,1532,0,38549,126,25717,23981,18858,10733
2021-12-04 14:30:00+00,11057,0,5123,17112,432,2062,1736,80,774,0,38376,130,25177,23441,18318,11057
2021-12-04 15:00:00+00,12700,0,5119,17070,454,1088,1744,92,254,0,38521,141,24641,22897,17778,12700
2021-12-04 15:30:00+00,13277,0,5120,17120,484,1094,1738,81,20,0,38934,145,24482,22744,17624,13277
2021-12-04 16:00:00+00,13160,0,5120,16808,564,2826,1737,108,0,0,40323,146,24229,22492,17372,13160
2021-12-04 16:30:00+00,13998,0,5117,16628,563,2920,1738,404,0,136,41504,153,24046,22308,17191,13998
2021-12-04 17:00:00+00,14286,0,5118,16405,558,3442,1740,261,0,694,42504,156,23821,22081,16963,14286
2021-12-04 17:30:00+00,14497,0,5120,16194,561,3506,1740,255,0,644,42517,159,23615,21875,16755,14497
2021-12-04 18:00:00+00,14588,0,5117,16085,550,3139,1868,459,0,422,42228,162,23620,21752,16635,14588
2021-12-04 18:30:00+00,13852,0,5116,16075,548,2966,2060,238,0,386,41241,157,23799,21739,16623,13852
2021-12-04 19:00:00+00,12572,0,5116,15987,533,3432,2206,96,0,0,39942,150,23842,21636,16520,12572
2021-12-04 19:30:00+00,11474,0,5110,15789,528,3384,2327,81,0,12,38705,143,23754,21427,16317,11474
2021-12-04 20:00:00+00,10175,0,5113,15741,497,3884,2340,81,0,0,37831,134,23691,21351,16238,10175
2021-12-04 20:30:00+00,8967,0,5111,15487,498,3926,2349,82,0,18,36438,127,23445,21096,15985,8967
2021-12-04 21:00:00+00,8212,0,5117,15131,491,3734,2347,77,0,0,35109,122,23086,20739,15622,8212
2021-12-04 21:30:00+00,7295,0,5113,15024,473,3582,2350,79,0,0,33916,115,22960,20610,15497,7295
2021-12-04 22:00:00+00,7139,0,5117,14789,468,3261,2349,78,0,8,33209,116,22723,20374,15257,7139
2021-12-04 22:30:00+00,6105,0,5115,14636,468,2910,2347,89,0,0,31670,107,22566,20220,15104,6105
2021-12-04 23:00:00+00,5461,0,5117,14661,466,2922,2349,87,0,12,31075,101,22593,20244,15127,5461
2021-12-04 23:30:00+00,4673,0,5117,14260,465,3032,2349,76,0,16,29988,96,22191,19842,14725,4673
2021-12-05 00:00:00+00,4246,0,5116,14054,459,3038,2347,76,0,0,29336,94,21976,19629,14513,4246
2021-12-05 00:30:00+00,4865,0,5116,13962,442,3038,2344,76,0,0,29843,100,21864,19520,14404,4865
2021-12-05 01:00:00+00,4955,0,5103,13543,440,3000,2344,76,0,0,29461,103,21430,19086,13983,4955
2021-12-05 01:30:00+00,4852,0,5106,13445,437,2948,2281,79,0,0,29148,101,21269,18988,13882,4852
2021-12-05 02:00:00+00,4785,0,5098,13511,438,2766,2304,79,0,0,28981,101,21351,19047,13949,4785
2021-12-05 02:30:00+00,4704,0,5093,13376,429,2654,2353,80,0,0,28689,99,21251,18898,13805,4704
2021-12-05 03:00:00+00,4636,0,5079,13358,428,2516,2349,76,0,0,28442,100,21214,18865,13786,4636
2021-12-05 03:30:00+00,4432,0,5078,13439,424,2412,2278,76,0,0,28139,96,21219,18941,13863,4432
2021-12-05 04:00:00+00,4441,0,5065,13658,421,2474,2292,77,0,0,28428,95,21436,19144,14079,4441
2021-12-05 04:30:00+00,4040,0,5058,13912,421,2416,2333,76,0,0,28256,89,21724,19391,14333,4040
2021-12-05 05:00:00+00,3898,0,5050,13994,437,2464,2333,77,0,0,28253,89,21814,19481,14431,3898
2021-12-05 05:30:00+00,4023,0,5040,14016,433,2500,2316,78,0,0,28406,91,21805,19489,14449,4023
2021-12-05 06:00:00+00,4663,0,5036,13842,433,2142,2243,78,0,0,28438,92,21554,19312,14276,4663
2021-12-05 06:30:00+00,5150,0,5023,14099,462,2020,2240,81,0,0,29075,94,21824,19584,14561,5150
2021-12-05 07:00:00+00,6458,0,5022,13881,468,1766,2239,88,0,0,29922,106,21610,19371,14349,6458
2021-12-05 07:30:00+00,7408,0,5018,13822,470,1858,2238,184,0,84,31082,117,21548,19310,14292,7408
2021-12-05 08:00:00+00,7634,0,5021,14065,494,2184,2240,91,36,0,31765,120,21856,19616,14595,7634
2021-12-05 08:30:00+00,9057,0,5016,14076,522,2280,2240,76,208,0,33475,132,22062,19822,14806,9057
2021-12-05 09:00:00+00,10227,70,5019,13861,613,2524,2240,79,384,0,35017,143,22117,19877,14858,10297
2021-12-05 09:30:00+00,11143,210,5025,13525,619,2522,2239,76,659,72,36090,153,22067,19828,14803,11353
2021-12-05 10:00:00+00,11789,483,5021,13056,609,2292,2240,86,1085,32,36693,161,22011,19771,14750,12272
2021-12-05 10:30:00+00,12587,714,5017,12770,605,2152,2242,91,1409,26,37613,169,22043,19801,14784,13301
2021-12-05 11:00:00+00,13438,888,5018,12519,596,1776,2239,89,1758,156,38477,174,22130,19891,14873,14326
2021-12-05 11:30:00+00,14147,756,5021,12550,595,1776,2224,90,1659,78,38896,176,22049,19825,14804,14903
2021-12-05 12:00:00+00,14188,572,5021,12271,664,3148,2150,93,1746,78,39931,171,21852,19702,14681,14760
2021-12-05 12:30:00+00,14646,702,5033,12066,654,3218,2160,91,1558,0,40128,178,21471,19311,14278,15348
2021-12-05 13:00:00+00,14848,817,5035,11813,670,3330,2147,95,1365,14,40134,184,21030,18883,13848,15665
2021-12-05 13:30:00+00,15041,1144,5051,11267,671,3336,2140,97,1107,32,39886,194,20236,18096,13045,16185
2021-12-05 14:00:00+00,15886,1688,5062,10928,670,2486,2161,92,953,0,39926,211,19774,17613,12551,17574
2021-12-05 14:30:00+00,16700,1674,5068,10566,669,2474,2186,98,498,20,39953,219,18987,16801,11733,18374
2021-12-05 15:00:00+00,17741,1359,5069,10172,724,2668,2222,95,169,40,40259,222,18356,16134,11065,19100
2021-12-05 15:30:00+00,18903,1415,5074,9557,722,3074,2245,101,10,52,41153,231,17608,15363,10289,20318
2021-12-05 16:00:00+00,19218,1380,5077,8992,738,4262,2239,182,0,698,42786,231,17046,14807,9730,20598
2021-12-05 16:30:00+00,19817,1435,5081,8545,860,4304,2251,374,0,1222,43889,233,16737,14486,9405,21252
2021-12-05 17:00:00+00,19988,1729,5083,7893,895,4224,2272,571,0,1620,44275,238,16143,13871,8788,21717
2021-12-05 17:30:00+00,19858,1746,5084,7656,900,4224,2289,612,0,1434,43803,241,15929,13640,8556,21604
2021-12-05 18:00:00+00,19692,1569,5097,7603,802,4064,2353,465,0,1286,42931,240,15855,13502,8405,21261
2021-12-05 18:30:00+00,19571,1341,5100,7243,799,4058,2370,297,0,1366,42145,237,15512,13142,8042,20912
2021-12-05 19:00:00+00,19434,1503,5106,6856,798,4208,2366,221,0,542,41034,247,15126,12760,7654,20937
2021-12-05 19:30:00+00,18922,1642,5112,6461,788,4222,2413,171,0,194,39925,253,14774,12361,7249,20564
2021-12-05 20:00:00+00,19160,1746,5110,6251,604,3284,2419,198,0,230,39002,264,14384,11965,6855,20906
2021-12-05 20:30:00+00,18694,1661,5113,5784,548,3304,2417,105,0,158,37784,265,13862,11445,6332,20355
2021-12-05 21:00:00+00,18269,1362,5117,5528,527,2792,2418,93,0,232,36338,262,13590,11172,6055,19631
2021-12-05 21:30:00+00,17073,1172,5129,5726,518,2716,2419,91,0,0,34844,254,13792,11373,6244,18245
2021-12-05 22:00:00+00,15746,816,5124,5493,460,3092,2419,92,0,20,33262,243,13496,11077,5953,16562
2021-12-05 22:30:00+00,14562,464,5127,5323,456,3100,2418,114,0,12,31576,231,13324,10906,5779,15026
2021-12-05 23:00:00+00,12212,419,5128,5523,423,3286,2420,107,0,4,29522,215,13494,11074,5946,12631
2021-12-05 23:30:00+00,10978,430,5127,5749,399,3294,2403,188,0,0,28568,207,13678,11275,6148,11408
2021-12-06 00:00:00+00,10580,494,5132,6117,371,3450,2415,111,0,0,28670,201,14035,11620,6488,11074
2021-12-06 00:30:00+00,10906,499,5129,6409,372,3442,2421,127,0,0,29305,201,14331,11910,6781,11405
2021-12-06 01:00:00+00,10892,476,5127,6768,372,3144,2422,281,0,0,29482,200,14689,12267,7140,11368
2021-12-06 01:30:00+00,10586,420,5124,7102,372,3144,2412,275,0,0,29435,195,15010,12598,7474,11006
2021-12-06 02:00:00+00,11019,482,5127,7405,368,3144,2397,276,0,0,30218,197,15297,12900,7773,11501
2021-12-06 02:30:00+00,10878,444,5120,7560,357,3116,2410,278,0,0,30163,194,15447,13037,7917,11322
2021-12-06 03:00:00+00,11424,429,5125,7800,344,2730,2408,208,0,0,30468,195,15677,13269,8144,11853
2021-12-06 03:30:00+00,11362,420,5126,7706,366,2720,2401,82,0,0,30183,195,15599,13198,8072,11782
2021-12-06 04:00:00+00,12381,481,5125,7796,364,1456,2410,81,0,0,30094,202,15695,13285,8160,12862
2021-12-06 04:30:00+00,12279,500,5123,8023,363,1388,2410,81,0,0,30167,200,15919,13509,8386,12779
2021-12-06 05:00:00+00,13908,622,5124,8353,398,670,2428,74,0,0,31577,211,16303,13875,8751,14530
2021-12-06 05:30:00+00,14767,888,5126,8867,400,292,2425,133,0,0,32898,216,16818,14393,9267,15655
2021-12-06 06:00:00+00,15222,1121,5123,9584,408,292,2428,153,0,12,34343,219,17543,15115,9992,16343
2021-12-06 06:30:00+00,17242,1389,5124,10401,417,332,2418,145,0,46,37514,228,18360,15942,10818,18631
2021-12-06 07:00:00+00,18357,1342,5124,11110,421,470,2404,147,0,0,39375,229,19059,16655,11531,19699
2021-12-06 07:30:00+00,19744,1334,5125,11603,428,536,2423,175,0,184,41552,231,19579,17156,12031,21078
2021-12-06 08:00:00+00,20397,1390,5123,11861,429,712,2422,250,4,256,42844,234,19839,17417,12294,21787
2021-12-06 08:30:00+00,20720,1467,5128,11790,431,724,2434,228,95,380,43397,236,19878,17444,12316,22187
2021-12-06 09:00:00+00,21291,1479,5121,11380,459,1056,2417,448,229,918,44798,239,19606,17189,12068,22770
2021-12-06 09:30:00+00,21345,1476,5121,11337,469,1078,2370,664,341,1284,45485,237,19638,17268,12147,22821
2021-12-06 10:00:00+00,21518,1474,5124,12073,580,1074,2372,544,433,1018,46210,234,20582,18210,13086,22992
2021-12-06 10:30:00+00,21372,1478,5122,13159,543,1042,2389,446,505,674,46730,229,21718,19329,14207,22850
2021-12-06 11:00:00+00,21194,1477,5128,13479,498,1190,2386,340,573,836,47101,227,22064,19678,14550,22671
2021-12-06 11:30:00+00,21204,1477,5135,13562,469,1192,2379,467,788,748,47421,226,22333,19954,14819,22681
2021-12-06 12:00:00+00,21191,1478,5121,13737,496,978,2364,555,951,1048,47919,222,22669,20305,15184,22669
2021-12-06 12:30:00+00,21087,1477,5128,14165,580,976,2381,529,1170,444,47937,221,23424,21043,15915,22564
2021-12-06 13:00:00+00,21124,1479,5123,14305,585,450,2383,334,1134,852,47769,216,23530,21147,16024,22603
2021-12-06 13:30:00+00,21217,1476,5128,13957,582,398,2378,335,1047,738,47256,219,23092,20714,15586,22693
2021-12-06 14:00:00+00,21295,1476,5127,13657,507,272,2375,424,894,1288,47315,218,22560,20185,15058,22771
2021-12-06 14:30:00+00,21262,1475,5126,14037,645,272,2373,506,518,770,46984,220,22699,20326,15200,22737
2021-12-06 15:00:00+00,20761,1474,5128,13374,648,1362,2366,539,220,536,46408,225,21736,19370,14242,22235
2021-12-06 15:30:00+00,20933,1476,5126,12905,741,1485,2342,430,16,1140,46594,226,21130,18788,13662,22409
2021-12-06 16:00:00+00,20717,1477,5128,13403,848,1540,2343,419,0,778,46653,222,21722,19379,14251,22194
2021-12-06 16:30:00+00,20771,1474,5123,13490,855,1570,2372,589,0,1664,47908,218,21840,19468,14345,22245
2021-12-06 17:00:00+00,20696,1475,5125,13491,852,2042,2379,642,0,1528,48230,219,21847,19468,14343,22171
2021-12-06 17:30:00+00,20604,1476,5117,13239,845,1938,2376,695,0,1776,48066,218,21577,19201,14084,22080
2021-12-06 18:00:00+00,20407,1454,5121,13976,831,2204,2377,551,0,930,47851,219,22305,19928,14807,21861
2021-12-06 18:30:00+00,20255,1365,5115,14195,828,2210,2378,342,0,588,47276,217,22516,20138,15023,21620
2021-12-06 19:00:00+00,19739,1463,5120,14308,812,2474,2377,193,0,78,46564,217,22617,20240,15120,21202
2021-12-06 19:30:00+00,18610,1344,5118,14602,778,2520,2380,181,0,16,45549,209,22878,20498,15380,19954
2021-12-06 20:00:00+00,17417,974,5116,14980,698,2742,2379,183,0,16,44505,196,23173,20794,15678,18391
2021-12-06 20:30:00+00,16307,643,5116,14627,644,2748,2354,185,0,200,42824,186,22741,20387,15271,16950
2021-12-06 21:00:00+00,14754,497,5120,14537,598,2612,2311,148,0,56,40633,177,22566,20255,15135,15251
2021-12-06 21:30:00+00,12557,497,5113,14588,546,2612,2302,94,0,6,38315,165,22549,20247,15134,13054
2021-12-06 22:00:00+00,10394,494,5124,14627,543,2728,2310,91,0,0,36311,150,22604,20294,15170,10888
2021-12-06 22:30:00+00,8944,405,5119,14478,485,2740,2291,112,0,0,34574,139,22373,20082,14963,9349
2021-12-06 23:00:00+00,8780,236,5125,14377,484,2588,2291,88,0,0,33969,134,22277,19986,14861,9016
2021-12-06 23:30:00+00,8693,231,5122,13754,483,2588,2295,96,0,0,33262,136,21654,19359,14237,8924
2021-12-07 00:00:00+00,8541,230,5123,13158,468,2740,2288,91,0,0,32639,136,21037,18749,13626,8771
2021-12-07 00:30:00+00,9215,246,5123,12503,461,2742,2286,89,0,0,32665,144,20373,18087,12964,9461
2021-12-07 01:00:00+00,8811,249,5123,11644,419,2742,2296,94,0,0,31378,145,19482,17186,12063,9060
2021-12-07 01:30:00+00,9007,245,5122,10767,419,2742,2336,96,0,0,30734,151,18644,16308,11186,9252
2021-12-07 02:00:00+00,8783,274,5123,10062,427,3046,2371,95,0,0,30181,153,17983,15612,10489,9057
2021-12-07 02:30:00+00,8914,374,5119,9160,431,3216,2388,99,0,0,29701,163,17098,14710,9591,9288
2021-12-07 03:00:00+00,8824,336,5126,8070,432,4094,2463,95,0,0,29440,166,16091,13628,8502,9160
2021-12-07 03:30:00+00,8901,320,5122,7251,435,4162,2689,96,0,0,28976,171,15497,12808,7686,9221
2021-12-07 04:00:00+00,8891,449,5126,6339,448,3736,2793,95,0,0,27877,181,14706,11913,6787,9340
2021-12-07 04:30:00+00,8979,559,5127,6197,448,3716,2780,116,0,0,27922,186,14552,11772,6645,9538
2021-12-07 05:00:00+00,9854,1008,5123,6372,472,3144,2722,92,0,0,28787,205,14689,11967,6844,10862
2021-12-07 05:30:00+00,10896,1144,5120,6005,470,3100,2692,89,0,0,29516,218,14287,11595,6475,12040
2021-12-07 06:00:00+00,12360,1326,5113,6406,574,2104,2777,92,0,0,30752,227,14869,12092,6980,13686
2021-12-07 06:30:00+00,13662,1464,5105,7079,584,2038,2779,119,0,0,32831,232,15548,12769,7663,15126
2021-12-07 07:00:00+00,14869,1443,5101,7427,667,2594,2775,123,0,62,35061,233,15970,13195,8094,16312
2021-12-07 07:30:00+00,15644,1634,5096,7487,717,2612,2749,152,0,350,36440,238,16049,13300,8204,17278
2021-12-07 08:00:00+00,16180,1900,5087,7859,798,2112,2751,122,10,168,36988,245,16505,13754,8667,18080
2021-12-07 08:30:00+00,16560,1897,5077,8446,798,2106,2752,239,44,454,38373,241,17117,14365,9288,18457
2021-12-07 09:00:00+00,16817,1763,5057,10063,783,2494,2728,209,132,290,40336,230,18763,16035,10978,18580
2021-12-07 09:30:00+00,16972,1568,5036,12032,714,2494,2724,116,212,140,42008,217,20717,17993,12958,18540
2021-12-07 10:00:00+00,17247,1251,5028,13925,753,2034,2914,689,260,144,44245,206,22880,19966,14938,18498
2021-12-07 10:30:00+00,17374,1376,5025,15478,701,2054,2726,110,264,0,45108,201,24194,21468,16443,18750
2021-12-07 11:00:00+00,17594,1197,5029,16198,465,1738,2764,98,359,0,45441,195,24815,22051,17022,18791
2021-12-07 11:30:00+00,17689,1291,5029,16590,426,1578,2737,98,375,62,45875,194,25157,22420,17391,18980
2021-12-07 12:00:00+00,17795,1552,5027,16900,397,1396,2813,268,357,82,46586,200,25494,22681,17654,19347
2021-12-07 12:30:00+00,17781,1492,5023,17251,403,1364,2894,223,442,0,46873,197,26013,23119,18096,19273
2021-12-07 13:00:00+00,17849,1068,5019,17564,386,1274,2938,116,629,256,47099,188,26536,23598,18579,18917
2021-12-07 13:30:00+00,17877,1000,5014,17968,387,1268,2915,94,579,8,47109,187,26862,23947,18934,18877
2021-12-07 14:00:00+00,18022,985,5008,18488,368,1292,2917,105,418,0,47602,186,27198,24281,19274,19007
2021-12-07 14:30:00+00,18296,935,5005,18582,366,1292,2916,89,347,0,47827,186,27216,24300,19295,19231
2021-12-07 15:00:00+00,18669,934,5000,18613,430,1176,2904,78,164,0,47968,187,27111,24207,19207,19603
2021-12-07 15:30:00+00,19292,1095,4997,18504,449,1182,2897,91,14,68,48589,193,26861,23964,18967,20387
2021-12-07 16:00:00+00,19285,944,4973,18224,622,2080,2891,105,0,448,49572,187,26710,23819,18846,20229
2021-12-07 16:30:00+00,19843,1349,4970,17694,648,2166,2918,219,0,852,50659,195,26230,23312,18342,21192
2021-12-07 17:00:00+00,19851,1532,4975,17618,664,2598,2904,300,0,844,51286,200,26161,23257,18282,21383
2021-12-07 17:30:00+00,19832,1578,4973,17370,663,2610,2896,255,0,718,50895,202,25902,23006,18033,21410
2021-12-07 18:00:00+00,19565,1644,4972,17214,683,2424,2902,240,0,520,50164,204,25771,22869,17897,21209
2021-12-07 18:30:00+00,19130,1801,4966,16744,641,2406,2907,217,0,374,49186,207,25258,22351,17385,20931
2021-12-07 19:00:00+00,17661,1177,4971,16379,573,2730,2961,121,0,356,46929,192,24884,21923,16952,18838
2021-12-07 19:30:00+00,16608,991,4973,16354,556,2762,2961,94,0,0,45299,186,24844,21883,16910,17599
2021-12-07 20:00:00+00,14342,829,4973,16737,540,2762,2968,77,0,0,43228,170,25218,22250,17277,15171
2021-12-07 20:30:00+00,12934,424,4968,17058,518,2762,2971,77,0,6,41718,154,25515,22544,17576,13358
2021-12-07 21:00:00+00,10830,186,4969,17430,522,2742,2962,87,0,120,39848,135,25883,22921,17952,11016
2021-12-07 21:30:00+00,9227,0,4973,17381,450,2736,2969,79,0,88,37903,120,25773,22804,17831,9227
2021-12-07 22:00:00+00,8919,0,4975,17415,457,2692,2961,83,0,0,37502,118,25808,22847,17872,8919
2021-12-07 22:30:00+00,7552,0,4978,17399,456,2712,2956,92,0,0,36145,108,25789,22833,17855,7552
2021-12-07 23:00:00+00,4808,0,4973,17309,457,2810,2746,78,0,0,33181,85,25485,22739,17766,4808
2021-12-07 23:30:00+00,3772,0,4977,16955,455,2966,2777,75,0,0,31977,78,25164,22387,17410,3772
2021-12-08 00:00:00+00,3564,0,4975,16488,455,3042,2669,73,0,0,31266,76,24587,21918,16943,3564
2021-12-08 00:30:00+00,3339,0,4969,16863,458,3070,2499,79,0,0,31277,73,24789,22290,17321,3339
2021-12-08 01:00:00+00,3031,0,4973,16539,458,3270,2858,74,0,0,31203,71,24828,21970,16997,3031
2021-12-08 01:30:00+00,2986,0,4969,15978,456,3266,2981,71,0,0,30707,72,24384,21403,16434,2986
2021-12-08 02:00:00+00,3286,0,4970,15695,442,2876,2983,71,0,0,30323,75,24090,21107,16137,3286
2021-12-08 02:30:00+00,3289,0,4966,15469,445,2880,2973,70,0,0,30092,75,23853,20880,15914,3289
2021-12-08 03:00:00+00,2902,0,4967,14957,445,3132,2978,80,0,0,29461,74,23347,20369,15402,2902
2021-12-08 03:30:00+00,2859,0,4975,14595,445,3146,2980,85,0,0,29085,75,22995,20015,15040,2859
2021-12-08 04:00:00+00,3281,0,4970,14029,455,2930,2984,190,0,0,28839,81,22438,19454,14484,3281
2021-12-08 04:30:00+00,3553,0,4972,13997,456,2926,2984,272,0,0,29160,85,22409,19425,14453,3553
2021-12-08 05:00:00+00,4199,118,4977,14088,473,3048,2776,263,0,0,29942,95,22314,19538,14561,4317
2021-12-08 05:30:00+00,5621,267,4881,13538,480,3046,2440,80,0,0,30353,113,21339,18899,14018,5888
2021-12-08 06:00:00+00,8726,532,4773,13885,489,2630,2848,83,0,0,33966,142,21995,19147,14374,9258
2021-12-08 06:30:00+00,11089,704,4754,14125,497,2596,2953,88,0,0,36806,160,22329,19376,14622,11793
2021-12-08 07:00:00+00,13478,862,4754,14094,541,2374,2966,92,0,0,39161,178,22355,19389,14635,14340
2021-12-08 07:30:00+00,15512,1154,4749,13921,526,2232,2983,114,0,22,41213,194,22179,19196,14447,16666
2021-12-08 08:00:00+00,16488,1433,4754,14077,558,2216,2992,113,25,0,42656,202,22406,19414,14660,17921
2021-12-08 08:30:00+00,16780,1711,4755,14088,565,2272,2980,103,200,0,43454,207,22588,19608,14853,18491
2021-12-08 09:00:00+00,18116,1944,4753,14062,581,2336,2989,358,540,300,45979,215,22925,19936,15183,20060
2021-12-08 09:30:00+00,18228,1975,4786,13910,643,2312,2991,486,945,346,46622,214,23275,20284,15498,20203
2021-12-08 10:00:00+00,18374,1935,4884,13765,728,2174,3016,432,1053,224,46585,214,23446,20430,15546,20309
2021-12-08 10:30:00+00,18351,1937,5010,13626,667,2190,3003,407,1427,194,46812,212,23733,20730,15720,20288
2021-12-08 11:00:00+00,18347,1926,5019,13741,629,2372,2993,398,1764,0,47189,210,24146,21153,16134,20273
2021-12-08 11:30:00+00,18391,1950,5025,13764,625,2382,2994,252,1875,0,47258,210,24283,21289,16264,20341
2021-12-08 12:00:00+00,18298,1977,5018,13604,608,2206,2985,98,1913,0,46707,209,24128,21143,16125,20275
2021-12-08 12:30:00+00,18357,1978,4931,13384,607,2284,2988,96,1862,20,46507,212,23772,20784,15853,20335
2021-12-08 13:00:00+00,18721,1979,4760,13269,513,2312,3006,115,1797,136,46608,215,23345,20339,15579,20700
2021-12-08 13:30:00+00,18516,1964,4744,13407,509,2338,3006,112,1452,52,46100,215,23118,20112,15368,20480
2021-12-08 14:00:00+00,18518,1951,4743,13112,509,2404,3003,129,1004,186,45559,218,22371,19368,14625,20469
2021-12-08 14:30:00+00,18696,1974,4752,13054,507,2288,3006,111,571,10,44969,222,21890,18884,14132,20670
2021-12-08 15:00:00+00,18612,1712,4915,12882,558,1936,3008,102,215,218,44158,220,21578,18570,13655,20324
2021-12-08 15:30:00+00,19215,1755,5010,12467,661,2030,3008,176,10,278,44610,225,21156,18148,13138,20970
2021-12-08 16:00:00+00,18842,1968,5013,12518,742,2612,3018,238,0,878,45829,222,21291,18273,13260,20810
2021-12-08 16:30:00+00,19481,1971,5016,12036,825,2598,3026,501,0,1384,46838,224,20903,17877,12861,21452
2021-12-08 17:00:00+00,20185,1974,5015,11883,851,2696,3046,701,0,1302,47653,230,20795,17749,12734,22159
2021-12-08 17:30:00+00,20776,1972,5022,11740,822,2574,3027,737,0,682,47352,236,20611,17584,12562,22748
2021-12-08 18:00:00+00,20576,1975,5034,11606,862,2840,3014,620,0,838,47365,234,20516,17502,12468,22551
2021-12-08 18:30:00+00,19779,1975,5004,11847,883,2725,3046,286,0,784,46329,229,20780,17734,12730,21754
2021-12-08 19:00:00+00,19873,1972,4817,11987,887,2953,3048,194,0,226,45957,233,20739,17691,12874,21845
2021-12-08 19:30:00+00,19188,1974,4741,11933,885,2893,3044,155,0,200,45012,231,20603,17559,12818,21162
2021-12-08 20:00:00+00,18243,1975,4749,12022,846,2774,3040,146,0,0,43795,228,20657,17617,12868,20218
2021-12-08 20:30:00+00,16723,1974,4744,12262,736,2762,3037,132,0,0,42370,221,20779,17742,12998,18697
2021-12-08 21:00:00+00,14723,1978,4751,12429,587,2742,3027,113,0,0,40350,212,20794,17767,13016,16701
2021-12-08 21:30:00+00,12728,1880,4788,12547,514,2742,3021,115,0,0,38335,201,20870,17849,13061,14608
2021-12-08 22:00:00+00,11504,1224,4954,12668,517,2742,3012,96,0,0,36717,179,21151,18139,13185,12728
2021-12-08 22:30:00+00,10081,764,5051,12616,516,2742,3016,70,0,0,34856,160,21199,18183,13132,10845
2021-12-08 23:00:00+00,8250,788,5051,12432,548,2506,3031,108,0,20,32734,149,21062,18031,12980,9038
2021-12-08 23:30:00+00,7284,849,5059,12104,623,2504,3018,160,0,0,31601,145,20804,17786,12727,8133
2021-12-09 00:00:00+00,7340,839,5064,11620,606,2684,3009,126,0,0,31288,149,20299,17290,12226,8179
2021-12-09 00:30:00+00,7661,978,5066,11224,645,2686,3044,224,0,0,31528,157,19979,16935,11869,8639
2021-12-09 01:00:00+00,7624,990,5073,11088,639,2744,3047,346,0,0,31551,159,19847,16800,11727,8614
2021-12-09 01:30:00+00,7545,995,5063,10901,577,2744,3048,210,0,0,31083,158,19589,16541,11478,8540
2021-12-09 02:00:00+00,7949,865,5068,10779,488,2746,3043,69,0,0,31007,158,19378,16335,11267,8814
2021-12-09 02:30:00+00,8428,993,5006,10691,476,2746,3048,65,0,0,31453,166,19221,16173,11167,9421
2021-12-09 03:00:00+00,8920,981,4819,10683,469,2454,3041,67,0,0,31434,170,19012,15971,11152,9901
2021-12-09 03:30:00+00,9311,980,4783,10669,470,2454,3016,67,0,0,31750,173,18938,15922,11139,10291
2021-12-09 04:00:00+00,9969,979,4781,10660,484,2636,3013,68,0,0,32590,178,18938,15925,11144,10948
2021-12-09 04:30:00+00,10672,860,4783,10294,484,2636,3014,68,0,0,32811,182,18575,15561,10778,11532
2021-12-09 05:00:00+00,11816,996,4850,9685,484,1842,3012,64,0,0,32748,195,18031,15019,10169,12812
2021-12-09 05:30:00+00,13110,1043,5025,9416,481,1802,3017,62,0,0,33956,205,17939,14922,9897,14153
2021-12-09 06:00:00+00,14815,1318,5038,9563,485,1562,3021,68,0,30,35900,218,18107,15086,10048,16133
2021-12-09 06:30:00+00,16369,1690,5039,9005,508,1426,3017,64,0,36,37154,235,17569,14552,9513,18059
2021-12-09 07:00:00+00,17823,1926,5044,8469,665,694,2996,112,0,166,37895,244,17174,14178,9134,19749
2021-12-09 07:30:00+00,18843,1972,5067,7974,716,694,2971,439,0,266,38943,251,16728,13757,8690,20815
2021-12-09 08:00:00+00,19606,1976,5067,7594,803,1654,2977,453,23,256,40409,257,16464,13487,8420,21582
2021-12-09 08:30:00+00,20215,1977,5066,7401,808,1872,2978,456,189,162,41124,261,16442,13464,8398,22192
2021-12-09 09:00:00+00,20766,1974,5067,7157,795,1960,2987,462,508,878,42555,257,16514,13527,8460,22740
2021-12-09 09:30:00+00,21219,1979,5067,7093,804,1990,2988,528,1228,590,43486,257,17180,14192,9125,23198
2021-12-09 10:00:00+00,21670,1976,5083,6719,781,1742,2988,477,1854,606,43896,257,17425,14437,9354,23646
2021-12-09 10:30:00+00,22078,1974,5080,6090,956,1878,2987,274,2396,356,44069,260,17509,14522,9442,24052
2021-12-09 11:00:00+00,22518,1975,5070,5963,885,2094,2990,152,2692,490,44830,261,17600,14610,9540,24493
2021-12-09 11:30:00+00,22860,1976,5070,6331,806,2210,2987,139,2741,456,45576,261,17935,14948,9878,24836
2021-12-09 12:00:00+00,23210,1888,5070,6857,697,2082,2985,126,2527,548,45990,260,18136,15151,10081,25098
2021-12-09 12:30:00+00,23448,1845,5071,7188,617,2094,2988,126,2055,170,45602,263,17919,14931,9860,25293
2021-12-09 13:00:00+00,23071,1802,5073,6745,608,1890,2986,247,2067,510,44999,262,17479,14493,9420,24873
2021-12-09 13:30:00+00,22753,1862,5074,6967,606,1894,3034,228,1669,374,44461,263,17350,14316,9242,24615
2021-12-09 14:00:00+00,22703,1875,5076,7414,699,2024,3043,179,1067,476,44556,264,17299,14256,9180,24578
2021-12-09 14:30:00+00,22380,1916,5071,7839,755,2030,3067,194,546,596,44394,263,17278,14211,9140,24296
2021-12-09 15:00:00+00,21726,1965,5078,8337,800,2224,3069,418,114,198,43929,263,17398,14329,9251,23691
2021-12-09 15:30:00+00,21764,1967,5078,8894,818,2226,3075,389,2,414,44627,259,17867,14792,9714,23731
2021-12-09 16:00:00+00,21856,1970,5082,9200,873,2968,3080,371,0,1012,46412,254,18235,15155,10073,23826
2021-12-09 16:30:00+00,21848,1969,5124,9393,975,2960,3078,705,0,1278,47330,251,18570,15492,10368,23817
2021-12-09 17:00:00+00,21868,1972,5146,9704,958,3180,3076,627,0,1304,47835,248,18884,15808,10662,23840
2021-12-09 17:30:00+00,21766,1966,5166,9865,956,3210,3081,583,0,1046,47639,248,19068,15987,10821,23732
2021-12-09 18:00:00+00,21658,1967,5164,9952,955,3202,3050,441,0,1016,47405,247,19121,16071,10907,23625
2021-12-09 18:30:00+00,21346,1968,5162,10283,963,3118,3042,349,0,134,46365,249,19450,16408,11246,23314
2021-12-09 19:00:00+00,19806,1961,5168,11497,863,3390,3049,91,0,0,45825,238,20577,17528,12360,21767
2021-12-09 19:30:00+00,17916,1961,5161,12529,812,3188,3051,71,0,0,44689,225,21553,18502,13341,19877
2021-12-09 20:00:00+00,16393,1878,5157,12990,811,3086,3056,67,0,0,43438,215,22014,18958,13801,18271
2021-12-09 20:30:00+00,14536,1682,5160,13814,687,2962,3019,62,0,0,41922,199,22680,19661,14501,16218
2021-12-09 21:00:00+00,13189,1092,5159,14000,601,2954,2963,67,0,20,40045,182,22723,19760,14601,14281
2021-12-09 21:30:00+00,11869,666,5159,13775,577,2804,2943,63,0,0,37856,166,22454,19511,14352,12535
2021-12-09 22:00:00+00,10627,224,5160,13986,544,3042,2939,67,0,0,36589,150,22629,19690,14530,10851
2021-12-09 22:30:00+00,8576,0,5158,14185,527,3056,3007,79,0,0,34588,130,22877,19870,14712,8576
2021-12-09 23:00:00+00,5507,0,5158,13905,511,3052,3014,64,0,0,31211,105,22588,19574,14416,5507
2021-12-09 23:30:00+00,4540,0,5161,13913,506,3174,3005,62,0,0,30361,98,22585,19580,14419,4540
2021-12-10 00:00:00+00,3947,0,5160,13902,482,3818,3000,70,0,0,30379,93,22544,19544,14384,3947
2021-12-10 00:30:00+00,4308,0,5161,13832,460,3932,3013,61,0,0,30767,98,22466,19453,14292,4308
2021-12-10 01:00:00+00,4017,0,5160,13604,467,4552,3011,61,0,0,30872,93,22242,19231,14071,4017
2021-12-10 01:30:00+00,3833,0,5167,13426,469,4406,3010,62,0,0,30373,90,22072,19062,13895,3833
2021-12-10 02:00:00+00,4205,0,5166,13132,471,3680,2990,61,0,0,29705,95,21759,18769,13603,4205
2021-12-10 02:30:00+00,4300,0,5166,12750,473,3600,3012,60,0,0,29361,97,21401,18389,13223,4300
2021-12-10 03:00:00+00,4430,0,5163,12679,509,3358,2906,61,0,0,29106,99,21257,18351,13188,4430
2021-12-10 03:30:00+00,4419,0,5165,12441,509,3218,2638,60,0,0,28450,98,20753,18115,12950,4419
2021-12-10 04:00:00+00,4603,0,5159,12344,486,2828,2400,65,0,0,27885,101,20389,17989,12830,4603
2021-12-10 04:30:00+00,4385,159,5162,12411,472,2978,2362,62,0,0,27991,105,20407,18045,12883,4544
2021-12-10 05:00:00+00,5455,230,5163,12609,492,2240,2372,62,0,0,28623,115,20636,18264,13101,5685
2021-12-10 05:30:00+00,6573,448,5159,12353,491,2262,2343,62,0,0,29691,133,20346,18003,12844,7021
2021-12-10 06:00:00+00,10385,702,5161,12779,488,1492,2389,61,0,0,33457,162,20817,18428,13267,11087
2021-12-10 06:30:00+00,12835,992,5163,12945,471,1470,2359,61,0,0,36296,183,20938,18579,13416,13827
2021-12-10 07:00:00+00,16874,1065,5152,12895,484,1236,2393,65,0,40,40204,204,20924,18531,13379,17939
2021-12-10 07:30:00+00,18516,1377,5152,13139,632,1256,2365,81,0,88,42606,215,21288,18923,13771,19893
2021-12-10 08:00:00+00,19066,1431,5154,13721,855,1396,2340,64,30,66,44123,215,22100,19760,14606,20497
2021-12-10 08:30:00+00,19525,1595,5148,13537,857,1294,2345,72,324,152,44849,218,22211,19866,14718,21120
2021-12-10 09:00:00+00,19766,1712,5154,13788,856,1150,2346,64,1062,0,45898,216,23206,20860,15706,21478
2021-12-10 09:30:00+00,19537,1719,5150,13990,855,1010,2331,63,1826,0,46481,210,24152,21821,16671,21256
2021-12-10 10:00:00+00,19305,1718,5155,14022,832,862,2328,60,2605,14,46901,205,24942,22614,17459,21023
2021-12-10 10:30:00+00,18802,1722,5155,14139,826,724,2328,65,3171,0,46932,199,25619,23291,18136,20524
2021-12-10 11:00:00+00,18470,1720,5155,14250,758,726,2349,63,3614,0,47105,195,26126,23777,18622,20190
2021-12-10 11:30:00+00,18407,1722,5149,13971,659,694,2353,72,3715,50,46792,196,25847,23494,18345,20129
2021-12-10 12:00:00+00,18504,1720,5146,14027,569,712,2345,74,3779,18,46894,197,25866,23521,18375,20224
2021-12-10 12:30:00+00,18472,1722,5147,14173,567,726,2345,68,3709,0,46929,196,25941,23596,18449,20194
2021-12-10 13:00:00+00,17611,1723,5150,14310,577,860,2336,70,3362,24,46023,194,25735,23399,18249,19334
2021-12-10 13:30:00+00,17700,1830,5154,13999,578,836,2331,66,2663,24,45181,200,24725,22394,17240,19530
2021-12-10 14:00:00+00,18102,1926,5153,13687,594,944,2324,69,1888,242,44929,208,23646,21322,16169,20028
2021-12-10 14:30:00+00,18617,1920,5159,13080,596,1018,2356,67,1057,320,44190,217,22248,19892,14733,20537
2021-12-10 15:00:00+00,18566,1920,5157,12659,765,966,2362,91,314,468,43268,221,21257,18895,13738,20486
2021-12-10 15:30:00+00,19235,1921,5156,12206,918,1200,2367,212,15,694,43924,227,20662,18295,13139,21156
2021-12-10 16:00:00+00,19477,1969,5157,11962,1001,1272,2384,453,0,902,44577,229,20504,18120,12963,21446
2021-12-10 16:30:00+00,19803,1969,5162,12215,1048,1172,2525,604,0,1332,45830,226,20950,18425,13263,21772
2021-12-10 17:00:00+00,19303,1971,5163,11937,927,2474,2746,466,0,990,45977,225,20773,18027,12864,21274
2021-12-10 17:30:00+00,19470,1972,5161,11721,906,2532,2936,514,0,748,45960,227,20724,17788,12627,21442
2021-12-10 18:00:00+00,19236,1971,5161,11730,1048,2500,2990,399,0,1278,46313,225,20929,17939,12778,21207
2021-12-10 18:30:00+00,19455,1971,5163,11466,1059,2498,2976,278,0,362,45228,231,20664,17688,12525,21426
2021-12-10 19:00:00+00,18268,1969,5159,11295,1012,2898,3002,116,0,16,43735,229,20468,17466,12307,20237
2021-12-10 19:30:00+00,17449,1970,5161,11109,879,2926,2993,73,0,0,42560,227,20142,17149,11988,19419
2021-12-10 20:00:00+00,16943,1971,5158,11123,593,2738,2989,72,0,76,41663,226,19863,16874,11716,18914
2021-12-10 20:30:00+00,15830,1973,5154,10894,571,2742,2986,80,0,104,40334,223,19605,16619,11465,17803
2021-12-10 21:00:00+00,14510,1968,5159,10711,483,2940,2950,70,0,124,38915,218,19303,16353,11194,16478
2021-12-10 21:30:00+00,13410,1969,5160,10539,481,2950,2901,65,0,0,37475,214,19081,16180,11020,15379
2021-12-10 22:00:00+00,12065,1877,5162,10338,441,2992,2904,66,0,2,35847,207,18845,15941,10779,13942
2021-12-10 22:30:00+00,11264,1530,5158,9648,432,2994,2901,70,0,112,34109,199,18139,15238,10080,12794
2021-12-10 23:00:00+00,8918,1373,5156,9169,413,3960,2900,66,0,106,32061,182,17638,14738,9582,10291
2021-12-10 23:30:00+00,8375,1152,5157,8549,412,3992,2902,65,0,72,30676,176,17020,14118,8961,9527
2021-12-11 00:00:00+00,8216,979,5154,8032,412,4410,2880,67,0,104,30254,173,16478,13598,8444,9195
2021-12-11 00:30:00+00,8448,974,5161,7746,461,4418,2791,61,0,384,30444,174,16159,13368,8207,9422
2021-12-11 01:00:00+00,8328,975,5160,7480,483,4388,2790,64,0,106,29774,178,15913,13123,7963,9303
2021-12-11 01:30:00+00,8252,980,5158,7021,481,4410,2762,69,0,0,29133,181,15422,12660,7502,9232
2021-12-11 02:00:00+00,8319,985,5157,6393,411,4626,2767,72,0,0,28730,187,14728,11961,6804,9304
2021-12-11 02:30:00+00,8245,979,5161,5897,407,4720,2763,71,0,0,28243,191,14228,11465,6304,9224
2021-12-11 03:00:00+00,8168,980,5162,5506,407,4942,2765,71,0,0,28001,194,13840,11075,5913,9148
2021-12-11 03:30:00+00,8102,864,5164,5213,405,4938,2699,69,0,0,27454,192,13481,10782,5618,8966
2021-12-11 04:00:00+00,8279,726,5159,4867,406,5160,2368,67,0,0,27032,195,12800,10432,5273,9005
2021-12-11 04:30:00+00,8561,600,5158,4741,403,5154,2352,69,0,0,27038,194,12654,10302,5144,9161
2021-12-11 05:00:00+00,8738,608,5154,4700,439,4950,2360,64,0,0,27013,199,12653,10293,5139,9346
2021-12-11 05:30:00+00,8851,918,5157,4748,438,5036,2347,63,0,0,27558,208,12690,10343,5186,9769
2021-12-11 06:00:00+00,9484,1458,5158,4762,435,4976,2347,64,0,46,28730,226,12702,10355,5197,10942
2021-12-11 06:30:00+00,9911,1752,5158,5035,473,4980,2349,64,0,0,29722,234,13015,10666,5508,11663
2021-12-11 07:00:00+00,12375,1819,5156,5336,671,3658,2363,67,0,38,31483,251,13526,11163,6007,14194
2021-12-11 07:30:00+00,13416,1817,5153,5618,691,3622,2360,64,0,22,32763,253,13822,11462,6309,15233
2021-12-11 08:00:00+00,13429,1841,5155,6266,778,4930,2361,69,19,0,34848,241,14579,12218,7063,15270
2021-12-11 08:30:00+00,14095,1953,5158,6839,795,4984,2364,83,186,0,36457,240,15342,12978,7820,16048
2021-12-11 09:00:00+00,14070,1949,5155,7405,774,5514,2372,93,438,74,37844,233,16144,13772,8617,16019
2021-12-11 09:30:00+00,14292,1952,5158,8282,651,5518,2356,82,609,0,38900,229,17056,14700,9542,16244
2021-12-11 10:00:00+00,14710,1950,5148,8666,587,5240,2364,72,804,32,39573,228,17569,15205,10057,16660
2021-12-11 10:30:00+00,14858,1959,5146,8952,579,5070,2353,112,835,0,39864,227,17865,15512,10366,16817
2021-12-11 11:00:00+00,15211,1959,5134,9208,548,4438,2357,179,924,0,39958,230,18171,15814,10680,17170
2021-12-11 11:30:00+00,15197,1966,5135,9541,552,4440,2367,265,851,0,40314,229,18446,16079,10944,17163
2021-12-11 12:00:00+00,15193,1973,5131,9826,529,4394,2376,99,772,18,40311,227,18634,16258,11127,17166
2021-12-11 12:30:00+00,15135,1971,5128,10057,515,4324,2363,130,665,32,40320,226,18728,16365,11237,17106
2021-12-11 13:00:00+00,15146,1973,5117,10281,521,4072,2364,82,578,68,40202,226,18861,16497,11380,17119
2021-12-11 13:30:00+00,15143,1959,5115,10219,534,3986,2350,65,398,0,39769,227,18616,16266,11151,17102
2021-12-11 14:00:00+00,15107,1965,5109,10296,574,3528,2361,91,201,20,39252,223,18541,16180,11071,17072
2021-12-11 14:30:00+00,15060,1965,5113,10429,589,3428,2369,144,88,0,39185,222,18588,16219,11106,17025
2021-12-11 15:00:00+00,15223,1953,5108,10811,691,2940,2369,195,19,0,39309,221,18998,16629,11521,17176
2021-12-11 15:30:00+00,15326,1947,5112,11323,718,2960,2367,224,0,0,39977,219,19520,17153,12041,17273
2021-12-11 16:00:00+00,15418,1931,5111,11506,758,3788,2361,236,0,112,41221,216,19736,17375,12264,17349
2021-12-11 16:30:00+00,15145,1964,5112,12184,764,3502,2387,219,0,424,41701,208,20447,18060,12948,17109
2021-12-11 17:00:00+00,15086,1969,5117,12416,761,4072,2386,217,0,866,42890,206,20680,18294,13177,17055
2021-12-11 17:30:00+00,14994,1968,5117,12843,772,4112,2375,210,0,924,43316,203,21107,18732,13615,16962
2021-12-11 18:00:00+00,14757,1970,5119,13158,748,3766,2383,193,0,798,42892,202,21408,19025,13906,16727
2021-12-11 18:30:00+00,14431,1969,5116,13182,721,3710,2378,177,0,430,42113,203,21397,19019,13903,16400
2021-12-11 19:00:00+00,14007,1948,5121,13232,718,2766,2348,175,0,0,40316,206,21419,19071,13950,15955
2021-12-11 19:30:00+00,13375,1946,5121,13705,653,2766,2364,127,0,0,40057,200,21843,19479,14358,15321
2021-12-11 20:00:00+00,12765,1951,5115,13946,590,2766,2360,124,0,14,39631,197,22011,19651,14536,14716
2021-12-11 20:30:00+00,11839,1956,5110,13927,549,2766,2355,78,0,120,38700,192,21941,19586,14476,13795
2021-12-11 21:00:00+00,10864,1961,5111,13745,517,2746,2361,86,0,12,37403,188,21734,19373,14262,12825
2021-12-11 21:30:00+00,9553,1812,5111,13554,501,2744,2344,119,0,0,35738,179,21510,19166,14055,11365
2021-12-11 22:00:00+00,8280,1359,5110,13238,497,2744,2354,105,0,0,33687,162,21199,18845,13735,9639
2021-12-11 22:30:00+00,7111,846,5110,13010,473,2744,2361,114,0,0,31769,142,20954,18593,13483,7957
2021-12-11 23:00:00+00,6195,295,5114,12850,433,3672,2272,94,0,0,30925,119,20669,18397,13283,6490
2021-12-11 23:30:00+00,5563,88,5112,12517,435,3844,1972,90,0,12,29634,108,20036,18064,12952,5651
2021-12-12 00:00:00+00,5350,0,5116,12198,434,4340,2011,95,0,0,29544,101,19759,17748,12632,5350
2021-12-12 00:30:00+00,5227,0,5113,11809,430,4330,2111,91,0,0,29112,101,19463,17352,12239,5227
2021-12-12 01:00:00+00,4934,0,5104,11201,410,3550,2296,90,0,0,27585,102,19011,16715,11611,4934
2021-12-12 01:30:00+00,4511,0,5109,11089,409,3512,2320,92,0,0,27042,98,18927,16607,11498,4511
2021-12-12 02:00:00+00,4225,0,5109,10660,409,3626,2216,92,0,0,26337,96,18394,16178,11069,4225
2021-12-12 02:30:00+00,3989,0,5105,10174,406,3636,2218,91,0,0,25619,95,17903,15685,10580,3989
2021-12-12 03:00:00+00,3776,0,5107,10000,404,3938,2239,94,0,0,25558,93,17750,15511,10404,3776
2021-12-12 03:30:00+00,3480,0,5110,10095,394,3946,2357,86,0,0,25469,89,17956,15599,10489,3480
2021-12-12 04:00:00+00,3466,0,5108,10011,402,3986,2358,86,0,0,25417,89,17879,15521,10413,3466
2021-12-12 04:30:00+00,3754,0,5106,9622,402,3984,2372,90,0,0,25330,94,17502,15130,10024,3754
2021-12-12 05:00:00+00,3883,0,5106,8952,477,3780,2368,67,0,0,24633,98,16903,14535,9429,3883
2021-12-12 05:30:00+00,4039,0,5100,8465,478,3778,2364,66,0,0,24290,102,16407,14043,8943,4039
2021-12-12 06:00:00+00,4479,110,5105,8621,494,3560,2369,65,0,46,24849,110,16589,14220,9115,4589
2021-12-12 06:30:00+00,5567,347,5108,8230,499,3572,2362,77,0,0,25762,132,16199,13837,8729,5914
2021-12-12 07:00:00+00,7055,521,5106,7702,562,2992,2367,100,0,312,26717,154,15737,13370,8264,7576
2021-12-12 07:30:00+00,8419,779,5111,7322,597,2974,2357,99,0,84,27742,177,15387,13030,7919,9198
2021-12-12 08:00:00+00,9299,956,5108,7325,700,3228,2367,103,8,0,29094,187,15508,13141,8033,10255
2021-12-12 08:30:00+00,10449,1216,5104,7157,745,3376,2368,106,116,146,30783,202,15490,13122,8018,11665
2021-12-12 09:00:00+00,10875,1347,5110,7271,767,4448,2366,95,324,0,32603,199,15838,13472,8362,12222
2021-12-12 09:30:00+00,11100,1644,5109,7339,768,4584,2377,102,612,32,33667,204,16205,13828,8719,12744
2021-12-12 10:00:00+00,11537,1646,5115,7593,760,4756,2322,94,1043,0,34866,206,16833,14511,9396,13183
2021-12-12 10:30:00+00,11052,1851,5114,7976,766,4872,2330,94,1411,0,35466,204,17597,15267,10153,12903
2021-12-12 11:00:00+00,10842,1890,5118,8547,749,4688,2371,119,1498,0,35822,202,18283,15912,10794,12732
2021-12-12 11:30:00+00,10864,1872,5114,9203,747,4658,2365,116,1437,0,36376,199,18866,16501,11387,12736
2021-12-12 12:00:00+00,10558,1679,5118,10168,708,4738,2418,133,1384,0,36904,190,19796,17378,12260,12237
2021-12-12 12:30:00+00,10025,1682,5114,10779,709,4778,2475,106,1382,0,37050,184,20459,17984,12870,11707
2021-12-12 13:00:00+00,9924,1660,5113,10831,690,4734,2565,96,1185,0,36798,184,20384,17819,12706,11584
2021-12-12 13:30:00+00,9867,1685,5110,10609,676,4782,2718,98,726,0,36271,188,19839,17121,12011,11552
2021-12-12 14:00:00+00,10735,1763,5116,10799,731,3730,2719,98,655,16,36362,193,20020,17301,12185,12498
2021-12-12 14:30:00+00,10483,1691,5112,10883,731,3712,2822,99,344,6,35883,191,19892,17070,11958,12174
2021-12-12 15:00:00+00,10771,1686,5112,11327,805,4136,2855,100,68,0,36860,186,20167,17312,12200,12457
2021-12-12 15:30:00+00,11319,1628,5116,11895,808,4256,2878,99,2,0,38001,186,20699,17821,12705,12947
2021-12-12 16:00:00+00,12191,1640,5116,12406,893,4140,2944,129,0,0,39459,189,21359,18415,13299,13831
2021-12-12 16:30:00+00,12433,1722,5107,12735,1030,4150,2870,289,0,480,40816,188,21742,18872,13765,14155
2021-12-12 17:00:00+00,12281,1736,5105,13116,1027,4310,2940,333,0,632,41480,188,22188,19248,14143,14017
2021-12-12 17:30:00+00,11805,1730,5113,14157,1013,4290,2970,96,0,86,41260,182,23253,20283,15170,13535
2021-12-12 18:00:00+00,11361,1650,5111,14888,786,3526,2941,188,0,0,40451,180,23726,20785,15674,13011
2021-12-12 18:30:00+00,10814,1559,5115,14993,718,3430,2949,155,0,0,39733,175,23775,20826,15711,12373
2021-12-12 19:00:00+00,10231,1383,5112,14884,689,3466,2905,55,0,78,38803,168,23590,20685,15573,11614
2021-12-12 19:30:00+00,9287,974,5114,15015,688,3418,2873,52,0,0,37421,154,23690,20817,15703,10261
2021-12-12 20:00:00+00,8522,599,5111,14975,628,3346,2872,54,0,0,36107,140,23586,20714,15603,9121
2021-12-12 20:30:00+00,7664,412,5111,15124,613,3106,2877,54,0,0,34961,127,23725,20848,15737,8076
2021-12-12 21:00:00+00,5832,181,5114,15302,615,3374,2891,52,0,0,33361,107,23922,21031,15917,6013
2021-12-12 21:30:00+00,5540,90,5109,15075,616,3150,2882,58,0,0,32520,101,23682,20800,15691,5630
2021-12-12 22:00:00+00,5248,0,5106,15044,618,2778,2873,61,0,0,31728,94,23641,20768,15662,5248
2021-12-12 22:30:00+00,4512,0,5106,14930,606,2662,2826,85,0,0,30727,86,23468,20642,15536,4512
2021-12-12 23:00:00+00,4233,0,5109,14959,597,2026,2820,55,0,0,29799,84,23485,20665,15556,4233
2021-12-12 23:30:00+00,3629,0,5110,14978,618,1942,2866,54,0,0,29197,77,23572,20706,15596,3629
2021-12-13 00:00:00+00,4274,0,5104,14857,612,1548,2884,63,0,0,29342,82,23457,20573,15469,4274
2021-12-13 00:30:00+00,4604,0,5102,14817,597,1550,2845,58,0,0,29573,85,23361,20516,15414,4604
2021-12-13 01:00:00+00,4270,0,5102,14736,594,1808,2848,57,0,0,29415,84,23280,20432,15330,4270
2021-12-13 01:30:00+00,4061,0,5105,14569,583,1808,2851,53,0,0,29030,83,23108,20257,15152,4061
2021-12-13 02:00:00+00,3520,0,5108,14317,579,2030,2863,52,0,0,28469,79,22867,20004,14896,3520
2021-12-13 02:30:00+00,3537,0,5104,14136,587,2032,2874,53,0,0,28323,79,22701,19827,14723,3537
2021-12-13 03:00:00+00,2866,0,5104,13529,582,2542,2882,52,0,0,27557,75,22097,19215,14111,2866
2021-12-13 03:30:00+00,2922,0,5105,12989,581,2494,2886,51,0,0,27029,76,21561,18675,13570,2922
2021-12-13 04:00:00+00,3258,0,5111,12637,575,2459,2934,64,0,0,27037,80,21257,18323,13212,3258
2021-12-13 04:30:00+00,3910,139,5112,11986,589,2375,2950,50,0,0,27111,93,20637,17687,12575,4049
2021-12-13 05:00:00+00,4846,385,5114,11667,597,1614,2966,57,0,102,27349,110,20344,17378,12264,5231
2021-12-13 05:30:00+00,6043,661,5111,11441,599,1473,2966,52,0,146,28492,129,20117,17151,12040,6704
2021-12-13 06:00:00+00,9160,884,5108,11010,754,1310,2956,53,0,396,31631,161,19828,16872,11764,10044
2021-12-13 06:30:00+00,12171,1120,5104,10877,761,1253,2960,55,0,200,34501,187,19702,16742,11638,13291
2021-12-13 07:00:00+00,16115,1382,5105,10865,794,1268,2955,74,0,194,38752,214,19719,16764,11659,17497
2021-12-13 07:30:00+00,17531,1619,5103,10535,809,1226,2962,212,0,378,40375,225,19409,16447,11344,19150
2021-12-13 08:00:00+00,18229,1887,5107,9720,891,1404,2950,323,9,200,40720,239,18677,15727,10620,20116
2021-12-13 08:30:00+00,18851,1947,5107,8793,794,504,2952,429,111,290,39779,251,17757,14805,9698,20798
2021-12-13 09:00:00+00,19242,1945,5107,8362,803,794,2954,681,264,328,40480,253,17490,14536,9429,21187
2021-12-13 09:30:00+00,19496,1946,5105,8316,810,1388,2973,690,433,256,41412,251,17637,14664,9559,21442
2021-12-13 10:00:00+00,19391,1947,5112,8383,813,1329,2988,657,608,192,41420,249,17904,14916,9804,21338
2021-12-13 10:30:00+00,19281,1947,5109,7723,809,1316,3010,631,694,310,40830,252,17345,14335,9226,21228
2021-12-13 11:00:00+00,19130,1938,5112,8208,813,1529,3015,436,779,188,41148,247,17927,14912,9800,21068
2021-12-13 11:30:00+00,19195,1929,5121,8055,772,1513,3027,462,788,234,41095,248,17763,14736,9615,21124
2021-12-13 12:00:00+00,19573,1945,5124,7941,731,1541,2977,391,765,390,41378,249,17538,14561,9437,21518
2021-12-13 12:30:00+00,19676,1944,5112,7805,776,1626,2963,456,772,480,41610,250,17428,14465,9353,21620
2021-12-13 13:00:00+00,19846,1948,5112,7681,757,1815,2964,489,756,330,41698,250,17270,14306,9194,21794
2021-12-13 13:30:00+00,19883,1948,5112,7682,761,1840,3008,412,527,152,41325,252,17090,14082,8970,21831
2021-12-13 14:00:00+00,19697,1945,5105,7549,816,2048,3028,395,341,336,41260,250,16839,13811,8706,21642
2021-12-13 14:30:00+00,19770,1950,5109,7356,822,2082,3031,394,182,340,41036,253,16500,13469,8360,21720
2021-12-13 15:00:00+00,19755,1952,5108,7189,875,2400,3032,521,48,314,41194,253,16252,13220,8112,21707
2021-12-13 15:30:00+00,19956,1955,5112,7565,903,2486,3029,559,0,682,42247,250,16609,13580,8468,21911
2021-12-13 16:00:00+00,20546,1959,5107,7808,947,2612,3032,553,0,1274,43838,246,16894,13862,8754,22505
2021-12-13 16:30:00+00,20682,1958,5106,8192,960,2642,3003,744,0,1760,45047,242,17261,14258,9152,22640
2021-12-13 17:00:00+00,20685,1959,5110,8107,992,3180,2973,849,0,1564,45419,241,17182,14209,9099,22644
2021-12-13 17:30:00+00,20627,1959,5110,8312,991,3224,2980,889,0,1480,45572,240,17393,14413,9303,22586
2021-12-13 18:00:00+00,20835,1958,5109,8334,911,2744,2941,630,0,1514,44976,245,17294,14354,9244,22793
2021-12-13 18:30:00+00,20544,1957,5112,8231,883,2692,2900,394,0,1218,43931,246,17126,14226,9114,22501
2021-12-13 19:00:00+00,20066,1946,5110,7937,852,3186,2941,314,0,408,42760,254,16840,13899,8789,22012
2021-12-13 19:30:00+00,19476,1948,5110,7608,816,3070,3024,172,0,504,41728,253,16558,13534,8424,21424
2021-12-13 20:00:00+00,19598,1958,5112,7030,702,2756,3020,155,0,718,41049,258,15864,12844,7732,21556
2021-12-13 20:30:00+00,18966,1944,5109,6544,693,2644,3014,121,0,484,39519,260,15360,12346,7237,20910
2021-12-13 21:00:00+00,17572,1879,5108,6449,665,2454,3013,102,0,124,37366,258,15235,12222,7114,19451
2021-12-13 21:30:00+00,16020,1774,5108,6337,665,2488,3014,91,0,190,35687,250,15124,12110,7002,17794
2021-12-13 22:00:00+00,14140,1572,5108,6462,634,2594,2963,88,0,378,33939,237,15167,12204,7096,15712
2021-12-13 22:30:00+00,12907,1553,5105,5947,597,2500,2917,85,0,386,31997,234,14566,11649,6544,14460
2021-12-13 23:00:00+00,11751,1536,5101,5649,645,2728,2920,82,0,360,30772,229,14315,11395,6294,13287
2021-12-13 23:30:00+00,10928,1696,5102,5345,647,2838,2870,83,0,114,29623,234,13964,11094,5992,12624
2021-12-14 00:00:00+00,10317,1503,5101,5314,588,3102,2766,83,0,0,28774,230,13769,11003,5902,11820
2021-12-14 00:30:00+00,10637,1456,5102,5514,499,3224,2723,83,0,0,29238,231,13838,11115,6013,12093
2021-12-14 01:00:00+00,10179,1478,5104,5530,499,3504,2801,83,0,0,29178,230,13934,11133,6029,11657
2021-12-14 01:30:00+00,9798,1464,5104,5598,499,3480,2795,83,0,0,28821,227,13996,11201,6097,11262
2021-12-14 02:00:00+00,10003,1448,5107,5829,498,3600,2734,83,0,0,29302,227,14168,11434,6327,11451
2021-12-14 02:30:00+00,9656,1440,5105,6152,497,3546,2771,83,0,0,29250,222,14525,11754,6649,11096
2021-12-14 03:00:00+00,9794,1337,5110,6412,498,3258,2797,83,0,0,29289,219,14817,12020,6910,11131
2021-12-14 03:30:00+00,9385,1245,5107,6669,499,3044,2801,92,0,0,28842,210,15076,12275,7168,10630
2021-12-14 04:00:00+00,9103,1211,5105,7242,543,2536,2812,95,0,0,28647,204,15702,12890,7785,10314
2021-12-14 04:30:00+00,9394,1162,5108,7042,519,2462,2813,111,0,0,28611,205,15482,12669,7561,10556
2021-12-14 05:00:00+00,10071,1260,5104,7385,523,2274,2816,84,0,0,29517,211,15828,13012,7908,11331
2021-12-14 05:30:00+00,10670,1237,5109,8019,524,2242,2822,94,0,0,30717,209,16474,13652,8543,11907
2021-12-14 06:00:00+00,11378,1226,5109,8383,571,2330,2822,84,0,0,31903,211,16885,14063,8954,12604
2021-12-14 06:30:00+00,13726,1326,5107,8560,571,2346,2815,89,0,0,34540,225,17053,14238,9131,15052
2021-12-14 07:00:00+00,15940,1430,5106,8805,568,2174,2875,93,0,0,36991,234,17354,14479,9373,17370
2021-12-14 07:30:00+00,17592,1479,5103,8880,581,2226,2889,115,0,204,39069,241,17453,14564,9461,19071
2021-12-14 08:00:00+00,18722,1466,5108,8847,765,2046,2884,324,1,160,40323,244,17605,14721,9613,20188
2021-12-14 08:30:00+00,18774,1369,5109,9170,816,2046,2884,418,66,148,40800,240,18045,15161,10052,20143
2021-12-14 09:00:00+00,19026,1424,5105,9299,616,2128,2892,443,242,174,41349,240,18154,15262,10157,20450
2021-12-14 09:30:00+00,19075,1430,5106,9137,614,2110,2894,507,574,170,41617,239,18325,15431,10325,20505
2021-12-14 10:00:00+00,19087,1424,5104,9395,596,1466,2905,521,909,266,41673,234,18909,16004,10900,20511
2021-12-14 10:30:00+00,19081,1426,5104,9414,580,1798,2898,437,1054,300,42092,233,19050,16152,11048,20507
2021-12-14 11:00:00+00,18479,1250,5103,9910,573,2186,2893,131,1258,290,42073,224,19737,16844,11741,19729
2021-12-14 11:30:00+00,17913,1329,5105,10566,574,2252,2894,77,1244,0,41954,221,20383,17489,12384,19242
2021-12-14 12:00:00+00,18075,1053,5104,10774,571,2448,2890,58,1163,44,42180,219,20502,17612,12508,19128
2021-12-14 12:30:00+00,17850,1053,5104,11089,553,2432,2891,50,1090,0,42112,217,20727,17836,12732,18903
2021-12-14 13:00:00+00,17452,1444,5109,11626,565,2752,2882,60,886,0,42776,220,21068,18186,13077,18896
2021-12-14 13:30:00+00,16782,1431,5108,11877,551,2802,2884,64,825,0,42324,216,21245,18361,13253,18213
2021-12-14 14:00:00+00,17200,1346,5107,11916,526,2516,2877,65,586,56,42195,218,21012,18135,13028,18546
2021-12-14 14:30:00+00,16722,1040,5105,12129,527,2510,2888,66,206,0,41193,212,20855,17967,12862,17762
2021-12-14 15:00:00+00,16569,823,5108,12303,551,2442,2932,175,45,0,40948,207,20939,18007,12899,17392
2021-12-14 15:30:00+00,16777,932,5104,12701,562,2444,2937,205,1,302,41965,207,21305,18368,13264,17709
2021-12-14 16:00:00+00,17725,1252,5106,12762,601,2300,2937,280,0,508,43471,211,21406,18469,13363,18977
2021-12-14 16:30:00+00,18488,1438,5105,12707,632,2284,2944,422,0,738,44758,217,21388,18444,13339,19926
2021-12-14 17:00:00+00,18601,1517,5103,12511,634,2366,2954,637,0,976,45299,218,21202,18248,13145,20118
2021-12-14 17:30:00+00,18749,1765,5105,12525,628,2202,2920,606,0,684,45184,223,21178,18258,13153,20514
2021-12-14 18:00:00+00,18333,1651,5112,12791,618,2642,2927,569,0,432,45075,220,21448,18521,13409,19984
2021-12-14 18:30:00+00,17761,1466,5107,13216,602,2576,2927,443,0,78,44176,214,21852,18925,13818,19227
2021-12-14 19:00:00+00,16688,1412,5112,13209,565,2528,2930,227,0,98,42769,208,21816,18886,13774,18100
2021-12-14 19:30:00+00,15886,1231,5110,13101,533,2616,2930,129,0,72,41608,202,21674,18744,13634,17117
2021-12-14 20:00:00+00,14747,1220,5110,13200,469,3076,2929,161,0,186,41098,199,21708,18779,13669,15967
2021-12-14 20:30:00+00,13417,1188,5112,13289,476,3092,2930,179,0,2,39685,192,21807,18877,13765,14605
2021-12-14 21:00:00+00,11886,991,5104,13027,483,3236,2927,88,0,208,37950,182,21541,18614,13510,12877
2021-12-14 21:30:00+00,10003,1124,5108,13232,481,3156,2927,56,0,38,36125,173,21748,18821,13713,11127
2021-12-14 22:00:00+00,8825,848,5104,12976,474,3106,2976,56,0,96,34461,161,21530,18554,13450,9673
2021-12-14 22:30:00+00,7623,396,5105,13001,466,3090,2981,64,0,46,32772,142,21553,18572,13467,8019
2021-12-14 23:00:00+00,5762,233,5100,12943,450,3586,2975,54,0,0,31103,124,21468,18493,13393,5995
2021-12-14 23:30:00+00,4950,235,5100,12926,451,3514,2975,56,0,0,30207,116,21452,18477,13377,5185
2021-12-15 00:00:00+00,4745,233,5104,12807,450,3616,2957,105,0,0,30017,116,21318,18361,13257,4978
2021-12-15 00:30:00+00,5192,239,5095,12805,451,3636,2977,130,0,0,30525,121,21328,18351,13256,5431
2021-12-15 01:00:00+00,5306,232,5101,12608,449,3548,2961,132,0,0,30337,122,21119,18158,13057,5538
2021-12-15 01:30:00+00,5052,233,5096,12465,446,3476,2973,135,0,0,29876,120,20980,18007,12911,5285
2021-12-15 02:00:00+00,4657,234,5099,12303,444,3574,2970,119,0,0,29400,117,20816,17846,12747,4891
2021-12-15 02:30:00+00,4325,239,5093,12288,444,3522,2976,122,0,0,29009,114,20801,17825,12732,4564
2021-12-15 03:00:00+00,4760,233,5099,12285,444,3002,2960,122,0,0,28905,118,20788,17828,12729,4993
2021-12-15 03:30:00+00,4432,230,5106,12377,441,2844,2950,123,0,0,28503,112,20874,17924,12818,4662
2021-12-15 04:00:00+00,4531,242,5100,12389,433,2332,2979,121,0,0,28127,111,20901,17922,12822,4773
2021-12-15 04:30:00+00,4957,232,5108,12307,427,2384,2963,120,0,0,28498,116,20805,17842,12734,5189
2021-12-15 05:00:00+00,5778,237,5105,12181,426,2226,2962,120,0,0,29035,124,20674,17712,12607,6015
2021-12-15 05:30:00+00,6632,233,5102,12012,442,2246,2968,115,0,0,29750,132,20524,17556,12454,6865
2021-12-15 06:00:00+00,8856,371,5105,12089,462,2372,2965,114,0,0,32334,154,20621,17656,12551,9227
2021-12-15 06:30:00+00,10950,531,5105,12481,462,2292,2966,115,0,0,34902,170,21014,18048,12943,11481
2021-12-15 07:00:00+00,14264,725,5099,12404,463,1550,2983,122,0,308,37918,187,20949,17966,12867,14989
2021-12-15 07:30:00+00,15648,908,5103,12374,463,1352,3000,324,0,380,39552,197,20940,17940,12837,16556
2021-12-15 08:00:00+00,16220,1087,5100,12298,462,1846,2999,416,0,36,40464,208,20859,17860,12760,17307
2021-12-15 08:30:00+00,16168,1169,5103,12302,450,1926,3000,324,78,22,40542,208,20933,17933,12830,17337
2021-12-15 09:00:00+00,16879,1209,5098,12015,463,2066,3001,137,391,356,41615,209,20968,17967,12869,18088
2021-12-15 09:30:00+00,17335,1442,5103,11565,524,1972,3004,129,775,180,42029,216,20971,17967,12864,18777
2021-12-15 10:00:00+00,17538,1754,5103,11108,538,1496,2980,198,1208,240,42163,220,20937,17957,12854,19292
2021-12-15 10:30:00+00,17906,1727,5104,11026,510,1424,2960,232,1459,52,42400,221,21059,18099,12995,19633
2021-12-15 11:00:00+00,17965,1729,5103,10917,523,1488,2957,265,1495,42,42484,223,20995,18038,12935,19694
2021-12-15 11:30:00+00,17765,1879,5104,10894,532,1694,2948,263,1667,34,42780,225,21145,18197,13093,19644
2021-12-15 12:00:00+00,17794,1745,5106,10713,540,1918,2873,243,1528,50,42510,224,20760,17887,12781,19539
2021-12-15 12:30:00+00,18211,1507,5108,10360,557,1812,2960,128,1216,158,42017,223,20201,17241,12133,19718
2021-12-15 13:00:00+00,18320,1321,5107,10521,596,1900,2960,212,1040,136,42113,220,20224,17264,12157,19641
2021-12-15 13:30:00+00,18247,1317,5112,10546,567,1858,2951,231,830,0,41659,222,20006,17055,11943,19564
2021-12-15 14:00:00+00,17684,1189,5111,10447,582,2472,2761,177,520,88,41031,219,19421,16660,11549,18873
2021-12-15 14:30:00+00,17856,1186,5113,10268,591,2558,2852,157,299,0,40880,222,19123,16271,11158,19042
2021-12-15 15:00:00+00,18194,1141,5105,9952,590,2152,2713,141,71,0,40059,225,18431,15718,10613,19335
2021-12-15 15:30:00+00,18374,1188,5105,9800,601,2148,2740,164,2,552,40674,224,18248,15508,10403,19562
2021-12-15 16:00:00+00,18752,1086,5100,9480,747,3426,2668,279,0,1098,42636,220,17995,15327,10227,19838
2021-12-15 16:30:00+00,19784,1073,5106,8932,829,3340,2796,536,0,1184,43580,225,17663,14867,9761,20857
2021-12-15 17:00:00+00,19455,1113,5105,8715,885,3790,2863,688,0,736,43350,225,17568,14705,9600,20568
2021-12-15 17:30:00+00,19369,1203,5096,7954,951,3804,2897,683,0,1326,43283,227,16898,14001,8905,20572
2021-12-15 18:00:00+00,19042,1427,5100,7546,954,3878,2940,631,0,1338,42856,234,16540,13600,8500,20469
2021-12-15 18:30:00+00,18822,1468,5099,7322,956,3936,2955,499,0,1352,42409,235,16332,13377,8278,20290
2021-12-15 19:00:00+00,18935,1465,5101,6936,937,3724,2894,446,0,662,41100,247,15868,12974,7873,20400
2021-12-15 19:30:00+00,18675,1465,5101,6708,938,3810,2892,202,0,174,39965,251,15639,12747,7646,20140
2021-12-15 20:00:00+00,17934,1466,5105,6754,880,3740,2855,142,0,192,39068,247,15594,12740,7634,19400
2021-12-15 20:30:00+00,16697,1407,5102,6502,875,3706,2847,138,0,246,37520,243,15326,12479,7377,18104
2021-12-15 21:00:00+00,16531,1064,5104,6170,681,3242,2858,134,0,256,36040,241,14813,11955,6851,17595
2021-12-15 21:30:00+00,15669,689,5100,5925,623,3208,2864,135,0,0,34213,234,14512,11648,6548,16358
2021-12-15 22:00:00+00,14177,690,5102,5810,626,3100,2900,134,0,0,32539,229,14438,11538,6436,14867
2021-12-15 22:30:00+00,13890,703,5097,5497,529,3020,2761,134,0,46,31676,230,13884,11123,6026,14592
2021-12-15 23:00:00+00,13600,892,5102,4821,480,3016,2529,131,0,0,30571,239,12932,10403,5301,14492
2021-12-15 23:30:00+00,13698,750,5097,4410,446,2966,2574,137,0,0,30078,240,12527,9953,4856,14448
2021-12-16 00:00:00+00,14085,731,5098,4149,449,2952,2600,134,0,0,30198,245,12296,9696,4598,14816
2021-12-16 00:30:00+00,13865,842,5092,3951,450,3090,2611,136,0,0,30037,249,12104,9493,4401,14707
2021-12-16 01:00:00+00,13609,721,5094,3834,449,3270,2598,136,0,0,29711,246,11975,9377,4283,14330
2021-12-16 01:30:00+00,13579,688,5099,3590,404,3042,2572,134,0,0,29108,246,11665,9093,3994,14267
2021-12-16 02:00:00+00,13212,689,5094,3435,384,3116,2548,135,0,0,28613,247,11461,8913,3819,13901
2021-12-16 02:30:00+00,12946,689,5094,3346,383,3154,2510,136,0,0,28258,247,11333,8823,3729,13635
2021-12-16 03:00:00+00,12615,688,5095,3258,383,3198,2546,136,0,0,27919,246,11282,8736,3641,13303
2021-12-16 03:30:00+00,12209,690,5100,3221,399,3100,2622,136,0,0,27477,243,11342,8720,3620,12899
2021-12-16 04:00:00+00,12657,687,5103,3346,400,2602,2600,136,0,0,27531,247,11449,8849,3746,13344
2021-12-16 04:30:00+00,13020,800,5158,3170,399,2348,2507,135,0,0,27537,252,11234,8727,3569,13820
2021-12-16 05:00:00+00,15225,1109,5162,3102,410,1178,2515,181,0,0,28882,264,11189,8674,3512,16334
2021-12-16 05:30:00+00,16541,1491,5164,3130,407,1254,2426,166,0,0,30579,278,11127,8701,3537,18032
2021-12-16 06:00:00+00,19140,1778,5164,3105,442,1134,2273,136,0,0,33172,293,10984,8711,3547,20918
2021-12-16 06:30:00+00,21394,1860,5166,3112,475,1134,2531,141,0,0,35813,299,11284,8753,3587,23254
2021-12-16 07:00:00+00,22471,1870,5160,3040,700,1190,2748,155,0,270,37604,298,11648,8900,3740,24341
2021-12-16 07:30:00+00,23362,1959,5160,3132,714,1414,2738,316,0,402,39197,301,11744,9006,3846,25321
2021-12-16 08:00:00+00,23054,1798,5159,3289,781,1596,2684,392,0,236,38989,297,11913,9229,4070,24852
2021-12-16 08:30:00+00,23146,1846,5162,3153,799,1684,2744,383,32,286,39235,298,11890,9146,3984,24992
2021-12-16 09:00:00+00,23012,1962,5160,3084,781,2322,2754,396,193,108,39772,298,11972,9218,4058,24974
2021-12-16 09:30:00+00,22921,1964,5162,3172,663,2324,2729,485,467,124,40011,296,12193,9464,4302,24885
2021-12-16 10:00:00+00,22917,1962,5163,3265,590,2206,2752,483,713,462,40513,292,12483,9731,4568,24879
2021-12-16 10:30:00+00,22744,1964,5176,3355,689,2124,2739,521,907,418,40637,289,12866,10127,4951,24708
2021-12-16 11:00:00+00,22701,1922,5198,3397,556,1986,2738,463,1118,134,40213,290,13007,10269,5071,24623
2021-12-16 11:30:00+00,22639,1918,5213,3635,536,1956,2744,551,1142,40,40374,288,13270,10526,5313,24557
2021-12-16 12:00:00+00,22098,1875,5239,3808,530,3186,2791,350,1159,0,41036,279,13527,10736,5497,23973
2021-12-16 12:30:00+00,21937,1888,5270,3668,557,3366,2886,302,1067,36,40977,280,13448,10562,5292,23825
2021-12-16 13:00:00+00,21014,1771,5274,3407,566,4408,2867,324,998,102,40731,273,13112,10245,4971,22785
2021-12-16 13:30:00+00,21084,1444,5283,3299,567,4552,2878,531,917,118,40673,269,12944,10066,4783,22528
2021-12-16 14:00:00+00,20991,1455,5286,3236,655,4518,2880,560,621,0,40202,272,12678,9798,4512,22446
2021-12-16 14:30:00+00,20934,1464,5284,3067,650,4470,2820,452,270,0,39411,276,12091,9271,3987,22398
2021-12-16 15:00:00+00,20761,1487,5281,3141,712,4570,2521,634,67,250,39424,276,11722,9201,3920,22248
2021-12-16 15:30:00+00,21332,1473,5279,3077,684,4512,2100,516,2,1212,40187,273,11142,9042,3763,22805
2021-12-16 16:00:00+00,22335,1386,5277,3128,880,4922,2107,581,0,1406,42022,276,11392,9285,4008,23721
2021-12-16 16:30:00+00,22727,1266,5278,3140,885,4856,2152,680,0,2068,43052,272,11455,9303,4025,23993
2021-12-16 17:00:00+00,22827,1184,5304,3136,854,4774,2228,953,0,1836,43096,273,11522,9294,3990,24011
2021-12-16 17:30:00+00,22940,1105,5309,2979,825,4776,2306,1013,0,1978,43231,272,11419,9113,3804,24045
2021-12-16 18:00:00+00,22946,906,5334,2899,731,4778,2399,956,0,1884,42833,270,11363,8964,3630,23852
2021-12-16 18:30:00+00,22676,983,5342,2969,721,4778,2403,792,0,1960,42624,270,11435,9032,3690,23659
2021-12-16 19:00:00+00,22335,995,5338,2923,714,4494,2375,784,0,1102,41060,271,11350,8975,3637,23330
2021-12-16 19:30:00+00,22013,996,5343,2938,697,4604,2369,666,0,728,40354,273,11347,8978,3635,23009
2021-12-16 20:00:00+00,21670,996,5341,2897,500,4250,2373,649,0,468,39144,270,11111,8738,3397,22666
2021-12-16 20:30:00+00,20587,995,5341,2966,486,4430,2372,421,0,340,37938,268,11165,8793,3452,21582
2021-12-16 21:00:00+00,19515,968,5346,2907,468,4702,2376,237,0,38,36557,273,11097,8721,3375,20483
2021-12-16 21:30:00+00,18129,966,5346,2837,464,4426,2371,148,0,0,34687,268,11018,8647,3301,19095
2021-12-16 22:00:00+00,17991,980,5346,2732,447,3372,2374,141,0,6,33389,276,10899,8525,3179,18971
2021-12-16 22:30:00+00,16740,979,5350,2668,442,3240,2382,149,0,0,31950,271,10842,8460,3110,17719
2021-12-16 23:00:00+00,16334,882,5348,2456,437,2638,2250,134,0,16,30495,271,10491,8241,2893,17216
2021-12-16 23:30:00+00,15911,664,5349,2382,429,2566,2188,133,0,0,29622,265,10348,8160,2811,16575
2021-12-17 00:00:00+00,15551,802,5348,2437,373,2888,2169,132,0,0,29700,267,10327,8158,2810,16353
2021-12-17 00:30:00+00,15992,910,5350,2275,369,3032,2167,133,0,0,30228,273,10161,7994,2644,16902
2021-12-17 01:00:00+00,15491,928,5358,2305,363,3058,2143,137,0,0,29783,272,10169,8026,2668,16419
2021-12-17 01:30:00+00,15342,817,5355,2195,357,2970,2159,140,0,0,29334,269,10066,7907,2552,16159
2021-12-17 02:00:00+00,15322,560,5359,2142,348,2850,2062,141,0,0,28784,264,9911,7849,2490,15882
2021-12-17 02:30:00+00,15355,460,5357,2021,347,2860,2016,143,0,0,28559,264,9741,7725,2368,15815
2021-12-17 03:00:00+00,15412,467,5355,1707,344,2830,2053,142,0,0,28310,266,9459,7406,2051,15879
2021-12-17 03:30:00+00,15375,466,5352,1545,344,2720,2169,142,0,0,28113,266,9410,7241,1889,15841
2021-12-17 04:00:00+00,15600,624,5360,1455,379,2362,2160,151,0,0,28091,273,9354,7194,1834,16224
2021-12-17 04:30:00+00,15871,829,5359,1395,382,2484,2173,138,0,0,28631,280,9309,7136,1777,16700
2021-12-17 05:00:00+00,16595,1108,5361,1360,396,1292,2168,134,0,0,28414,287,9285,7117,1756,17703
2021-12-17 05:30:00+00,17477,1300,5360,1327,396,1290,2109,132,0,0,29391,295,9192,7083,1723,18777
2021-12-17 06:00:00+00,18775,1475,5359,1287,402,1432,2155,138,0,0,31023,304,9203,7048,1689,20250
2021-12-17 06:30:00+00,19941,1441,5358,1199,402,1578,2251,135,0,116,32421,306,9210,6959,1601,21382
2021-12-17 07:00:00+00,21039,1328,5357,1156,572,2028,2379,161,0,66,34086,305,9464,7085,1728,22367
2021-12-17 07:30:00+00,21624,1416,5359,1113,707,2186,2382,360,0,808,35955,301,9561,7179,1820,23040
2021-12-17 08:00:00+00,22017,1238,5355,1109,779,3968,2349,317,0,456,37588,289,9592,7243,1888,23255
2021-12-17 08:30:00+00,22299,1404,5351,1094,831,4214,2385,404,77,108,38168,294,9738,7353,2002,23703
2021-12-17 09:00:00+00,22482,1570,5352,1187,875,4112,2412,416,348,110,38863,295,10174,7762,2410,24052
2021-12-17 09:30:00+00,22533,1790,5351,1265,882,4088,2431,304,684,330,39658,293,10613,8182,2831,24323
2021-12-17 10:00:00+00,22593,1952,5354,1257,869,4512,2425,278,999,272,40511,292,10904,8479,3125,24545
2021-12-17 10:30:00+00,22632,1904,5356,1155,849,4476,2441,296,1300,332,40741,290,11101,8660,3304,24536
2021-12-17 11:00:00+00,22842,1918,5359,1172,854,4136,2457,461,1493,142,40834,294,11335,8878,3519,24760
2021-12-17 11:30:00+00,22820,1941,5357,1236,838,4160,2437,490,1529,44,40852,295,11397,8960,3603,24761
2021-12-17 12:00:00+00,22783,1967,5357,1282,840,4828,2400,469,1524,86,41536,293,11403,9003,3646,24750
2021-12-17 12:30:00+00,22598,2004,5360,1341,845,4838,2374,335,1466,106,41267,293,11386,9012,3652,24602
2021-12-17 13:00:00+00,22059,2008,5362,1356,853,4902,2368,291,1344,342,40885,290,11283,8915,3553,24067
2021-12-17 13:30:00+00,21751,2010,5360,1311,857,4904,2364,341,1048,436,40382,291,10940,8576,3216,23761
2021-12-17 14:00:00+00,22106,2009,5363,1213,870,4788,2351,292,669,436,40097,296,10466,8115,2752,24115
2021-12-17 14:30:00+00,22257,1910,5364,1324,830,4782,2368,269,318,306,39728,298,10204,7836,2472,24167
2021-12-17 15:00:00+00,22169,1740,5364,1390,846,4982,2373,268,89,382,39603,296,10062,7689,2325,23909
2021-12-17 15:30:00+00,22089,1732,5360,1549,848,4990,2377,238,3,1108,40294,290,10137,7760,2400,23821
2021-12-17 16:00:00+00,22626,1513,5362,1740,924,5670,2377,399,0,1424,42035,286,10403,8026,2664,24139
2021-12-17 16:30:00+00,22798,1424,5357,1920,947,5596,2397,609,0,1864,42912,282,10621,8224,2867,24222
2021-12-17 17:00:00+00,22729,1286,5353,2120,982,5518,2360,813,0,2004,43165,277,10815,8455,3102,24015
2021-12-17 17:30:00+00,22580,1137,5356,2388,1001,5518,2360,734,0,2004,43078,272,11105,8745,3389,23717
2021-12-17 18:00:00+00,22469,1202,5356,2629,968,4962,2364,758,0,2154,42862,268,11317,8953,3597,23671
2021-12-17 18:30:00+00,22312,995,5358,2674,902,4878,2405,505,0,1996,42025,263,11339,8934,3576,23307
2021-12-17 19:00:00+00,22110,980,5361,2665,873,4908,2408,515,0,1078,40898,268,11307,8899,3538,23090
2021-12-17 19:30:00+00,21374,978,5356,2745,856,4990,2410,309,0,450,39468,270,11367,8957,3601,22352
2021-12-17 20:00:00+00,20887,979,5358,2783,547,4808,2378,201,0,292,38233,272,11066,8688,3330,21866
2021-12-17 20:30:00+00,19895,977,5357,2793,501,4776,2378,190,0,128,36995,270,11029,8651,3294,20872
2021-12-17 21:00:00+00,18525,925,5359,2694,472,4848,2363,175,0,142,35503,271,10888,8525,3166,19450
2021-12-17 21:30:00+00,18008,829,5360,2574,464,4616,2241,166,0,0,34258,270,10639,8398,3038,18837
2021-12-17 22:00:00+00,18098,509,5366,2574,403,3404,2322,160,0,50,32886,267,10665,8343,2977,18607
2021-12-17 22:30:00+00,16753,348,5361,2600,387,3334,2211,174,0,32,31200,259,10559,8348,2987,17101
2021-12-17 23:00:00+00,13768,20,5357,2666,385,4706,2104,171,0,18,29195,228,10512,8408,3051,13788
2021-12-17 23:30:00+00,13011,0,5360,2647,383,4676,1944,164,0,8,28193,222,10334,8390,3030,13011
2021-12-18 00:00:00+00,12772,0,5355,2583,352,4614,1912,168,0,0,27756,219,10202,8290,2935,12772
2021-12-18 00:30:00+00,12984,0,5351,2625,344,4742,1917,163,0,64,28190,220,10237,8320,2969,12984
2021-12-18 01:00:00+00,13084,0,5354,2694,314,5068,1908,161,0,0,28583,222,10270,8362,3008,13084
2021-12-18 01:30:00+00,12860,0,5354,2743,313,4938,1901,164,0,0,28273,219,10311,8410,3056,12860
2021-12-18 02:00:00+00,12520,0,5358,2814,293,4648,1896,163,0,0,27692,220,10361,8465,3107,12520
2021-12-18 02:30:00+00,12311,0,5352,2719,294,4660,1891,163,0,0,27390,219,10256,8365,3013,12311
2021-12-18 03:00:00+00,12263,0,5360,2533,293,4714,1999,172,0,0,27334,221,10185,8186,2826,12263
2021-12-18 03:30:00+00,12021,0,5360,2483,290,4622,1909,172,0,0,26857,219,10042,8133,2773,12021
2021-12-18 04:00:00+00,12179,0,5364,2414,285,4230,1595,221,0,0,26288,226,9658,8063,2699,12179
2021-12-18 04:30:00+00,12216,0,5358,2428,285,4168,1604,197,0,0,26256,226,9675,8071,2713,12216
2021-12-18 05:00:00+00,12560,0,5363,2373,333,3906,1591,199,0,0,26325,231,9660,8069,2706,12560
2021-12-18 05:30:00+00,13172,0,5364,2312,342,3888,1602,173,0,0,26853,235,9620,8018,2654,13172
2021-12-18 06:00:00+00,13915,0,5368,2371,393,3462,1604,169,0,0,27282,238,9736,8132,2764,13915
2021-12-18 06:30:00+00,14760,0,5368,2469,406,3548,1551,162,0,0,28264,243,9794,8243,2875,14760
2021-12-18 07:00:00+00,16705,0,5370,2560,469,2792,1404,160,0,0,29460,257,9803,8399,3029,16705
2021-12-18 07:30:00+00,17602,139,5366,2572,509,2928,1406,160,0,14,30696,264,9853,8447,3081,17741
2021-12-18 08:00:00+00,17938,228,5368,2632,739,3908,1446,178,0,0,32437,258,10185,8739,3371,18166
2021-12-18 08:30:00+00,18960,231,5367,2625,740,4192,1519,170,33,46,33883,262,10284,8765,3398,19191
2021-12-18 09:00:00+00,19262,337,5363,2523,760,4974,1518,165,201,164,35267,260,10365,8847,3484,19599
2021-12-18 09:30:00+00,19648,622,5361,2431,759,4948,1568,169,454,284,36244,264,10573,9005,3644,20270
2021-12-18 10:00:00+00,19673,837,5365,2453,754,4844,1579,343,711,232,36791,268,10862,9283,3918,20510
2021-12-18 10:30:00+00,19887,908,5361,2420,774,4864,1541,419,927,102,37203,270,11023,9482,4121,20795
2021-12-18 11:00:00+00,19961,1071,5363,2311,769,5534,1518,242,1083,248,38100,269,11044,9526,4163,21032
2021-12-18 11:30:00+00,20331,1278,5362,2215,750,5600,1522,205,1170,0,38433,276,11019,9497,4135,21609
2021-12-18 12:00:00+00,20586,1467,5363,2132,737,5030,1587,209,1247,40,38398,283,11066,9479,4116,22053
2021-12-18 12:30:00+00,20470,1475,5363,2089,737,5010,1589,219,1241,4,38197,283,11019,9430,4067,21945
2021-12-18 13:00:00+00,20548,1474,5364,1971,737,5136,1570,208,1157,12,38177,284,10799,9229,3865,22022
2021-12-18 13:30:00+00,20682,1473,5381,1838,737,4990,1553,205,1022,0,37881,286,10531,8978,3597,22155
2021-12-18 14:00:00+00,21016,1478,5389,1860,739,4374,1582,205,789,162,37594,288,10359,8777,3388,22494
2021-12-18 14:30:00+00,20958,1474,5397,1852,765,4510,1555,204,462,152,37329,291,10031,8476,3079,22432
2021-12-18 15:00:00+00,21082,1476,5410,1833,792,4938,1549,296,148,56,37580,291,9732,8183,2773,22558
2021-12-18 15:30:00+00,21210,1477,5424,1827,793,5078,1538,425,7,158,37937,292,9589,8051,2627,22687
2021-12-18 16:00:00+00,20941,1476,5435,1906,827,5226,1541,483,0,1112,38947,284,9709,8168,2733,22417
2021-12-18 16:30:00+00,21745,1477,5456,1900,846,5356,1540,622,0,1534,40476,284,9742,8202,2746,23222
2021-12-18 17:00:00+00,21977,1474,5456,1909,846,5556,1540,932,0,1762,41452,281,9751,8211,2755,23451
2021-12-18 17:30:00+00,22108,1477,5451,1848,847,5518,1553,882,0,1838,41522,281,9699,8146,2695,23585
2021-12-18 18:00:00+00,22304,1476,5461,1817,849,5556,1523,757,0,1174,40917,287,9650,8127,2666,23780
2021-12-18 18:30:00+00,21824,1477,5469,1796,839,5380,1574,545,0,834,39738,287,9678,8104,2635,23301
2021-12-18 19:00:00+00,21404,1342,5473,1780,813,5294,1778,223,0,268,38375,289,9844,8066,2593,22746
2021-12-18 19:30:00+00,21007,870,5471,1734,794,5114,2012,168,0,0,37170,280,10011,7999,2528,21877
2021-12-18 20:00:00+00,20963,402,5469,1694,669,4824,2119,163,0,268,36571,273,9951,7832,2363,21365
2021-12-18 20:30:00+00,20479,32,5473,1653,654,4626,2154,161,0,54,35286,265,9934,7780,2307,20511
2021-12-18 21:00:00+00,19230,0,5480,1528,470,4850,2169,163,0,158,34048,262,9647,7478,1998,19230
2021-12-18 21:30:00+00,18260,0,5490,1466,435,4888,2197,177,0,70,32983,260,9588,7391,1901,18260
2021-12-18 22:00:00+00,17745,0,5504,1471,362,4104,2159,174,0,44,31563,255,9496,7337,1833,17745
2021-12-18 22:30:00+00,16918,0,5505,1366,347,3782,2167,169,0,48,30302,250,9385,7218,1713,16918
2021-12-18 23:00:00+00,16064,0,5511,1307,330,3076,2152,165,0,84,28689,248,9300,7148,1637,16064
2021-12-18 23:30:00+00,14968,0,5517,1282,324,3176,2130,182,0,0,27579,244,9253,7123,1606,14968
2021-12-19 00:00:00+00,14603,0,5519,1291,312,3486,2087,161,0,0,27459,242,9209,7122,1603,14603
2021-12-19 00:30:00+00,14758,0,5517,1274,311,3578,2123,166,0,0,27727,244,9225,7102,1585,14758
2021-12-19 01:00:00+00,14736,0,5514,1201,311,3738,2127,161,0,0,27788,247,9153,7026,1512,14736
2021-12-19 01:30:00+00,14435,0,5511,1104,318,3616,2151,161,0,0,27296,245,9084,6933,1422,14435
2021-12-19 02:00:00+00,14626,0,5516,1062,298,3306,2166,173,0,0,27147,247,9042,6876,1360,14626
2021-12-19 02:30:00+00,14528,0,5512,1003,277,3174,2167,173,0,0,26834,247,8959,6792,1280,14528
2021-12-19 03:00:00+00,14787,0,5519,1009,275,2862,2059,173,0,0,26684,252,8862,6803,1284,14787
2021-12-19 03:30:00+00,14641,0,5513,1040,275,2822,2089,172,0,0,26552,250,8917,6828,1315,14641
2021-12-19 04:00:00+00,14660,0,5533,1078,265,2512,2170,156,0,0,26374,252,9046,6876,1343,14660
2021-12-19 04:30:00+00,14533,0,5533,1164,274,2512,2186,142,0,0,26344,251,9157,6971,1438,14533
2021-12-19 05:00:00+00,14405,0,5531,1277,332,2610,2288,142,0,0,26585,248,9428,7140,1609,14405
2021-12-19 05:30:00+00,14302,0,5546,1428,334,2744,2312,131,0,0,26797,246,9620,7308,1762,14302
2021-12-19 06:00:00+00,15025,0,5544,1403,346,2862,2329,131,0,0,27640,250,9622,7293,1749,15025
2021-12-19 06:30:00+00,15766,0,5548,1369,371,2928,2339,132,0,0,28453,255,9627,7288,1740,15766
2021-12-19 07:00:00+00,16167,0,5546,1308,421,2884,2407,136,0,0,28869,256,9682,7275,1729,16167
2021-12-19 07:30:00+00,16534,0,5551,1288,517,2922,2848,174,0,0,29834,255,10204,7356,1805,16534
2021-12-19 08:00:00+00,17022,0,5546,1303,563,3054,2916,136,2,0,30542,258,10330,7414,1868,17022
2021-12-19 08:30:00+00,18346,0,5550,1385,672,3010,2919,241,69,14,32206,261,10595,7676,2126,18346
2021-12-19 09:00:00+00,19196,0,5549,1556,665,3562,2919,247,271,0,33965,260,10960,8041,2492,19196
2021-12-19 09:30:00+00,20105,0,5548,1748,730,3540,2919,180,514,0,35284,260,11459,8540,2992,20105
2021-12-19 10:00:00+00,20207,0,5545,1781,729,4336,2874,180,775,58,36485,254,11704,8830,3285,20207
2021-12-19 10:30:00+00,20765,0,5544,1804,733,4366,2913,179,1048,0,37352,254,12042,9129,3585,20765
2021-12-19 11:00:00+00,20651,0,5548,1879,762,4850,2915,182,1183,0,37970,249,12287,9372,3824,20651
2021-12-19 11:30:00+00,20888,2,5546,1977,752,4850,2914,221,1252,0,38402,249,12441,9527,3981,20890
2021-12-19 12:00:00+00,21022,85,5564,2140,749,4892,2915,212,1190,0,38769,250,12558,9643,4079,21107
2021-12-19 12:30:00+00,20965,227,5585,2353,748,4822,2911,210,1154,28,39003,250,12751,9840,4255,21192
2021-12-19 13:00:00+00,21255,229,5583,2401,609,4686,2921,187,1025,14,38910,251,12539,9618,4035,21484
2021-12-19 13:30:00+00,21248,272,5584,2537,590,4586,2998,190,872,68,38945,251,12581,9583,3999,21520
2021-12-19 14:00:00+00,21446,394,5584,2612,603,4214,3002,223,634,0,38712,257,12435,9433,3849,21840
2021-12-19 14:30:00+00,21641,390,5610,2789,628,4160,3005,197,313,0,38733,258,12345,9340,3730,22031
2021-12-19 15:00:00+00,22280,479,5638,2878,749,3560,2953,365,79,14,38995,266,12297,9344,3706,22759
2021-12-19 15:30:00+00,22596,497,5642,2995,755,3680,2927,366,4,0,39462,268,12323,9396,3754,23093
2021-12-19 16:00:00+00,22676,485,5661,3388,839,4710,2954,308,0,356,41377,258,12842,9888,4227,23161
2021-12-19 16:30:00+00,22883,495,5669,3616,872,4820,2916,540,0,850,42661,255,13073,10157,4488,23378
2021-12-19 17:00:00+00,22704,498,5670,3770,1016,4678,2920,688,0,1196,43140,251,13376,10456,4786,23202
2021-12-19 17:30:00+00,22674,494,5665,3573,1021,4678,2948,701,0,1036,42790,253,13207,10259,4594,23168
2021-12-19 18:00:00+00,22546,497,5672,3445,1020,3828,2993,739,0,876,41616,259,13130,10137,4465,23043
2021-12-19 18:30:00+00,22522,496,5671,3362,1005,3766,2995,587,0,496,40900,262,13033,10038,4367,23018
2021-12-19 19:00:00+00,22745,499,5671,3442,834,3188,2996,378,0,22,39775,269,12943,9947,4276,23244
2021-12-19 19:30:00+00,21787,371,5673,3801,817,2970,2997,224,0,0,38640,261,13288,10291,4618,22158
2021-12-19 20:00:00+00,21077,40,5675,3861,662,3188,2999,132,0,0,37634,251,13197,10198,4523,21117
2021-12-19 20:30:00+00,19708,20,5672,3894,645,3074,2996,130,0,0,36139,245,13207,10211,4539,19728
2021-12-19 21:00:00+00,18881,0,5672,4022,441,2973,2998,133,0,14,35134,242,13133,10135,4463,18881
2021-12-19 21:30:00+00,17958,0,5697,4131,404,2896,2992,133,0,0,34211,237,13224,10232,4535,17958
2021-12-19 22:00:00+00,17903,0,5707,4029,387,2696,2994,134,0,0,33850,239,13117,10123,4416,17903
2021-12-19 22:30:00+00,16806,0,5705,3918,346,2672,2951,133,0,0,32531,235,12920,9969,4264,16806
2021-12-19 23:00:00+00,16086,0,5711,3806,290,1454,2657,129,0,0,30133,232,12464,9807,4096,16086
2021-12-19 23:30:00+00,15429,0,5715,3667,286,1334,2276,129,0,0,28836,230,11944,9668,3953,15429
2021-12-20 00:00:00+00,15094,0,5751,3578,256,1885,2250,130,0,0,28944,232,11835,9585,3834,15094
2021-12-20 00:30:00+00,15443,0,5767,3553,256,2036,2289,131,0,0,29475,235,11865,9576,3809,15443
2021-12-20 01:00:00+00,14651,0,5770,3417,255,2722,2278,135,0,0,29228,233,11720,9442,3672,14651
2021-12-20 01:30:00+00,14466,0,5767,3221,251,2614,2259,140,0,0,28718,232,11498,9239,3472,14466
2021-12-20 02:00:00+00,13919,0,5775,3021,216,2718,2233,142,0,0,28024,231,11245,9012,3237,13919
2021-12-20 02:30:00+00,13819,0,5777,2808,216,2760,2213,141,0,0,27734,233,11014,8801,3024,13819
2021-12-20 03:00:00+00,14327,0,5784,2747,207,2308,2213,140,0,0,27726,236,10951,8738,2954,14327
2021-12-20 03:30:00+00,14176,0,5784,2609,196,2186,2257,145,0,0,27353,235,10846,8589,2805,14176
2021-12-20 04:00:00+00,14220,64,5790,2496,194,2150,2236,140,0,0,27290,239,10716,8480,2690,14284
2021-12-20 04:30:00+00,14479,206,5817,2381,179,2138,2257,141,0,0,27598,245,10634,8377,2560,14685
2021-12-20 05:00:00+00,14977,498,5841,2267,360,2390,2286,130,0,0,28749,257,10754,8468,2627,15475
2021-12-20 05:30:00+00,15168,845,5843,2348,359,2396,2272,131,0,0,29362,266,10822,8550,2707,16013
2021-12-20 06:00:00+00,17954,1046,5844,2321,359,1316,2281,129,0,0,31250,281,10805,8524,2680,19000
2021-12-20 06:30:00+00,19843,1228,5846,2216,384,1300,2654,130,0,0,33601,290,11100,8446,2600,21071
2021-12-20 07:00:00+00,21299,1487,5844,2182,465,1396,2884,140,0,94,35791,296,11375,8491,2647,22786
2021-12-20 07:30:00+00,22741,1701,5842,2124,477,1598,2893,175,0,116,37667,304,11336,8443,2601,24442
2021-12-20 08:00:00+00,22877,1900,5844,2277,623,2972,2891,161,0,0,39545,307,11635,8744,2900,24777
2021-12-20 08:30:00+00,23616,1970,5842,2251,625,3126,2889,301,24,358,41002,307,11631,8742,2900,25586
2021-12-20 09:00:00+00,23931,1969,5844,2169,679,3480,2881,411,122,572,42058,305,11695,8814,2970,25900
2021-12-20 09:30:00+00,24098,1967,5858,2118,714,3516,2879,483,250,636,42519,304,11819,8940,3082,26065
2021-12-20 10:00:00+00,24199,1969,5895,2118,713,3548,2880,478,372,342,42514,305,11978,9098,3203,26168
2021-12-20 10:30:00+00,24410,1977,5888,2042,707,3488,2906,429,481,276,42604,305,12024,9118,3230,26387
2021-12-20 11:00:00+00,24382,1976,5889,2043,717,3380,3019,416,529,498,42849,304,12197,9178,3289,26358
2021-12-20 11:30:00+00,24300,1973,5896,1997,734,3412,3036,511,544,428,42831,304,12207,9171,3275,26273
2021-12-20 12:00:00+00,24514,2002,5905,1933,729,3180,2961,548,507,774,43053,304,12035,9074,3169,26516
2021-12-20 12:30:00+00,24584,2025,5938,1879,740,3168,2914,551,460,820,43079,305,11931,9017,3079,26609
2021-12-20 13:00:00+00,24485,2074,5943,1877,744,3536,2908,565,390,346,42868,307,11862,8954,3011,26559
2021-12-20 13:30:00+00,24612,2152,5945,1901,753,3584,2920,515,281,230,42893,310,11800,8880,2935,26764
2021-12-20 14:00:00+00,24704,2201,5944,1945,766,3528,2909,450,177,318,42942,310,11741,8832,2888,26905
2021-12-20 14:30:00+00,24285,2305,5949,1905,785,3616,2904,437,87,302,42575,311,11630,8726,2777,26590
2021-12-20 15:00:00+00,24004,2232,5947,1851,831,3050,2902,580,14,1478,42889,305,11545,8643,2696,26236
2021-12-20 15:30:00+00,23978,1598,5950,1909,866,3054,2904,643,0,1754,42656,293,11629,8725,2775,25576
2021-12-20 16:00:00+00,24094,1475,5953,1911,1012,3648,2905,661,0,1930,43589,285,11781,8876,2923,25569
2021-12-20 16:30:00+00,24167,1476,5957,1876,1073,3748,2952,891,0,1980,44120,285,11858,8906,2949,25643
2021-12-20 17:00:00+00,23503,1473,5986,1930,1048,4416,2899,1214,0,2336,44805,277,11863,8964,2978,24976
2021-12-20 17:30:00+00,23425,1475,5996,1920,1022,4500,2870,1222,0,2110,44540,278,11808,8938,2942,24900
2021-12-20 18:00:00+00,23811,1470,5996,1858,887,4174,2872,926,0,2088,44082,283,11613,8741,2745,25281
2021-12-20 18:30:00+00,23562,1472,5993,1904,848,4126,2868,766,0,2080,43619,282,11613,8745,2752,25034
2021-12-20 19:00:00+00,23878,1474,5993,1912,820,4048,2881,663,0,868,42537,293,11606,8725,2732,25352
2021-12-20 19:30:00+00,23573,1474,5990,1777,817,4004,2899,359,0,636,41529,295,11483,8584,2594,25047
2021-12-20 20:00:00+00,23396,1477,5991,1667,746,3734,2847,249,0,76,40183,301,11251,8404,2413,24873
2021-12-20 20:30:00+00,22526,1477,5993,1645,633,3528,2847,176,0,14,38839,300,11118,8271,2278,24003
2021-12-20 21:00:00+00,21802,1478,5991,1669,464,3174,2846,170,0,20,37614,300,10970,8124,2133,23280
2021-12-20 21:30:00+00,20366,1477,5986,1574,461,3042,2855,150,0,0,35911,296,10876,8021,2035,21843
2021-12-20 22:00:00+00,19315,1477,5989,1518,445,3052,2857,131,0,0,34784,294,10809,7952,1963,20792
2021-12-20 22:30:00+00,18123,1477,5994,1484,431,2996,2841,130,0,0,33476,291,10750,7909,1915,19600
2021-12-20 23:00:00+00,17365,1476,5991,1455,428,2788,2736,129,0,0,32368,290,10610,7874,1883,18841
2021-12-20 23:30:00+00,16400,1476,5994,1379,421,2624,2616,129,0,0,31039,287,10410,7794,1800,17876
2021-12-21 00:00:00+00,16629,1480,6027,1345,293,2428,2571,130,0,0,30903,288,10236,7665,1638,18109
2021-12-21 00:30:00+00,17092,1478,6049,1266,290,2510,2533,141,0,0,31359,291,10138,7605,1556,18570
2021-12-21 01:00:00+00,16669,1477,6045,1244,271,2720,2556,140,0,0,31122,290,10116,7560,1515,18146
2021-12-21 01:30:00+00,16191,1478,6053,1244,258,2744,2541,139,0,0,30648,289,10096,7555,1502,17669
2021-12-21 02:00:00+00,15841,1477,6050,1244,238,2676,2561,140,0,0,30227,289,10093,7532,1482,17318
2021-12-21 02:30:00+00,15595,1477,6043,1218,239,2594,2612,141,0,0,29919,287,10112,7500,1457,17072
2021-12-21 03:00:00+00,15508,1477,6047,1192,240,2506,2594,139,0,0,29703,286,10073,7479,1432,16985
2021-12-21 03:30:00+00,15356,1475,6043,1192,239,2434,2608,139,0,0,29486,285,10082,7474,1431,16831
2021-12-21 04:00:00+00,15950,1474,6070,1205,238,1508,2629,134,0,0,29208,284,10142,7513,1443,17424
2021-12-21 04:30:00+00,16196,1471,6073,1172,238,1404,2668,129,0,0,29351,285,10151,7483,1410,17667
2021-12-21 05:00:00+00,17700,1559,6072,1168,328,885,2826,153,0,0,30691,297,10394,7568,1496,19259
2021-12-21 05:30:00+00,18573,1770,6074,1193,327,878,2744,130,0,0,31689,304,10338,7594,1520,20343
2021-12-21 06:00:00+00,19443,1940,6075,1188,309,910,2755,128,0,0,32748,313,10327,7572,1497,21383
2021-12-21 06:30:00+00,20974,1975,6072,1254,312,936,2865,128,0,0,34516,316,10502,7638,1566,22949
2021-12-21 07:00:00+00,20957,1973,6075,1281,393,2012,2925,168,0,0,35784,316,10674,7749,1674,22930
2021-12-21 07:30:00+00,21493,1974,6067,1268,562,2282,2941,519,0,256,37362,314,10838,7897,1830,23467
2021-12-21 08:00:00+00,22507,1977,6102,1361,698,2502,2944,582,0,0,38673,310,11105,8161,2059,24484
2021-12-21 08:30:00+00,23539,1978,6106,1483,700,2560,2943,558,60,0,39927,311,11292,8349,2243,25517
2021-12-21 09:00:00+00,23532,1976,6104,1608,696,3492,2945,477,211,64,41105,305,11564,8619,2515,25508
2021-12-21 09:30:00+00,23913,1976,6121,1637,693,3498,2946,421,392,162,41759,303,11789,8843,2722,25889
2021-12-21 10:00:00+00,24341,1977,6130,1560,663,2920,3017,535,572,84,41799,305,11942,8925,2795,26318
2021-12-21 10:30:00+00,24284,1974,6149,1452,682,2946,3041,629,727,266,42150,303,12051,9010,2861,26258
2021-12-21 11:00:00+00,24388,1978,6172,1410,713,3624,3067,495,813,348,43008,304,12175,9108,2936,26366
2021-12-21 11:30:00+00,24542,1975,6195,1367,712,3652,3048,508,845,236,43080,305,12167,9119,2924,26517
2021-12-21 12:00:00+00,24624,1976,6186,1320,736,3550,3090,453,925,338,43198,305,12257,9167,2981,26600
2021-12-21 12:30:00+00,24595,1978,6218,1378,748,3548,3084,454,874,380,43257,304,12302,9218,3000,26573
2021-12-21 13:00:00+00,24650,1975,6215,1399,752,3348,3087,417,773,270,42886,306,12226,9139,2924,26625
2021-12-21 13:30:00+00,24407,1977,6220,1353,741,3330,3088,374,639,450,42579,306,12041,8953,2733,26384
2021-12-21 14:00:00+00,24588,1974,6260,1355,752,2792,3089,456,464,378,42108,308,11920,8831,2571,26562
2021-12-21 14:30:00+00,24184,2008,6326,1363,760,2786,3090,519,268,208,41512,310,11807,8717,2391,26192
2021-12-21 15:00:00+00,24469,2004,6349,1377,781,2462,3124,461,90,742,41859,308,11721,8597,2248,26473
2021-12-21 15:30:00+00,24523,2005,6361,1498,797,2454,3121,658,5,1110,42532,305,11782,8661,2300,26528
2021-12-21 16:00:00+00,24735,2007,6372,1626,839,3486,3122,690,0,728,43605,304,11959,8837,2465,26742
2021-12-21 16:30:00+00,24485,2005,6368,1723,858,3528,3123,913,0,1604,44607,296,12072,8949,2581,26490
2021-12-21 17:00:00+00,24252,2000,6361,1832,879,3962,3128,993,0,1626,45033,293,12200,9072,2711,26252
2021-12-21 17:30:00+00,23813,1999,6371,1816,916,3986,3131,968,0,1556,44556,291,12234,9103,2732,25812
2021-12-21 18:00:00+00,24313,2007,6369,1811,862,3700,3132,734,0,1352,44280,297,12174,9042,2673,26320
2021-12-21 18:30:00+00,24182,2008,6367,1947,814,3696,3125,683,0,1138,43960,298,12253,9128,2761,26190
2021-12-21 19:00:00+00,23517,2006,6368,2083,811,4264,3086,490,0,744,43369,296,12348,9262,2894,25523
2021-12-21 19:30:00+00,22880,1953,6367,2226,800,4262,3073,372,0,154,42087,298,12466,9393,3026,24833
2021-12-21 20:00:00+00,22596,1909,6365,2383,595,3674,3060,262,0,324,41168,299,12403,9343,2978,24505
2021-12-21 20:30:00+00,21660,1911,6368,2543,537,3670,3075,185,0,14,39963,298,12523,9448,3080,23571
2021-12-21 21:00:00+00,21234,1910,6369,2638,393,3628,3076,188,0,0,39436,297,12476,9400,3031,23144
2021-12-21 21:30:00+00,19792,1826,6029,2625,379,3628,3078,188,0,0,37545,294,12111,9033,3004,21618
2021-12-21 22:00:00+00,18181,1493,6364,2699,354,3648,3075,192,0,0,36006,280,12492,9417,3053,19674
2021-12-21 22:30:00+00,16186,1479,6370,2852,313,3650,3067,194,0,0,34111,272,12602,9535,3165,17665
2021-12-21 23:00:00+00,14737,1480,6365,2998,292,3362,3064,185,0,0,32483,266,12719,9655,3290,16217
2021-12-21 23:30:00+00,13519,1479,6374,3110,288,3268,3068,184,0,0,31290,260,12840,9772,3398,14998
2021-12-22 00:00:00+00,12943,1478,6375,3173,284,3470,3063,185,0,0,30971,256,12895,9832,3457,14421
2021-12-22 00:30:00+00,13370,1480,6371,3164,283,3528,3061,189,0,0,31446,259,12879,9818,3447,14850
2021-12-22 01:00:00+00,13255,1477,6371,3117,250,3598,3062,187,0,0,31317,258,12800,9738,3367,14732
2021-12-22 01:30:00+00,12796,1477,6375,3069,231,3534,3063,185,0,0,30730,256,12738,9675,3300,14273
2021-12-22 02:00:00+00,12397,1471,6413,3357,209,3376,3065,185,0,0,30473,253,13044,9979,3566,13868
2021-12-22 02:30:00+00,11899,1448,6468,3672,206,3386,3065,150,0,0,30294,247,13411,10346,3878,13347
2021-12-22 03:00:00+00,11820,1446,6461,3937,204,3122,3062,132,0,0,30184,243,13664,10602,4141,13266
2021-12-22 03:30:00+00,11209,1446,6460,4214,203,3120,3058,130,0,0,29840,238,13935,10877,4417,12655
2021-12-22 04:00:00+00,11776,1447,6459,4457,198,2408,3047,129,0,0,29921,240,14161,11114,4655,13223
2021-12-22 04:30:00+00,11767,1447,6458,4709,198,2402,3053,130,0,0,30164,238,14418,11365,4907,13214
2021-12-22 05:00:00+00,12603,1447,6455,4898,248,1704,3059,130,0,0,30544,235,14660,11601,5146,14050
2021-12-22 05:30:00+00,13557,1446,6462,4969,281,1670,3058,134,0,0,31577,240,14770,11712,5250,15003
2021-12-22 06:00:00+00,15878,1447,6463,5202,291,1254,3058,129,0,0,33722,250,15014,11956,5493,17325
2021-12-22 06:30:00+00,17554,1447,6463,5248,292,1214,3056,128,0,0,35402,257,15059,12003,5540,19001
2021-12-22 07:00:00+00,20113,1448,6456,5198,374,1064,3055,134,0,54,37896,266,15083,12028,5572,21561
2021-12-22 07:30:00+00,21561,1449,6460,5431,500,1024,3049,132,0,0,39606,269,15440,12391,5931,23010
2021-12-22 08:00:00+00,21920,1452,6459,5532,611,1786,3051,132,5,0,40948,272,15658,12607,6148,23372
2021-12-22 08:30:00+00,22289,1448,6464,5834,603,1902,3070,317,205,280,42412,269,16176,13106,6642,23737
2021-12-22 09:00:00+00,22247,1448,6467,6090,615,2530,3064,357,565,0,43383,267,16801,13737,7270,23695
2021-12-22 09:30:00+00,22117,1449,6464,6230,624,2540,3066,368,857,284,43999,262,17241,14175,7711,23566
2021-12-22 10:00:00+00,22405,1448,6460,6333,456,3062,3074,371,1102,332,45043,260,17425,14351,7891,23853
2021-12-22 10:30:00+00,22717,1449,6465,6388,450,3082,3083,367,1238,210,45449,261,17624,14541,8076,24166
2021-12-22 11:00:00+00,22861,1448,6474,6251,477,3130,3011,356,1102,288,45398,261,17315,14304,7830,24309
2021-12-22 11:30:00+00,22951,1449,6471,6482,458,3128,2815,341,945,370,45410,261,17171,14356,7885,24400
2021-12-22 12:00:00+00,22910,1450,6465,6289,442,3088,2867,333,824,936,45604,259,16887,14020,7555,24360
2021-12-22 12:30:00+00,22964,1480,6467,6406,449,2996,2868,342,700,874,45546,260,16890,14022,7555,24444
2021-12-22 13:00:00+00,23271,1480,6463,6349,512,2788,2866,354,633,694,45410,263,16823,13957,7494,24751
2021-12-22 13:30:00+00,23577,1477,6465,6200,537,2748,2857,344,514,204,44923,268,16573,13716,7251,25054
2021-12-22 14:00:00+00,23343,1480,6468,6429,594,2606,2862,340,335,156,44613,266,16688,13826,7358,24823
2021-12-22 14:30:00+00,22591,1481,6486,6825,628,2628,2863,368,224,100,44194,262,17026,14163,7677,24072
2021-12-22 15:00:00+00,22248,1479,6560,6861,748,2140,2852,547,99,1054,44588,258,17120,14268,7708,23727
2021-12-22 15:30:00+00,22056,1476,6471,6972,794,2230,2932,573,5,1472,44981,255,17174,14242,7771,23532
2021-12-22 16:00:00+00,22026,1471,6560,7192,859,2196,3081,574,0,1428,45387,251,17692,14611,8051,23497
2021-12-22 16:30:00+00,22180,1480,6559,7485,897,2188,3087,600,0,1604,46080,249,18028,14941,8382,23660
2021-12-22 17:00:00+00,22052,1484,6559,7657,896,2532,3085,712,0,1802,46779,244,18197,15112,8553,23536
2021-12-22 17:30:00+00,22011,1480,6562,7783,812,2450,3115,788,0,1686,46687,244,18272,15157,8595,23491
2021-12-22 18:00:00+00,22036,1480,6634,7646,737,2666,3114,464,0,1616,46393,244,18131,15017,8383,23516
2021-12-22 18:30:00+00,22138,1477,6662,7565,727,2660,3084,338,0,930,45581,248,18038,14954,8292,23615
2021-12-22 19:00:00+00,21993,1480,6661,7348,711,3032,3086,422,0,142,44875,253,17806,14720,8059,23473
2021-12-22 19:30:00+00,21331,1478,6659,7169,677,2900,3082,415,0,142,43853,252,17587,14505,7846,22809
2021-12-22 20:00:00+00,20264,1480,6658,7063,506,3000,3074,266,0,142,42453,250,17301,14227,7569,21744
2021-12-22 20:30:00+00,18673,1481,6657,7026,431,3190,3081,243,0,0,40782,246,17195,14114,7457,20154
2021-12-22 21:00:00+00,17622,1449,6657,6737,333,3432,3083,234,0,100,39647,245,16810,13727,7070,19071
2021-12-22 21:30:00+00,16092,1336,6707,6325,333,3428,3081,174,0,182,37658,238,16446,13365,6658,17428
2021-12-22 22:00:00+00,14928,1286,6682,5863,282,3594,3082,138,0,28,35883,238,15909,12827,6145,16214
2021-12-22 22:30:00+00,13748,986,6625,5681,282,3508,3080,141,0,178,34229,226,15668,12588,5963,14734
2021-12-22 23:00:00+00,11949,483,6630,5536,278,3400,3083,129,0,48,31536,207,15527,12444,5814,12432
2021-12-22 23:30:00+00,10965,75,6631,5441,273,3438,3089,132,0,0,30044,193,15434,12345,5714,11040
2021-12-23 00:00:00+00,10480,0,6630,5757,214,3640,3086,140,0,0,29947,183,15687,12601,5971,10480
2021-12-23 00:30:00+00,10383,0,6649,6056,214,3652,3127,129,0,0,30210,181,16046,12919,6270,10383
2021-12-23 01:00:00+00,10089,0,6640,5859,214,3712,3136,129,0,0,29779,180,15849,12713,6073,10089
2021-12-23 01:30:00+00,9353,0,6639,5898,200,3722,3119,129,0,0,29060,174,15856,12737,6098,9353
2021-12-23 02:00:00+00,9563,0,6634,5874,154,3644,3108,130,0,0,29107,176,15770,12662,6028,9563
2021-12-23 02:30:00+00,9268,0,6639,6033,150,3536,3113,133,0,0,28872,172,15935,12822,6183,9268
2021-12-23 03:00:00+00,9583,0,6637,5880,150,3616,3111,135,0,0,29112,176,15778,12667,6030,9583
2021-12-23 03:30:00+00,9591,0,6631,5599,150,3506,3115,138,0,0,28730,177,15495,12380,5749,9591
2021-12-23 04:00:00+00,9740,0,6633,5550,150,3602,3111,135,0,0,28921,180,15444,12333,5700,9740
2021-12-23 04:30:00+00,9736,0,6630,5652,147,3628,3113,129,0,0,29035,179,15542,12429,5799,9736
2021-12-23 05:00:00+00,9242,0,6629,5706,166,3406,3113,130,0,0,28392,176,15614,12501,5872,9242
2021-12-23 05:30:00+00,9732,0,6625,5777,179,3384,3114,130,0,0,28941,179,15695,12581,5956,9732
2021-12-23 06:00:00+00,12097,163,6624,5771,264,2826,3110,130,0,0,30985,198,15769,12659,6035,12260
2021-12-23 06:30:00+00,13407,229,6622,5949,273,2754,3108,129,0,0,32471,205,15952,12844,6222,13636
2021-12-23 07:00:00+00,15941,382,6619,5998,369,2178,3112,136,0,0,34735,219,16098,12986,6367,16323
2021-12-23 07:30:00+00,17337,461,6625,6212,368,2188,3105,139,0,0,36435,226,16310,13205,6580,17798
2021-12-23 08:00:00+00,17759,459,6622,6860,408,2506,3084,131,0,0,37829,223,16974,13890,7268,18218
2021-12-23 08:30:00+00,17957,459,6627,7695,397,2608,3117,168,9,0,39037,220,17845,14728,8101,18416
2021-12-23 09:00:00+00,17977,458,6623,8329,380,2638,3158,148,66,220,39997,212,18556,15398,8775,18435
2021-12-23 09:30:00+00,18597,458,6627,8499,363,2624,3169,132,158,0,40627,214,18816,15647,9020,19055
2021-12-23 10:00:00+00,18977,460,6626,8499,334,2448,3166,135,263,148,41056,214,18888,15722,9096,19437
2021-12-23 10:30:00+00,18917,459,6635,8403,331,2478,3168,128,281,0,40800,215,18818,15650,9015,19376
2021-12-23 11:00:00+00,18890,459,6638,8294,304,3118,3135,132,305,0,41275,218,18676,15541,8903,19349
2021-12-23 11:30:00+00,18301,426,6632,8540,318,3308,3137,154,308,138,41262,214,18935,15798,9166,18727
2021-12-23 12:00:00+00,18884,241,6629,8189,317,3174,3064,152,351,326,41327,213,18550,15486,8857,19125
2021-12-23 12:30:00+00,18972,232,6634,8344,315,3036,3134,140,327,0,41134,213,18754,15620,8986,19204
2021-12-23 13:00:00+00,19634,194,6630,8319,328,3036,3133,140,310,156,41880,217,18720,15587,8957,19828
2021-12-23 13:30:00+00,19703,0,6635,8291,345,2880,3075,133,239,54,41355,214,18585,15510,8875,19703
2021-12-23 14:00:00+00,19580,0,6635,8726,407,2608,2937,131,196,0,41220,209,18900,15964,9328,19580
2021-12-23 14:30:00+00,19544,0,6632,9157,439,2559,2946,133,153,98,41661,206,19327,16381,9749,19544
2021-12-23 15:00:00+00,19559,0,6635,9647,467,2364,2950,147,70,0,41839,205,19769,16819,10184,19559
2021-12-23 15:30:00+00,19144,0,6633,10143,522,2504,2918,145,13,26,42048,202,20229,17311,10678,19144
2021-12-23 16:00:00+00,19454,0,6624,10405,591,1982,2925,311,0,614,42906,200,20545,17620,10996,19454
2021-12-23 16:30:00+00,20010,0,6628,10185,612,1932,2907,374,0,1100,43748,202,20332,17425,10797,20010
2021-12-23 17:00:00+00,20513,0,6630,9688,610,2180,2931,320,0,1034,43906,207,19859,16928,10298,20513
2021-12-23 17:30:00+00,20548,0,6629,9355,612,2194,2930,315,0,800,43383,209,19526,16596,9967,20548
2021-12-23 18:00:00+00,20450,0,6634,9278,557,2728,2910,277,0,880,43714,208,19379,16469,9835,20450
2021-12-23 18:30:00+00,20438,0,6641,9209,536,2742,2943,234,0,490,43233,210,19329,16386,9745,20438
2021-12-23 19:00:00+00,19816,0,6638,9179,536,2766,2974,180,0,0,42089,208,19327,16353,9715,19816
2021-12-23 19:30:00+00,18783,0,6630,8958,518,2766,2914,240,0,250,41059,204,19020,16106,9476,18783
2021-12-23 20:00:00+00,17604,0,6636,8632,342,2766,2906,177,0,26,39089,202,18516,15610,8974,17604
2021-12-23 20:30:00+00,16563,0,6626,8361,317,2766,2897,166,0,64,37760,198,18201,15304,8678,16563
2021-12-23 21:00:00+00,15272,0,6630,8251,267,2740,2993,166,0,14,36333,192,18141,15148,8518,15272
2021-12-23 21:30:00+00,13825,0,6634,8201,245,2740,2966,165,0,0,34776,184,18046,15080,8446,13825
2021-12-23 22:00:00+00,12653,0,6632,8195,227,2746,2723,171,0,0,33347,177,17777,15054,8422,12653
2021-12-23 22:30:00+00,11160,0,6623,8119,220,2746,2641,167,0,80,31756,167,17603,14962,8339,11160
2021-12-23 23:00:00+00,8627,0,6627,8551,209,2818,2693,157,0,26,29708,146,18080,15387,8760,8627
2021-12-23 23:30:00+00,7221,0,6627,8680,209,2904,2555,158,0,0,28354,135,18071,15516,8889,7221
2021-12-24 00:00:00+00,6666,0,6634,8475,198,3020,2465,156,0,0,27614,133,17772,15307,8673,6666
2021-12-24 00:30:00+00,6985,0,6629,8331,183,3128,2531,158,0,0,27945,138,17674,15143,8514,6985
2021-12-24 01:00:00+00,7153,0,6634,8155,166,3252,2484,166,0,0,28010,142,17439,14955,8321,7153
2021-12-24 01:30:00+00,6956,0,6631,7843,165,3248,2418,168,0,0,27429,142,17057,14639,8008,6956
2021-12-24 02:00:00+00,6939,0,6640,7698,179,3152,2387,167,0,0,27162,141,16904,14517,7877,6939
2021-12-24 02:30:00+00,6412,0,6637,7816,179,3122,2388,166,0,0,26720,135,17020,14632,7995,6412
2021-12-24 03:00:00+00,6254,0,6638,7710,168,3200,2449,167,0,0,26586,135,16965,14516,7878,6254
2021-12-24 03:30:00+00,5890,0,6640,7851,164,3188,2485,167,0,0,26385,131,17140,14655,8015,5890
2021-12-24 04:00:00+00,5905,0,6640,7660,136,3430,2627,168,0,0,26566,135,17063,14436,7796,5905
2021-12-24 04:30:00+00,5716,0,6636,7779,144,3548,2627,167,0,0,26617,134,17186,14559,7923,5716
2021-12-24 05:00:00+00,5838,0,6633,7846,154,3514,2585,160,0,0,26730,134,17218,14633,8000,5838
2021-12-24 05:30:00+00,6619,0,6634,7565,171,3508,2585,157,0,0,27239,143,16955,14370,7736,6619
2021-12-24 06:00:00+00,8057,0,6630,7499,214,3482,2692,159,0,0,28733,155,17035,14343,7713,8057
2021-12-24 06:30:00+00,9644,0,6629,6690,233,3592,2791,157,0,0,29736,173,16343,13552,6923,9644
2021-12-24 07:00:00+00,12310,0,6627,6534,344,3018,2725,65,0,98,31721,189,16230,13505,6878,12310
2021-12-24 07:30:00+00,13616,0,6630,6362,356,3146,2694,59,0,0,32863,200,16042,13348,6718,13616
2021-12-24 08:00:00+00,14933,0,6628,6390,480,3388,2842,76,2,0,34739,205,16342,13500,6872,14933
2021-12-24 08:30:00+00,15715,0,6633,6404,476,3570,3058,178,84,124,36242,209,16655,13597,6964,15715
2021-12-24 09:00:00+00,15752,0,6627,6259,515,3540,3077,185,266,84,36305,208,16744,13667,7040,15752
2021-12-24 09:30:00+00,16358,0,6632,6318,527,3616,3084,167,569,198,37469,208,17130,14046,7414,16358
2021-12-24 10:00:00+00,16558,0,6623,6350,533,3898,3083,139,730,46,37960,205,17319,14236,7613,16558
2021-12-24 10:30:00+00,16725,0,6627,6305,551,3872,3085,142,765,0,38072,206,17333,14248,7621,16725
2021-12-24 11:00:00+00,17042,0,6627,6383,542,3674,3083,135,850,0,38336,206,17485,14402,7775,17042
2021-12-24 11:30:00+00,17091,0,6628,6451,546,3650,3106,167,914,38,38591,205,17645,14539,7911,17091
2021-12-24 12:00:00+00,17474,0,6632,6502,631,2910,3108,192,874,144,38467,207,17747,14639,8007,17474
2021-12-24 12:30:00+00,17370,0,6624,6762,557,2812,3111,187,721,44,38188,207,17775,14664,8040,17370
2021-12-24 13:00:00+00,17060,0,6627,7468,435,2722,3021,173,711,0,38217,200,18262,15241,8614,17060
2021-12-24 13:30:00+00,16634,0,6623,8152,398,2654,2779,135,492,0,37867,195,18444,15665,9042,16634
2021-12-24 14:00:00+00,17183,0,6624,8673,402,2112,2804,131,313,0,38242,198,18816,16012,9388,17183
2021-12-24 14:30:00+00,16491,0,6622,9255,393,1974,2829,140,170,36,37910,191,19269,16440,9818,16491
2021-12-24 15:00:00+00,16208,0,6624,9716,422,1852,2841,138,32,0,37833,189,19635,16794,10170,16208
2021-12-24 15:30:00+00,16263,0,6620,9883,408,1972,2925,136,1,0,38208,190,19837,16912,10292,16263
2021-12-24 16:00:00+00,16925,0,6626,10067,396,2368,3095,144,0,0,39621,194,20184,17089,10463,16925
2021-12-24 16:30:00+00,16838,0,6686,10182,394,2480,2979,157,0,528,40244,191,20241,17262,10576,16838
2021-12-24 17:00:00+00,16803,0,6721,10402,392,2814,3051,199,0,424,40806,189,20566,17515,10794,16803
2021-12-24 17:30:00+00,16036,0,6728,10771,396,2820,3108,195,0,466,40520,183,21003,17895,11167,16036
2021-12-24 18:00:00+00,15613,0,6730,11106,420,2786,3107,146,0,592,40500,179,21363,18256,11526,15613
2021-12-24 18:30:00+00,14007,0,6734,11713,414,2782,3081,142,0,592,39465,168,21942,18861,12127,14007
2021-12-24 19:00:00+00,11794,0,6736,12056,397,3260,2914,136,0,2,37295,157,22103,19189,12453,11794
2021-12-24 19:30:00+00,10585,0,6733,12275,384,3210,2556,140,0,14,35897,148,21948,19392,12659,10585
2021-12-24 20:00:00+00,9964,0,6729,12155,291,3176,2499,140,0,42,34996,145,21674,19175,12446,9964
2021-12-24 20:30:00+00,8948,0,6734,12144,278,3166,2572,132,0,36,34010,138,21728,19156,12422,8948
2021-12-24 21:00:00+00,8332,0,6731,12333,240,3182,2568,135,0,74,33595,134,21872,19304,12573,8332
2021-12-24 21:30:00+00,7217,0,6726,12441,242,3218,2647,133,0,52,32676,126,22056,19409,12683,7217
2021-12-24 22:00:00+00,6205,0,6730,12365,231,3290,2500,127,0,82,31530,117,21826,19326,12596,6205
2021-12-24 22:30:00+00,4878,0,6726,12331,207,3292,2304,125,0,40,29903,105,21568,19264,12538,4878
2021-12-24 23:00:00+00,2982,0,6722,12404,206,3692,1830,124,0,0,27960,83,21162,19332,12610,2982
2021-12-24 23:30:00+00,2428,0,6724,12254,181,3564,1791,115,0,0,27057,74,20950,19159,12435,2428
2021-12-25 00:00:00+00,2447,0,6718,12396,169,2978,1791,117,0,0,26616,70,21074,19283,12565,2447
2021-12-25 00:30:00+00,2492,0,6720,12693,163,3044,1792,117,0,0,27021,71,21368,19576,12856,2492
2021-12-25 01:00:00+00,2632,0,6720,12916,137,3136,1790,116,0,0,27447,73,21563,19773,13053,2632
2021-12-25 01:30:00+00,2446,0,6729,13233,137,2858,1789,115,0,0,27307,67,21888,20099,13370,2446
2021-12-25 02:00:00+00,2606,0,6729,13430,137,1736,1789,115,0,0,26542,61,22085,20296,13567,2606
2021-12-25 02:30:00+00,2362,0,6729,13608,137,1590,1790,131,0,0,26347,57,22264,20474,13745,2362
2021-12-25 03:00:00+00,2875,0,6729,13905,137,586,1885,116,0,0,26233,59,22656,20771,14042,2875
2021-12-25 03:30:00+00,2749,0,6732,13776,136,496,1808,115,0,0,25812,57,22452,20644,13912,2749
2021-12-25 04:00:00+00,2817,0,6739,13751,136,414,1792,115,0,0,25764,59,22418,20626,13887,2817
2021-12-25 04:30:00+00,2636,0,6742,13933,138,348,1787,115,0,0,25699,55,22600,20813,14071,2636
2021-12-25 05:00:00+00,2386,0,6740,14116,155,578,1788,117,0,0,25880,52,22799,21011,14271,2386
2021-12-25 05:30:00+00,2414,0,6738,14219,158,652,1787,116,0,0,26084,53,22902,21115,14377,2414
2021-12-25 06:00:00+00,2259,0,6736,14066,171,1288,1788,115,0,0,26423,52,22761,20973,14237,2259
2021-12-25 06:30:00+00,2100,0,6737,14517,185,1568,1831,118,0,0,27056,54,23270,21439,14702,2100
2021-12-25 07:00:00+00,2104,0,6738,15046,267,1628,1790,114,0,0,27687,56,23841,22051,15313,2104
2021-12-25 07:30:00+00,2155,0,6728,15335,247,1786,1844,118,0,0,28213,58,24154,22310,15582,2155
2021-12-25 08:00:00+00,2669,0,6730,15497,258,2572,2182,114,0,0,30022,66,24667,22485,15755,2669
2021-12-25 08:30:00+00,3768,0,6723,15465,267,2752,2465,120,11,48,31619,79,24931,22466,15743,3768
2021-12-25 09:00:00+00,4593,0,6728,15613,334,3010,2469,116,85,372,33320,85,25229,22760,16032,4593
2021-12-25 09:30:00+00,5215,0,6728,15773,340,2970,2473,142,213,630,34484,89,25527,23054,16326,5215
2021-12-25 10:00:00+00,5400,0,6732,15834,320,2974,2478,165,395,712,35010,90,25759,23281,16549,5400
2021-12-25 10:30:00+00,5963,0,6736,15947,339,2896,2475,123,515,670,35664,93,26012,23537,16801,5963
2021-12-25 11:00:00+00,6333,0,6738,16195,364,2834,2390,156,558,358,35926,95,26245,23855,17117,6333
2021-12-25 11:30:00+00,6466,0,6737,16195,419,2944,2408,168,585,822,36744,96,26344,23936,17199,6466
2021-12-25 12:00:00+00,6687,0,6742,16192,420,3356,2332,159,591,1284,37763,95,26277,23945,17203,6687
2021-12-25 12:30:00+00,7077,0,6740,16262,420,3478,2311,162,492,1552,38494,98,26225,23914,17174,7077
2021-12-25 13:00:00+00,7290,0,6743,16217,504,3656,2231,168,390,1548,38747,98,26085,23854,17111,7290
2021-12-25 13:30:00+00,7237,0,6738,16224,546,3550,2312,162,274,1150,38193,98,26094,23782,17044,7237
2021-12-25 14:00:00+00,7350,0,6737,16321,508,3358,2363,177,162,436,37412,102,26091,23728,16991,7350
2021-12-25 14:30:00+00,6738,0,6742,16405,394,3242,2369,150,64,388,36492,96,25974,23605,16863,6738
2021-12-25 15:00:00+00,6048,0,6739,16724,396,2482,2387,126,9,730,35641,89,26255,23868,17129,6048
2021-12-25 15:30:00+00,5827,0,6735,16614,458,2456,2214,118,0,398,34820,88,26021,23807,17072,5827
2021-12-25 16:00:00+00,6136,0,6735,16359,459,2252,2427,128,0,556,35052,91,25980,23553,16818,6136
2021-12-25 16:30:00+00,6032,0,6755,15977,458,2240,2321,129,0,590,34502,91,25511,23190,16435,6032
2021-12-25 17:00:00+00,6102,0,6749,15728,452,2548,2321,128,0,832,34860,95,25250,22929,16180,6102
2021-12-25 17:30:00+00,5893,0,6754,15555,359,2392,2231,116,0,750,34050,92,24899,22668,15914,5893
2021-12-25 18:00:00+00,6055,0,6752,15538,326,1788,2325,124,0,764,33672,92,24941,22616,15864,6055
2021-12-25 18:30:00+00,6009,0,6759,15534,310,1668,2456,117,0,396,33249,92,25059,22603,15844,6009
2021-12-25 19:00:00+00,5697,0,6757,15420,316,2086,2366,118,0,90,32850,92,24859,22493,15736,5697
2021-12-25 19:30:00+00,5466,0,6759,15365,323,1940,2226,117,0,94,32290,88,24673,22447,15688,5466
2021-12-25 20:00:00+00,5549,0,6762,15361,280,1560,2187,124,0,162,31985,87,24590,22403,15641,5549
2021-12-25 20:30:00+00,5519,0,6762,15172,273,1396,2141,120,0,322,31705,85,24348,22207,15445,5519
2021-12-25 21:00:00+00,5699,0,6762,15126,251,748,2148,118,0,476,31328,82,24287,22139,15377,5699
2021-12-25 21:30:00+00,5193,0,6758,14960,238,772,2155,114,0,408,30598,78,24111,21956,15198,5193
2021-12-25 22:00:00+00,4133,0,6761,14760,215,924,2155,113,0,204,29265,73,23891,21736,14975,4133
2021-12-25 22:30:00+00,3454,0,6766,14627,211,1012,2143,114,0,236,28563,68,23747,21604,14838,3454
2021-12-25 23:00:00+00,2804,0,6767,14561,190,1402,1988,114,0,0,27826,63,23506,21518,14751,2804
2021-12-25 23:30:00+00,2630,0,6763,14580,170,1338,1852,115,0,0,27448,60,23365,21513,14750,2630
2021-12-26 00:00:00+00,2726,0,6766,14444,149,1460,1823,114,0,0,27482,62,23182,21359,14593,2726
2021-12-26 00:30:00+00,3381,0,6763,14203,147,1440,1845,114,0,0,27893,70,22958,21113,14350,3381
2021-12-26 01:00:00+00,3597,0,6766,14277,125,1148,1911,114,0,0,27938,69,23079,21168,14402,3597
2021-12-26 01:30:00+00,3347,0,6762,14322,124,1116,1951,114,0,0,27736,66,23159,21208,14446,3347
2021-12-26 02:00:00+00,3123,0,6767,14586,124,1144,1857,114,0,0,27715,61,23334,21477,14710,3123
2021-12-26 02:30:00+00,2673,0,6772,14714,124,1126,1817,114,0,0,27340,55,23427,21610,14838,2673
2021-12-26 03:00:00+00,3091,0,6769,14747,123,326,1893,114,0,0,27063,58,23532,21639,14870,3091
2021-12-26 03:30:00+00,3041,0,6770,14713,123,298,1868,114,0,0,26927,57,23474,21606,14836,3041
2021-12-26 04:00:00+00,3077,0,6768,14640,124,98,1840,115,0,0,26662,55,23372,21532,14764,3077
2021-12-26 04:30:00+00,2739,0,6766,14785,124,98,1832,115,0,0,26459,51,23507,21675,14909,2739
2021-12-26 05:00:00+00,3106,0,6773,14608,143,0,1832,115,0,0,26577,56,23356,21524,14751,3106
2021-12-26 05:30:00+00,3437,0,6771,14447,143,0,1838,115,0,0,26751,60,23199,21361,14590,3437
2021-12-26 06:00:00+00,3160,0,6767,14436,159,76,1844,115,0,0,26557,57,23206,21362,14595,3160
2021-12-26 06:30:00+00,3405,0,6768,14401,163,76,1831,114,0,0,26758,60,23163,21332,14564,3405
2021-12-26 07:00:00+00,4071,0,6760,14108,230,0,1870,119,0,0,27158,69,22968,21098,14338,4071
2021-12-26 07:30:00+00,4619,0,6767,13841,237,0,1820,116,0,0,27400,76,22665,20845,14078,4619
2021-12-26 08:00:00+00,4891,0,6770,13843,288,178,1913,121,0,0,28004,79,22814,20901,14131,4891
2021-12-26 08:30:00+00,5827,0,6765,13813,272,266,2115,115,14,0,29187,90,22979,20864,14099,5827
2021-12-26 09:00:00+00,6695,0,6764,13630,309,694,2206,121,78,70,30566,100,22986,20780,14016,6695
2021-12-26 09:30:00+00,7673,0,6767,13563,324,830,2275,120,200,294,32046,109,23129,20854,14087,7673
2021-12-26 10:00:00+00,7729,0,6768,13679,360,1822,2246,121,336,42,33103,115,23389,21143,14375,7729
2021-12-26 10:30:00+00,8378,0,6766,13557,393,1798,2181,122,477,50,33722,119,23374,21193,14427,8378
2021-12-26 11:00:00+00,8559,0,6765,13130,392,2552,2332,120,620,50,34520,123,23239,20907,14142,8559
2021-12-26 11:30:00+00,9025,0,6770,12867,372,2596,2495,113,799,144,35181,127,23303,20808,14038,9025
2021-12-26 12:00:00+00,9073,0,6779,12685,372,3514,2499,114,873,14,35923,125,23208,20709,13930,9073
2021-12-26 12:30:00+00,9394,0,6782,12295,371,3568,2398,114,949,0,35871,129,22795,20397,13615,9394
2021-12-26 13:00:00+00,9146,0,6781,11940,371,4184,2361,124,919,0,35826,127,22372,20011,13230,9146
2021-12-26 13:30:00+00,9196,0,6783,11579,388,4202,2313,125,795,0,35381,129,21858,19545,12762,9196
2021-12-26 14:00:00+00,9315,0,6785,11131,408,4396,2222,124,613,0,34994,132,21159,18937,12152,9315
2021-12-26 14:30:00+00,9679,0,6787,10773,412,4376,2161,123,464,0,34775,137,20597,18436,11649,9679
2021-12-26 15:00:00+00,10512,0,6782,10466,428,3526,2401,115,217,22,34469,147,20294,17893,11111,10512
2021-12-26 15:30:00+00,11183,0,6786,10021,459,3496,2519,116,21,0,34601,154,19806,17287,10501,11183
2021-12-26 16:00:00+00,11484,0,6780,9744,470,4058,2498,128,0,496,35658,152,19492,16994,10214,11484
2021-12-26 16:30:00+00,12505,0,6778,9391,471,4112,2519,138,0,820,36734,159,19159,16640,9862,12505
2021-12-26 17:00:00+00,12575,0,6781,9180,475,4362,2518,143,0,1242,37276,157,18954,16436,9655,12575
2021-12-26 17:30:00+00,12607,0,6778,8819,511,4386,2507,136,0,1246,36990,159,18615,16108,9330,12607
2021-12-26 18:00:00+00,13170,0,6776,8366,549,3978,2503,167,0,954,36463,167,18194,15691,8915,13170
2021-12-26 18:30:00+00,12979,0,6783,8079,487,3974,2502,139,0,974,35917,167,17851,15349,8566,12979
2021-12-26 19:00:00+00,12746,0,6787,7682,399,4076,2506,122,0,826,35144,169,17374,14868,8081,12746
2021-12-26 19:30:00+00,12360,0,6781,7572,380,4098,2511,132,0,468,34302,169,17244,14733,7952,12360
2021-12-26 20:00:00+00,11824,0,6786,7435,276,4476,2520,116,0,242,33675,167,17017,14497,7711,11824
2021-12-26 20:30:00+00,11247,0,6786,7382,274,4478,2524,117,0,0,32808,164,16966,14442,7656,11247
2021-12-26 21:00:00+00,10690,0,6792,7269,246,4334,2522,128,0,0,31981,162,16829,14307,7515,10690
2021-12-26 21:30:00+00,9934,0,6792,7021,233,4328,2520,122,0,0,30950,157,16566,14046,7254,9934
2021-12-26 22:00:00+00,9322,0,6793,6467,232,4040,2507,114,0,44,29519,155,15999,13492,6699,9322
2021-12-26 22:30:00+00,8346,0,6793,6444,227,4066,2500,115,0,0,28491,148,15964,13464,6671,8346
2021-12-26 23:00:00+00,6913,0,6793,6346,202,4690,2257,114,0,94,27409,135,15598,13341,6548,6913
2021-12-26 23:30:00+00,6410,0,6796,6135,191,4662,2059,126,0,0,26379,131,15181,13122,6326,6410
2021-12-27 00:00:00+00,6109,0,6792,6221,144,4744,2031,134,0,0,26175,128,15188,13157,6365,6109
2021-12-27 00:30:00+00,6286,0,6763,6046,143,4792,2120,131,0,76,26357,131,15072,12952,6189,6286
2021-12-27 01:00:00+00,6282,0,6769,5938,135,4926,2153,131,0,0,26334,133,14995,12842,6073,6282
2021-12-27 01:30:00+00,6390,0,6772,5652,134,4936,2152,136,0,0,26172,136,14710,12558,5786,6390
2021-12-27 02:00:00+00,6231,0,6772,5572,132,4834,2150,136,0,0,25827,134,14626,12476,5704,6231
2021-12-27 02:30:00+00,5983,0,6770,5532,130,4850,2080,142,0,0,25487,132,14512,12432,5662,5983
2021-12-27 03:00:00+00,6053,0,6768,5394,130,4620,1986,142,0,0,25093,133,14278,12292,5524,6053
2021-12-27 03:30:00+00,6197,0,6769,5165,130,4582,1971,142,0,0,24956,135,14035,12064,5295,6197
2021-12-27 04:00:00+00,6000,0,6773,5171,130,4358,1947,137,0,0,24516,134,14021,12074,5301,6000
2021-12-27 04:30:00+00,5793,0,6767,5208,129,4342,1837,145,0,0,24221,132,13941,12104,5337,5793
2021-12-27 05:00:00+00,5952,0,6774,5414,148,3994,1867,133,0,0,24282,127,14203,12336,5562,5952
2021-12-27 05:30:00+00,6010,0,6769,5536,148,3988,1871,143,0,0,24465,128,14324,12453,5684,6010
2021-12-27 06:00:00+00,6998,0,6772,5297,148,3312,2059,138,0,0,24724,144,14276,12217,5445,6998
2021-12-27 06:30:00+00,7898,0,6766,5217,149,3164,2245,132,0,0,25571,152,14377,12132,5366,7898
2021-12-27 07:00:00+00,10571,0,6773,5227,164,1154,2468,134,0,296,26787,178,14632,12164,5391,10571
2021-12-27 07:30:00+00,11596,0,6767,5244,174,1122,2566,136,0,0,27605,188,14751,12185,5418,11596
2021-12-27 08:00:00+00,12626,0,6763,5067,252,1204,2614,132,0,0,28658,201,14696,12082,5319,12626
2021-12-27 08:30:00+00,13603,0,6767,5179,252,1358,2751,131,28,4,30073,207,14977,12226,5459,13603
2021-12-27 09:00:00+00,13929,0,6767,5599,280,2156,2744,147,120,0,31742,203,15510,12766,5999,13929
2021-12-27 09:30:00+00,14616,0,6764,5816,311,2272,2837,133,246,0,32995,205,15974,13137,6373,14616
2021-12-27 10:00:00+00,14784,0,6763,5793,347,2976,2948,131,411,0,34153,199,16262,13314,6551,14784
2021-12-27 10:30:00+00,15331,0,6759,5625,360,2976,3076,132,517,56,34832,201,16337,13261,6502,15331
2021-12-27 11:00:00+00,15402,0,6762,5709,355,3376,3070,136,575,46,35431,199,16471,13401,6639,15402
2021-12-27 11:30:00+00,15319,0,6766,5856,356,3380,3144,135,519,476,35951,196,16641,13497,6731,15319
2021-12-27 12:00:00+00,15405,0,6765,5920,395,4204,3153,134,566,234,36776,195,16799,13646,6881,15405
2021-12-27 12:30:00+00,15538,0,6772,5911,378,4320,3148,130,703,114,37014,196,16912,13764,6992,15538
2021-12-27 13:00:00+00,15716,0,6771,6025,377,3230,3144,135,634,632,36664,194,16951,13807,7036,15716
2021-12-27 13:30:00+00,15691,0,6777,5908,366,3210,3127,130,548,562,36319,195,16726,13599,6822,15691
2021-12-27 14:00:00+00,15710,0,6774,5935,371,3094,3134,131,450,410,36009,202,16664,13530,6756,15710
2021-12-27 14:30:00+00,15431,0,6779,6440,409,3010,3154,128,289,252,35892,198,17071,13917,7138,15431
2021-12-27 15:00:00+00,15223,0,6778,7224,484,2174,3157,165,90,716,36011,195,17733,14576,7798,15223
2021-12-27 15:30:00+00,15112,0,6803,7646,461,2216,3152,134,7,760,36291,192,18069,14917,8114,15112
2021-12-27 16:00:00+00,14834,0,6794,7539,513,4106,3024,180,0,438,37428,182,17870,14846,8052,14834
2021-12-27 16:30:00+00,15459,0,6793,7864,512,4226,3037,182,0,886,38958,182,18206,15168,8376,15459
2021-12-27 17:00:00+00,15423,0,6799,8455,536,4378,2793,274,0,1182,39840,179,18583,15790,8991,15423
2021-12-27 17:30:00+00,15637,0,6795,8667,536,4374,2393,309,0,1216,39927,180,18391,15998,9203,15637
2021-12-27 18:00:00+00,15246,0,6800,9041,536,4188,2339,150,0,942,39242,178,18716,16377,9577,15246
2021-12-27 18:30:00+00,14341,0,6797,8988,538,4158,2503,202,0,800,38327,174,18826,16323,9526,14341
2021-12-27 19:00:00+00,13999,0,6793,8461,523,4604,2512,157,0,10,37059,176,18289,15777,8984,13999
2021-12-27 19:30:00+00,13182,0,6798,8231,517,4646,2526,137,0,18,36055,172,18072,15546,8748,13182
2021-12-27 20:00:00+00,11989,0,6795,8291,443,4732,2455,133,0,0,34838,164,17984,15529,8734,11989
2021-12-27 20:30:00+00,10709,0,6797,8304,425,4736,2405,163,0,14,33553,155,17931,15526,8729,10709
2021-12-27 21:00:00+00,10091,0,6800,8124,371,4672,2370,129,0,4,32561,152,17665,15295,8495,10091
2021-12-27 21:30:00+00,9047,0,6796,7758,365,4652,2392,141,0,20,31171,146,17311,14919,8123,9047
2021-12-27 22:00:00+00,8405,0,6795,7385,281,4520,2409,138,0,10,29943,144,16870,14461,7666,8405
2021-12-27 22:30:00+00,7493,0,6791,6694,268,4526,2711,136,0,0,28619,139,16464,13753,6962,7493
2021-12-27 23:00:00+00,6164,0,6795,6208,250,4724,2924,134,0,0,27199,128,16177,13253,6458,6164
2021-12-27 23:30:00+00,5174,0,6795,6250,231,4744,2735,151,0,0,26080,118,16011,13276,6481,5174
2021-12-28 00:00:00+00,4923,0,6788,6232,146,4744,2779,133,0,0,25745,111,15945,13166,6378,4923
2021-12-28 00:30:00+00,4917,0,6796,6515,142,4888,2695,143,0,0,26096,111,16148,13453,6657,4917
2021-12-28 01:00:00+00,4481,0,6788,6625,140,4970,2594,130,0,0,25728,107,16147,13553,6765,4481
2021-12-28 01:30:00+00,4181,0,6790,6596,139,4914,2485,129,0,0,25234,103,16010,13525,6735,4181
2021-12-28 02:00:00+00,4481,0,6783,6237,137,5148,2512,130,0,0,25428,111,15669,13157,6374,4481
2021-12-28 02:30:00+00,4501,0,6787,6176,136,5178,2469,129,0,0,25376,112,15568,13099,6312,4501
2021-12-28 03:00:00+00,4539,0,6783,5932,116,5266,2393,133,0,0,25162,115,15224,12831,6048,4539
2021-12-28 03:30:00+00,4541,0,6792,5769,107,5160,2333,132,0,0,24834,114,15001,12668,5876,4541
2021-12-28 04:00:00+00,4798,0,6792,5585,104,4726,2337,137,0,0,24479,119,14818,12481,5689,4798
2021-12-28 04:30:00+00,4480,0,6795,5627,104,4644,2316,136,0,0,24102,115,14842,12526,5731,4480
2021-12-28 05:00:00+00,4486,0,6793,5724,123,4386,2323,138,0,0,23973,113,14963,12640,5847,4486
2021-12-28 05:30:00+00,4407,0,6804,6107,123,4454,2332,137,0,0,24364,112,15366,13034,6230,4407
2021-12-28 06:00:00+00,4736,0,6798,6408,173,4496,2321,135,0,0,25067,112,15700,13379,6581,4736
2021-12-28 06:30:00+00,5064,0,6802,6762,176,4556,2220,131,0,0,25711,114,15960,13740,6938,5064
2021-12-28 07:00:00+00,6105,0,6797,6797,192,4240,2224,132,0,112,26599,123,16010,13786,6989,6105
2021-12-28 07:30:00+00,6872,0,6795,6741,232,4280,2230,131,0,42,27323,131,15998,13768,6973,6872
2021-12-28 08:00:00+00,7641,0,6794,6919,313,4404,2386,133,0,212,28802,134,16412,14026,7232,7641
2021-12-28 08:30:00+00,8298,0,6799,6904,312,4588,3027,129,54,2,30113,142,17096,14069,7270,8298
2021-12-28 09:00:00+00,8923,0,6793,6855,379,4748,3122,132,286,202,31440,142,17435,14313,7520,8923
2021-12-28 09:30:00+00,9663,0,6795,6941,413,4818,3117,137,326,428,32638,147,17592,14475,7680,9663
2021-12-28 10:00:00+00,10581,0,6798,7113,436,4744,3130,130,502,444,33878,151,17979,14849,8051,10581
2021-12-28 10:30:00+00,11523,0,6800,7411,462,4746,3118,129,984,170,35343,155,18775,15657,8857,11523
2021-12-28 11:00:00+00,11925,0,6795,7971,425,4746,3109,129,1180,0,36280,156,19480,16371,9576,11925
2021-12-28 11:30:00+00,11923,0,6799,8459,420,4746,2998,129,955,0,36429,155,19631,16633,9834,11923
2021-12-28 12:00:00+00,12352,0,6793,8436,427,4744,2907,130,1162,0,36951,157,19725,16818,10025,12352
2021-12-28 12:30:00+00,12707,0,6798,8295,442,4746,2744,131,1135,0,36998,160,19414,16670,9872,12707
2021-12-28 13:00:00+00,12576,0,6796,8496,453,4746,2518,134,1182,6,36907,158,19445,16927,10131,12576
2021-12-28 13:30:00+00,12586,0,6796,8614,445,4742,2223,133,1097,0,36636,158,19175,16952,10156,12586
2021-12-28 14:00:00+00,12588,0,6796,8684,441,4626,2230,134,729,0,36228,160,18880,16650,9854,12588
2021-12-28 14:30:00+00,12581,0,6798,8832,442,4604,2254,132,405,0,36048,161,18731,16477,9679,12581
2021-12-28 15:00:00+00,13868,0,6786,8530,461,4318,2274,134,117,56,36544,173,18168,15894,9108,13868
2021-12-28 15:30:00+00,14579,0,6783,8310,471,4302,2441,131,6,56,37079,178,18011,15570,8787,14579
2021-12-28 16:00:00+00,15511,0,6785,7984,526,4720,2775,159,0,62,38522,182,18070,15295,8510,15511
2021-12-28 16:30:00+00,15978,0,6793,7836,525,4766,3071,177,0,524,39670,183,18225,15154,8361,15978
2021-12-28 17:00:00+00,16041,0,6792,7617,587,4762,3071,402,0,1308,40580,181,18067,14996,8204,16041
2021-12-28 17:30:00+00,16145,0,6799,7538,594,4764,3079,454,0,1354,40727,182,18010,14931,8132,16145
2021-12-28 18:00:00+00,15863,0,6795,7167,577,4766,3096,221,0,1338,39823,181,17635,14539,7744,15863
2021-12-28 18:30:00+00,15807,0,6793,6852,578,4766,3065,197,0,996,39054,184,17288,14223,7430,15807
2021-12-28 19:00:00+00,15301,0,6796,6515,548,4766,3091,175,0,288,37480,186,16950,13859,7063,15301
2021-12-28 19:30:00+00,14766,0,6795,6434,487,3970,3096,144,0,64,35756,187,16812,13716,6921,14766
2021-12-28 20:00:00+00,13820,0,6798,6296,425,4766,3097,132,0,198,35532,180,16616,13519,6721,13820
2021-12-28 20:30:00+00,12262,0,6800,6315,406,4766,3089,134,0,394,34166,169,16610,13521,6721,12262
2021-12-28 21:00:00+00,11190,0,6802,6079,353,4802,3098,133,0,428,32885,164,16332,13234,6432,11190
2021-12-28 21:30:00+00,10437,0,6804,5576,335,4754,3097,130,0,498,31631,160,15812,12715,5911,10437
2021-12-28 22:00:00+00,9519,0,6818,5640,224,4746,2772,131,0,298,30148,154,15454,12682,5864,9519
2021-12-28 22:30:00+00,8968,0,6810,5574,217,4746,2538,136,0,62,29051,152,15139,12601,5791,8968
2021-12-28 23:00:00+00,7421,0,6796,5139,195,4746,2574,138,0,410,27419,139,14704,12130,5334,7421
2021-12-28 23:30:00+00,6573,0,6802,4447,185,4820,2533,155,0,268,25783,136,13967,11434,4632,6573
2021-12-29 00:00:00+00,6617,0,6796,4056,135,5084,2535,149,0,148,25520,145,13522,10987,4191,6617
2021-12-29 00:30:00+00,6795,0,6794,3931,135,5392,2535,154,0,338,26074,150,13395,10860,4066,6795
2021-12-29 01:00:00+00,6693,0,6796,3732,134,5548,2515,133,0,2,25553,154,13177,10662,3866,6693
2021-12-29 01:30:00+00,6566,0,6791,3546,133,5396,2522,130,0,0,25084,152,12992,10470,3679,6566
2021-12-29 02:00:00+00,6323,0,6794,3728,132,5620,2508,134,0,0,25239,152,13162,10654,3860,6323
2021-12-29 02:30:00+00,6014,0,6792,3770,131,5634,2518,129,0,0,24988,149,13211,10693,3901,6014
2021-12-29 03:00:00+00,6375,0,6790,3688,130,5174,2498,133,0,0,24788,154,13106,10608,3818,6375
2021-12-29 03:30:00+00,6276,0,6789,3718,129,5060,2467,134,0,0,24573,151,13103,10636,3847,6276
2021-12-29 04:00:00+00,5980,0,6792,4194,127,5102,2364,133,0,0,24692,146,13477,11113,4321,5980
2021-12-29 04:30:00+00,5550,0,6796,4717,127,5122,2297,134,0,0,24743,139,13937,11640,4844,5550
2021-12-29 05:00:00+00,5564,0,6794,5196,145,4798,2252,134,0,0,24883,137,14387,12135,5341,5564
2021-12-29 05:30:00+00,5420,0,6800,6152,150,4884,2177,134,0,0,25717,131,15279,13102,6302,5420
2021-12-29 06:00:00+00,5224,0,6801,7385,196,4716,2166,129,0,0,26617,120,16548,14382,7581,5224
2021-12-29 06:30:00+00,4789,0,6803,8641,198,4770,2186,129,0,0,27516,111,17828,15642,8839,4789
2021-12-29 07:00:00+00,5741,0,6804,9591,212,3774,2308,130,0,0,28560,115,18915,16607,9803,5741
2021-12-29 07:30:00+00,5661,0,6809,10641,209,3718,2395,133,0,0,29566,110,20054,17659,10850,5661
2021-12-29 08:00:00+00,6090,0,6799,11583,255,3322,2588,141,0,0,30778,110,21225,18637,11838,6090
2021-12-29 08:30:00+00,6159,0,6796,12433,254,3320,2832,137,3,0,31934,108,22318,19486,12690,6159
2021-12-29 09:00:00+00,6065,0,6809,14072,282,3334,2852,127,31,0,33572,101,24046,21194,14385,6065
2021-12-29 09:30:00+00,5880,0,6798,15102,312,3242,2809,120,93,0,34356,95,25114,22305,15507,5880
2021-12-29 10:00:00+00,6554,0,6791,15785,321,2714,2753,125,205,86,35334,97,25855,23102,16311,6554
2021-12-29 10:30:00+00,6695,0,6798,16423,319,2614,2717,131,328,28,36053,96,26585,23868,17070,6695
2021-12-29 11:00:00+00,7576,0,6796,16874,306,1428,2788,149,442,1384,37743,96,27206,24418,17622,7576
2021-12-29 11:30:00+00,7830,0,6796,16820,306,1558,2735,182,592,1548,38367,99,27249,24514,17718,7830
2021-12-29 12:00:00+00,7985,0,6796,17005,282,1404,2723,168,805,1496,38664,100,27611,24888,18092,7985
2021-12-29 12:30:00+00,8050,0,6799,17285,265,1348,2634,126,891,1226,38624,99,27874,25240,18441,8050
2021-12-29 13:00:00+00,7415,0,6804,17364,296,1858,2414,114,1117,1186,38568,92,27995,25581,18777,7415
2021-12-29 13:30:00+00,6826,0,6800,17402,327,1716,2404,114,1279,1004,37872,86,28212,25808,19008,6826
2021-12-29 14:00:00+00,7697,6,6804,17353,369,1202,2437,115,1173,1114,38270,95,28136,25699,18895,7703
2021-12-29 14:30:00+00,7842,39,6799,17303,373,1086,2610,116,755,1236,38159,97,27840,25230,18431,7881
2021-12-29 15:00:00+00,6566,110,6803,17301,403,1420,2659,116,339,620,36337,89,27505,24846,18043,6676
2021-12-29 15:30:00+00,6542,274,6800,17511,414,1466,2759,124,51,712,36653,91,27535,24776,17976,6816
2021-12-29 16:00:00+00,6302,411,6798,16990,448,3186,2683,149,0,748,37715,95,26919,24236,17438,6713
2021-12-29 16:30:00+00,6527,438,6797,17200,452,3350,2694,247,0,1722,39427,95,27143,24449,17652,6965
2021-12-29 17:00:00+00,5846,400,6804,17611,500,4752,2509,325,0,1790,40537,91,27424,24915,18111,6246
2021-12-29 17:30:00+00,5969,359,6797,17553,532,4762,2503,325,0,1772,40572,91,27385,24882,18085,6328
2021-12-29 18:00:00+00,5761,245,6792,17367,517,4764,2524,211,0,1726,39907,87,27200,24676,17884,6006
2021-12-29 18:30:00+00,5479,268,6796,17189,506,4764,2399,214,0,1436,39051,86,26890,24491,17695,5747
2021-12-29 19:00:00+00,4749,299,6792,16394,496,4784,2544,280,0,1150,37488,84,26226,23682,16890,5048
2021-12-29 19:30:00+00,4480,298,6798,15923,490,4794,2704,210,0,442,36139,84,25915,23211,16413,4778
2021-12-29 20:00:00+00,4261,3,6791,15868,433,4726,2746,177,0,20,35025,77,25838,23092,16301,4264
2021-12-29 20:30:00+00,3377,0,6804,15872,389,4612,2620,171,0,20,33865,68,25685,23065,16261,3377
2021-12-29 21:00:00+00,2957,0,6799,15661,344,3852,2469,117,0,62,32261,63,25273,22804,16005,2957
2021-12-29 21:30:00+00,2637,0,6805,15314,363,3634,2251,118,0,0,31122,58,24733,22482,15677,2637
2021-12-29 22:00:00+00,2781,0,6798,15671,329,2112,2185,121,0,0,29997,52,24983,22798,16000,2781
2021-12-29 22:30:00+00,2398,0,6800,15574,327,1984,2167,124,0,0,29374,48,24868,22701,15901,2398
2021-12-29 23:00:00+00,1903,0,6804,15642,296,1454,2200,116,0,0,28415,48,24942,22742,15938,1903
2021-12-29 23:30:00+00,1700,0,6796,15570,296,1486,2220,116,0,0,28184,47,24882,22662,15866,1700
2021-12-30 00:00:00+00,2587,0,6799,15309,281,814,2372,115,0,0,28277,55,24761,22389,15590,2587
2021-12-30 00:30:00+00,2718,0,6798,15287,277,854,2561,122,0,0,28617,57,24923,22362,15564,2718
2021-12-30 01:00:00+00,2851,0,6797,15400,275,696,2565,119,0,0,28703,54,25037,22472,15675,2851
2021-12-30 01:30:00+00,2256,0,6800,15555,274,606,2423,119,0,0,28033,45,25052,22629,15829,2256
2021-12-30 02:00:00+00,2748,0,6792,15508,222,290,2454,119,0,0,28133,53,24976,22522,15730,2748
2021-12-30 02:30:00+00,2494,0,6796,15562,204,216,2545,119,0,0,27936,49,25107,22562,15766,2494
2021-12-30 03:00:00+00,2065,0,6796,15768,193,300,2312,119,0,0,27553,45,25069,22757,15961,2065
2021-12-30 03:30:00+00,2058,0,6797,15501,194,238,2244,118,0,0,27150,44,24736,22492,15695,2058
2021-12-30 04:00:00+00,2155,0,6794,15694,192,188,2272,118,0,0,27413,45,24952,22680,15886,2155
2021-12-30 04:30:00+00,2263,0,6800,15627,189,70,2231,118,0,0,27298,45,24847,22616,15816,2263
2021-12-30 05:00:00+00,2404,0,6797,15577,201,30,2340,115,0,0,27464,46,24915,22575,15778,2404
2021-12-30 05:30:00+00,2598,0,6799,15572,202,56,2482,117,0,0,27826,50,25055,22573,15774,2598
2021-12-30 06:00:00+00,2531,0,6799,15638,221,256,2403,127,0,0,27975,48,25061,22658,15859,2531
2021-12-30 06:30:00+00,2668,0,6797,15834,248,284,2487,122,0,0,28440,49,25366,22879,16082,2668
2021-12-30 07:00:00+00,2469,0,6801,16150,296,884,2429,117,0,0,29146,51,25676,23247,16446,2469
2021-12-30 07:30:00+00,2408,0,6800,15947,306,950,2372,124,0,0,28907,51,25425,23053,16253,2408
2021-12-30 08:00:00+00,2308,0,6799,15284,342,2262,2348,116,0,0,29459,55,24773,22425,15626,2308
2021-12-30 08:30:00+00,2555,0,6795,15982,379,2538,2390,119,29,0,30787,59,25575,23185,16390,2555
2021-12-30 09:00:00+00,3149,0,6794,16224,425,2530,2570,122,182,0,31996,61,26195,23625,16831,3149
2021-12-30 09:30:00+00,3318,0,6789,16133,447,2582,2650,123,404,0,32446,63,26423,23773,16984,3318
2021-12-30 10:00:00+00,3375,0,6785,16058,462,3570,2345,123,738,48,33504,62,26388,24043,17258,3375
2021-12-30 10:30:00+00,3595,0,6792,16237,467,3606,2418,77,990,134,34316,63,26904,24486,17694,3595
2021-12-30 11:00:00+00,4191,0,6790,16143,596,3420,2643,110,1016,204,35113,67,27188,24545,17755,4191
2021-12-30 11:30:00+00,4782,0,6796,16110,632,3440,2631,131,834,296,35652,73,27003,24372,17576,4782
2021-12-30 12:00:00+00,4791,0,6789,16023,712,3742,2702,125,585,468,35937,75,26811,24109,17320,4791
2021-12-30 12:30:00+00,5548,0,6797,15263,697,3752,2755,116,464,618,36010,83,25976,23221,16424,5548
2021-12-30 13:00:00+00,5533,0,6797,14840,653,3752,2733,114,447,990,35859,84,25470,22737,15940,5533
2021-12-30 13:30:00+00,5120,0,6803,15319,661,3752,2723,115,357,850,35700,79,25863,23140,16337,5120
2021-12-30 14:00:00+00,5051,0,6795,15209,624,3752,2681,214,238,1046,35610,79,25547,22866,16071,5051
2021-12-30 14:30:00+00,5993,0,6803,14800,645,3740,2686,227,126,612,35632,90,25060,22374,15571,5993
2021-12-30 15:00:00+00,6797,0,6801,14612,560,3346,2702,141,38,1162,36159,97,24713,22011,15210,6797
2021-12-30 15:30:00+00,7490,0,6811,14488,521,3312,2676,126,2,944,36370,103,24498,21822,15011,7490
2021-12-30 16:00:00+00,7725,0,6807,14601,600,3718,2700,228,0,1322,37701,103,24708,22008,15201,7725
2021-12-30 16:30:00+00,8238,0,6801,14173,689,3756,2583,289,0,2146,38675,106,24246,21663,14862,8238
2021-12-30 17:00:00+00,8895,0,6810,13828,739,3772,2635,466,0,2256,39401,112,24012,21377,14567,8895
2021-12-30 17:30:00+00,8511,0,6805,13882,838,3772,2497,570,0,2214,39089,109,24022,21525,14720,8511
2021-12-30 18:00:00+00,8153,0,6804,13868,811,3802,2373,329,0,2370,38510,106,23856,21483,14679,8153
2021-12-30 18:30:00+00,7794,0,6797,13831,734,3852,2512,300,0,2342,38162,104,23874,21362,14565,7794
2021-12-30 19:00:00+00,7407,0,6798,13590,732,3992,2646,272,0,1628,37065,104,23766,21120,14322,7407
2021-12-30 19:30:00+00,6646,0,6801,13682,752,3934,2590,266,0,932,35603,99,23825,21235,14434,6646
2021-12-30 20:00:00+00,5652,0,6794,13893,575,4024,2444,274,0,634,34290,92,23706,21262,14468,5652
2021-12-30 20:30:00+00,4862,0,6794,14018,537,3966,2251,276,0,350,33054,85,23600,21349,14555,4862
2021-12-30 21:00:00+00,3952,0,6791,14077,447,4044,2338,265,0,0,31914,78,23653,21315,14524,3952
2021-12-30 21:30:00+00,2988,0,6798,14006,401,3880,2276,270,0,0,30619,67,23481,21205,14407,2988
2021-12-30 22:00:00+00,2684,0,6796,12711,400,4040,2206,264,0,0,29101,68,22113,19907,13111,2684
2021-12-30 22:30:00+00,2676,0,6796,12021,383,3842,2164,265,0,0,28147,68,21364,19200,12404,2676
2021-12-30 23:00:00+00,2658,0,6794,11828,379,2722,2038,303,0,0,26722,69,21039,19001,12207,2658
2021-12-30 23:30:00+00,2459,0,6805,11792,378,2644,1916,265,0,0,26259,67,20891,18975,12170,2459
2021-12-31 00:00:00+00,2577,0,6797,12101,376,2182,1908,269,0,0,26210,68,21182,19274,12477,2577
2021-12-31 00:30:00+00,2728,0,6804,12335,360,2282,2014,268,0,0,26791,71,21513,19499,12695,2728
2021-12-31 01:00:00+00,2787,0,6800,12328,359,2106,2063,265,0,0,26708,69,21550,19487,12687,2787
2021-12-31 01:30:00+00,2568,0,6799,12488,329,1886,1806,261,0,0,26137,63,21422,19616,12817,2568
2021-12-31 02:00:00+00,2456,0,6798,12848,326,1582,1773,258,0,0,26041,60,21745,19972,13174,2456
2021-12-31 02:30:00+00,2414,0,6793,12815,326,1490,1755,259,0,0,25852,58,21689,19934,13141,2414
2021-12-31 03:00:00+00,2523,0,6791,12831,328,1010,1760,261,0,0,25504,58,21710,19950,13159,2523
2021-12-31 03:30:00+00,2483,0,6794,12494,327,930,1757,247,0,0,25032,57,21372,19615,12821,2483
2021-12-31 04:00:00+00,2554,0,6785,12423,327,1044,1811,131,0,0,25075,59,21346,19535,12750,2554
2021-12-31 04:30:00+00,2600,0,6789,12476,336,998,1782,132,0,0,25113,59,21383,19601,12812,2600
2021-12-31 05:00:00+00,2812,0,6781,12409,336,748,1948,127,0,0,25161,64,21474,19526,12745,2812
2021-12-31 05:30:00+00,2993,0,6788,12259,339,888,2185,137,0,0,25589,70,21571,19386,12598,2993
2021-12-31 06:00:00+00,2968,0,6796,12200,355,1776,2069,132,0,0,26296,73,21420,19351,12555,2968
2021-12-31 06:30:00+00,3091,0,6800,12470,369,1912,1960,132,0,0,26734,75,21599,19639,12839,3091
2021-12-31 07:00:00+00,2901,0,6801,12403,402,2702,1806,76,0,0,27091,78,21412,19606,12805,2901
2021-12-31 07:30:00+00,2802,0,6803,12398,405,3064,1814,61,0,0,27347,76,21420,19606,12803,2802
2021-12-31 08:00:00+00,2829,0,6798,12701,418,3454,1813,60,0,0,28073,72,21730,19917,13119,2829
2021-12-31 08:30:00+00,2931,0,6796,13485,421,3798,1896,66,11,0,29404,74,22609,20713,13917,2931
2021-12-31 09:00:00+00,2947,0,6800,13940,553,4410,1847,60,143,0,30700,71,23283,21436,14636,2947
2021-12-31 09:30:00+00,3004,0,6792,14131,677,4316,1901,65,383,68,31337,68,23884,21983,15191,3004
2021-12-31 10:00:00+00,3299,0,6793,14306,664,4150,2050,66,723,362,32413,69,24536,22486,15693,3299
2021-12-31 10:30:00+00,3366,0,6790,14362,506,4068,2134,71,1148,394,32839,68,24940,22806,16016,3366
2021-12-31 11:00:00+00,3649,0,6792,14454,608,3976,2214,64,1517,314,33588,69,25585,23371,16579,3649
2021-12-31 11:30:00+00,3794,0,6790,14546,631,3934,2193,63,1706,288,33945,69,25866,23673,16883,3794
2021-12-31 12:00:00+00,4355,0,6793,14546,641,3132,2280,60,1900,316,34023,76,26160,23880,17087,4355
2021-12-31 12:30:00+00,4487,0,6791,14410,643,3463,2213,71,1977,412,34467,77,26034,23821,17030,4487
2021-12-31 13:00:00+00,4716,0,6792,14041,628,3706,1946,67,1715,460,34071,79,25122,23176,16384,4716
2021-12-31 13:30:00+00,4959,0,6795,13847,625,3700,1838,63,1454,354,33635,82,24559,22721,15926,4959
2021-12-31 14:00:00+00,5094,0,6799,13740,625,3944,1727,64,941,138,33072,86,23832,22105,15306,5094
2021-12-31 14:30:00+00,5162,0,6796,13479,574,4004,1661,67,585,442,32770,88,23095,21434,14638,5162
2021-12-31 15:00:00+00,5345,0,6802,13440,413,3902,1661,149,235,1236,33183,88,22551,20890,14088,5345
2021-12-31 15:30:00+00,6258,0,6802,13106,480,3986,1660,159,23,1368,33842,98,22071,20411,13609,6258
2021-12-31 16:00:00+00,7431,0,6800,13211,577,3834,1669,207,0,1516,35245,106,22257,20588,13788,7431
2021-12-31 16:30:00+00,8341,0,6801,13460,683,3982,1663,227,0,1652,36809,113,22607,20944,14143,8341
2021-12-31 17:00:00+00,9060,0,6795,13172,739,3410,1656,562,0,2012,37406,121,22362,20706,13911,9060
2021-12-31 17:30:00+00,9003,0,6792,13093,734,3398,1787,389,0,2188,37384,119,22406,20619,13827,9003
2021-12-31 18:00:00+00,9018,0,6791,12877,747,3084,1870,261,0,2170,36818,122,22285,20415,13624,9018
2021-12-31 18:30:00+00,8374,0,6789,12404,760,3034,1889,156,0,2258,35664,117,21842,19953,13164,8374
2021-12-31 19:00:00+00,8133,0,6788,11933,760,3342,2008,115,0,1762,34841,121,21489,19481,12693,8133
2021-12-31 19:30:00+00,7618,0,6792,11609,758,3334,2100,69,0,1008,33288,120,21259,19159,12367,7618
2021-12-31 20:00:00+00,7130,0,6791,11582,784,3192,2108,65,0,590,32242,119,21265,19157,12366,7130
2021-12-31 20:30:00+00,6146,0,6793,11958,618,3120,1905,68,0,274,30882,110,21274,19369,12576,6146
2021-12-31 21:00:00+00,4964,0,6785,11822,522,3400,1702,73,0,184,29452,100,20831,19129,12344,4964
2021-12-31 21:30:00+00,4070,0,6792,11722,559,3424,1691,69,0,80,28407,92,20764,19073,12281,4070
2021-12-31 22:00:00+00,3601,0,6799,11842,464,3214,1797,67,0,0,27784,87,20902,19105,12306,3601
2021-12-31 22:30:00+00,2863,0,6801,11969,387,3200,1829,65,0,0,27114,79,20986,19157,12356,2863
2021-12-31 23:00:00+00,2802,0,6801,12368,352,1652,1597,63,0,0,25634,73,21118,19520,12720,2802
2021-12-31 23:30:00+00,2729,0,6806,12894,337,1452,1525,77,0,0,25820,68,21562,20037,13231,2729
2022-01-01 00:00:00+00,2844,0,6799,12587,286,1502,1536,70,0,0,25624,72,21208,19672,12873,2844
2022-01-01 00:30:00+00,2953,0,6800,13016,283,1500,1553,149,0,0,26254,73,21652,20099,13299,2953
2022-01-01 01:00:00+00,2879,0,6808,13674,260,1328,1528,144,0,0,26621,71,22270,20742,13934,2879
2022-01-01 01:30:00+00,2691,0,6804,13723,268,1126,1521,144,0,0,26277,66,22316,20795,13991,2691
2022-01-01 02:00:00+00,3450,0,6796,14123,248,796,1602,88,0,0,27103,72,22769,21167,14371,3450
2022-01-01 02:30:00+00,3159,0,6800,14270,226,684,1521,57,0,0,26717,66,22817,21296,14496,3159
2022-01-01 03:00:00+00,3014,0,6797,14862,218,704,1524,63,0,0,27182,63,23401,21877,15080,3014
2022-01-01 03:30:00+00,2827,0,6793,14789,219,504,1520,72,0,0,26724,58,23321,21801,15008,2827
2022-01-01 04:00:00+00,2798,0,6800,14576,218,632,1527,57,0,0,26608,60,23121,21594,14794,2798
2022-01-01 04:30:00+00,2748,0,6796,14465,229,420,1526,53,0,0,26237,56,23016,21490,14694,2748
2022-01-01 05:00:00+00,2629,0,6799,14626,214,304,1545,55,0,0,26172,53,23184,21639,14840,2629
2022-01-01 05:30:00+00,2636,0,6801,14598,211,316,1573,55,0,0,26190,53,23183,21610,14809,2636
2022-01-01 06:00:00+00,2778,0,6796,15110,228,198,1601,58,0,0,26769,52,23735,22134,15338,2778
2022-01-01 06:30:00+00,2505,0,6804,15666,229,256,1602,54,0,0,27116,48,24301,22699,15895,2505
2022-01-01 07:00:00+00,2451,0,6805,16035,249,150,1623,57,0,0,27370,46,24712,23089,16284,2451
2022-01-01 07:30:00+00,2567,0,6807,15835,278,228,1472,54,0,0,27241,48,24392,22920,16113,2567
2022-01-01 08:00:00+00,2780,0,6801,15921,277,172,1344,69,0,0,27364,50,24343,22999,16198,2780
2022-01-01 08:30:00+00,2698,0,6810,16336,277,368,1336,63,87,0,27975,50,24846,23510,16700,2698
2022-01-01 09:00:00+00,2757,0,6810,16569,293,156,1345,62,441,0,28433,47,25458,24113,17303,2757
2022-01-01 09:30:00+00,3246,0,6802,16607,289,210,1357,74,910,0,29495,53,25965,24608,17806,3246
2022-01-01 10:00:00+00,3174,0,6804,16618,278,238,1356,73,1116,56,29713,49,26172,24816,18012,3174
2022-01-01 10:30:00+00,3139,0,6805,16913,300,439,1353,72,1382,142,30545,49,26753,25400,18595,3139
2022-01-01 11:00:00+00,2473,0,6804,16886,295,888,1353,68,1518,300,30585,42,26856,25503,18699,2473
2022-01-01 11:30:00+00,2771,0,6802,16949,283,920,1390,66,1433,406,31020,46,26857,25467,18665,2771
2022-01-01 12:00:00+00,3313,0,6801,16937,261,540,1607,239,1446,616,31760,51,27052,25445,18644,3313
2022-01-01 12:30:00+00,3550,0,6806,17022,269,540,1678,466,1286,410,32027,56,27061,25383,18577,3550
2022-01-01 13:00:00+00,3160,0,6803,16766,251,1100,1676,198,1145,416,31515,51,26641,24965,18162,3160
2022-01-01 13:30:00+00,3477,0,6798,16367,236,1124,1676,134,1061,200,31073,56,26138,24462,17664,3477
2022-01-01 14:00:00+00,3457,0,6796,16207,235,1104,1697,155,868,504,31023,56,25803,24106,17310,3457
2022-01-01 14:30:00+00,3579,0,6798,16140,237,1116,1663,151,612,298,30594,58,25450,23787,16989,3579
2022-01-01 15:00:00+00,3745,0,6792,16150,353,1442,1439,142,209,632,30904,60,24943,23504,16712,3745
2022-01-01 15:30:00+00,4254,0,6792,15918,384,1622,1421,140,35,676,31242,68,24550,23129,16337,4254
2022-01-01 16:00:00+00,5006,0,6790,15506,349,1937,1485,159,0,1498,32730,72,24130,22645,15855,5006
2022-01-01 16:30:00+00,5681,0,6797,15560,353,2102,1646,267,0,1952,34358,80,24356,22710,15913,5681
2022-01-01 17:00:00+00,5426,0,6797,15617,394,2720,1716,374,0,2030,35074,79,24524,22808,16011,5426
2022-01-01 17:30:00+00,5611,0,6797,15570,408,2650,1707,362,0,2030,35135,79,24482,22775,15978,5611
2022-01-01 18:00:00+00,5792,0,6795,15341,408,2573,1712,274,0,2028,34923,82,24256,22544,15749,5792
2022-01-01 18:30:00+00,5773,0,6791,15224,398,2501,1632,200,0,1884,34404,81,24045,22413,15622,5773
2022-01-01 19:00:00+00,4747,0,6794,15250,402,2658,1474,143,0,1450,32918,72,23920,22446,15652,4747
2022-01-01 19:30:00+00,4223,0,6798,14937,405,2624,1472,138,0,1304,31901,67,23612,22140,15342,4223
2022-01-01 20:00:00+00,4912,0,6796,14656,324,1606,1473,136,0,880,30784,75,23250,21776,14980,4912
2022-01-01 20:30:00+00,4561,0,6796,14460,319,1556,1479,150,0,742,30063,73,23054,21575,14779,4561
2022-01-01 21:00:00+00,3726,0,6795,14495,312,2114,1474,189,0,352,29457,69,23076,21602,14807,3726
2022-01-01 21:30:00+00,2962,0,6786,14342,311,2074,1476,152,0,188,28291,61,22915,21439,14653,2962
2022-01-01 22:00:00+00,2804,0,6791,14755,266,1354,1478,154,0,162,27764,58,23290,21812,15021,2804
2022-01-01 22:30:00+00,2796,0,6795,14516,244,1008,1657,162,0,0,27178,56,23212,21555,14760,2796
2022-01-01 23:00:00+00,3152,0,6799,14821,244,214,1780,160,0,0,27170,56,23644,21864,15065,3152
2022-01-01 23:30:00+00,3186,0,6810,14715,242,212,1768,138,0,0,27071,56,23535,21767,14957,3186
2022-01-02 00:00:00+00,2187,0,6815,14762,246,488,1764,134,0,0,26396,43,23587,21823,15008,2187
2022-01-02 00:30:00+00,2346,0,6820,14387,243,492,1777,138,0,0,26203,46,23227,21450,14630,2346
2022-01-02 01:00:00+00,2273,0,6824,14471,228,842,1758,134,0,0,26530,47,23281,21523,14699,2273
2022-01-02 01:30:00+00,2254,0,6822,14301,222,820,1759,133,0,0,26311,47,23104,21345,14523,2254
2022-01-02 02:00:00+00,2337,0,6819,14089,194,204,1758,138,0,0,25539,48,22860,21102,14283,2337
2022-01-02 02:30:00+00,2163,0,6823,14284,180,236,1754,139,0,0,25579,46,23041,21287,14464,2163
2022-01-02 03:00:00+00,2184,0,6806,14581,169,300,1766,140,0,0,25946,47,23322,21556,14750,2184
2022-01-02 03:30:00+00,2148,0,6807,14529,168,166,1762,140,0,0,25720,46,23266,21504,14697,2148
2022-01-02 04:00:00+00,2328,0,6798,14489,168,322,1766,140,0,0,26011,51,23221,21455,14657,2328
2022-01-02 04:30:00+00,2199,0,6798,14372,169,274,1754,140,0,0,25706,48,23093,21339,14541,2199
2022-01-02 05:00:00+00,2694,0,6799,14360,190,295,1756,141,0,0,26235,55,23105,21349,14550,2694
2022-01-02 05:30:00+00,2597,0,6806,14768,211,232,1752,140,0,0,26506,52,23537,21785,14979,2597
2022-01-02 06:00:00+00,2391,0,6801,15204,212,342,1772,141,0,0,26863,50,23989,22217,15416,2391
2022-01-02 06:30:00+00,2675,0,6793,15097,212,344,1784,143,0,0,27048,54,23886,22102,15309,2675
2022-01-02 07:00:00+00,2347,0,6803,15335,216,349,1764,134,0,0,26948,50,24118,22354,15551,2347
2022-01-02 07:30:00+00,2341,0,6807,15435,235,320,1761,134,0,0,27033,49,24238,22477,15670,2341
2022-01-02 08:00:00+00,3070,0,6803,15166,258,360,1571,139,0,0,27367,58,23798,22227,15424,3070
2022-01-02 08:30:00+00,3601,0,6805,14961,261,504,1477,142,149,0,27900,66,23653,22176,15371,3601
2022-01-02 09:00:00+00,3101,0,6809,15224,241,660,1474,157,709,22,28397,59,24457,22983,16174,3101
2022-01-02 09:30:00+00,3421,0,6809,15726,238,782,1474,151,1291,90,29982,62,25538,24064,17255,3421
2022-01-02 10:00:00+00,3322,0,6805,15544,268,1518,1469,142,1719,12,30799,58,25805,24336,17531,3322
2022-01-02 10:30:00+00,3421,0,6804,15928,266,1590,1567,134,2094,0,31804,58,26659,25092,18288,3421
2022-01-02 11:00:00+00,4101,0,6810,16052,238,1634,1615,136,1933,166,32686,65,26649,25034,18223,4101
2022-01-02 11:30:00+00,4457,0,6813,16112,244,1670,1683,134,2181,222,33516,68,27033,25350,18537,4457
2022-01-02 12:00:00+00,4087,0,6814,16225,274,2734,1669,151,1502,232,33688,66,26484,24815,18001,4087
2022-01-02 12:30:00+00,4419,0,6812,16622,274,2728,1639,141,1523,222,34380,68,26870,25231,18419,4419
2022-01-02 13:00:00+00,4379,0,6810,16802,274,3092,1500,139,1046,602,34644,68,26432,24932,18122,4379
2022-01-02 13:30:00+00,4765,0,6808,16888,278,3022,1468,135,682,432,34478,72,26124,24656,17848,4765
2022-01-02 14:00:00+00,5238,0,6805,16712,297,2506,1491,68,414,506,34037,78,25719,24228,17423,5238
2022-01-02 14:30:00+00,5032,0,6804,16443,311,2608,1561,54,358,962,34133,77,25477,23916,17112,5032
2022-01-02 15:00:00+00,5745,0,6803,16409,366,1854,1520,72,214,1490,34473,80,25312,23792,16989,5745
2022-01-02 15:30:00+00,6443,0,6802,16307,368,1928,1470,86,49,1536,34989,88,24996,23526,16724,6443
2022-01-02 16:00:00+00,6871,0,6800,16439,387,2480,1613,167,0,1208,35966,95,25240,23627,16826,6871
2022-01-02 16:30:00+00,7244,0,6800,16234,404,2622,1776,228,0,2006,37313,97,25213,23437,16638,7244
2022-01-02 17:00:00+00,7103,0,6799,16377,440,3688,1807,356,0,1702,38272,95,25423,23616,16817,7103
2022-01-02 17:30:00+00,6782,0,6798,16069,453,3666,1730,341,0,2222,38061,91,25050,23320,16522,6782
2022-01-02 18:00:00+00,6667,0,6796,15921,480,3184,1646,164,0,2120,36979,89,24844,23198,16401,6667
2022-01-02 18:30:00+00,6391,0,6795,16364,491,2920,1584,96,0,1440,36081,85,25234,23650,16855,6391
2022-01-02 19:00:00+00,5994,0,6793,16603,514,2652,1616,53,0,1090,35315,84,25526,23910,17117,5994
2022-01-02 19:30:00+00,5285,0,6789,17034,555,2544,1496,46,0,428,34177,77,25874,24378,17589,5285
2022-01-02 20:00:00+00,4281,0,6784,17234,529,2102,1484,58,0,1008,33480,66,26031,24547,17763,4281
2022-01-02 20:30:00+00,3338,0,6785,17268,564,2122,1478,52,0,932,32539,57,26095,24617,17832,3338
2022-01-02 21:00:00+00,2991,0,6785,17136,540,1870,1588,57,0,492,31459,56,26049,24461,17676,2991
2022-01-02 21:30:00+00,2617,0,6783,17020,523,1324,1791,47,0,252,30357,48,26117,24326,17543,2617
2022-01-02 22:00:00+00,3378,0,6779,16974,505,366,1889,49,0,264,30204,56,26147,24258,17479,3378
2022-01-02 22:30:00+00,3463,0,6783,16938,483,312,1920,48,0,0,29947,58,26124,24204,17421,3463
2022-01-02 23:00:00+00,3367,0,6782,16427,474,630,1998,46,0,0,29724,57,25681,23683,16901,3367
2022-01-02 23:30:00+00,3187,0,6786,15603,446,450,1851,45,0,0,28368,54,24686,22835,16049,3187
2022-01-03 00:00:00+00,2723,0,6789,15648,277,714,1793,47,0,0,27991,49,24507,22714,15925,2723
2022-01-03 00:30:00+00,3013,0,6794,15695,274,792,1799,53,0,0,28420,54,24562,22763,15969,3013
2022-01-03 01:00:00+00,2611,0,6799,15785,259,1212,1779,49,0,0,28494,50,24622,22843,16044,2611
2022-01-03 01:30:00+00,2275,0,6800,15694,255,1220,1730,49,0,0,28023,46,24479,22749,15949,2275
2022-01-03 02:00:00+00,2195,0,6799,15621,254,798,1747,50,0,0,27464,45,24421,22674,15875,2195
2022-01-03 02:30:00+00,2127,0,6801,15174,254,886,1768,49,0,0,27059,46,23997,22229,15428,2127
2022-01-03 03:00:00+00,2212,0,6792,15414,254,530,1779,53,0,0,27034,47,24239,22460,15668,2212
2022-01-03 03:30:00+00,2045,0,6794,14703,256,410,1774,63,0,0,26045,45,23527,21753,14959,2045
2022-01-03 04:00:00+00,2020,0,6791,14172,265,200,1795,68,0,0,25311,44,23023,21228,14437,2020
2022-01-03 04:30:00+00,1986,0,6794,14211,267,96,1773,47,0,0,25174,42,23045,21272,14478,1986
2022-01-03 05:00:00+00,2036,0,6793,15350,280,208,1779,50,0,0,26496,42,24202,22423,15630,2036
2022-01-03 05:30:00+00,2422,0,6784,16005,298,184,1805,60,0,0,27558,46,24892,23087,16303,2422
2022-01-03 06:00:00+00,3043,0,6785,16209,329,392,1903,75,0,0,28736,57,25226,23323,16538,3043
2022-01-03 06:30:00+00,3114,0,6794,16376,443,666,1987,81,0,0,29461,61,25600,23613,16819,3114
2022-01-03 07:00:00+00,3536,0,6792,16161,535,592,1911,50,0,0,29577,65,25399,23488,16696,3536
2022-01-03 07:30:00+00,3805,0,6781,15800,550,620,1743,56,0,454,29809,67,24874,23131,16350,3805
2022-01-03 08:00:00+00,4548,0,6785,15448,573,480,1471,46,0,408,29759,74,24277,22806,16021,4548
2022-01-03 08:30:00+00,5700,0,6788,15339,581,468,1476,69,101,408,30930,86,24285,22809,16021,5700
2022-01-03 09:00:00+00,7383,0,6788,15316,589,232,1535,105,452,368,32768,99,24680,23145,16357,7383
2022-01-03 09:30:00+00,7970,0,6790,15552,607,306,1532,66,858,380,34061,102,25339,23807,17017,7970
2022-01-03 10:00:00+00,7141,0,6776,16299,621,476,1441,46,1186,264,34250,89,26323,24882,18106,7141
2022-01-03 10:30:00+00,7263,0,6771,16571,617,456,1449,58,1349,270,34804,89,26757,25308,18537,7263
2022-01-03 11:00:00+00,7090,0,6771,16279,661,957,1568,51,1910,264,35551,88,27189,25621,18850,7090
2022-01-03 11:30:00+00,7835,0,6765,15734,663,952,1629,66,1845,196,35685,96,26636,25007,18242,7835
2022-01-03 12:00:00+00,8142,0,6770,15244,670,1318,1617,59,1472,136,35428,101,25773,24156,17386,8142
2022-01-03 12:30:00+00,8058,0,6766,15282,809,1378,1502,60,1179,142,35176,101,25538,24036,17270,8058
2022-01-03 13:00:00+00,8369,0,6766,15089,814,1524,1454,60,983,142,35201,103,25106,23652,16886,8369
2022-01-03 13:30:00+00,8493,0,6764,14809,817,1582,1445,68,777,142,34897,106,24612,23167,16403,8493
2022-01-03 14:00:00+00,8469,0,6758,14609,809,2090,1450,63,646,142,35036,107,24272,22822,16064,8469
2022-01-03 14:30:00+00,8784,0,6763,14367,810,2108,1498,68,466,266,35130,111,23904,22406,15643,8784
2022-01-03 15:00:00+00,9335,0,6763,13959,702,2054,1681,57,194,602,35347,117,23299,21618,14855,9335
2022-01-03 15:30:00+00,9907,0,6758,13983,721,2198,1628,79,24,904,36202,122,23114,21486,14728,9907
2022-01-03 16:00:00+00,10440,0,6766,14192,918,2966,1623,166,0,1138,38209,123,23499,21876,15110,10440
2022-01-03 16:30:00+00,11520,0,6760,13858,917,3736,1631,214,0,1956,40592,127,23166,21535,14775,11520
2022-01-03 17:00:00+00,12319,0,6770,13708,952,4422,1632,511,0,1656,41970,134,23062,21430,14660,12319
2022-01-03 17:30:00+00,12126,0,6773,13524,953,4385,1648,496,0,1652,41557,132,22898,21250,14477,12126
2022-01-03 18:00:00+00,11867,0,6765,13108,953,4110,1725,389,0,1902,40819,132,22551,20826,14061,11867
2022-01-03 18:30:00+00,11548,0,6773,13012,950,4060,1725,285,0,1730,40083,130,22460,20735,13962,11548
2022-01-03 19:00:00+00,10581,0,6776,12454,932,4696,1652,227,0,1146,38464,129,21814,20162,13386,10581
2022-01-03 19:30:00+00,9911,0,6773,12181,933,4632,1531,173,0,732,36866,126,21418,19887,13114,9911
2022-01-03 20:00:00+00,8718,0,6769,12102,931,4476,1448,161,0,1020,35625,117,21250,19802,13033,8718
2022-01-03 20:30:00+00,7701,0,6771,12200,920,4304,1446,155,0,872,34369,107,21337,19891,13120,7701
2022-01-03 21:00:00+00,6772,0,6765,12177,818,4346,1468,122,0,670,33138,101,21228,19760,12995,6772
2022-01-03 21:30:00+00,5970,0,6766,12127,692,4212,1494,102,0,428,31791,95,21079,19585,12819,5970
2022-01-03 22:00:00+00,5497,0,6768,12235,724,3410,1564,98,0,316,30612,90,21291,19727,12959,5497
2022-01-03 22:30:00+00,4614,0,6765,12180,724,3270,1726,100,0,0,29379,81,21395,19669,12904,4614
2022-01-03 23:00:00+00,3810,0,6757,11849,712,3002,1771,102,0,0,28003,70,21089,19318,12561,3810
2022-01-03 23:30:00+00,2896,0,6764,11853,708,3112,1790,94,0,0,27217,60,21115,19325,12561,2896
2022-01-04 00:00:00+00,2925,0,6761,11687,688,3056,1743,95,0,0,26955,66,20879,19136,12375,2925
2022-01-04 00:30:00+00,3482,0,6764,10997,675,3162,1905,103,0,0,27088,76,20341,18436,11672,3482
2022-01-04 01:00:00+00,3606,0,6768,10822,671,3330,1971,99,0,0,27267,80,20232,18261,11493,3606
2022-01-04 01:30:00+00,3646,0,6766,10622,671,3148,1979,107,0,0,26939,78,20038,18059,11293,3646
2022-01-04 02:00:00+00,3567,0,6772,10346,625,2876,1973,107,0,0,26266,79,19716,17743,10971,3567
2022-01-04 02:30:00+00,3630,0,6772,10348,551,2779,2024,103,0,0,26208,80,19696,17672,10900,3630
2022-01-04 03:00:00+00,3627,0,6773,10616,551,2282,2049,99,0,0,25997,75,19989,17940,11167,3627
2022-01-04 03:30:00+00,3473,0,6774,10923,593,2236,1871,44,0,0,25914,71,20161,18290,11516,3473
2022-01-04 04:00:00+00,3342,0,6776,11581,593,1468,1745,45,0,0,25550,69,20695,18950,12174,3342
2022-01-04 04:30:00+00,3281,0,6764,11522,599,1499,1775,52,0,0,25492,69,20660,18885,12121,3281
2022-01-04 05:00:00+00,3467,0,6760,10751,589,2140,1768,54,0,0,25529,76,19868,18100,11340,3467
2022-01-04 05:30:00+00,4539,0,6765,10511,590,2308,1795,51,0,0,26559,91,19661,17866,11101,4539
2022-01-04 06:00:00+00,5929,0,6764,10297,625,2038,2022,63,0,314,28052,104,19708,17686,10922,5929
2022-01-04 06:30:00+00,7883,0,6764,10381,748,2064,2237,55,0,166,30298,122,20130,17893,11129,7883
2022-01-04 07:00:00+00,9006,0,6763,10651,779,2984,2026,104,0,54,32367,129,20219,18193,11430,9006
2022-01-04 07:30:00+00,10629,0,6764,11134,776,3044,2106,104,0,84,34641,139,20780,18674,11910,10629
2022-01-04 08:00:00+00,11942,0,6761,11455,810,2766,2409,155,0,510,36808,147,21435,19026,12265,11942
2022-01-04 08:30:00+00,13083,0,6763,11928,826,2730,2431,239,40,336,38376,153,21988,19557,12794,13083
2022-01-04 09:00:00+00,13063,0,6764,12503,826,3334,2433,362,370,134,39789,150,22896,20463,13699,13063
2022-01-04 09:30:00+00,13017,0,6767,13040,825,3314,2430,304,808,130,40635,146,23870,21440,14673,13017
2022-01-04 10:00:00+00,13027,0,6751,13315,809,3018,2428,250,1235,496,41329,137,24538,22110,15359,13027
2022-01-04 10:30:00+00,13069,0,6746,13916,800,3000,2427,264,1718,142,42082,134,25607,23180,16434,13069
2022-01-04 11:00:00+00,13037,0,6758,13960,800,2986,2419,272,2169,208,42609,132,26106,23687,16929,13037
2022-01-04 11:30:00+00,12873,0,6766,14529,786,2986,2412,261,2460,136,43209,129,26953,24541,17775,12873
2022-01-04 12:00:00+00,12832,0,6744,14798,786,2924,2431,277,2964,282,44038,126,27723,25292,18548,12832
2022-01-04 12:30:00+00,12721,0,6748,15108,785,2912,2362,298,3321,290,44545,124,28324,25962,19214,12721
2022-01-04 13:00:00+00,12194,0,6741,15402,795,3044,2355,314,3400,74,44319,120,28693,26338,19597,12194
2022-01-04 13:30:00+00,12044,0,6740,15510,798,3038,2346,276,3106,0,43858,120,28500,26154,19414,12044
2022-01-04 14:00:00+00,12155,0,6735,15162,769,3142,2347,206,2280,196,42992,126,27293,24946,18211,12155
2022-01-04 14:30:00+00,12859,0,6739,14719,642,3094,2346,216,1252,714,42581,134,25698,23352,16613,12859
2022-01-04 15:00:00+00,13654,0,6743,14858,636,2100,2350,388,578,1232,42539,139,25165,22815,16072,13654
2022-01-04 15:30:00+00,14030,0,6740,14755,650,2092,2357,438,121,1628,42811,142,24623,22266,15526,14030
2022-01-04 16:00:00+00,14166,0,6743,14678,709,3660,2355,433,0,1886,44630,140,24485,22130,15387,14166
2022-01-04 16:30:00+00,14717,0,6741,15032,712,3746,2429,573,0,2244,46194,141,24914,22485,15744,14717
2022-01-04 17:00:00+00,15428,0,6747,15634,726,3854,2420,585,0,2112,47506,144,25527,23107,16360,15428
2022-01-04 17:30:00+00,15470,0,6747,16397,773,3856,2405,572,0,1778,47998,143,26322,23917,17170,15470
2022-01-04 18:00:00+00,15116,0,6750,16435,793,2958,2397,523,0,1930,46902,143,26375,23978,17228,15116
2022-01-04 18:30:00+00,14552,0,6750,16176,793,2960,2389,468,0,1854,45942,141,26108,23719,16969,14552
2022-01-04 19:00:00+00,13304,0,6753,16428,749,3986,2384,400,0,1154,45158,135,26314,23930,17177,13304
2022-01-04 19:30:00+00,12550,0,6750,16661,743,4008,2376,365,0,98,43551,133,26530,24154,17404,12550
2022-01-04 20:00:00+00,10532,0,6750,16919,697,3948,2374,350,0,254,41824,120,26740,24366,17616,10532
2022-01-04 20:30:00+00,8792,0,6753,17070,682,3928,2372,210,0,258,40065,107,26877,24505,17752,8792
2022-01-04 21:00:00+00,7486,0,6748,16977,623,3928,2215,134,0,134,38245,100,26563,24348,17600,7486
2022-01-04 21:30:00+00,6006,0,6740,16904,619,3826,2024,100,0,32,36251,88,26287,24263,17523,6006
2022-01-04 22:00:00+00,5282,0,6744,17176,556,2304,2025,110,0,64,34261,79,26501,24476,17732,5282
2022-01-04 22:30:00+00,4035,0,6741,17262,554,2302,1935,69,0,8,32906,67,26492,24557,17816,4035
2022-01-04 23:00:00+00,3063,0,6748,16622,554,2924,1925,27,0,0,31863,61,25849,23924,17176,3063
2022-01-04 23:30:00+00,2690,0,6741,16116,533,2954,1918,15,0,0,30967,58,25308,23390,16649,2690
2022-01-05 00:00:00+00,2795,0,6751,16069,510,2970,1806,22,0,0,30923,56,25136,23330,16579,2795
2022-01-05 00:30:00+00,2820,0,6746,16282,509,2962,2095,12,0,0,31426,57,25632,23537,16791,2820
2022-01-05 01:00:00+00,2320,0,6746,16684,495,3260,2094,36,0,0,31635,50,26019,23925,17179,2320
2022-01-05 01:30:00+00,1819,0,6739,16989,505,3284,1952,51,0,0,31339,44,26185,24233,17494,1819
2022-01-05 02:00:00+00,1721,0,6751,17320,491,3124,1803,52,0,0,31262,44,26365,24562,17811,1721
2022-01-05 02:30:00+00,1794,0,6744,17019,478,3104,1746,53,0,0,30938,46,25987,24241,17497,1794
2022-01-05 03:00:00+00,1917,0,6746,17006,473,2630,1753,49,0,0,30574,46,25978,24225,17479,1917
2022-01-05 03:30:00+00,1873,0,6743,16745,482,2616,1766,54,0,0,30279,46,25736,23970,17227,1873
2022-01-05 04:00:00+00,2466,0,6747,16553,474,1890,1944,53,0,0,30127,54,25718,23774,17027,2466
2022-01-05 04:30:00+00,2309,0,6741,16651,440,1892,1953,54,0,0,30040,52,25785,23832,17091,2309
2022-01-05 05:00:00+00,2523,0,6741,16317,459,2224,1912,54,0,0,30230,54,25429,23517,16776,2523
2022-01-05 05:30:00+00,3177,0,6711,16292,470,2268,1955,58,0,0,30931,61,25428,23473,16762,3177
2022-01-05 06:00:00+00,4228,0,6684,16425,500,2478,2019,46,0,0,32380,71,25628,23609,16925,4228
2022-01-05 06:30:00+00,6107,0,6684,16277,556,2506,2098,44,0,0,34272,89,25615,23517,16833,6107
2022-01-05 07:00:00+00,9026,0,6680,15996,618,2234,2378,61,0,386,37379,111,25672,23294,16614,9026
2022-01-05 07:30:00+00,11590,0,6686,15832,617,2226,2394,55,0,312,39712,130,25529,23135,16449,11590
2022-01-05 08:00:00+00,13514,0,6686,15658,656,2170,2364,65,8,156,41277,143,25372,23008,16322,13514
2022-01-05 08:30:00+00,13898,0,6691,15644,662,2174,2423,185,311,160,42148,145,25731,23308,16617,13898
2022-01-05 09:00:00+00,13686,0,6682,15571,716,3282,2434,176,1199,84,43830,137,26602,24168,17486,13686
2022-01-05 09:30:00+00,14018,0,6686,15261,745,3332,2435,170,2241,0,44888,137,27368,24933,18247,14018
2022-01-05 10:00:00+00,13764,0,6679,15016,743,3348,2344,139,3052,0,45085,133,27834,25490,18811,13764
2022-01-05 10:30:00+00,13656,0,6680,14834,760,3354,2322,130,3715,0,45451,131,28311,25989,19309,13656
2022-01-05 11:00:00+00,14167,0,6680,14276,743,3218,2331,130,4042,0,45587,136,28072,25741,19061,14167
2022-01-05 11:30:00+00,14301,0,6683,13910,722,3208,2358,136,4383,0,45701,137,28056,25698,19015,14301
2022-01-05 12:00:00+00,14216,0,6679,13452,723,3950,2425,139,4536,16,46136,137,27815,25390,18711,14216
2022-01-05 12:30:00+00,14657,0,6677,12843,705,3988,2424,138,4416,0,45848,142,27065,24641,17964,14657
2022-01-05 13:00:00+00,15036,0,6680,12425,704,4052,2419,131,3957,0,45404,147,26185,23766,17086,15036
2022-01-05 13:30:00+00,15360,0,6672,12067,704,4056,2421,140,3186,0,44606,152,25050,22629,15957,15360
2022-01-05 14:00:00+00,15571,0,6666,11509,823,4342,2422,156,2452,142,44083,157,23872,21450,14784,15571
2022-01-05 14:30:00+00,16664,0,6665,10803,872,4344,2425,152,1581,224,43730,168,22346,19921,13256,16664
2022-01-05 15:00:00+00,18260,0,6667,10586,933,3866,2432,173,693,88,43698,180,21311,18879,12212,18260
2022-01-05 15:30:00+00,19415,0,6668,10235,964,3854,2437,176,126,256,44131,189,20430,17993,11325,19415
2022-01-05 16:00:00+00,20775,0,6672,9504,1059,3390,2435,406,0,736,44977,196,19670,17235,10563,20775
2022-01-05 16:30:00+00,21577,0,6670,8652,1060,3350,2438,655,0,1628,46030,200,18820,16382,9712,21577
2022-01-05 17:00:00+00,21383,0,6673,8389,1106,4362,2442,874,0,1644,46873,201,18610,16168,9495,21383
2022-01-05 17:30:00+00,21328,0,6671,8021,1111,4374,2440,916,0,2076,46937,201,18243,15803,9132,21328
2022-01-05 18:00:00+00,20978,0,6669,7533,1096,4412,2444,816,0,2218,46166,201,17742,15298,8629,20978
2022-01-05 18:30:00+00,21123,0,6678,6938,1085,4436,2445,617,0,1912,45234,205,17146,14701,8023,21123
2022-01-05 19:00:00+00,20631,0,6678,6638,1060,4756,2441,553,0,1352,44109,208,16817,14376,7698,20631
2022-01-05 19:30:00+00,20027,0,6679,6584,1019,4714,2432,472,0,1216,43143,206,16714,14282,7603,20027
2022-01-05 20:00:00+00,19929,0,6678,6290,1008,4752,2437,365,0,286,41745,211,16413,13976,7298,19929
2022-01-05 20:30:00+00,19123,0,6676,6093,986,4662,2424,246,0,0,40210,210,16179,13755,7079,19123
2022-01-05 21:00:00+00,17785,0,6676,5910,904,4546,2409,194,0,92,38516,205,15899,13490,6814,17785
2022-01-05 21:30:00+00,16534,0,6539,5712,867,4545,2410,158,0,108,36873,200,15528,13118,6579,16534
2022-01-05 22:00:00+00,14962,0,6345,5666,801,4684,2414,150,0,66,35088,194,15226,12812,6467,14962
2022-01-05 22:30:00+00,13648,0,6322,5117,682,4710,2413,145,0,48,33085,191,14534,12121,5799,13648
2022-01-05 23:00:00+00,12738,0,6136,4648,618,4382,2407,197,0,0,31126,188,13809,11402,5266,12738
2022-01-05 23:30:00+00,11856,0,5974,4194,623,4338,2401,221,0,24,29631,185,13192,10791,4817,11856
2022-01-06 00:00:00+00,11560,0,5985,3964,733,4648,2341,135,0,14,29380,190,13023,10682,4697,11560
2022-01-06 00:30:00+00,11910,0,5979,3715,734,4934,2348,163,0,48,29831,196,12776,10428,4449,11910
2022-01-06 01:00:00+00,11618,0,5984,3976,721,5146,2400,149,0,0,29994,194,13081,10681,4697,11618
2022-01-06 01:30:00+00,11176,0,5978,3974,623,5214,2400,131,0,0,29496,192,12975,10575,4597,11176
2022-01-06 02:00:00+00,11372,0,5981,4284,462,5020,2405,135,0,0,29659,191,13132,10727,4746,11372
2022-01-06 02:30:00+00,10996,0,5987,4776,461,5066,2403,143,0,0,29832,186,13627,11224,5237,10996
2022-01-06 03:00:00+00,10755,0,5983,5148,462,4716,2405,145,0,0,29614,183,13998,11593,5610,10755
2022-01-06 03:30:00+00,9851,0,5988,6138,460,4702,2356,144,0,0,29639,170,14942,12586,6598,9851
2022-01-06 04:00:00+00,8786,0,5983,7383,458,4776,2317,145,0,0,29848,156,16141,13824,7841,8786
2022-01-06 04:30:00+00,8366,0,5981,8108,457,4776,2263,134,0,0,30085,149,16809,14546,8565,8366
2022-01-06 05:00:00+00,10047,0,5981,8316,457,2612,2243,121,0,0,29777,163,16997,14754,8773,10047
2022-01-06 05:30:00+00,10821,0,5980,8388,389,2544,2220,117,0,0,30459,168,16977,14757,8777,10821
2022-01-06 06:00:00+00,12343,0,5973,8306,440,2822,2339,122,0,0,32345,175,17058,14719,8746,12343
2022-01-06 06:30:00+00,14269,0,5972,8673,481,2826,2440,200,0,138,34999,184,17566,15126,9154,14269
2022-01-06 07:00:00+00,16727,0,5964,9002,545,3170,2463,146,0,164,38181,193,17974,15511,9547,16727
2022-01-06 07:30:00+00,17581,0,5971,9454,571,3190,2470,230,0,294,39761,195,18466,15996,10025,17581
2022-01-06 08:00:00+00,18256,0,5967,10009,587,3526,2471,322,9,78,41225,196,19043,16572,10605,18256
2022-01-06 08:30:00+00,18622,0,5971,10472,561,3544,2469,377,296,104,42416,194,19769,17300,11329,18622
2022-01-06 09:00:00+00,18425,0,5968,10846,518,4008,2470,357,782,302,43676,188,20584,18114,12146,18425
2022-01-06 09:30:00+00,18448,0,5968,11296,507,3958,2471,322,1202,282,44454,184,21444,18973,13005,18448
2022-01-06 10:00:00+00,18585,0,5956,11702,469,3300,2462,259,1426,778,44937,183,22015,19553,13597,18585
2022-01-06 10:30:00+00,18641,0,5928,12426,466,3254,2448,230,1224,262,44879,184,22492,20044,14116,18641
2022-01-06 11:00:00+00,17980,0,5920,13728,466,3498,2453,210,1023,0,45278,176,23590,21137,15217,17980
2022-01-06 11:30:00+00,17708,0,5922,14808,446,3514,2466,138,949,0,45951,171,24591,22125,16203,17708
2022-01-06 12:00:00+00,17380,0,5916,15731,451,3630,2466,137,694,50,46455,168,25258,22792,16876,17380
2022-01-06 12:30:00+00,17470,0,5921,16092,463,3452,2470,149,571,14,46602,167,25517,23047,17126,17470
2022-01-06 13:00:00+00,17231,0,5916,16408,472,3258,2466,158,503,16,46428,164,25765,23299,17383,17231
2022-01-06 13:30:00+00,16953,0,5857,16571,472,3222,2464,151,421,0,46111,163,25785,23321,17464,16953
2022-01-06 14:00:00+00,16834,0,5820,16714,479,2870,2466,137,459,0,45779,161,25938,23472,17652,16834
2022-01-06 14:30:00+00,16672,0,5820,16489,493,2874,2465,136,272,16,45237,162,25539,23074,17254,16672
2022-01-06 15:00:00+00,16416,0,5842,16720,508,2834,2467,136,101,0,45024,159,25638,23171,17329,16416
2022-01-06 15:30:00+00,16649,0,5852,16959,500,2928,2467,141,31,0,45527,161,25809,23342,17490,16649
2022-01-06 16:00:00+00,16335,0,5858,17029,567,3502,2469,207,0,756,46723,157,25923,23454,17596,16335
2022-01-06 16:30:00+00,16693,0,5859,17094,574,3508,2468,302,0,1036,47534,157,25995,23527,17668,16693
2022-01-06 17:00:00+00,16722,0,5859,17157,572,3080,2468,375,0,1362,47595,159,26056,23588,17729,16722
2022-01-06 17:30:00+00,16168,0,5857,17208,633,2982,2467,393,0,1362,47070,156,26166,23698,17842,16168
2022-01-06 18:00:00+00,15833,0,5855,17053,702,2868,2470,393,0,1302,46476,156,26080,23610,17755,15833
2022-01-06 18:30:00+00,14959,0,5859,17385,730,2804,2472,303,0,1174,45686,150,26446,23974,18115,14959
2022-01-06 19:00:00+00,14139,0,5859,17285,664,3642,2469,229,0,394,44681,146,26277,23808,17949,14139
2022-01-06 19:30:00+00,12994,0,5860,17092,633,3758,2447,191,0,0,42975,142,26032,23585,17725,12994
2022-01-06 20:00:00+00,11202,0,5863,16960,590,4156,2442,189,0,16,41418,130,25855,23413,17550,11202
2022-01-06 20:30:00+00,9400,0,5864,16914,562,4218,2440,192,0,24,39614,119,25780,23340,17476,9400
2022-01-06 21:00:00+00,8235,0,5863,16478,484,3938,2442,177,0,2,37619,113,25267,22825,16962,8235
2022-01-06 21:30:00+00,6841,0,5863,16261,547,3808,2441,130,0,0,35891,102,25112,22671,16808,6841
2022-01-06 22:00:00+00,6200,0,5868,16073,523,3204,2424,119,0,0,34411,102,24888,22464,16596,6200
2022-01-06 22:30:00+00,4524,0,5858,15865,476,3162,2351,124,0,0,32360,88,24550,22199,16341,4524
2022-01-06 23:00:00+00,3145,0,5852,15432,476,3106,2289,131,0,0,30431,75,24049,21760,15908,3145
2022-01-06 23:30:00+00,2512,0,5854,15355,468,3208,2102,117,0,0,29616,69,23779,21677,15823,2512
2022-01-07 00:00:00+00,2400,0,5860,15192,434,3116,2095,117,0,0,29214,64,23581,21486,15626,2400
2022-01-07 00:30:00+00,2448,0,5756,15177,423,3276,2113,124,0,0,29317,67,23469,21356,15600,2448
2022-01-07 01:00:00+00,2290,0,5707,15152,398,4468,2092,118,0,0,30225,67,23349,21257,15550,2290
2022-01-07 01:30:00+00,2231,0,5709,15087,397,4454,2089,130,0,0,30097,65,23282,21193,15484,2231
2022-01-07 02:00:00+00,2263,0,5662,15191,394,4058,2081,125,0,0,29774,67,23328,21247,15585,2263
2022-01-07 02:30:00+00,2283,0,5587,15320,388,4068,1901,131,0,0,29678,68,23196,21295,15708,2283
2022-01-07 03:00:00+00,2228,0,5589,15281,388,4346,1859,127,0,0,29818,68,23117,21258,15669,2228
2022-01-07 03:30:00+00,2215,0,5589,14851,387,4248,1904,125,0,0,29319,68,22731,20827,15238,2215
2022-01-07 04:00:00+00,2237,0,5599,14930,385,3748,2005,126,0,0,29030,69,22919,20914,15315,2237
2022-01-07 04:30:00+00,2261,0,5655,14949,390,3738,2020,134,0,0,29147,69,23014,20994,15339,2261
2022-01-07 05:00:00+00,2266,0,5727,15045,400,3480,2120,135,0,0,29173,69,23292,21172,15445,2266
2022-01-07 05:30:00+00,2746,0,5784,15247,403,3508,2151,135,0,0,29974,74,23585,21434,15650,2746
2022-01-07 06:00:00+00,4147,0,5778,15574,510,3326,2385,136,0,0,31856,85,24247,21862,16084,4147
2022-01-07 06:30:00+00,5932,0,5779,15929,577,3230,2543,133,0,0,34123,99,24828,22285,16506,5932
2022-01-07 07:00:00+00,9916,0,5772,15860,642,2950,2953,139,0,124,38356,127,25227,22274,16502,9916
2022-01-07 07:30:00+00,12136,0,5770,15707,695,2798,3007,139,0,162,40414,141,25179,22172,16402,12136
2022-01-07 08:00:00+00,13473,0,5767,15400,750,2596,3014,140,5,236,41381,147,24936,21922,16155,13473
2022-01-07 08:30:00+00,14048,0,5772,15344,746,2698,3076,155,215,198,42252,151,25153,22077,16305,14048
2022-01-07 09:00:00+00,13415,0,5771,15371,785,3938,3079,138,853,204,43554,140,25859,22780,17009,13415
2022-01-07 09:30:00+00,13466,0,5776,15172,766,4042,3077,146,1627,180,44252,139,26418,23341,17565,13466
2022-01-07 10:00:00+00,13363,0,5750,14789,758,4442,3052,140,2218,280,44792,137,26567,23515,17765,13363
2022-01-07 10:30:00+00,13606,0,5686,14680,796,4450,3094,132,2479,66,44989,139,26735,23641,17955,13606
2022-01-07 11:00:00+00,13819,0,5538,14790,737,4468,3039,143,2704,0,45238,140,26808,23769,18231,13819
2022-01-07 11:30:00+00,13925,0,5530,14737,724,4476,3004,167,2684,38,45285,141,26679,23675,18145,13925
2022-01-07 12:00:00+00,14313,0,5405,14771,725,4508,3008,159,2140,90,45119,146,26049,23041,17636,14313
2022-01-07 12:30:00+00,14573,0,5406,14607,726,4506,3018,147,1978,182,45143,149,25735,22717,17311,14573
2022-01-07 13:00:00+00,14563,0,5396,14533,764,4214,3022,262,1672,508,44934,148,25387,22365,16969,14563
2022-01-07 13:30:00+00,14760,0,5333,14243,769,4196,3036,421,1030,500,44288,153,24411,21375,16042,14760
2022-01-07 14:00:00+00,15346,0,5245,14090,757,4334,3047,395,598,166,43978,159,23737,20690,15445,15346
2022-01-07 14:30:00+00,15807,0,5212,13694,755,4336,3080,337,377,0,43598,164,23118,20038,14826,15807
2022-01-07 15:00:00+00,16099,0,5210,13534,780,4746,3079,130,193,0,43771,167,22796,19717,14507,16099
2022-01-07 15:30:00+00,16664,0,5203,13176,810,4744,3079,181,33,302,44192,171,22301,19222,14019,16664
2022-01-07 16:00:00+00,17105,0,5210,12925,905,4766,3101,238,0,1256,45506,171,22141,19040,13830,17105
2022-01-07 16:30:00+00,17546,0,5199,12780,898,4766,3102,382,0,1780,46453,172,21979,18877,13678,17546
2022-01-07 17:00:00+00,17688,0,5203,12725,915,4766,3103,641,0,1818,46859,173,21946,18843,13640,17688
2022-01-07 17:30:00+00,17701,0,5234,12407,922,4766,3097,759,0,1644,46530,175,21660,18563,13329,17701
2022-01-07 18:00:00+00,17727,0,5323,11787,924,4750,3047,584,0,1868,46010,176,21081,18034,12711,17727
2022-01-07 18:30:00+00,17609,0,5394,11443,920,4746,3054,499,0,1668,45333,177,20811,17757,12363,17609
2022-01-07 19:00:00+00,17802,0,5398,10798,863,4458,3052,285,0,1178,43834,183,20111,17059,11661,17802
2022-01-07 19:30:00+00,17121,0,5396,10853,800,4450,3049,223,0,562,42454,182,20098,17049,11653,17121
2022-01-07 20:00:00+00,16615,0,5397,10962,680,4168,3036,163,0,52,41073,183,20075,17039,11642,16615
2022-01-07 20:30:00+00,15467,0,5401,10678,670,4218,3018,168,0,50,39670,179,19767,16749,11348,15467
2022-01-07 21:00:00+00,14209,0,5401,10254,550,4418,2946,155,0,66,37999,174,19151,16205,10804,14209
2022-01-07 21:30:00+00,12975,0,5406,9775,569,4546,2945,159,0,104,36479,170,18695,15750,10344,12975
2022-01-07 22:00:00+00,11876,0,5421,9247,326,1990,2942,146,0,200,32148,168,17936,14994,9573,11876
2022-01-07 22:30:00+00,10457,0,5427,9327,321,2810,2872,163,0,108,31485,160,17947,15075,9648,10457
2022-01-07 23:00:00+00,8293,0,5435,9070,441,5074,2667,296,0,110,31386,146,17613,14946,9511,8293
2022-01-07 23:30:00+00,7019,0,5420,9446,439,4850,2828,294,0,0,30296,131,18133,15305,9885,7019
2022-01-08 00:00:00+00,6540,0,5339,9585,425,4794,2867,249,0,0,29799,127,18216,15349,10010,6540
2022-01-08 00:30:00+00,6626,0,5263,9528,420,5008,2962,181,0,176,30164,130,18173,15211,9948,6626
2022-01-08 01:00:00+00,6178,0,5262,9537,392,5350,2969,179,0,0,29867,126,18160,15191,9929,6178
2022-01-08 01:30:00+00,5428,0,5259,9459,370,5354,2966,182,0,0,29018,120,18054,15088,9829,5428
2022-01-08 02:00:00+00,4663,0,5264,9521,348,5356,2976,172,0,90,28390,112,18109,15133,9869,4663
2022-01-08 02:30:00+00,3963,0,5272,10033,350,5308,2978,171,0,0,28075,102,18633,15655,10383,3963
2022-01-08 03:00:00+00,3861,0,5326,10480,278,5300,2974,174,0,0,28393,99,19058,16084,10758,3861
2022-01-08 03:30:00+00,2918,0,5390,11405,275,5256,2942,183,0,0,28369,86,20012,17070,11680,2918
2022-01-08 04:00:00+00,3443,0,5376,11776,260,3890,2938,163,0,0,27846,92,20350,17412,12036,3443
2022-01-08 04:30:00+00,3297,0,5312,12027,257,3844,2956,196,0,0,27889,90,20552,17596,12284,3297
2022-01-08 05:00:00+00,4272,0,5260,12387,257,3056,2959,201,0,0,28392,100,20863,17904,12644,4272
2022-01-08 05:30:00+00,4402,0,5262,12349,279,2996,2945,197,0,0,28430,101,20835,17890,12628,4402
2022-01-08 06:00:00+00,5122,0,5265,13120,308,2462,2945,198,0,0,29420,103,21638,18693,13428,5122
2022-01-08 06:30:00+00,5724,0,5267,13829,320,2458,2812,196,0,0,30606,107,22228,19416,14149,5724
2022-01-08 07:00:00+00,5899,0,5264,14829,320,1918,2743,170,0,0,31143,103,23156,20413,15149,5899
2022-01-08 07:30:00+00,6098,0,5262,15372,313,1844,2760,145,0,0,31794,102,23707,20947,15685,6098
2022-01-08 08:00:00+00,7056,0,5261,16077,338,2348,2818,147,0,6,34051,109,24494,21676,16415,7056
2022-01-08 08:30:00+00,7112,0,5299,16443,374,2380,2852,156,8,32,34656,108,24976,22124,16825,7112
2022-01-08 09:00:00+00,7168,0,5373,16382,429,3918,2709,145,48,0,36172,108,24941,22232,16859,7168
2022-01-08 09:30:00+00,8088,0,5449,16267,489,4060,2557,159,115,14,37198,115,24877,22320,16871,8088
2022-01-08 10:00:00+00,9341,0,5440,16043,617,3414,2580,171,211,248,38065,122,24891,22311,16871,9341
2022-01-08 10:30:00+00,10218,0,5442,15699,624,3398,2901,164,274,80,38800,129,24940,22039,16597,10218
2022-01-08 11:00:00+00,10388,0,5439,14282,499,4846,2790,171,304,454,39173,132,23314,20524,15085,10388
2022-01-08 11:30:00+00,11022,0,5431,14099,496,4820,2866,224,285,424,39667,136,23177,20311,14880,11022
2022-01-08 12:00:00+00,11190,0,5360,14250,508,4884,3039,327,312,0,39870,139,23469,20430,15070,11190
2022-01-08 12:30:00+00,11101,0,5268,14771,503,4862,3051,198,496,0,40250,135,24089,21038,15770,11101
2022-01-08 13:00:00+00,10913,0,5256,14738,524,5008,3052,192,576,0,40259,133,24146,21094,15838,10913
2022-01-08 13:30:00+00,10577,0,5256,14611,540,5060,3050,183,531,0,39808,132,23988,20938,15682,10577
2022-01-08 14:00:00+00,10428,0,5290,14221,514,5198,3032,180,371,0,39234,134,23428,20396,15106,10428
2022-01-08 14:30:00+00,10335,0,5369,13988,517,5232,3025,180,283,76,39005,134,23182,20157,14788,10335
2022-01-08 15:00:00+00,10746,0,5441,13950,550,5098,2993,176,122,0,39076,136,23056,20063,14622,10746
2022-01-08 15:30:00+00,11148,0,5441,13823,570,5142,2649,182,44,58,39057,140,22527,19878,14437,11148
2022-01-08 16:00:00+00,11752,0,5443,13675,762,5210,2680,197,0,516,40235,143,22560,19880,14437,11752
2022-01-08 16:30:00+00,12166,0,5439,14060,764,5270,2822,250,0,608,41379,144,23085,20263,14824,12166
2022-01-08 17:00:00+00,12322,0,5438,13974,872,5000,2990,281,0,1398,42275,140,23274,20284,14846,12322
2022-01-08 17:30:00+00,12628,0,5434,14081,876,4892,3003,358,0,1366,42638,141,23394,20391,14957,12628
2022-01-08 18:00:00+00,12038,0,5438,14517,859,4938,3021,248,0,1138,42197,137,23835,20814,15376,12038
2022-01-08 18:30:00+00,11216,0,5434,14911,859,4856,2786,209,0,1034,41305,130,23990,21204,15770,11216
2022-01-08 19:00:00+00,10920,0,5440,14995,847,4988,2551,197,0,138,40076,132,23833,21282,15842,10920
2022-01-08 19:30:00+00,9645,0,5438,14841,833,4914,2639,195,0,0,38505,124,23751,21112,15674,9645
2022-01-08 20:00:00+00,8285,0,5440,15073,618,5012,2640,179,0,0,37247,115,23771,21131,15691,8285
2022-01-08 20:30:00+00,6949,0,5398,15285,589,5000,2587,183,0,28,36019,104,23859,21272,15874,6949
2022-01-08 21:00:00+00,5604,0,5307,15118,517,5224,2707,190,0,18,34685,96,23649,20942,15635,5604
2022-01-08 21:30:00+00,4596,0,5252,14984,470,5266,2731,198,0,22,33519,88,23437,20706,15454,4596
2022-01-08 22:00:00+00,3831,0,5258,15064,461,4720,2587,188,0,0,32109,77,23370,20783,15525,3831
2022-01-08 22:30:00+00,3252,0,5256,15044,460,4540,2190,184,0,0,30926,68,22950,20760,15504,3252
2022-01-08 23:00:00+00,2653,0,5260,15076,460,4512,1658,194,0,0,29813,62,22454,20796,15536,2653
2022-01-08 23:30:00+00,2782,0,5257,14187,425,4706,1622,185,0,0,29164,68,21491,19869,14612,2782
2022-01-09 00:00:00+00,2840,0,5253,14070,390,4888,1626,185,0,0,29252,74,21339,19713,14460,2840
2022-01-09 00:30:00+00,3027,0,5268,14040,390,4932,1689,181,0,0,29527,77,21387,19698,14430,3027
2022-01-09 01:00:00+00,3074,0,5333,13772,373,5018,1707,183,0,0,29460,79,21185,19478,14145,3074
2022-01-09 01:30:00+00,2978,0,5416,13559,369,4918,1793,181,0,0,29214,77,21137,19344,13928,2978
2022-01-09 02:00:00+00,2935,0,5437,13398,353,4592,1718,185,0,0,28618,77,20906,19188,13751,2935
2022-01-09 02:30:00+00,2723,0,5439,13448,352,4512,1707,185,0,0,28366,73,20946,19239,13800,2723
2022-01-09 03:00:00+00,2801,0,5439,13182,350,4376,1665,184,0,0,27997,72,20636,18971,13532,2801
2022-01-09 03:30:00+00,2646,0,5439,13165,346,4242,1661,178,0,0,27677,69,20611,18950,13511,2646
2022-01-09 04:00:00+00,2736,0,5439,13015,329,3828,1627,181,0,0,27155,70,20410,18783,13344,2736
2022-01-09 04:30:00+00,2821,0,5438,12672,336,3706,1655,179,0,0,26807,71,20101,18446,13008,2821
2022-01-09 05:00:00+00,2798,0,5443,12539,399,3968,1672,180,0,0,26999,78,20053,18381,12938,2798
2022-01-09 05:30:00+00,2742,0,5440,12860,401,4118,1654,180,0,0,27395,78,20355,18701,13261,2742
2022-01-09 06:00:00+00,2881,0,5444,13117,418,4458,1731,200,0,0,28249,80,20710,18979,13535,2881
2022-01-09 06:30:00+00,3635,0,5440,12659,435,4490,1773,187,0,0,28619,90,20307,18534,13094,3635
2022-01-09 07:00:00+00,4184,0,5441,12412,459,4644,2022,189,0,0,29351,93,20334,18312,12871,4184
2022-01-09 07:30:00+00,4733,0,5440,12515,476,4690,2204,175,0,0,30233,98,20635,18431,12991,4733
2022-01-09 08:00:00+00,5838,0,5440,12604,492,4208,2336,160,10,0,31088,105,20882,18546,13106,5838
2022-01-09 08:30:00+00,6557,6,5469,12281,512,4386,2562,162,309,64,32309,113,21133,18571,13102,6564
2022-01-09 09:00:00+00,7244,13,5518,11816,512,5386,2854,159,1085,0,34587,121,21785,18931,13413,7257
2022-01-09 09:30:00+00,8072,36,5521,11618,514,5404,2749,161,1805,0,35880,126,22207,19458,13937,8108
2022-01-09 10:00:00+00,8932,119,5513,11373,517,5396,2693,160,2431,0,37134,132,22527,19834,14321,9051
2022-01-09 10:30:00+00,9515,250,5525,11058,542,5272,2667,160,3008,0,37997,136,22800,20133,14608,9765
2022-01-09 11:00:00+00,10213,285,5532,10682,505,5134,2746,159,3452,0,38708,141,22917,20171,14639,10498
2022-01-09 11:30:00+00,10592,311,5533,10417,502,5114,2841,162,3591,0,39063,145,22884,20043,14510,10903
2022-01-09 12:00:00+00,11562,344,5531,9891,472,4794,3009,166,3479,48,39296,153,22382,19373,13842,11906
2022-01-09 12:30:00+00,12532,380,5529,9273,470,4776,3066,178,3210,84,39498,162,21548,18482,12953,12912
2022-01-09 13:00:00+00,12989,367,5536,8815,513,5282,3071,170,2863,38,39644,169,20798,17727,12191,13356
2022-01-09 13:30:00+00,13734,417,5535,8334,518,5152,3034,171,2280,26,39201,178,19701,16667,11132,14151
2022-01-09 14:00:00+00,14734,467,5537,7756,551,4856,2956,181,1656,52,38746,188,18456,15500,9963,15201
2022-01-09 14:30:00+00,15872,486,5541,7260,566,4722,3090,162,943,12,38654,199,17400,14310,8769,16358
2022-01-09 15:00:00+00,16864,500,5537,6991,589,4460,3093,215,323,448,39020,208,16533,13440,7903,17364
2022-01-09 15:30:00+00,18170,501,5543,6791,621,4454,3091,239,49,632,40091,215,16095,13004,7461,18671
2022-01-09 16:00:00+00,19393,482,5539,6520,852,4758,3099,333,0,1208,42184,217,16010,12911,7372,19875
2022-01-09 16:30:00+00,20383,498,5542,6349,858,4766,3095,439,0,1414,43344,221,15844,12749,7207,20881
2022-01-09 17:00:00+00,20829,500,5535,6263,872,4766,3101,643,0,2024,44533,221,15771,12670,7135,21329
2022-01-09 17:30:00+00,20760,465,5533,5837,874,4766,3110,704,0,2322,44371,221,15354,12244,6711,21225
2022-01-09 18:00:00+00,20687,501,5535,5440,877,4764,3104,633,0,1970,43511,224,14956,11852,6317,21188
2022-01-09 18:30:00+00,20204,500,5537,5129,864,4762,3104,456,0,1728,42284,225,14634,11530,5993,20704
2022-01-09 19:00:00+00,20085,500,5534,4822,842,4602,3099,431,0,1042,40957,231,14297,11198,5664,20585
2022-01-09 19:30:00+00,19742,501,5529,4626,734,4604,3109,379,0,604,39828,234,13998,10889,5360,20243
2022-01-09 20:00:00+00,19272,500,5531,4355,661,4268,3107,267,0,420,38381,236,13654,10547,5016,19772
2022-01-09 20:30:00+00,18417,499,5526,3946,589,4250,3108,185,0,352,36872,236,13169,10061,4535,18916
2022-01-09 21:00:00+00,17641,500,5534,3611,592,4466,3092,179,0,28,35643,236,12829,9737,4203,18141
2022-01-09 21:30:00+00,16515,499,5535,3385,516,4472,3085,165,0,2,34174,233,12521,9436,3901,17014
2022-01-09 22:00:00+00,15290,368,5539,3066,425,4656,3089,165,0,0,32598,226,12119,9030,3491,15658
2022-01-09 22:30:00+00,13886,240,5537,2903,404,4566,3093,167,0,0,30796,216,11937,8844,3307,14126
2022-01-09 23:00:00+00,13580,250,5574,2922,405,2978,3091,163,0,124,29087,218,11992,8901,3327,13830
2022-01-09 23:30:00+00,13048,235,5584,3179,385,2940,3084,163,0,0,28618,214,12232,9148,3564,13283
2022-01-10 00:00:00+00,12550,232,5588,3511,334,3478,3083,158,0,0,28934,214,12516,9433,3845,12782
2022-01-10 00:30:00+00,12707,237,5586,3629,331,3518,3084,161,0,0,29253,214,12630,9546,3960,12944
2022-01-10 01:00:00+00,12771,233,5589,3807,329,3454,3082,164,0,0,29429,213,12807,9725,4136,13004
2022-01-10 01:30:00+00,12566,232,5584,3978,328,3402,3083,166,0,0,29339,210,12973,9890,4306,12798
2022-01-10 02:00:00+00,12735,252,5586,3971,312,3114,3087,167,0,0,29224,214,12956,9869,4283,12987
2022-01-10 02:30:00+00,12399,426,5584,4029,310,3118,3085,167,0,0,29118,216,13008,9923,4339,12825
2022-01-10 03:00:00+00,12413,432,5588,4165,309,2386,3088,165,0,0,28546,218,13150,10062,4474,12845
2022-01-10 03:30:00+00,12112,295,5585,4689,306,2426,3092,165,0,0,28670,209,13672,10580,4995,12407
2022-01-10 04:00:00+00,13277,428,5587,5165,304,1168,3093,166,0,0,29188,215,14149,11056,5469,13705
2022-01-10 04:30:00+00,13240,527,5585,5450,306,1074,3091,168,0,0,29441,214,14432,11341,5756,13767
2022-01-10 05:00:00+00,13960,577,5590,5729,387,1094,3068,159,0,0,30564,220,14774,11706,6116,14537
2022-01-10 05:30:00+00,14644,695,5590,6013,393,1052,2954,159,0,0,31500,225,14950,11996,6406,15339
2022-01-10 06:00:00+00,17326,920,5586,6297,391,1058,2920,160,0,0,34658,241,15194,12274,6688,18246
2022-01-10 06:30:00+00,19600,1234,5590,6672,407,1068,3064,160,0,0,37795,253,15733,12669,7079,20834
2022-01-10 07:00:00+00,20289,1289,5592,6889,422,1374,3080,191,0,0,39126,255,15983,12903,7311,21578
2022-01-10 07:30:00+00,20935,1429,5587,7214,435,1320,3082,300,0,374,40676,254,16318,13236,7649,22364
2022-01-10 08:00:00+00,21486,1472,5589,7445,436,1624,3085,360,1,180,41678,255,16556,13471,7882,22958
2022-01-10 08:30:00+00,21566,1473,5592,7609,434,1780,3101,305,34,236,42130,254,16770,13669,8077,23039
2022-01-10 09:00:00+00,22045,1478,5579,7866,399,1900,3092,298,132,674,43463,252,17068,13976,8397,23523
2022-01-10 09:30:00+00,22404,1476,5583,8389,390,1952,3060,259,273,142,43928,252,17695,14635,9052,23880
2022-01-10 10:00:00+00,22250,1479,5566,8928,409,1876,2994,280,384,130,44296,249,18281,15287,9721,23729
2022-01-10 10:30:00+00,22019,1479,5554,9445,444,1860,3025,318,477,136,44757,245,18945,15920,10366,23498
2022-01-10 11:00:00+00,22162,1480,5572,9716,418,1560,3077,281,562,216,45044,243,19345,16268,10696,23642
2022-01-10 11:30:00+00,21896,1480,5560,10248,417,1564,2997,265,590,30,45047,240,19812,16815,11255,23376
2022-01-10 12:00:00+00,21144,1479,5552,10447,404,2098,3079,240,611,0,45054,236,20093,17014,11462,22623
2022-01-10 12:30:00+00,20929,1480,5557,10709,414,2108,3086,256,573,0,45112,234,20339,17253,11696,22409
2022-01-10 13:00:00+00,21588,1480,5559,10837,415,1690,3099,236,536,0,45440,239,20446,17347,11788,23068
2022-01-10 13:30:00+00,20917,1481,5563,10957,417,1652,3095,250,477,0,44809,236,20509,17414,11851,22398
2022-01-10 14:00:00+00,20949,1476,5563,10813,449,1336,3098,242,426,48,44400,237,20349,17251,11688,22425
2022-01-10 14:30:00+00,20587,1478,5564,10727,513,1150,3094,278,302,396,44089,234,20200,17106,11542,22065
2022-01-10 15:00:00+00,20873,1477,5571,10888,528,776,3097,341,150,216,43917,235,20234,17137,11566,22350
2022-01-10 15:30:00+00,20679,1480,5559,11255,554,608,3097,319,39,898,44488,228,20504,17407,11848,22159
2022-01-10 16:00:00+00,20975,1480,5566,11813,604,610,3070,485,0,1010,45613,225,21053,17983,12417,22455
2022-01-10 16:30:00+00,21221,1443,5559,12225,639,610,3069,603,0,1394,46763,222,21492,18423,12864,22664
2022-01-10 17:00:00+00,21970,1452,5559,12626,638,758,3070,693,0,1672,48438,220,21893,18823,13264,23422
2022-01-10 17:30:00+00,22231,1454,5550,12862,639,786,3069,712,0,1340,48643,221,22120,19051,13501,23685
2022-01-10 18:00:00+00,22124,1477,5553,12797,618,332,3057,650,0,1374,47982,222,22025,18968,13415,23601
2022-01-10 18:30:00+00,21626,1477,5550,12832,631,332,3038,582,0,1222,47290,221,22051,19013,13463,23103
2022-01-10 19:00:00+00,21340,1471,5555,12672,631,660,3035,460,0,202,46026,224,21893,18858,13303,22811
2022-01-10 19:30:00+00,20614,1353,5551,12337,635,694,3015,206,0,0,44405,221,21538,18523,12972,21967
2022-01-10 20:00:00+00,19736,1448,5550,12101,601,694,3015,161,0,230,43536,219,21267,18252,12702,21184
2022-01-10 20:30:00+00,18330,1434,5549,12630,559,694,3035,149,0,30,42410,212,21773,18738,13189,19764
2022-01-10 21:00:00+00,17452,1343,5543,12211,530,694,3065,176,0,96,41110,208,21349,18284,12741,18795
2022-01-10 21:30:00+00,16612,1320,5548,11380,510,694,3082,172,0,124,39442,208,20520,17438,11890,17932
2022-01-10 22:00:00+00,15701,1176,5549,11028,485,694,3055,168,0,0,37856,204,20117,17062,11513,16877
2022-01-10 22:30:00+00,14500,941,5542,10564,483,694,3018,165,0,0,35907,195,19607,16589,11047,15441
2022-01-10 23:00:00+00,12010,862,5550,10160,474,694,2933,166,0,0,32849,181,19117,16184,10634,12872
2022-01-10 23:30:00+00,10995,849,5550,9804,461,694,2973,161,0,0,31487,176,18788,15815,10265,11844
2022-01-11 00:00:00+00,10508,645,5549,9406,453,1008,2995,162,0,0,30726,169,18403,15408,9859,11153
2022-01-11 00:30:00+00,10998,854,5586,9011,464,1016,3079,179,0,0,31187,180,18140,15061,9475,11852
2022-01-11 01:00:00+00,10486,759,5593,8968,475,1434,2919,161,0,0,30795,176,17955,15036,9443,11245
2022-01-11 01:30:00+00,10247,597,5586,8909,477,1468,2850,161,0,0,30295,171,17822,14972,9386,10844
2022-01-11 02:00:00+00,9562,459,5590,9115,429,1844,2768,167,0,0,29934,162,17902,15134,9544,10021
2022-01-11 02:30:00+00,9384,461,5590,9248,417,1846,2654,167,0,0,29767,160,17909,15255,9665,9845
2022-01-11 03:00:00+00,9555,461,5589,9375,412,1410,2584,162,0,0,29548,161,17960,15376,9787,10016
2022-01-11 03:30:00+00,9387,508,5595,9282,411,1362,2577,149,0,0,29271,161,17865,15288,9693,9895
2022-01-11 04:00:00+00,10215,578,5599,9171,409,866,2600,149,0,0,29587,168,17779,15179,9580,10793
2022-01-11 04:30:00+00,10239,533,5595,9283,409,862,2578,154,0,0,29653,167,17865,15287,9692,10772
2022-01-11 05:00:00+00,10707,857,5594,9360,405,694,2719,157,0,0,30493,177,18078,15359,9765,11564
2022-01-11 05:30:00+00,11350,886,5591,9302,415,694,2870,151,0,0,31259,182,18178,15308,9717,12236
2022-01-11 06:00:00+00,14648,1067,5593,9036,444,756,2846,152,0,138,34680,207,17919,15073,9480,15715
2022-01-11 06:30:00+00,16988,1228,5595,9108,485,994,2870,149,0,16,37433,224,18058,15188,9593,18216
2022-01-11 07:00:00+00,20068,1711,5592,8683,540,918,2897,207,0,660,41276,243,17712,14815,9223,21779
2022-01-11 07:30:00+00,21947,1966,5598,8558,565,912,2904,576,0,82,43108,258,17625,14721,9123,23913
2022-01-11 08:00:00+00,22816,1970,5594,8046,700,852,2927,580,1,0,43486,264,17268,14341,8747,24786
2022-01-11 08:30:00+00,22923,1968,5590,7461,708,994,2943,627,55,294,43563,266,16757,13814,8224,24891
2022-01-11 09:00:00+00,22843,1917,5592,7108,723,1114,2933,577,223,122,43152,266,16579,13646,8054,24760
2022-01-11 09:30:00+00,22951,1914,5592,6469,718,1102,2945,602,466,584,43343,266,16190,13245,7653,24865
2022-01-11 10:00:00+00,22928,1963,5591,6100,618,1856,2899,597,689,270,43511,271,15897,12998,7407,24891
2022-01-11 10:30:00+00,22843,1928,5589,6098,566,1936,2830,558,1004,440,43792,268,16087,13257,7668,24771
2022-01-11 11:00:00+00,22378,1832,5595,6215,479,2580,2726,548,1155,0,43508,268,16170,13444,7849,24210
2022-01-11 11:30:00+00,22486,1572,5593,6218,488,2694,2650,319,1242,76,43338,263,16191,13541,7948,24058
2022-01-11 12:00:00+00,22338,1549,5595,6447,488,2954,2627,143,1099,0,43240,262,16256,13629,8034,23887
2022-01-11 12:30:00+00,22011,1500,5596,6684,489,2948,2625,159,1094,0,43106,258,16488,13863,8267,23511
2022-01-11 13:00:00+00,22743,1706,5590,6527,486,2634,2621,164,1060,34,43565,265,16284,13663,8073,24449
2022-01-11 13:30:00+00,22538,1728,5591,6431,484,2582,2619,175,846,76,43070,267,15971,13352,7761,24266
2022-01-11 14:00:00+00,22899,1723,5594,6287,514,2374,2699,163,699,102,43054,270,15793,13094,7500,24622
2022-01-11 14:30:00+00,22845,1759,5594,6216,550,2346,2642,172,569,0,42693,273,15571,12929,7335,24604
2022-01-11 15:00:00+00,22732,1778,5589,6184,575,1834,2169,230,399,860,42350,270,14916,12747,7158,24510
2022-01-11 15:30:00+00,23212,1848,5595,6182,614,1766,2198,220,133,1188,42956,271,14722,12524,6929,25060
2022-01-11 16:00:00+00,23276,1907,5597,6341,733,1902,2293,353,2,774,43178,270,14966,12673,7076,25183
2022-01-11 16:30:00+00,23732,1962,5595,6339,756,1870,2285,631,0,1428,44598,268,14975,12690,7095,25694
2022-01-11 17:00:00+00,23632,1890,5597,6377,754,2686,2302,739,0,1826,45803,264,15030,12728,7131,25522
2022-01-11 17:30:00+00,23750,1790,5598,6335,752,2764,2312,697,0,1530,45528,265,14997,12685,7087,25540
2022-01-11 18:00:00+00,23813,1935,5591,6323,756,1952,2309,688,0,1748,45115,268,14979,12670,7079,25748
2022-01-11 18:30:00+00,23769,1738,5592,6251,754,1946,2326,651,0,1512,44539,267,14923,12597,7005,25507
2022-01-11 19:00:00+00,23436,1483,5589,6128,612,2402,2283,446,0,946,43325,266,14612,12329,6740,24919
2022-01-11 19:30:00+00,23347,1426,5592,6096,601,2430,2206,173,0,268,42139,269,14495,12289,6697,24773
2022-01-11 20:00:00+00,22892,1178,5591,6095,551,2298,2303,203,0,16,41127,267,14540,12237,6646,24070
2022-01-11 20:30:00+00,21807,1000,5538,6316,550,2216,2101,169,0,0,39697,260,14505,12404,6866,22807
2022-01-11 21:00:00+00,20883,1000,5520,6421,517,1926,1949,175,0,54,38445,258,14407,12458,6938,21883
2022-01-11 21:30:00+00,19214,873,5523,6679,509,1854,1929,164,0,0,36745,248,14640,12711,7188,20087
2022-01-11 22:00:00+00,18554,521,5513,6823,476,944,2201,155,0,0,35187,234,15013,12812,7299,19075
2022-01-11 22:30:00+00,16556,379,5510,7045,474,850,2118,156,0,0,33088,219,15147,13029,7519,16935
2022-01-11 23:00:00+00,15556,433,5507,6903,476,902,1723,182,0,0,31682,217,14609,12886,7379,15989
2022-01-11 23:30:00+00,15207,319,5512,6949,476,856,1520,145,0,0,30984,213,14457,12937,7425,15526
2022-01-12 00:00:00+00,15552,395,5508,7109,429,924,1540,148,0,0,31605,216,14586,13046,7538,15947
2022-01-12 00:30:00+00,16002,417,5511,7142,429,926,1576,232,0,0,32235,220,14658,13082,7571,16419
2022-01-12 01:00:00+00,15957,453,5509,7137,393,1210,1569,225,0,0,32453,223,14608,13039,7530,16410
2022-01-12 01:30:00+00,15567,303,5514,7493,374,1222,1571,158,0,0,32202,214,14952,13381,7867,15870
2022-01-12 02:00:00+00,15066,243,5506,7547,371,1112,1567,150,0,0,31562,209,14991,13424,7918,15309
2022-01-12 02:30:00+00,14863,246,5501,7466,371,1112,1574,151,0,0,31284,208,14912,13338,7837,15109
2022-01-12 03:00:00+00,14939,276,5506,7797,369,694,1573,148,0,0,31302,204,15245,13672,8166,15215
2022-01-12 03:30:00+00,14496,235,5497,7936,370,694,1612,151,0,0,30991,199,15415,13803,8306,14731
2022-01-12 04:00:00+00,15138,329,5501,7798,385,694,1642,150,0,0,31637,206,15326,13684,8183,15467
2022-01-12 04:30:00+00,15439,424,5500,7686,379,694,1643,159,0,0,31924,211,15208,13565,8065,15863
2022-01-12 05:00:00+00,15899,618,5503,7723,425,826,1592,147,0,0,32733,218,15243,13651,8148,16517
2022-01-12 05:30:00+00,16741,851,5503,7848,427,804,1631,142,0,0,33947,226,15409,13778,8275,17592
2022-01-12 06:00:00+00,18495,1164,5499,7825,467,1044,1838,144,0,0,36476,241,15629,13791,8292,19659
2022-01-12 06:30:00+00,20263,1398,5503,7744,469,934,2110,158,0,0,38579,252,15826,13716,8213,21661
2022-01-12 07:00:00+00,22264,1558,5504,7575,503,1060,2257,389,0,282,41392,261,15839,13582,8078,23822
2022-01-12 07:30:00+00,22888,1761,5504,7694,512,1298,2297,528,0,678,43160,264,16007,13710,8206,24649
2022-01-12 08:00:00+00,23158,1916,5500,7632,686,1244,2297,649,15,1118,44215,264,16130,13833,8333,25074
2022-01-12 08:30:00+00,23595,1878,5487,7280,586,1328,2297,634,331,1484,44900,264,15981,13684,8197,25473
2022-01-12 09:00:00+00,23529,1919,5459,7384,515,1184,2295,609,1046,966,44906,262,16699,14404,8945,25448
2022-01-12 09:30:00+00,23636,1926,5453,7550,511,1082,2298,581,2025,536,45598,258,17837,15539,10086,25562
2022-01-12 10:00:00+00,23890,1929,5452,7511,490,934,2300,671,2902,574,46653,254,18655,16355,10903,25819
2022-01-12 10:30:00+00,23788,1923,5451,7647,487,786,2298,674,3455,226,46735,251,19338,17040,11589,25711
2022-01-12 11:00:00+00,23745,1930,5451,7692,435,852,2298,568,4031,500,47502,246,19907,17609,12158,25675
2022-01-12 11:30:00+00,23732,1927,5454,7655,442,902,2297,469,4316,106,47300,247,20164,17867,12413,25659
2022-01-12 12:00:00+00,23891,1937,5447,7502,415,908,2299,438,4394,18,47249,249,20057,17758,12311,25828
2022-01-12 12:30:00+00,23767,1936,5451,7346,418,790,2288,355,4323,154,46828,248,19826,17538,12086,25703
2022-01-12 13:00:00+00,23798,1932,5450,7291,416,792,2282,374,4054,216,46605,250,19493,17211,11761,25730
2022-01-12 13:30:00+00,23682,1923,5457,7477,423,728,2281,297,3636,168,46072,250,19274,16993,11536,25605
2022-01-12 14:00:00+00,22918,1491,5452,7601,490,760,2184,226,3047,0,44169,245,18774,16590,11138,24409
2022-01-12 14:30:00+00,22809,1683,5453,7550,475,862,2179,187,2233,92,43523,252,17890,15711,10258,24492
2022-01-12 15:00:00+00,23046,1633,5456,7526,503,702,2192,187,1237,88,42570,257,16914,14722,9266,24679
2022-01-12 15:30:00+00,23223,1644,5459,7497,693,800,2199,280,340,514,42649,260,16188,13989,8530,24867
2022-01-12 16:00:00+00,23063,1635,5457,7765,728,1140,2208,429,12,616,43053,257,16170,13962,8505,24698
2022-01-12 16:30:00+00,23433,1686,5450,7990,739,1230,2253,678,0,1582,45041,253,16432,14179,8729,25119
2022-01-12 17:00:00+00,22883,1693,5450,8396,749,2174,2212,787,0,1754,46098,245,16807,14595,9145,24576
2022-01-12 17:30:00+00,22987,1569,5452,8676,751,2266,2111,796,0,1634,46242,243,16990,14879,9427,24556
2022-01-12 18:00:00+00,23153,1485,5452,8845,721,1719,2200,624,0,1580,45779,244,17218,15018,9566,24638
2022-01-12 18:30:00+00,23018,1476,5448,8831,715,1622,2164,493,0,1598,45365,243,17158,14994,9546,24494
2022-01-12 19:00:00+00,23202,1391,5446,8954,707,2140,2235,591,0,956,45622,248,17342,15107,9661,24593
2022-01-12 19:30:00+00,23258,1377,5451,8643,542,2220,2220,503,0,512,44726,254,16856,14636,9185,24635
2022-01-12 20:00:00+00,22721,1238,5448,8534,555,1960,2212,465,0,136,43269,254,16749,14537,9089,23959
2022-01-12 20:30:00+00,21858,917,5441,8308,485,1956,2099,357,0,318,41739,247,16333,14234,8793,22775
2022-01-12 21:00:00+00,20181,768,5374,8143,454,2000,2001,322,0,108,39351,242,15972,13971,8597,20949
2022-01-12 21:30:00+00,18973,433,5355,8215,443,2010,1937,228,0,0,37594,232,15950,14013,8658,19406
2022-01-12 22:00:00+00,18098,297,5355,8233,395,1886,1850,152,0,52,36318,224,15833,13983,8628,18395
2022-01-12 22:30:00+00,17030,229,5356,8222,383,1768,1438,149,0,0,34575,219,15399,13961,8605,17259
2022-01-12 23:00:00+00,15839,232,5365,8244,380,1680,1242,144,0,0,33126,215,15231,13989,8624,16071
2022-01-12 23:30:00+00,15584,229,5369,8271,377,1711,1246,143,0,0,32930,213,15263,14017,8648,15813
2022-01-13 00:00:00+00,14731,231,5369,8287,372,1895,1267,143,0,0,32295,207,15295,14028,8659,14962
2022-01-13 00:30:00+00,14959,301,5364,8232,376,2012,1287,178,0,0,32709,211,15259,13972,8608,15260
2022-01-13 01:00:00+00,14576,238,5366,8174,374,2246,1257,148,0,0,32379,207,15171,13914,8548,14814
2022-01-13 01:30:00+00,14270,232,5365,7991,373,2150,1265,153,0,0,31799,206,14994,13729,8364,14502
2022-01-13 02:00:00+00,13977,235,5368,7882,373,2024,1276,151,0,0,31286,205,14899,13623,8255,14212
2022-01-13 02:30:00+00,13566,229,5367,8135,371,2022,1274,152,0,0,31116,200,15147,13873,8506,13795
2022-01-13 03:00:00+00,13125,230,5361,8132,372,2140,1279,153,0,0,30792,197,15144,13865,8504,13355
2022-01-13 03:30:00+00,13104,230,5358,7849,377,2142,1286,153,0,0,30499,199,14870,13584,8226,13334
2022-01-13 04:00:00+00,14229,230,5361,7901,376,1382,1278,154,0,0,30911,203,14916,13638,8277,14459
2022-01-13 04:30:00+00,14450,232,5358,7846,376,1372,1285,145,0,0,31064,205,14865,13580,8222,14682
2022-01-13 05:00:00+00,14194,430,5357,7789,407,1386,1343,144,0,0,31050,210,14896,13553,8196,14624
2022-01-13 05:30:00+00,14582,730,5358,7794,410,1634,1380,145,0,0,32033,220,14942,13562,8204,15312
2022-01-13 06:00:00+00,16187,1010,5357,7805,421,1808,1569,162,0,0,34319,235,15152,13583,8226,17197
2022-01-13 06:30:00+00,18333,1306,5356,7810,431,1724,2293,148,0,0,37401,247,15890,13597,8241,19639
2022-01-13 07:00:00+00,20441,1395,5359,7818,497,1358,2613,164,0,190,39835,252,16287,13674,8315,21836
2022-01-13 07:30:00+00,21712,1419,5358,7786,706,1570,2743,303,0,514,42111,254,16593,13850,8492,23131
2022-01-13 08:00:00+00,21915,1469,5356,7789,716,2152,2731,619,15,640,43402,257,16607,13876,8520,23384
2022-01-13 08:30:00+00,22078,1550,5361,8130,693,2214,2739,677,345,170,43957,257,17268,14529,9168,23628
2022-01-13 09:00:00+00,22193,1630,5313,8182,687,2412,2739,638,1339,156,45289,252,18260,15521,10208,23823
2022-01-13 09:30:00+00,22138,1643,5233,7753,720,2372,2672,459,2415,302,45707,248,18793,16121,10888,23781
2022-01-13 10:00:00+00,22102,1643,5221,7992,637,2058,2695,320,3287,308,46263,240,19832,17137,11916,23745
2022-01-13 10:30:00+00,21947,1673,5219,8144,553,1904,2706,309,3809,0,46264,238,20431,17725,12506,23620
2022-01-13 11:00:00+00,21561,1682,5217,8095,534,2196,2704,227,4272,0,46488,235,20822,18118,12901,23243
2022-01-13 11:30:00+00,21226,1704,5214,8021,530,2132,2709,154,4717,0,46407,231,21191,18482,13268,22930
2022-01-13 12:00:00+00,21514,1764,5211,7778,514,2024,2712,138,4859,68,46582,232,21074,18362,13151,23278
2022-01-13 12:30:00+00,21194,1816,5214,7718,526,2026,2713,138,4746,0,46091,233,20917,18204,12990,23010
2022-01-13 13:00:00+00,21358,1817,5219,7727,615,1760,2752,167,4445,46,45906,235,20758,18006,12787,23175
2022-01-13 13:30:00+00,21407,1783,5215,7569,537,1758,2796,163,3996,0,45224,238,20113,17317,12102,23190
2022-01-13 14:00:00+00,21057,1775,5322,7448,530,1730,2812,140,3283,0,44097,242,19395,16583,11261,22832
2022-01-13 14:30:00+00,21400,1761,5345,7157,557,1748,2820,146,2400,218,43552,248,18279,15459,10114,23161
2022-01-13 15:00:00+00,21566,1781,5343,7045,585,2132,2823,146,1286,62,42769,258,17082,14259,8916,23347
2022-01-13 15:30:00+00,22217,1781,5344,7047,603,2226,2814,198,310,316,42856,265,16118,13304,7960,23998
2022-01-13 16:00:00+00,22199,1778,5349,7048,651,2398,2825,439,11,796,43494,264,15884,13059,7710,23977
2022-01-13 16:30:00+00,22555,1781,5359,7061,786,2482,2820,722,0,1196,44762,262,16026,13206,7847,24336
2022-01-13 17:00:00+00,22647,1788,5253,7081,863,3032,2823,916,0,1662,46065,257,16020,13197,7944,24435
2022-01-13 17:30:00+00,22463,1880,5202,7095,887,3060,2821,944,0,1704,46056,258,16005,13184,7982,24343
2022-01-13 18:00:00+00,22184,1880,5200,7090,862,2752,2899,592,0,1752,45211,257,16051,13152,7952,24064
2022-01-13 18:30:00+00,21885,1808,5240,7064,850,2748,2899,508,0,1556,44558,256,16053,13154,7914,23693
2022-01-13 19:00:00+00,21693,1818,5362,7030,768,3310,2898,379,0,750,44008,259,16058,13160,7798,23511
2022-01-13 19:30:00+00,21201,1780,5439,6994,777,3216,2898,357,0,12,42674,261,16108,13210,7771,22981
2022-01-13 20:00:00+00,20974,1873,5443,6959,655,2656,2897,268,0,0,41725,266,15954,13057,7614,22847
2022-01-13 20:30:00+00,19752,1878,5436,6916,200,2560,2896,157,0,300,40095,263,15448,12552,7116,21630
2022-01-13 21:00:00+00,19212,1875,5437,6849,437,2668,2749,173,0,10,39410,262,15472,12723,7286,21087
2022-01-13 21:30:00+00,17701,1598,5439,6758,551,2666,2644,179,0,0,37536,252,15392,12748,7309,19299
2022-01-13 22:00:00+00,16790,839,5438,6660,504,2466,2650,168,0,0,35515,235,15252,12602,7164,17629
2022-01-13 22:30:00+00,15756,690,5436,6563,511,2396,2345,171,0,0,33868,228,14855,12510,7074,16446
2022-01-13 23:00:00+00,14679,692,5434,6466,510,2550,1966,165,0,0,32462,224,14376,12410,6976,15371
2022-01-13 23:30:00+00,14187,689,5434,6356,515,2600,1962,165,0,0,31908,222,14267,12305,6871,14876
2022-01-14 00:00:00+00,14520,705,5436,6257,517,2530,1964,166,0,0,32095,227,14174,12210,6774,15225
2022-01-14 00:30:00+00,15033,767,5438,6177,516,2538,1988,205,0,0,32662,231,14119,12131,6693,15800
2022-01-14 01:00:00+00,15275,805,5422,6096,497,2412,1965,174,0,0,32646,233,13980,12015,6593,16080
2022-01-14 01:30:00+00,15157,760,5283,6016,494,2406,1973,172,0,0,32261,233,13766,11793,6510,15917
2022-01-14 02:00:00+00,15139,690,5220,5934,463,2446,1969,172,0,0,32033,233,13586,11617,6397,15829
2022-01-14 02:30:00+00,15438,721,5216,5334,463,2448,1976,173,0,0,31769,240,12989,11013,5797,16159
2022-01-14 03:00:00+00,15631,692,5219,4782,499,2394,1988,176,0,0,31381,244,12488,10500,5281,16323
2022-01-14 03:30:00+00,15594,689,5214,4432,529,2394,1988,175,0,0,31015,246,12163,10175,4961,16283
2022-01-14 04:00:00+00,16094,730,5214,4051,529,2346,1985,173,0,0,31122,252,11779,9794,4580,16824
2022-01-14 04:30:00+00,16192,716,5234,3623,561,2346,1980,180,0,0,30832,256,11398,9418,4184,16908
2022-01-14 05:00:00+00,16460,739,5340,3402,579,1878,1983,167,0,0,30548,259,11304,9321,3981,17199
2022-01-14 05:30:00+00,17351,919,5348,3119,578,1870,1978,169,0,0,31332,270,11023,9045,3697,18270
2022-01-14 06:00:00+00,19579,1445,5344,2792,598,1880,1972,176,0,34,33820,291,10706,8734,3390,21024
2022-01-14 06:30:00+00,21620,1842,5342,2372,626,2110,2425,204,0,40,36581,306,10765,8340,2998,23462
2022-01-14 07:00:00+00,22660,2112,5342,1993,750,2216,2826,310,0,206,38415,312,10911,8085,2743,24772
2022-01-14 07:30:00+00,23516,2332,5347,1735,785,2434,2937,439,0,386,39911,317,10804,7867,2520,25848
2022-01-14 08:00:00+00,23653,2310,5346,1515,834,4130,2941,461,19,372,41581,309,10655,7714,2368,25963
2022-01-14 08:30:00+00,23760,2374,5349,1399,908,4250,2897,488,370,480,42275,307,10923,8026,2677,26134
2022-01-14 09:00:00+00,23727,2428,5280,1276,989,4948,2892,509,1304,252,43605,301,11741,8849,3569,26155
2022-01-14 09:30:00+00,23773,2421,5214,1254,984,4878,2899,580,2292,258,44553,295,12643,9744,4530,26194
2022-01-14 10:00:00+00,23518,2279,5213,1270,980,5188,2899,446,3095,16,44904,290,13457,10558,5345,25797
2022-01-14 10:30:00+00,23554,2132,5216,1157,835,5206,2897,333,3740,26,45096,285,13845,10948,5732,25686
2022-01-14 11:00:00+00,23381,1939,5219,1088,807,5098,2896,294,4206,18,44946,280,14216,11320,6101,25320
2022-01-14 11:30:00+00,23288,1764,5215,1042,742,5070,2902,196,4530,0,44749,276,14431,11529,6314,25052
2022-01-14 12:00:00+00,22931,1715,5224,1028,722,5296,2901,190,4632,0,44639,272,14507,11606,6382,24646
2022-01-14 12:30:00+00,22434,1729,5306,986,732,5316,2904,205,4627,0,44239,270,14555,11651,6345,24163
2022-01-14 13:00:00+00,21222,1831,5417,940,791,5540,2892,454,4416,0,43503,270,14456,11564,6147,23053
2022-01-14 13:30:00+00,20860,1831,5437,860,939,5550,2899,341,3932,0,42649,271,14067,11168,5731,22691
2022-01-14 14:00:00+00,20898,1836,5435,828,940,5528,2854,389,3257,24,41989,276,13314,10460,5025,22734
2022-01-14 14:30:00+00,21437,1823,5435,818,943,5520,2713,410,2426,0,41525,284,12335,9622,4187,23260
2022-01-14 15:00:00+00,21387,1817,5435,812,965,5154,2735,576,1368,476,40725,287,11315,8580,3145,23204
2022-01-14 15:30:00+00,21569,1842,5436,766,1015,5166,2794,695,373,1234,40890,290,10384,7590,2154,23411
2022-01-14 16:00:00+00,22066,1838,5440,799,1036,5372,2935,812,18,1340,41656,295,10228,7293,1853,23904
2022-01-14 16:30:00+00,22755,1843,5442,960,1042,5312,2887,850,0,1448,42539,296,10331,7444,2002,24598
2022-01-14 17:00:00+00,23152,1853,5443,1110,1091,5284,2711,1026,0,1584,43254,295,10356,7644,2202,25005
2022-01-14 17:30:00+00,22798,1882,5444,1382,1087,5284,2731,1173,0,1656,43437,293,10644,7913,2469,24680
2022-01-14 18:00:00+00,22500,1663,5443,1613,1087,5314,2720,1012,0,2082,43434,284,10863,8143,2700,24163
2022-01-14 18:30:00+00,22577,1658,5444,1732,1069,5318,2730,910,0,1868,43306,285,10975,8245,2801,24235
2022-01-14 19:00:00+00,21815,1660,5441,1786,1034,5162,2704,823,0,1116,41541,286,10965,8261,2820,23475
2022-01-14 19:30:00+00,21418,1627,5439,1800,1026,5224,2700,625,0,978,40837,285,10965,8265,2826,23045
2022-01-14 20:00:00+00,21321,1419,5436,1832,964,5130,2700,473,0,620,39895,282,10932,8232,2796,22740
2022-01-14 20:30:00+00,21009,1239,5359,1815,849,5088,2690,249,0,136,38434,283,10713,8023,2664,22248
2022-01-14 21:00:00+00,20033,980,5227,1864,644,5412,2683,219,0,134,37196,279,10418,7735,2508,21013
2022-01-14 21:30:00+00,18876,979,5222,1811,638,5190,2700,165,0,12,35593,275,10371,7671,2449,19855
2022-01-14 22:00:00+00,18236,981,5221,1828,594,3986,2645,169,0,12,33672,276,10288,7643,2422,19217
2022-01-14 22:30:00+00,16910,981,5256,2046,594,3706,2628,165,0,0,32286,268,10524,7896,2640,17891
2022-01-14 23:00:00+00,15979,966,5344,2017,590,3220,2367,161,0,0,30644,268,10318,7951,2607,16945
2022-01-14 23:30:00+00,15453,678,5347,2047,570,3204,2004,170,0,10,29483,261,9968,7964,2617,16131
2022-01-15 00:00:00+00,15594,748,5351,2094,422,3176,1846,170,0,0,29401,265,9713,7867,2516,16342
2022-01-15 00:30:00+00,15481,950,5351,2205,418,3326,1846,170,0,0,29747,269,9820,7974,2623,16431
2022-01-15 01:00:00+00,14976,960,5355,2305,370,3384,1828,165,0,0,29343,266,9858,8030,2675,15936
2022-01-15 01:30:00+00,14530,971,5346,2413,354,3306,1845,167,0,0,28932,262,9958,8113,2767,15501
2022-01-15 02:00:00+00,14158,980,5345,2459,351,3456,1814,167,0,0,28730,260,9969,8155,2810,15138
2022-01-15 02:30:00+00,14093,971,5344,2552,349,3398,1769,168,0,0,28644,259,10014,8245,2901,15064
2022-01-15 03:00:00+00,14209,965,5347,2874,348,2632,1770,165,0,0,28310,262,10339,8569,3222,15174
2022-01-15 03:30:00+00,13711,977,5339,3233,348,2632,1724,167,0,0,28131,257,10644,8920,3581,14688
2022-01-15 04:00:00+00,14599,976,5373,3185,348,2474,1737,169,0,0,28861,260,10643,8906,3533,15575
2022-01-15 04:30:00+00,14638,978,5437,2987,348,2470,1767,168,0,0,28793,261,10539,8772,3335,15616
2022-01-15 05:00:00+00,14990,981,5427,2753,375,2046,1810,167,0,0,28549,265,10365,8555,3128,15971
2022-01-15 05:30:00+00,15118,981,5431,2693,596,2040,1986,166,0,0,29011,263,10706,8720,3289,16099
2022-01-15 06:00:00+00,15331,980,5432,2601,636,1974,2085,164,0,0,29203,263,10754,8669,3237,16311
2022-01-15 06:30:00+00,16653,970,5439,2570,640,1964,2025,162,0,0,30423,269,10674,8649,3210,17623
2022-01-15 07:00:00+00,17910,979,5433,2583,647,1364,2066,174,0,120,31276,272,10729,8663,3230,18889
2022-01-15 07:30:00+00,18662,982,5440,2575,653,1504,2083,166,0,138,32203,275,10751,8668,3228,19644
2022-01-15 08:00:00+00,18992,907,5437,2601,706,2544,1970,174,1,346,33678,267,10715,8745,3308,19899
2022-01-15 08:30:00+00,19930,1134,5374,2536,816,2890,1982,171,68,382,35283,275,10776,8794,3420,21064
2022-01-15 09:00:00+00,20087,1343,5261,2596,836,4028,1983,200,266,306,36906,272,10942,8959,3698,21430
2022-01-15 09:30:00+00,20408,1474,5219,2667,849,4122,2010,233,528,230,37740,274,11273,9263,4044,21882
2022-01-15 10:00:00+00,20527,1476,5216,2640,852,4392,2019,329,832,232,38515,271,11559,9540,4324,22003
2022-01-15 10:30:00+00,20545,1480,5214,2405,852,4462,2036,414,957,534,38899,270,11464,9428,4214,22025
2022-01-15 11:00:00+00,20543,1480,5236,2405,836,4410,2081,365,1019,656,39031,268,11577,9496,4260,22023
2022-01-15 11:30:00+00,20510,1481,5343,2607,836,4400,2105,385,1091,626,39384,266,11982,9877,4534,21991
2022-01-15 12:00:00+00,20512,1480,5417,2633,788,4412,2110,395,1144,858,39749,264,12092,9982,4565,21992
2022-01-15 12:30:00+00,20507,1480,5417,2614,781,4322,2094,427,1111,938,39691,263,12017,9923,4506,21987
2022-01-15 13:00:00+00,20532,1482,5417,2834,781,4330,2111,412,977,462,39338,265,12120,10009,4592,22014
2022-01-15 13:30:00+00,20513,1478,5414,3055,780,4248,2114,334,1155,178,39269,264,12518,10404,4990,21991
2022-01-15 14:00:00+00,20337,1394,5412,3222,771,4338,2118,278,834,292,38996,263,12357,10239,4827,21731
2022-01-15 14:30:00+00,20417,1476,5416,3170,775,4246,2117,238,544,340,38739,266,12022,9905,4489,21893
2022-01-15 15:00:00+00,20543,1478,5414,3186,807,3926,2163,197,317,152,38183,269,11887,9724,4310,22021
2022-01-15 15:30:00+00,20613,1480,5413,3185,834,4056,2217,237,96,118,38249,271,11745,9528,4115,22093
2022-01-15 16:00:00+00,20471,1480,5371,3464,845,4220,2262,423,2,754,39292,264,11944,9682,4311,21951
2022-01-15 16:30:00+00,20747,1480,5237,3606,848,4298,2275,745,0,1824,41060,259,11966,9691,4454,22227
2022-01-15 17:00:00+00,21536,1479,5209,3865,948,4112,2298,757,0,2216,42420,256,12320,10022,4813,23015
2022-01-15 17:30:00+00,21562,1480,5212,4398,963,4068,2312,726,0,1850,42571,255,12885,10573,5361,23042
2022-01-15 18:00:00+00,20519,1459,5217,4627,962,4188,2317,651,0,1950,41890,249,13123,10806,5589,21978
2022-01-15 18:30:00+00,20094,1463,5322,4966,882,4122,2329,560,0,1782,41520,246,13499,11170,5848,21557
2022-01-15 19:00:00+00,20177,1478,5412,5278,869,3914,2330,323,0,442,40223,254,13889,11559,6147,21655
2022-01-15 19:30:00+00,19563,1478,5411,5205,866,3926,2333,186,0,176,39144,254,13815,11482,6071,21041
2022-01-15 20:00:00+00,18632,1340,5419,5233,772,3756,2332,169,0,10,37663,250,13756,11424,6005,19972
2022-01-15 20:30:00+00,17471,1012,5416,5265,750,3710,2336,167,0,0,36127,239,13767,11431,6015,18483
2022-01-15 21:00:00+00,16289,831,5414,5662,500,3760,2331,168,0,10,34965,230,13907,11576,6162,17120
2022-01-15 21:30:00+00,15104,497,5413,6532,467,3600,2285,165,0,60,34123,211,14697,12412,6999,15601
2022-01-15 22:00:00+00,14429,716,5417,6872,363,2600,2253,157,0,90,32897,215,14905,12652,7235,15145
2022-01-15 22:30:00+00,12764,703,5417,7552,358,2608,2245,162,0,0,31809,202,15572,13327,7910,13467
2022-01-15 23:00:00+00,9383,580,5414,7963,322,4260,2046,168,0,0,30136,173,15745,13699,8285,9963
2022-01-15 23:30:00+00,8272,464,5422,8234,320,4326,2085,176,0,0,29299,160,16061,13976,8554,8736
2022-01-16 00:00:00+00,8110,459,5324,8404,296,4262,2106,161,0,0,29122,155,16130,14024,8700,8569
2022-01-16 00:30:00+00,8291,343,5225,8826,294,4352,2167,162,0,0,29660,153,16512,14345,9120,8634
2022-01-16 01:00:00+00,7747,232,5215,9466,278,4262,2114,163,0,0,29477,146,17073,14959,9744,7979
2022-01-16 01:30:00+00,7513,229,5223,9664,276,4164,1898,160,0,0,29127,143,17061,15163,9940,7742
2022-01-16 02:00:00+00,7348,234,5314,9707,260,3848,1892,167,0,0,28770,141,17173,15281,9967,7582
2022-01-16 02:30:00+00,7330,173,5415,9562,258,3789,1897,198,0,0,28622,139,17132,15235,9820,7503
2022-01-16 03:00:00+00,7745,115,5425,9578,258,3030,1897,167,0,0,28216,147,17158,15261,9836,7860
2022-01-16 03:30:00+00,7237,58,5419,9736,256,2892,1902,168,0,0,27668,139,17313,15411,9992,7295
2022-01-16 04:00:00+00,7329,0,5425,9757,255,2934,1938,168,0,0,27806,138,17375,15437,10012,7329
2022-01-16 04:30:00+00,7250,0,5419,9698,273,2882,2041,177,0,0,27740,137,17431,15390,9971,7250
2022-01-16 05:00:00+00,8094,0,5414,9339,270,2506,2089,172,0,0,27884,151,17112,15023,9609,8094
2022-01-16 05:30:00+00,8019,0,5415,9193,270,2688,2172,178,0,0,27935,153,17050,14878,9463,8019
2022-01-16 06:00:00+00,8230,0,5412,9099,319,2344,2417,182,0,0,28003,154,17247,14830,9418,8230
2022-01-16 06:30:00+00,8563,0,5412,9129,351,2442,2586,169,0,0,28652,157,17478,14892,9480,8563
2022-01-16 07:00:00+00,9712,0,5411,9193,400,2344,2740,166,0,0,29966,165,17744,15004,9593,9712
2022-01-16 07:30:00+00,9705,0,5413,9189,428,2470,2754,166,0,0,30125,166,17784,15030,9617,9705
2022-01-16 08:00:00+00,9534,12,5410,8848,440,3552,2578,170,9,64,30617,160,17285,14707,9297,9546
2022-01-16 08:30:00+00,10170,192,5417,8755,467,3734,2857,186,159,120,32057,169,17655,14798,9381,10362
2022-01-16 09:00:00+00,10038,264,5340,9063,478,4862,2887,175,496,90,33693,161,18264,15377,10037,10302
2022-01-16 09:30:00+00,10201,428,5223,9815,495,4968,2811,186,925,0,35052,162,19269,16458,11235,10629
2022-01-16 10:00:00+00,10927,461,5218,10033,562,4870,2552,214,1553,196,36586,161,19918,17366,12148,11388
2022-01-16 10:30:00+00,11410,615,5219,9814,535,4806,2716,213,2276,430,38034,164,20560,17844,12625,12025
2022-01-16 11:00:00+00,11681,728,5222,9884,518,4242,2955,263,2522,194,38209,165,21101,18146,12924,12409
2022-01-16 11:30:00+00,11718,887,5220,9790,504,4376,2936,300,3003,0,38734,168,21453,18517,13297,12605
2022-01-16 12:00:00+00,12110,978,5213,9419,513,4384,2972,330,2513,134,38566,176,20630,17658,12445,13088
2022-01-16 12:30:00+00,12707,978,5213,9551,523,4236,2977,224,2455,178,39042,177,20719,17742,12529,13685
2022-01-16 13:00:00+00,13210,978,5223,9258,447,4274,2973,337,2244,18,38962,184,20145,17172,11949,14188
2022-01-16 13:30:00+00,13192,978,5339,9149,452,4276,2974,497,1883,0,38740,186,19797,16823,11484,14170
2022-01-16 14:00:00+00,13238,857,5413,9517,464,4288,2958,530,1686,0,38951,183,20038,17080,11667,14095
2022-01-16 14:30:00+00,13901,710,5414,9764,483,4272,2735,392,1180,84,38935,185,19576,16841,11427,14611
2022-01-16 15:00:00+00,14693,832,5412,9674,527,4128,2598,190,777,84,38915,192,18988,16390,10978,15525
2022-01-16 15:30:00+00,15551,705,5415,9384,547,4140,2936,198,222,42,39140,198,18504,15568,10153,16256
2022-01-16 16:00:00+00,16370,912,5410,9684,609,3770,3035,329,14,356,40489,200,18752,15717,10307,17282
2022-01-16 16:30:00+00,16778,978,5408,10042,615,3896,3099,485,0,1150,42451,199,19164,16065,10657,17756
2022-01-16 17:00:00+00,17054,979,5415,9866,617,4166,3100,584,0,1636,43417,201,18998,15898,10483,18033
2022-01-16 17:30:00+00,17165,981,5416,9855,728,4148,3100,710,0,1440,43543,202,19099,15999,10583,18146
2022-01-16 18:00:00+00,17032,867,5416,10134,696,4006,3101,717,0,1094,43063,198,19347,16246,10830,17899
2022-01-16 18:30:00+00,16469,976,5419,9797,628,3982,3094,509,0,1060,41934,199,18938,15844,10425,17445
2022-01-16 19:00:00+00,16780,980,5423,9747,580,3022,3099,405,0,382,40418,208,18849,15750,10327,17760
2022-01-16 19:30:00+00,16083,978,5421,10028,481,2932,3101,316,0,0,39340,206,19031,15930,10509,17061
2022-01-16 20:00:00+00,15647,981,5413,9703,479,2102,3097,194,0,202,37818,205,18692,15595,10182,16628
2022-01-16 20:30:00+00,15131,981,5344,9407,489,2028,3083,181,0,26,36670,206,18323,15240,9896,16112
2022-01-16 21:00:00+00,14906,980,5223,9283,491,1220,3081,188,0,122,35494,210,18078,14997,9774,15886
2022-01-16 21:30:00+00,14072,811,5208,9377,476,1186,3083,169,0,0,34382,202,18144,15061,9853,14883
2022-01-16 22:00:00+00,13197,618,5201,9987,352,1834,3022,166,0,0,34377,190,18562,15540,10339,13815
2022-01-16 22:30:00+00,11881,473,5196,10198,314,1908,2757,166,0,28,32921,178,18465,15708,10512,12354
2022-01-16 23:00:00+00,10597,470,5269,10491,306,2478,2428,160,0,0,32199,171,18494,16066,10797,11067
2022-01-16 23:30:00+00,9464,461,5387,10697,301,2462,2309,161,0,0,31242,161,18694,16385,10998,9925
2022-01-17 00:00:00+00,9556,461,5415,10796,294,2270,2358,160,0,0,31310,159,18863,16505,11090,10017
2022-01-17 00:30:00+00,10123,461,5419,10566,281,2270,2446,170,0,0,31736,164,18712,16266,10847,10584
2022-01-17 01:00:00+00,10184,462,5417,10432,248,2536,2391,165,0,0,31835,168,18488,16097,10680,10646
2022-01-17 01:30:00+00,10126,461,5421,10001,247,2550,2196,166,0,0,31168,170,17865,15669,10248,10587
2022-01-17 02:00:00+00,9948,460,5420,9688,232,2746,2176,171,0,0,30841,171,17516,15340,9920,10408
2022-01-17 02:30:00+00,9485,461,5427,10135,230,2746,2139,170,0,0,30793,165,17931,15792,10365,9946
2022-01-17 03:00:00+00,9172,460,5418,9963,231,2742,2201,171,0,0,30358,164,17813,15612,10194,9632
2022-01-17 03:30:00+00,8822,461,5426,10030,230,2740,2180,170,0,0,30059,160,17866,15686,10260,9283
2022-01-17 04:00:00+00,9139,461,5352,9938,212,2746,2207,171,0,0,30226,164,17709,15502,10150,9600
2022-01-17 04:30:00+00,9569,461,5231,9507,214,2746,2162,169,0,0,30059,170,17114,14952,9721,10030
2022-01-17 05:00:00+00,9907,550,5219,9299,229,2594,2228,160,0,0,30186,175,16975,14747,9528,10457
2022-01-17 05:30:00+00,11231,748,5211,8855,230,2590,2260,160,0,0,31285,191,16556,14296,9085,11979
2022-01-17 06:00:00+00,12958,1131,5207,8721,264,2582,2469,161,0,0,33493,210,16661,14192,8985,14089
2022-01-17 06:30:00+00,15110,1290,5210,8754,312,2716,2978,160,0,134,36664,223,17254,14276,9066,16400
2022-01-17 07:00:00+00,17995,1709,5207,8613,364,2370,3047,165,0,34,39504,242,17231,14184,8977,19704
2022-01-17 07:30:00+00,19589,1913,5204,8270,388,2452,3068,169,0,110,41163,253,16930,13862,8658,21502
2022-01-17 08:00:00+00,19748,1903,5203,8157,481,2744,3098,210,31,68,41643,254,16970,13872,8669,21651
2022-01-17 08:30:00+00,20295,2111,5160,7783,512,2848,3105,256,489,174,42733,258,17049,13944,8784,22406
2022-01-17 09:00:00+00,21211,2294,4944,7573,523,2974,3108,376,1577,6,44586,263,17725,14617,9673,23505
2022-01-17 09:30:00+00,21429,2361,4958,7279,514,2902,3095,409,2555,0,45502,260,18401,15306,10348,23790
2022-01-17 10:00:00+00,21539,2347,4956,6911,556,3028,3092,366,3388,48,46231,258,18903,15811,10855,23886
2022-01-17 10:30:00+00,21691,2077,4954,6443,556,2962,3100,371,4020,0,46174,254,19073,15973,11019,23768
2022-01-17 11:00:00+00,20948,1760,4957,5872,500,3252,2980,271,4492,0,45032,247,18801,15821,10864,22708
2022-01-17 11:30:00+00,21125,1500,4962,5371,470,3294,2927,168,4784,44,44645,244,18514,15587,10625,22625
2022-01-17 12:00:00+00,21244,1409,4967,4790,467,3586,2941,184,4921,0,44509,244,18086,15145,10178,22653
2022-01-17 12:30:00+00,21441,1469,4954,4464,472,3576,2943,203,4862,0,44384,248,17695,14752,9798,22910
2022-01-17 13:00:00+00,21725,1576,4842,4076,513,3622,2967,171,4596,0,44088,255,16994,14027,9185,23301
2022-01-17 13:30:00+00,21784,1730,4748,3724,511,3658,2919,170,4198,0,43442,262,16100,13181,8433,23514
2022-01-17 14:00:00+00,21251,1838,4743,3653,517,4128,2900,212,3599,30,42871,264,15412,12512,7769,23089
2022-01-17 14:30:00+00,21203,1886,4747,3546,561,4268,2881,217,2767,52,42128,270,14502,11621,6874,23089
2022-01-17 15:00:00+00,20767,1883,4771,3457,578,4610,2680,234,1704,1514,42198,264,13190,10510,5739,22650
2022-01-17 15:30:00+00,21491,1888,4894,3287,661,4824,2670,285,534,1964,42498,271,12046,9376,4482,23379
2022-01-17 16:00:00+00,22832,1891,4956,3078,764,4676,2801,437,38,1658,43131,280,11637,8836,3880,24723
2022-01-17 16:30:00+00,23344,2087,4958,2901,907,4640,2842,719,0,1876,44274,284,11608,8766,3808,25431
2022-01-17 17:00:00+00,23369,2066,4956,2779,1035,5152,2808,1001,0,2254,45420,282,11578,8770,3814,25435
2022-01-17 17:30:00+00,23382,2144,4957,2609,1041,5184,2786,1096,0,2260,45459,284,11393,8607,3650,25526
2022-01-17 18:00:00+00,23404,1983,4964,2809,1045,5196,2804,924,0,1836,44965,284,11622,8818,3854,25387
2022-01-17 18:30:00+00,23367,1751,4968,3014,1026,5270,2828,759,0,2036,45019,278,11836,9008,4040,25118
2022-01-17 19:00:00+00,23047,1659,4970,3231,1017,5434,2868,691,0,1500,44417,276,12086,9218,4248,24706
2022-01-17 19:30:00+00,22720,1665,4968,3389,965,5464,2824,483,0,704,43182,280,12146,9322,4354,24385
2022-01-17 20:00:00+00,22409,1620,4968,3441,795,5088,2850,257,0,198,41626,283,12054,9204,4236,24029
2022-01-17 20:30:00+00,21797,1234,4969,3393,676,4996,2880,209,0,16,40170,277,11918,9038,4069,23031
2022-01-17 21:00:00+00,20699,977,4969,3592,625,4560,2861,168,0,158,38609,271,12047,9186,4217,21676
2022-01-17 21:30:00+00,19121,982,4969,3696,611,4290,2786,151,0,90,36696,265,12062,9276,4307,20103
2022-01-17 22:00:00+00,18108,978,4967,3542,390,3466,2951,150,0,164,34716,271,11850,8899,3932,19086
2022-01-17 22:30:00+00,16724,980,5000,3568,372,3236,2844,154,0,54,32932,265,11784,8940,3940,17704
2022-01-17 23:00:00+00,16083,979,5032,3677,353,2608,2471,146,0,38,31387,263,11533,9062,4030,17062
2022-01-17 23:30:00+00,15182,979,5030,4083,326,2588,2370,148,0,0,30706,257,11809,9439,4409,16161
2022-01-18 00:00:00+00,14351,981,5029,4410,268,2874,2348,146,0,0,30407,253,12055,9707,4678,15332
2022-01-18 00:30:00+00,14544,980,5028,4604,262,3050,2377,145,0,0,30990,253,12271,9894,4866,15524
2022-01-18 01:00:00+00,14493,965,5032,4700,261,3122,2407,144,0,0,31124,252,12400,9993,4961,15458
2022-01-18 01:30:00+00,14425,797,5030,4852,259,2984,2406,145,0,0,30898,246,12547,10141,5111,15222
2022-01-18 02:00:00+00,14681,921,5032,4945,224,2806,2407,152,0,0,31168,250,12608,10201,5169,15602
2022-01-18 02:30:00+00,14588,888,5034,4900,223,2830,2406,151,0,0,31020,250,12563,10157,5123,15476
2022-01-18 03:00:00+00,14727,842,5034,4797,224,2908,2417,152,0,0,31101,250,12472,10055,5021,15569
2022-01-18 03:30:00+00,14733,756,5035,4860,222,2958,2417,165,0,0,31146,248,12534,10117,5082,15489
2022-01-18 04:00:00+00,14651,814,5034,4909,222,2960,2419,152,0,0,31161,249,12584,10165,5131,15465
2022-01-18 04:30:00+00,14807,951,5036,4690,222,2942,2417,151,0,0,31216,254,12365,9948,4912,15758
2022-01-18 05:00:00+00,16175,914,5036,4641,238,1568,2392,145,0,0,31109,256,12307,9915,4879,17089
2022-01-18 05:30:00+00,17425,944,5036,4668,235,1540,2327,144,0,0,32319,262,12266,9939,4903,18369
2022-01-18 06:00:00+00,19620,952,5034,4889,336,1540,2388,258,0,0,35017,268,12647,10259,5225,20572
2022-01-18 06:30:00+00,21529,978,5026,5197,417,1536,2687,307,0,130,37807,270,13327,10640,5614,22507
2022-01-18 07:00:00+00,22462,974,5029,5304,702,1508,2989,464,0,300,39732,268,14024,11035,6006,23436
2022-01-18 07:30:00+00,23587,970,5029,5570,752,1508,3081,645,0,422,41564,269,14432,11351,6322,24557
2022-01-18 08:00:00+00,23180,980,5026,5639,765,2460,3085,739,36,426,42336,265,14551,11466,6440,24160
2022-01-18 08:30:00+00,23466,981,5031,5851,749,2546,3075,650,407,594,43350,261,15113,12038,7007,24447
2022-01-18 09:00:00+00,23343,980,5054,6093,750,3068,3067,520,1121,712,44708,252,16085,13018,7964,24323
2022-01-18 09:30:00+00,22925,979,5057,6577,756,3086,3032,475,1798,498,45183,246,17220,14188,9131,23904
2022-01-18 10:00:00+00,22938,976,5059,6811,635,3232,2988,253,2258,380,45530,244,17751,14763,9704,23914
2022-01-18 10:30:00+00,22491,977,5061,7194,605,3248,2868,274,2607,0,45325,241,18335,15467,10406,23468
2022-01-18 11:00:00+00,22337,981,5058,7596,567,2986,2572,219,3056,158,45530,236,18849,16277,11219,23318
2022-01-18 11:30:00+00,22435,981,5061,7691,533,2998,2544,167,2904,18,45332,237,18733,16189,11128,23416
2022-01-18 12:00:00+00,22754,972,5067,7634,401,2862,2431,159,2916,10,45206,240,18449,16018,10951,23726
2022-01-18 12:30:00+00,22234,894,5065,8143,396,2856,2428,160,2954,0,45130,234,18986,16558,11493,23128
2022-01-18 13:00:00+00,22539,680,5064,8417,357,2676,2425,167,2496,32,44853,233,18759,16334,11270,23219
2022-01-18 13:30:00+00,22549,677,5063,8527,320,2674,2423,154,2028,0,44415,235,18361,15938,10875,23226
2022-01-18 14:00:00+00,22504,780,5064,8879,336,2308,2415,158,1510,0,43954,239,18204,15789,10725,23284
2022-01-18 14:30:00+00,22683,738,5056,9045,329,2308,2435,185,1118,0,43897,241,17983,15548,10492,23421
2022-01-18 15:00:00+00,23256,892,5057,8706,371,2116,2422,217,640,90,43767,251,17196,14774,9717,24148
2022-01-18 15:30:00+00,23203,905,5057,8757,401,2120,2422,316,200,680,44061,250,16837,14415,9358,24108
2022-01-18 16:00:00+00,22224,978,5061,8894,477,2784,2421,392,20,724,43975,246,16873,14452,9391,23202
2022-01-18 16:30:00+00,22689,978,5059,9347,531,2860,2415,649,0,1384,45912,242,17352,14937,9878,23667
2022-01-18 17:00:00+00,23544,978,5058,9754,594,2938,2416,725,0,1422,47429,242,17822,15406,10348,24522
2022-01-18 17:30:00+00,23208,959,5059,9852,600,2838,2423,716,0,1622,47277,238,17934,15511,10452,24167
2022-01-18 18:00:00+00,23164,818,5058,10170,541,2848,2416,679,0,1660,47354,235,18185,15769,10711,23982
2022-01-18 18:30:00+00,22897,944,5065,10403,499,2736,2413,616,0,1316,46889,236,18380,15967,10902,23841
2022-01-18 19:00:00+00,22214,980,5063,10386,432,2702,2403,363,0,666,45209,238,18284,15881,10818,23194
2022-01-18 19:30:00+00,21520,910,5066,10868,427,2626,2415,197,0,78,44107,234,18776,16361,11295,22430
2022-01-18 20:00:00+00,20044,837,5066,11412,353,2678,2411,173,0,48,43022,228,19242,16831,11765,20881
2022-01-18 20:30:00+00,18493,972,5066,11506,329,2470,2258,170,0,46,41310,224,19159,16901,11835,19465
2022-01-18 21:00:00+00,16762,979,5070,11569,298,2474,2072,193,0,56,39473,217,19009,16937,11867,17741
2022-01-18 21:30:00+00,14908,977,5069,11384,286,2240,2083,157,0,322,37426,206,18822,16739,11670,15885
2022-01-18 22:00:00+00,13521,831,5072,11272,256,2012,2074,147,0,88,35273,197,18674,16600,11528,14352
2022-01-18 22:30:00+00,11981,484,5065,11359,246,1870,2075,165,0,134,33379,179,18745,16670,11605,12465
2022-01-18 23:00:00+00,10112,385,5074,11755,238,2040,1906,144,0,40,31694,160,18973,17067,11993,10497
2022-01-18 23:30:00+00,8882,264,5069,11818,228,2162,1726,146,0,74,30369,149,18841,17115,12046,9146
2022-01-19 00:00:00+00,8771,306,5082,12121,193,2302,1725,142,0,0,30642,145,19121,17396,12314,9077
2022-01-19 00:30:00+00,8703,273,5085,12303,174,2558,1735,148,0,0,30979,146,19297,17562,12477,8976
2022-01-19 01:00:00+00,8624,234,5087,12495,177,3062,1848,142,0,0,31669,146,19607,17759,12672,8858
2022-01-19 01:30:00+00,8439,26,5083,12661,178,2994,1856,146,0,0,31383,138,19778,17922,12839,8465
2022-01-19 02:00:00+00,8335,0,5087,13045,178,2684,1741,144,0,0,31214,133,20051,18310,13223,8335
2022-01-19 02:30:00+00,7844,0,5084,13308,176,2668,1726,143,0,0,30949,128,20294,18568,13484,7844
2022-01-19 03:00:00+00,8257,0,5086,13403,176,2014,1732,139,0,0,30807,128,20397,18665,13579,8257
2022-01-19 03:30:00+00,7772,0,5086,13531,176,2056,1731,143,0,0,30495,124,20524,18793,13707,7772
2022-01-19 04:00:00+00,8224,0,5088,13733,176,1670,1424,145,0,0,30460,126,20421,18997,13909,8224
2022-01-19 04:30:00+00,8134,0,5083,13664,176,1648,1433,151,0,0,30289,125,20356,18923,13840,8134
2022-01-19 05:00:00+00,8384,0,5084,13635,221,1804,1436,147,0,0,30711,130,20376,18940,13856,8384
2022-01-19 05:30:00+00,9241,0,5083,14062,210,1794,1432,147,0,0,31969,136,20787,19355,14272,9241
2022-01-19 06:00:00+00,11538,0,5082,14026,225,1492,1469,147,0,76,34055,150,20802,19333,14251,11538
2022-01-19 06:30:00+00,14504,0,5079,14270,280,1416,1628,148,0,0,37325,170,21257,19629,14550,14504
2022-01-19 07:00:00+00,16804,0,5076,14646,380,1254,1741,166,0,0,40067,185,21843,20102,15026,16804
2022-01-19 07:30:00+00,18144,0,5074,14681,406,1520,1759,358,0,44,41986,193,21920,20161,15087,18144
2022-01-19 08:00:00+00,18736,159,5072,14997,463,1386,1769,479,11,46,43118,195,22312,20543,15471,18895
2022-01-19 08:30:00+00,18445,286,5076,15444,429,1508,1769,408,178,136,43679,193,22896,21127,16051,18731
2022-01-19 09:00:00+00,18383,264,5076,15544,490,2132,1769,265,664,188,44775,189,23543,21774,16698,18647
2022-01-19 09:30:00+00,18207,363,5081,15365,500,2016,1760,219,1323,176,45010,186,24029,22269,17188,18570
2022-01-19 10:00:00+00,18021,241,5099,15502,441,2270,1714,187,2034,16,45525,182,24790,23076,17977,18262
2022-01-19 10:30:00+00,17904,239,5098,15410,420,2022,1574,172,2592,160,45591,178,25094,23520,18422,18143
2022-01-19 11:00:00+00,17956,233,5098,15410,340,2054,1669,173,2959,100,45992,176,25476,23807,18709,18189
2022-01-19 11:30:00+00,17379,232,5105,15742,343,2054,1760,164,3366,0,46145,171,26316,24556,19451,17611
2022-01-19 12:00:00+00,17413,238,5116,15683,294,1756,1769,164,3179,112,45724,172,26041,24272,19156,17651
2022-01-19 12:30:00+00,17278,243,5116,15729,280,1754,1637,175,3086,184,45482,172,25848,24211,19095,17521
2022-01-19 13:00:00+00,17376,237,5116,15939,283,2194,1421,154,3280,44,46044,169,26039,24618,19502,17613
2022-01-19 13:30:00+00,16904,236,5114,16094,286,2388,1403,124,3020,68,45637,167,25917,24514,19400,17140
2022-01-19 14:00:00+00,17140,240,5115,15847,308,2168,1400,132,2513,0,44863,171,25183,23783,18668,17380
2022-01-19 14:30:00+00,17535,243,5112,15510,324,2226,1419,157,1902,18,44446,177,24267,22848,17736,17778
2022-01-19 15:00:00+00,18334,239,5113,15012,345,2304,1535,134,1125,0,44141,185,23130,21595,16482,18573
2022-01-19 15:30:00+00,19043,355,5112,15022,358,2372,1659,203,495,0,44619,193,22646,20987,15875,19398
2022-01-19 16:00:00+00,19283,467,5112,14551,471,2843,1739,239,62,192,44959,199,21935,20196,15084,19750
2022-01-19 16:30:00+00,19731,469,5110,14287,579,3115,1738,545,0,898,46472,201,21714,19976,14866,20200
2022-01-19 17:00:00+00,18985,286,5110,14297,587,3238,1677,770,0,1666,46616,191,21671,19994,14884,19271
2022-01-19 17:30:00+00,19183,236,5113,14448,588,3284,1647,783,0,1748,47030,190,21796,20149,15036,19419
2022-01-19 18:00:00+00,19521,236,5108,14003,588,3211,1654,755,0,1784,46860,193,21353,19699,14591,19757
2022-01-19 18:30:00+00,19696,269,5110,13578,586,3160,1656,607,0,1664,46327,196,20930,19274,14164,19965
2022-01-19 19:00:00+00,19533,446,5109,13478,563,3122,1732,277,0,312,44572,204,20882,19150,14041,19979
2022-01-19 19:30:00+00,18813,329,5110,13502,524,2997,1729,214,0,0,43217,200,20864,19136,14026,19142
2022-01-19 20:00:00+00,18061,255,5110,13381,389,3058,1656,211,0,356,42477,196,20536,18880,13770,18316
2022-01-19 20:30:00+00,16849,256,5114,13652,337,2952,1750,173,0,14,41097,190,20853,19103,13989,17105
2022-01-19 21:00:00+00,15394,176,5114,13551,283,2778,1723,153,0,252,39424,179,20671,18948,13834,15570
2022-01-19 21:30:00+00,14055,0,5115,13527,269,2734,1649,150,0,140,37639,169,20560,18911,13796,14055
2022-01-19 22:00:00+00,13326,0,5116,13226,222,2592,1732,155,0,188,36557,166,20296,18564,13448,13326
2022-01-19 22:30:00+00,11701,0,5114,13316,215,2569,1769,149,0,0,34833,155,20414,18645,13531,11701
2022-01-19 23:00:00+00,10168,0,5118,13172,215,2482,1656,148,0,0,32959,145,20161,18505,13387,10168
2022-01-19 23:30:00+00,9703,0,5115,13327,212,2482,1580,147,0,0,32566,141,20234,18654,13539,9703
2022-01-20 00:00:00+00,9167,0,5109,13082,197,2452,1415,152,0,0,31574,136,19803,18388,13279,9167
2022-01-20 00:30:00+00,9663,0,5113,12863,197,2452,1492,152,0,0,31932,141,19665,18173,13060,9663
2022-01-20 01:00:00+00,9588,0,5113,13080,197,2482,1431,143,0,0,32034,139,19821,18390,13277,9588
2022-01-20 01:30:00+00,9291,0,5115,12876,195,2482,1455,147,0,0,31561,138,19641,18186,13071,9291
2022-01-20 02:00:00+00,9262,0,5113,12792,161,2412,1427,153,0,0,31320,138,19493,18066,12953,9262
2022-01-20 02:30:00+00,9152,0,5115,12476,161,2412,1432,156,0,0,30904,139,19184,17752,12637,9152
2022-01-20 03:00:00+00,9243,0,5113,11935,161,2386,1519,163,0,0,30520,142,18728,17209,12096,9243
2022-01-20 03:30:00+00,9331,0,5119,11808,160,2388,1625,161,0,0,30592,143,18712,17087,11968,9331
2022-01-20 04:00:00+00,9451,0,5117,11121,160,2618,1532,159,0,0,30158,147,17930,16398,11281,9451
2022-01-20 04:30:00+00,9621,0,5117,10908,160,2643,1581,163,0,0,30193,150,17766,16185,11068,9621
2022-01-20 05:00:00+00,9583,12,5120,10824,160,2584,1759,160,0,0,30202,150,17863,16104,10984,9595
2022-01-20 05:30:00+00,10578,37,5117,10716,163,2552,1765,169,0,0,31097,159,17761,15996,10879,10615
2022-01-20 06:00:00+00,13436,142,5115,10480,181,2675,1768,177,0,196,34170,181,17544,15776,10661,13578
2022-01-20 06:30:00+00,16664,470,5120,10151,226,2621,1759,565,0,84,37660,209,17256,15497,10377,17134
2022-01-20 07:00:00+00,19762,834,5113,10020,280,2099,1767,571,0,348,40794,230,17180,15413,10300,20596
2022-01-20 07:30:00+00,21935,1068,5112,9648,333,2102,1764,351,0,266,42579,244,16857,15093,9981,23003
2022-01-20 08:00:00+00,22663,995,5109,9402,600,2510,1768,229,49,528,43854,243,16928,15160,10051,23658
2022-01-20 08:30:00+00,23111,707,5107,9149,597,2606,1771,538,543,636,44766,239,17167,15396,10289,23818
2022-01-20 09:00:00+00,23082,875,5109,8704,596,2749,1770,574,1307,564,45329,240,17486,15716,10607,23957
2022-01-20 09:30:00+00,23054,959,5109,8451,595,2620,1771,648,2125,252,45584,240,18051,16280,11171,24013
2022-01-20 10:00:00+00,23027,980,5111,8455,498,2351,1772,711,2758,258,45921,237,18594,16822,11711,24007
2022-01-20 10:30:00+00,23126,980,5111,8110,457,2311,1770,509,3290,408,46072,235,18738,16968,11857,24106
2022-01-20 11:00:00+00,22979,979,5111,8274,455,2492,1772,398,3780,294,46534,231,19392,17620,12509,23958
2022-01-20 11:30:00+00,23006,980,5109,8355,398,2432,1771,251,4076,118,46495,230,19709,17938,12829,23986
2022-01-20 12:00:00+00,23042,979,5110,8269,410,2551,1773,332,4092,138,46696,230,19654,17881,12771,24021
2022-01-20 12:30:00+00,22838,978,5116,8598,407,2517,1772,445,3962,78,46711,229,19855,18083,12967,23816
2022-01-20 13:00:00+00,22647,1101,5116,9031,403,2465,1770,263,3748,0,46544,229,20068,18298,13182,23748
2022-01-20 13:30:00+00,22415,1360,5118,9171,404,2430,1766,240,3337,10,46251,233,19796,18030,12912,23775
2022-01-20 14:00:00+00,22139,1408,5116,9064,404,2387,1767,190,2746,154,45375,235,19097,17330,12214,23547
2022-01-20 14:30:00+00,22062,1526,5116,8750,405,2448,1766,198,2177,336,44784,241,18214,16448,11332,23588
2022-01-20 15:00:00+00,21789,1558,5117,8592,429,2582,1765,220,1377,16,43445,246,17280,15515,10398,23347
2022-01-20 15:30:00+00,22279,1632,5114,8464,494,2616,1771,167,521,210,43269,253,16364,14593,9479,23911
2022-01-20 16:00:00+00,22397,1743,5111,8541,668,3632,1772,309,71,176,44421,252,16163,14391,9280,24140
2022-01-20 16:30:00+00,22629,1747,5114,8361,755,3646,1775,550,0,1388,45965,248,16005,14230,9116,24376
2022-01-20 17:00:00+00,22767,1914,5112,8343,874,3888,1761,800,0,1566,47025,251,16090,14329,9217,24681
2022-01-20 17:30:00+00,22797,1928,5117,8564,874,3904,1771,791,0,1268,47014,252,16326,14555,9438,24725
2022-01-20 18:00:00+00,22768,1923,5113,8714,861,3532,1778,730,0,1352,46771,252,16466,14688,9575,24691
2022-01-20 18:30:00+00,22699,1917,5115,8440,836,3522,1776,633,0,1328,46266,253,16167,14391,9276,24616
2022-01-20 19:00:00+00,22130,1808,5114,8079,719,4524,1775,583,0,864,45596,251,15687,13912,8798,23938
2022-01-20 19:30:00+00,22117,1716,5114,8083,676,4514,1776,250,0,174,44420,253,15649,13873,8759,23833
2022-01-20 20:00:00+00,21957,1569,5118,8242,440,3260,1787,169,0,6,42548,257,15587,13800,8682,23526
2022-01-20 20:30:00+00,21468,1207,5118,8024,340,3202,1781,174,0,146,41460,250,15263,13482,8364,22675
2022-01-20 21:00:00+00,20557,940,5122,7817,237,2978,1780,170,0,198,39799,245,14956,13176,8054,21497
2022-01-20 21:30:00+00,18869,649,5122,8048,236,2942,1783,167,0,8,37824,233,15189,13406,8284,19518
2022-01-20 22:00:00+00,18164,37,5118,7791,235,2828,1782,168,0,112,36235,220,14926,13144,8026,18201
2022-01-20 22:30:00+00,16643,0,5120,7953,233,2746,1782,171,0,0,34648,211,15088,13306,8186,16643
2022-01-20 23:00:00+00,15535,0,5114,7892,233,2530,1781,161,0,0,33246,205,15020,13239,8125,15535
2022-01-20 23:30:00+00,15247,0,5118,7698,220,2524,1783,185,0,0,32775,205,14819,13036,7918,15247
2022-01-21 00:00:00+00,15096,0,5114,7764,150,2398,1784,161,0,0,32467,206,14812,13028,7914,15096
2022-01-21 00:30:00+00,15298,0,5116,8048,148,2398,1782,160,0,0,32950,205,15094,13312,8196,15298
2022-01-21 01:00:00+00,15340,0,5111,8233,148,2378,1783,162,0,0,33155,204,15275,13492,8381,15340
2022-01-21 01:30:00+00,15258,0,5110,8117,148,2389,1782,161,0,0,32965,204,15157,13375,8265,15258
2022-01-21 02:00:00+00,15306,0,5114,8080,128,2488,1784,163,0,0,33063,205,15106,13322,8208,15306
2022-01-21 02:30:00+00,15396,0,5113,7976,127,2471,1782,164,0,0,33029,206,14998,13216,8103,15396
2022-01-21 03:00:00+00,15501,0,5115,8078,125,2414,1783,161,0,0,33177,205,15101,13318,8203,15501
2022-01-21 03:30:00+00,15511,0,5113,8024,123,2389,1792,162,0,0,33114,206,15052,13260,8147,15511
2022-01-21 04:00:00+00,15788,0,5116,8108,123,2309,1820,164,0,0,33428,206,15167,13347,8231,15788
2022-01-21 04:30:00+00,16111,72,5116,8176,123,2295,1884,161,0,0,33938,209,15299,13415,8299,16183
2022-01-21 05:00:00+00,16886,143,5116,8165,139,2111,1959,169,0,0,34688,214,15379,13420,8304,17029
2022-01-21 05:30:00+00,17825,360,5120,8146,139,2113,2027,164,0,0,35894,223,15432,13405,8285,18185
2022-01-21 06:00:00+00,19186,621,5119,8028,207,1977,2330,160,0,162,37790,233,15684,13354,8235,19807
2022-01-21 06:30:00+00,20386,868,5123,8177,221,2214,2619,158,0,140,39906,242,16140,13521,8398,21254
2022-01-21 07:00:00+00,21462,852,5121,8441,295,2578,2752,171,0,190,41863,243,16609,13857,8736,22314
2022-01-21 07:30:00+00,22127,878,5121,8534,410,2751,2717,258,0,32,42828,247,16782,14065,8944,23005
2022-01-21 08:00:00+00,22615,992,5119,8585,580,2660,2720,363,37,60,43731,248,17041,14321,9202,23607
2022-01-21 08:30:00+00,22881,940,5116,8441,502,2680,2740,433,357,464,44554,246,17156,14416,9300,23821
2022-01-21 09:00:00+00,22983,1013,5116,8169,480,2877,2750,383,1014,438,45222,243,17529,14779,9663,23996
2022-01-21 09:30:00+00,23054,1299,5116,8126,456,2757,2753,352,1620,0,45534,246,18071,15318,10202,24353
2022-01-21 10:00:00+00,23132,1329,5114,8110,425,2439,2784,359,2055,60,45806,246,18488,15704,10590,24461
2022-01-21 10:30:00+00,23181,1162,5115,7917,423,2419,2803,276,2324,402,46022,241,18582,15779,10664,24343
2022-01-21 11:00:00+00,23272,1245,5133,7820,490,2480,2811,215,2225,198,45889,244,18479,15668,10535,24517
2022-01-21 11:30:00+00,23259,1335,5144,7788,411,2428,2835,190,1946,54,45390,248,18124,15289,10145,24594
2022-01-21 12:00:00+00,23265,1257,5143,7972,285,2732,2823,198,1853,10,45538,248,18076,15253,10110,24522
2022-01-21 12:30:00+00,23163,1159,5140,8118,266,2734,2826,185,1660,0,45251,247,18010,15184,10044,24322
2022-01-21 13:00:00+00,23154,1101,5141,8403,236,2594,2834,167,1565,0,45195,245,18179,15345,10204,24255
2022-01-21 13:30:00+00,23041,832,5146,8530,222,2588,2834,158,1328,0,44679,241,18060,15226,10080,23873
2022-01-21 14:00:00+00,22839,580,5142,8705,237,2212,2836,159,1017,76,43803,234,17937,15101,9959,23419
2022-01-21 14:30:00+00,22633,744,5144,9037,237,2108,2837,159,725,0,43624,235,17980,15143,9999,23377
2022-01-21 15:00:00+00,21598,1070,5143,9023,329,2596,2841,182,433,84,43299,236,17769,14928,9785,22668
2022-01-21 15:30:00+00,22154,1335,5143,8821,357,2764,2848,170,192,30,43814,245,17361,14513,9370,23489
2022-01-21 16:00:00+00,22053,1392,5141,8743,444,3276,2847,380,17,124,44417,247,17192,14345,9204,23445
2022-01-21 16:30:00+00,22243,1419,5141,8511,499,3340,2850,586,0,880,45469,247,17001,14151,9010,23662
2022-01-21 17:00:00+00,22403,1424,5140,8439,697,3252,2826,805,0,1494,46480,247,17102,14276,9136,23827
2022-01-21 17:30:00+00,22575,1423,5141,8335,725,3238,2848,762,0,1214,46261,250,17049,14201,9060,23998
2022-01-21 18:00:00+00,22371,1421,5142,8274,687,3364,2845,511,0,1344,45959,249,16948,14103,8961,23792
2022-01-21 18:30:00+00,22058,1420,5140,8244,613,3346,2820,446,0,852,44939,251,16817,13997,8857,23478
2022-01-21 19:00:00+00,21396,1410,5142,8208,439,3862,2834,262,0,516,44069,249,16623,13789,8647,22806
2022-01-21 19:30:00+00,20469,1350,5145,8417,433,3734,2851,190,0,30,42619,246,16846,13995,8850,21819
2022-01-21 20:00:00+00,19234,1054,5142,8703,363,3608,2852,173,0,0,41129,237,17060,14208,9066,20288
2022-01-21 20:30:00+00,18141,809,5141,8504,346,3508,2843,174,0,130,39596,228,16834,13991,8850,18950
2022-01-21 21:00:00+00,16804,482,5148,8505,255,3808,2817,161,0,0,37980,218,16725,13908,8760,17286
2022-01-21 21:30:00+00,15123,262,5149,8850,251,3724,2842,161,0,0,36362,204,17092,14250,9101,15385
2022-01-21 22:00:00+00,15198,0,5146,8991,201,3226,2846,171,0,0,35779,201,17184,14338,9192,15198
2022-01-21 22:30:00+00,13655,0,5147,8989,201,3126,2852,167,0,0,34137,192,17189,14337,9190,13655
2022-01-21 23:00:00+00,11562,0,5146,8671,200,2932,2841,163,0,74,31589,179,16858,14017,8871,11562
2022-01-21 23:30:00+00,10941,0,5149,8423,190,2780,2818,162,0,0,30463,175,16580,13762,8613,10941
2022-01-22 00:00:00+00,10774,0,5152,8284,129,2778,2820,159,0,0,30096,175,16385,13565,8413,10774
2022-01-22 00:30:00+00,11221,0,5144,7970,129,2748,2821,176,0,22,30231,180,16064,13243,8099,11221
2022-01-22 01:00:00+00,11159,0,5143,7837,117,2764,2815,172,0,0,30007,181,15912,13097,7954,11159
2022-01-22 01:30:00+00,10837,0,5141,7754,117,2716,2809,161,0,0,29535,178,15821,13012,7871,10837
2022-01-22 02:00:00+00,10478,0,5143,8037,101,2748,2811,161,0,0,29479,175,16092,13281,8138,10478
2022-01-22 02:30:00+00,10196,0,5140,8054,103,2750,2812,161,0,0,29216,172,16109,13297,8157,10196
2022-01-22 03:00:00+00,10084,0,5140,8005,103,2884,2674,160,0,0,29050,172,15922,13248,8108,10084
2022-01-22 03:30:00+00,10384,0,5138,7560,102,2874,2816,164,0,0,29038,176,15616,12800,7662,10384
2022-01-22 04:00:00+00,10547,0,5142,7515,102,2748,2818,164,0,0,29036,178,15577,12759,7617,10547
2022-01-22 04:30:00+00,10291,0,5141,7641,101,2748,2821,159,0,0,28902,175,15704,12883,7742,10291
2022-01-22 05:00:00+00,10556,0,5138,7502,117,2748,2701,167,0,0,28929,179,15458,12757,7619,10556
2022-01-22 05:30:00+00,10905,0,5145,7415,117,2748,2776,160,0,0,29266,181,15453,12677,7532,10905
2022-01-22 06:00:00+00,11449,0,5143,7301,152,2802,2816,158,0,0,29821,186,15412,12596,7453,11449
2022-01-22 06:30:00+00,12285,0,5146,7238,159,2810,2809,157,0,0,30604,193,15352,12543,7397,12285
2022-01-22 07:00:00+00,13589,0,5147,7114,223,2734,2763,159,0,132,31861,201,15247,12484,7337,13589
2022-01-22 07:30:00+00,14729,0,5147,7026,240,2878,2783,162,0,18,32983,210,15196,12413,7266,14729
2022-01-22 08:00:00+00,15097,0,5146,7003,486,3472,2811,157,38,28,34238,209,15484,12673,7527,15097
2022-01-22 08:30:00+00,15834,0,5145,6861,513,3736,2812,296,377,0,35574,213,15708,12896,7751,15834
2022-01-22 09:00:00+00,15961,0,5144,7097,477,4506,2816,549,918,0,37468,205,16452,13636,8492,15961
2022-01-22 09:30:00+00,16730,0,5142,7079,424,4490,2807,300,1410,0,38382,206,16862,14055,8913,16730
2022-01-22 10:00:00+00,16683,0,5143,7275,347,4540,2814,292,1835,64,38993,198,17414,14600,9457,16683
2022-01-22 10:30:00+00,16767,0,5142,7221,355,4420,2810,257,2137,38,39147,196,17665,14855,9713,16767
2022-01-22 11:00:00+00,16790,0,5143,7449,334,4362,2813,218,2306,0,39415,194,18045,15232,10089,16790
2022-01-22 11:30:00+00,16681,0,5140,7620,330,4382,2810,193,2333,0,39489,192,18233,15423,10283,16681
2022-01-22 12:00:00+00,16999,0,5134,7567,297,4330,2809,196,2171,30,39533,195,17978,15169,10035,16999
2022-01-22 12:30:00+00,17188,0,5141,7609,280,4330,2810,183,2128,24,39693,196,17968,15158,10017,17188
2022-01-22 13:00:00+00,17192,0,5139,7534,269,4504,2707,192,2104,18,39659,198,17753,15046,9907,17192
2022-01-22 13:30:00+00,17448,0,5143,7333,267,4476,2614,177,1767,22,39247,202,17124,14510,9367,17448
2022-01-22 14:00:00+00,17490,68,5148,7300,268,4414,2627,159,1306,0,38780,206,16649,14022,8874,17558
2022-01-22 14:30:00+00,17746,276,5146,7077,268,4312,2574,168,728,30,38325,215,15793,13219,8073,18022
2022-01-22 15:00:00+00,18512,534,5145,6891,305,3692,2579,186,399,36,38279,226,15319,12740,7595,19046
2022-01-22 15:30:00+00,19124,754,5147,6641,339,3532,2650,193,153,34,38567,235,14930,12280,7133,19878
2022-01-22 16:00:00+00,19279,844,5146,6125,477,4492,2762,204,21,126,39476,240,14531,11769,6623,20123
2022-01-22 16:30:00+00,19914,961,5145,5734,516,4678,2811,415,0,708,40882,244,14206,11395,6250,20875
2022-01-22 17:00:00+00,20148,973,5139,5641,544,4812,2814,658,0,1694,42423,241,14138,11324,6185,21121
2022-01-22 17:30:00+00,20213,974,5140,5530,587,4714,2816,740,0,1584,42298,242,14073,11257,6117,21187
2022-01-22 18:00:00+00,20077,974,5137,5486,577,4790,2814,683,0,1454,41992,242,14014,11200,6063,21051
2022-01-22 18:30:00+00,19892,975,5138,5316,660,4800,2811,487,0,966,41045,244,13925,11114,5976,20867
2022-01-22 19:00:00+00,19682,977,5138,5275,492,4682,2799,264,0,552,39861,249,13704,10905,5767,20659
2022-01-22 19:30:00+00,19524,832,5135,5162,416,4562,2798,234,0,44,38707,250,13511,10713,5578,20356
2022-01-22 20:00:00+00,19552,498,5136,5052,311,3780,2798,244,0,0,37371,251,13297,10499,5363,20050
2022-01-22 20:30:00+00,18776,351,5137,4868,278,3718,2798,233,0,0,36159,246,13081,10283,5146,19127
2022-01-22 21:00:00+00,17943,113,5139,4929,233,3574,2769,181,0,0,34881,237,13070,10301,5162,18056
2022-01-22 21:30:00+00,16682,0,5140,5062,232,3664,2750,163,0,0,33693,229,13184,10434,5294,16682
2022-01-22 22:00:00+00,14914,0,5142,5149,199,3792,2705,164,0,0,32065,221,13195,10490,5348,14914
2022-01-22 22:30:00+00,13723,0,5143,5134,173,3756,2712,167,0,0,30808,214,13162,10450,5307,13723
2022-01-22 23:00:00+00,12133,0,5141,5014,151,4000,2724,167,0,0,29330,204,13030,10306,5165,12133
2022-01-22 23:30:00+00,11551,0,5146,4963,146,3860,2695,161,0,0,28522,199,12950,10255,5109,11551
2022-01-23 00:00:00+00,11472,0,5147,4795,124,3852,2695,160,0,0,28245,200,12761,10066,4919,11472
2022-01-23 00:30:00+00,11756,0,5146,4788,122,3970,2783,159,0,0,28724,203,12839,10056,4910,11756
2022-01-23 01:00:00+00,11329,0,5148,4920,101,3928,2777,159,0,0,28362,200,12946,10169,5021,11329
2022-01-23 01:30:00+00,11003,0,5144,4842,100,3786,2656,161,0,0,27692,197,12742,10086,4942,11003
2022-01-23 02:00:00+00,10846,0,5143,4869,100,3382,2717,159,0,0,27216,197,12829,10112,4969,10846
2022-01-23 02:30:00+00,10735,0,5141,4842,100,3372,2750,157,0,0,27097,196,12833,10083,4942,10735
2022-01-23 03:00:00+00,10812,0,5143,4917,100,3334,2724,161,0,0,27191,195,12884,10160,5017,10812
2022-01-23 03:30:00+00,10448,0,5143,5045,100,3344,2624,164,0,0,26868,192,12912,10288,5145,10448
2022-01-23 04:00:00+00,10436,0,5145,5138,100,2944,2642,165,0,0,26570,194,13025,10383,5238,10436
2022-01-23 04:30:00+00,10272,0,5142,5196,101,2912,2657,168,0,0,26448,192,13096,10439,5297,10272
2022-01-23 05:00:00+00,9739,0,5143,5086,117,3476,2486,179,0,0,26226,187,12832,10346,5203,9739
2022-01-23 05:30:00+00,9661,0,5144,5324,117,3562,2406,168,0,0,26382,186,12991,10585,5441,9661
2022-01-23 06:00:00+00,10036,0,5139,5369,166,3286,2553,168,0,0,26717,189,13227,10674,5535,10036
2022-01-23 06:30:00+00,10422,0,5143,5475,164,3358,2590,160,0,0,27312,192,13372,10782,5639,10422
2022-01-23 07:00:00+00,11835,72,5143,5529,199,2386,2576,161,0,0,27901,195,13447,10871,5728,11907
2022-01-23 07:30:00+00,12444,230,5145,5479,215,2420,2691,163,0,0,28787,204,13530,10839,5694,12674
2022-01-23 08:00:00+00,13454,482,5144,5390,295,2532,2819,159,0,2,30277,212,13648,10829,5685,13936
2022-01-23 08:30:00+00,14306,716,5144,5517,315,2698,2813,164,15,236,31924,221,13804,10991,5847,15022
2022-01-23 09:00:00+00,14956,890,5141,5630,526,3462,2825,161,82,260,33933,224,14204,11379,6238,15846
2022-01-23 09:30:00+00,15569,1201,5141,5708,524,3614,2821,166,187,356,35287,232,14381,11560,6419,16770
2022-01-23 10:00:00+00,15788,1388,5139,6206,524,4300,2827,169,306,216,36863,232,15002,12175,7036,17176
2022-01-23 10:30:00+00,16134,1367,5138,6295,520,4252,2831,376,410,114,37437,232,15194,12363,7225,17501
2022-01-23 11:00:00+00,16352,1319,5132,6602,420,4380,2831,433,480,120,38069,230,15465,12634,7502,17671
2022-01-23 11:30:00+00,16574,1368,5134,6894,387,4516,2817,383,540,90,38703,231,15772,12955,7821,17942
2022-01-23 12:00:00+00,17109,1412,5135,7069,269,4582,2833,427,598,54,39488,234,15904,13071,7936,18521
2022-01-23 12:30:00+00,17405,1443,5139,7255,266,4526,2830,485,608,58,40015,234,16098,13268,8129,18848
2022-01-23 13:00:00+00,17710,1468,5136,7102,267,4410,2829,374,564,4,39864,236,15898,13069,7933,19178
2022-01-23 13:30:00+00,17992,1290,5145,7124,291,4292,2816,224,531,0,39705,233,15907,13091,7946,19282
2022-01-23 14:00:00+00,17891,1242,5145,7151,299,4342,2818,186,452,0,39526,233,15865,13047,7902,19133
2022-01-23 14:30:00+00,18067,1233,5143,7039,299,4150,2835,192,314,144,39416,233,15630,12795,7652,19300
2022-01-23 15:00:00+00,18584,1325,5147,7134,306,4218,2832,204,177,0,39927,238,15596,12764,7617,19909
2022-01-23 15:30:00+00,18955,1398,5146,6963,320,4378,2833,201,67,24,40285,243,15329,12496,7350,20353
2022-01-23 16:00:00+00,19726,1437,5147,6880,494,4540,2834,236,6,88,41388,247,15361,12527,7380,21163
2022-01-23 16:30:00+00,20239,1473,5145,6729,503,4568,2834,353,0,1026,42870,245,15211,12377,7232,21712
2022-01-23 17:00:00+00,20398,1477,5145,6632,554,4740,2944,583,0,1826,44299,242,15275,12331,7186,21875
2022-01-23 17:30:00+00,20487,1480,5148,6747,557,4740,2975,597,0,1508,44239,244,15427,12452,7304,21967
2022-01-23 18:00:00+00,20174,1481,5141,6690,589,4650,2978,406,0,1324,43433,244,15398,12420,7279,21655
2022-01-23 18:30:00+00,19520,1482,5138,6756,585,4528,2981,283,0,982,42255,242,15460,12479,7341,21002
2022-01-23 19:00:00+00,19943,1479,5139,6975,561,3270,2986,228,0,390,40971,252,15661,12675,7536,21422
2022-01-23 19:30:00+00,19367,1279,5140,6980,502,3168,2960,175,0,0,39571,250,15582,12622,7482,20646
2022-01-23 20:00:00+00,18225,1082,5136,7104,316,3414,2967,158,0,0,38402,245,15523,12556,7420,19307
2022-01-23 20:30:00+00,16985,1136,5137,7057,289,3414,2986,153,0,0,37157,241,15469,12483,7346,18121
2022-01-23 21:00:00+00,15948,721,5137,7513,242,3268,2927,160,0,0,35916,229,15819,12892,7755,16669
2022-01-23 21:30:00+00,14901,458,5138,7560,228,2960,2902,159,0,0,34306,217,15828,12926,7788,15359
2022-01-23 22:00:00+00,14744,459,5137,7649,194,2668,2973,152,0,0,33976,217,15953,12980,7843,15203
2022-01-23 22:30:00+00,13383,459,5140,7704,188,2430,2968,157,0,0,32429,208,16000,13032,7892,13842
2022-01-23 23:00:00+00,12938,460,5139,7656,171,1912,2967,161,0,0,31404,203,15933,12966,7827,13398
2022-01-23 23:30:00+00,12063,458,5140,7864,161,1994,2920,155,0,0,30755,197,16085,13165,8025,12521
2022-01-24 00:00:00+00,12038,458,5141,8077,118,2078,2888,152,0,0,30950,196,16224,13336,8195,12496
2022-01-24 00:30:00+00,12498,459,5143,8007,117,2218,2972,155,0,0,31569,201,16239,13267,8124,12957
2022-01-24 01:00:00+00,12427,459,5142,7911,116,2222,2955,152,0,0,31384,200,16124,13169,8027,12886
2022-01-24 01:30:00+00,12181,459,5144,7781,114,2110,2926,154,0,0,30869,198,15965,13039,7895,12640
2022-01-24 02:00:00+00,12390,459,5143,7469,99,2046,2925,151,0,0,30682,201,15636,12711,7568,12849
2022-01-24 02:30:00+00,12409,460,5137,7204,98,1978,2927,151,0,0,30364,203,15366,12439,7302,12869
2022-01-24 03:00:00+00,12471,459,5138,7022,98,1894,2926,151,0,0,30159,204,15184,12258,7120,12930
2022-01-24 03:30:00+00,12388,459,5139,6803,97,1856,2930,151,0,0,29823,205,14969,12039,6900,12847
2022-01-24 04:00:00+00,12925,461,5139,6786,97,1366,2975,154,0,0,29903,209,14997,12022,6883,13386
2022-01-24 04:30:00+00,13092,480,5138,6421,97,1214,2952,159,0,0,29553,212,14608,11656,6518,13572
2022-01-24 05:00:00+00,14229,614,5137,6240,97,1078,2913,162,0,0,30470,222,14387,11474,6337,14843
2022-01-24 05:30:00+00,15162,1058,5140,5939,108,1208,2895,156,0,0,31666,240,14082,11187,6047,16220
2022-01-24 06:00:00+00,17039,1538,5143,5688,189,1430,2962,178,0,0,34167,261,13982,11020,5877,18577
2022-01-24 06:30:00+00,19708,1862,5143,5355,208,1580,2964,183,0,0,37003,279,13670,10706,5563,21570
2022-01-24 07:00:00+00,21637,1912,5141,4921,227,1920,2967,219,0,326,39270,286,13256,10289,5148,23549
2022-01-24 07:30:00+00,22585,1966,5143,4889,395,1968,2968,379,0,544,40837,287,13395,10427,5284,24551
2022-01-24 08:00:00+00,22307,1976,5145,4666,509,2922,2979,575,0,250,41329,285,13299,10320,5175,24283
2022-01-24 08:30:00+00,23002,1944,5143,4540,531,3034,2981,522,20,394,42111,285,13215,10234,5091,24946
2022-01-24 09:00:00+00,22930,1877,5144,4223,525,4164,2984,498,128,884,43357,278,13004,10020,4876,24807
2022-01-24 09:30:00+00,23229,1978,5147,3913,650,4190,2956,561,298,710,43632,282,12964,10008,4861,25207
2022-01-24 10:00:00+00,23394,1977,5144,3671,810,4130,2977,713,443,468,43727,284,13045,10068,4924,25371
2022-01-24 10:30:00+00,23788,1945,5137,3515,799,4126,2984,611,590,724,44219,284,13025,10041,4904,25733
2022-01-24 11:00:00+00,23970,1978,5135,3463,759,4012,2976,624,689,790,44396,285,13022,10046,4911,25948
2022-01-24 11:30:00+00,24106,1980,5135,3434,758,4014,2991,670,813,562,44463,286,13131,10140,5005,26086
2022-01-24 12:00:00+00,24043,1981,5134,3237,726,4192,2991,714,856,886,44760,285,12944,9953,4819,26024
2022-01-24 12:30:00+00,23892,1942,5138,3078,731,4194,2992,785,827,856,44435,285,12766,9774,4636,25834
2022-01-24 13:00:00+00,23819,1895,5140,2986,770,4192,2988,690,814,308,43602,289,12698,9710,4570,25714
2022-01-24 13:30:00+00,23275,2045,5136,2901,744,4192,2980,700,721,274,42968,291,12482,9502,4366,25320
2022-01-24 14:00:00+00,23187,2234,5137,2613,745,4300,2903,724,584,316,42743,297,11982,9079,3942,25421
2022-01-24 14:30:00+00,22766,2381,5142,2505,812,4272,2792,730,394,334,42128,300,11645,8853,3711,25147
2022-01-24 15:00:00+00,22719,2583,5141,2338,893,3992,3032,531,213,1036,42478,299,11617,8585,3444,25302
2022-01-24 15:30:00+00,23022,2772,5146,2128,916,3950,3120,502,71,1416,43043,302,11381,8261,3115,25794
2022-01-24 16:00:00+00,22757,2910,5146,2082,921,4232,3112,637,7,1944,43748,302,11268,8156,3010,25667
2022-01-24 16:30:00+00,23744,2979,5147,1960,931,4164,3133,757,0,2086,44901,305,11171,8038,2891,26723
2022-01-24 17:00:00+00,23965,3034,5145,1747,1012,4386,3117,1134,0,2022,45562,308,11021,7904,2759,26999
2022-01-24 17:30:00+00,24019,3007,5144,1753,1012,4386,3118,1146,0,2022,45607,308,11027,7909,2765,27026
2022-01-24 18:00:00+00,23708,2899,5147,1610,1011,4450,3142,977,0,2020,44964,307,10910,7768,2621,26607
2022-01-24 18:30:00+00,23225,2684,5143,1514,1004,4484,3119,885,0,2020,44078,304,10780,7661,2518,25909
2022-01-24 19:00:00+00,22751,2547,5142,1528,982,4534,3093,698,0,1792,43067,302,10745,7652,2510,25298
2022-01-24 19:30:00+00,22819,2021,5139,1511,951,4696,3085,628,0,1630,42480,296,10686,7601,2462,24840
2022-01-24 20:00:00+00,22768,1983,5140,1440,701,4126,3067,531,0,1024,40780,299,10348,7281,2141,24751
2022-01-24 20:30:00+00,22183,1948,5138,1453,624,4016,3026,517,0,512,39417,300,10241,7215,2077,24131
2022-01-24 21:00:00+00,21997,1639,5140,1603,549,3722,2992,409,0,26,38077,297,10284,7292,2152,23636
2022-01-24 21:30:00+00,21101,1479,5142,1623,368,3500,2934,275,0,0,36422,293,10067,7133,1991,22580
2022-01-24 22:00:00+00,19923,1470,5141,1730,250,2722,2938,180,0,16,34370,295,10059,7121,1980,21393
2022-01-24 22:30:00+00,18466,1465,5143,1930,247,2508,2943,165,0,0,32867,288,10263,7320,2177,19931
2022-01-24 23:00:00+00,18672,1473,5145,2062,225,1804,2944,168,0,0,32493,298,10376,7432,2287,20145
2022-01-24 23:30:00+00,18440,1477,5145,2091,218,1700,2948,164,0,0,32183,296,10402,7454,2309,19917
2022-01-25 00:00:00+00,18289,1472,5146,2235,206,1836,2951,162,0,0,32297,294,10538,7587,2441,19761
2022-01-25 00:30:00+00,18247,1477,5144,2234,205,1862,2924,165,0,0,32258,294,10507,7583,2439,19724
2022-01-25 01:00:00+00,18433,1480,5144,2303,189,1954,2903,163,0,0,32569,293,10539,7636,2492,19913
2022-01-25 01:30:00+00,18129,1480,5143,2229,187,1890,2902,168,0,0,32128,293,10461,7559,2416,19609
2022-01-25 02:00:00+00,17801,1479,5144,2326,166,1966,2899,166,0,0,31947,291,10535,7636,2492,19280
2022-01-25 02:30:00+00,17584,1480,5141,2392,165,1966,2908,166,0,0,31802,290,10606,7698,2557,19064
2022-01-25 03:00:00+00,17729,1481,5139,2437,164,1508,2793,165,0,0,31416,290,10533,7740,2601,19210
2022-01-25 03:30:00+00,17571,1478,5137,2469,163,1498,2710,165,0,0,31191,290,10479,7769,2632,19049
2022-01-25 04:00:00+00,17792,1477,5137,2551,163,1340,2713,163,0,0,31336,290,10564,7851,2714,19269
2022-01-25 04:30:00+00,17799,1459,5138,2699,163,1378,2711,157,0,0,31504,288,10711,8000,2862,19258
2022-01-25 05:00:00+00,18036,1613,5138,2827,203,1124,2826,162,0,0,31929,289,10994,8168,3030,19649
2022-01-25 05:30:00+00,18566,1769,5141,2869,217,1432,2866,159,0,0,33019,294,11093,8227,3086,20335
2022-01-25 06:00:00+00,19938,1774,5141,3054,279,1646,2785,250,0,0,34867,298,11259,8474,3333,21712
2022-01-25 06:30:00+00,21629,1767,5144,3202,288,1800,2851,376,0,0,37057,301,11485,8634,3490,23396
2022-01-25 07:00:00+00,23013,1770,5142,3306,291,1600,2972,422,0,722,39238,297,11712,8740,3598,24783
2022-01-25 07:30:00+00,23745,1757,5139,3334,340,1574,2973,576,0,1552,40990,292,11786,8813,3674,25502
2022-01-25 08:00:00+00,24167,1763,5143,3424,402,1502,2967,617,0,1588,41573,291,11936,8969,3826,25930
2022-01-25 08:30:00+00,24403,1769,5144,3507,478,1478,2968,773,8,1638,42166,291,12105,9137,3993,26172
2022-01-25 09:00:00+00,24201,1765,5140,3810,577,2116,2972,804,58,1858,43301,284,12557,9585,4445,25966
2022-01-25 09:30:00+00,24589,1804,5146,4009,658,2200,2970,783,145,1518,43822,286,12928,9958,4812,26393
2022-01-25 10:00:00+00,24723,1810,5143,4082,638,2568,2972,770,233,1182,44121,291,13068,10096,4953,26533
2022-01-25 10:30:00+00,24619,1775,5139,4064,617,2518,2961,746,304,1442,44185,287,13085,10124,4985,26394
2022-01-25 11:00:00+00,24723,1777,5101,4235,565,3720,2958,692,358,406,44535,288,13217,10259,5158,26500
2022-01-25 11:30:00+00,24798,1778,5078,4384,563,3876,2960,618,411,198,44664,288,13396,10436,5358,26576
2022-01-25 12:00:00+00,24857,1872,5077,4646,519,3518,2953,637,433,594,45106,285,13628,10675,5598,26729
2022-01-25 12:30:00+00,24890,1910,5074,4583,500,3394,2959,705,436,524,44975,286,13552,10593,5519,26800
2022-01-25 13:00:00+00,24549,1848,5075,4639,499,4220,2965,698,427,364,45284,286,13605,10640,5565,26397
2022-01-25 13:30:00+00,24442,1779,5076,4765,500,4246,2963,660,392,132,44955,286,13696,10733,5657,26221
2022-01-25 14:00:00+00,24101,1944,5073,4680,486,3692,2961,507,303,252,43999,290,13503,10542,5469,26045
2022-01-25 14:30:00+00,23797,2068,5080,4889,499,3638,2962,568,213,282,43996,290,13643,10681,5601,25865
2022-01-25 15:00:00+00,23850,2078,5086,4944,571,3346,2982,653,125,32,43667,293,13708,10726,5640,25928
2022-01-25 15:30:00+00,23707,2151,5080,4883,605,3406,3023,699,41,86,43681,294,13632,10609,5529,25858
2022-01-25 16:00:00+00,23282,2136,5080,4781,756,4378,3050,777,3,450,44693,287,13670,10620,5540,25418
2022-01-25 16:30:00+00,24126,2149,5087,4951,719,4202,3077,864,0,652,45827,288,13834,10757,5670,26275
2022-01-25 17:00:00+00,24238,2244,5085,5264,715,3480,3107,961,0,1480,46574,282,14171,11064,5979,26482
2022-01-25 17:30:00+00,24143,2318,5089,5366,728,3476,3122,1011,0,1244,46497,284,14305,11183,6094,26461
2022-01-25 18:00:00+00,24079,2198,5088,5607,729,3004,3128,929,0,1394,46156,281,14552,11424,6336,26277
2022-01-25 18:30:00+00,24052,2159,5088,5756,728,2988,3131,762,0,938,45602,282,14703,11572,6484,26211
2022-01-25 19:00:00+00,22639,2180,5090,5983,593,4126,3135,701,0,256,44703,279,14801,11666,6576,24819
2022-01-25 19:30:00+00,21268,2191,5088,6173,677,4086,3140,560,0,262,43445,273,15078,11938,6850,23459
2022-01-25 20:00:00+00,21016,2143,5087,6289,483,3136,3137,424,0,388,42103,272,14996,11859,6772,23159
2022-01-25 20:30:00+00,20448,2129,5088,6182,411,3008,3137,302,0,128,40833,273,14818,11681,6593,22577
2022-01-25 21:00:00+00,20913,2047,5092,6283,381,1968,3115,211,0,38,40048,277,14871,11756,6664,22960
2022-01-25 21:30:00+00,19559,1744,5092,6504,383,1854,3080,209,0,0,38425,266,15059,11979,6887,21303
2022-01-25 22:00:00+00,18412,1476,5092,6637,326,1380,3106,158,0,20,36607,256,15161,12055,6963,19888
2022-01-25 22:30:00+00,16006,1475,5092,6741,255,1530,3135,149,0,0,34383,247,15223,12088,6996,17481
2022-01-25 23:00:00+00,13124,1475,5091,6896,241,2666,3065,144,0,0,32702,234,15293,12228,7137,14599
2022-01-25 23:30:00+00,11965,1475,5093,6991,234,2580,3100,144,0,0,31582,227,15418,12318,7225,13440
2022-01-26 00:00:00+00,12272,1459,5097,7230,209,2432,3039,158,0,0,31896,225,15575,12536,7439,13731
2022-01-26 00:30:00+00,12822,1473,5096,7146,210,2432,3080,161,0,0,32420,228,15532,12452,7356,14295
2022-01-26 01:00:00+00,12618,1468,5098,7354,209,2602,3098,158,0,0,32605,226,15759,12661,7563,14086
2022-01-26 01:30:00+00,12122,1468,5097,7477,209,2584,3111,161,0,0,32229,222,15894,12783,7686,13590
2022-01-26 02:00:00+00,11950,1471,5097,7620,191,2320,3113,159,0,0,31921,219,16021,12908,7811,13421
2022-01-26 02:30:00+00,11500,1469,5113,7849,172,2320,3111,159,0,0,31693,215,16245,13134,8021,12969
2022-01-26 03:00:00+00,11079,1466,5095,8292,153,2254,2948,162,0,0,31449,209,16488,13540,8445,12545
2022-01-26 03:30:00+00,10927,1477,5091,8447,144,2250,2695,165,0,0,31196,208,16377,13682,8591,12404
2022-01-26 04:00:00+00,11096,1474,5089,8362,144,1922,2754,163,0,0,31004,209,16349,13595,8506,12570
2022-01-26 04:30:00+00,10953,1477,5085,8343,146,1914,2871,170,0,0,30959,208,16445,13574,8489,12430
2022-01-26 05:00:00+00,11611,1472,5087,8624,164,1406,3070,163,0,0,31596,211,16944,13874,8788,13083
2022-01-26 05:30:00+00,12437,1463,5090,8587,211,1380,2978,159,0,0,32304,216,16866,13888,8798,13900
2022-01-26 06:00:00+00,13680,1488,5089,8317,466,816,3071,159,0,0,33085,219,16943,13872,8783,15168
2022-01-26 06:30:00+00,14754,1668,5087,8519,479,808,3074,162,0,0,34551,227,17159,14085,8998,16422
2022-01-26 07:00:00+00,15803,1737,5089,8572,561,694,3078,158,0,334,36026,230,17300,14222,9133,17540
2022-01-26 07:30:00+00,16471,1888,5090,8726,518,694,3082,155,0,678,37302,234,17416,14334,9244,18359
2022-01-26 08:00:00+00,16793,1895,5087,9225,571,844,3093,148,83,680,38419,232,18059,14966,9879,18688
2022-01-26 08:30:00+00,16848,1833,5083,9580,534,874,3095,143,467,826,39283,225,18758,15663,10581,18681
2022-01-26 09:00:00+00,16814,1739,5068,9781,502,1856,3080,138,801,530,40309,223,19233,16153,11084,18553
2022-01-26 09:30:00+00,16680,1778,5053,9818,516,1870,3077,133,1265,662,40852,219,19729,16652,11599,18458
2022-01-26 10:00:00+00,16833,1833,5051,10049,515,1344,3262,132,1790,216,41026,220,20668,17406,12354,18666
2022-01-26 10:30:00+00,16483,1714,5054,10667,423,1324,3079,131,2205,0,41080,211,21428,18349,13295,18197
2022-01-26 11:00:00+00,16456,1704,5063,11494,405,1196,3076,131,2802,0,42327,204,22840,19764,14701,18160
2022-01-26 11:30:00+00,16364,1708,5069,11997,413,1232,3074,130,3281,0,43269,199,23834,20760,15691,18072
2022-01-26 12:00:00+00,16297,1713,5073,12139,384,1116,3034,130,3814,10,43710,197,24444,21410,16337,18010
2022-01-26 12:30:00+00,16114,1708,5075,13008,367,1140,3005,127,3713,0,44257,193,25168,22163,17088,17822
2022-01-26 13:00:00+00,16017,1691,5077,13783,303,1160,2946,126,3310,0,44412,191,25419,22473,17396,17708
2022-01-26 13:30:00+00,15882,1703,5078,14187,304,1146,2895,125,2861,0,44181,191,25325,22430,17352,17585
2022-01-26 14:00:00+00,15869,1750,5078,14377,302,1172,2779,125,2220,0,43672,194,24756,21977,16899,17619
2022-01-26 14:30:00+00,15984,1827,5081,14715,313,1286,2857,128,1596,0,43786,198,24562,21705,16624,17811
2022-01-26 15:00:00+00,16211,1870,5082,14905,337,1422,3001,135,1045,0,44008,201,24370,21369,16287,18081
2022-01-26 15:30:00+00,16697,1882,5085,15122,355,1516,3047,147,516,0,44367,205,24125,21078,15993,18579
2022-01-26 16:00:00+00,16429,1872,5084,15484,397,2772,2952,236,96,62,45384,206,24012,21060,15976,18301
2022-01-26 16:30:00+00,17025,1874,5087,15926,382,2976,3070,304,0,116,46760,208,24465,21395,16308,18899
2022-01-26 17:00:00+00,17299,1874,5086,16479,420,2844,3080,312,0,1002,48396,203,25065,21985,16899,19173
2022-01-26 17:30:00+00,17345,1869,5086,16714,427,2820,3083,435,0,994,48773,202,25310,22227,17141,19214
2022-01-26 18:00:00+00,16654,1871,5084,16744,461,3228,3086,403,0,550,48081,201,25375,22289,17205,18525
2022-01-26 18:30:00+00,16420,1867,5082,16939,467,3248,3089,283,0,38,47433,201,25577,22488,17406,18287
2022-01-26 19:00:00+00,15119,1879,5084,17248,460,3088,3094,149,0,0,46121,193,25886,22792,17708,16998
2022-01-26 19:30:00+00,13667,1872,5084,17242,441,3082,3096,145,0,46,44675,186,25863,22767,17683,15539
2022-01-26 20:00:00+00,12326,1858,5083,17406,372,2852,3061,147,0,0,43105,178,25922,22861,17778,14184
2022-01-26 20:30:00+00,10573,1829,5078,17338,355,2852,3042,159,0,0,41226,168,25813,22771,17693,12402
2022-01-26 21:00:00+00,9268,1700,5081,16926,332,2964,3044,150,0,36,39501,161,25383,22339,17258,10968
2022-01-26 21:30:00+00,7744,1470,5081,16808,340,2896,2867,143,0,0,37349,147,25096,22229,17148,9214
2022-01-26 22:00:00+00,6521,1156,5082,16654,315,2528,2488,145,0,178,35067,133,24539,22051,16969,7677
2022-01-26 22:30:00+00,5374,1067,5082,16532,306,2458,2022,146,0,58,33045,123,23942,21920,16838,6441
2022-01-26 23:00:00+00,4226,823,5083,16708,287,2918,1516,142,0,0,31703,106,23594,22078,16995,5049
2022-01-26 23:30:00+00,3620,916,5086,16875,277,2778,1377,141,0,0,31070,100,23615,22238,17152,4536
2022-01-27 00:00:00+00,3696,992,5086,16929,292,2750,1379,143,0,0,31267,98,23686,22307,17221,4688
2022-01-27 00:30:00+00,3926,1167,5087,16846,288,2872,1378,148,0,0,31712,106,23599,22221,17134,5093
2022-01-27 01:00:00+00,3562,1247,5094,16889,245,2898,1376,143,0,0,31454,105,23604,22228,17134,4809
2022-01-27 01:30:00+00,3457,1061,5093,16838,244,2774,1375,142,0,0,30984,98,23550,22175,17082,4518
2022-01-27 02:00:00+00,3436,990,5092,16783,242,2742,1375,146,0,0,30806,96,23492,22117,17025,4426
2022-01-27 02:30:00+00,3285,1011,5090,16749,242,2744,1375,147,0,0,30643,95,23456,22081,16991,4296
2022-01-27 03:00:00+00,3267,868,5090,16687,242,2750,1392,148,0,0,30444,91,23411,22019,16929,4135
2022-01-27 03:30:00+00,3191,794,5090,16580,241,2742,1404,148,0,0,30190,89,23315,21911,16821,3985
2022-01-27 04:00:00+00,3195,847,5088,16575,242,2484,1406,140,0,0,29977,89,23311,21905,16817,4042
2022-01-27 04:30:00+00,3044,782,5088,16702,249,2484,1416,141,0,0,29906,85,23455,22039,16951,3826
2022-01-27 05:00:00+00,3136,744,5085,16984,297,2490,1427,140,0,0,30303,84,23793,22366,17281,3880
2022-01-27 05:30:00+00,3782,764,5088,17010,351,2490,1552,140,0,0,31177,90,24001,22449,17361,4546
2022-01-27 06:00:00+00,5306,1001,5084,16930,465,2334,1737,141,0,0,32998,111,24216,22479,17395,6307
2022-01-27 06:30:00+00,7504,1270,5089,16860,476,2334,1732,161,0,0,35426,135,24157,22425,17336,8774
2022-01-27 07:00:00+00,10698,1392,5084,17019,417,2074,1651,167,0,66,38568,160,24171,22520,17436,12090
2022-01-27 07:30:00+00,12340,1465,5085,17127,436,2124,1652,167,0,32,40428,171,24300,22648,17563,13805
2022-01-27 08:00:00+00,13412,1462,5085,17189,531,2412,1652,165,7,54,41969,174,24464,22812,17727,14874
2022-01-27 08:30:00+00,14408,1471,5087,16752,534,2476,1650,160,115,40,42693,182,24138,22488,17401,15879
2022-01-27 09:00:00+00,14783,1464,5085,16793,534,2766,1652,176,369,34,43656,181,24433,22781,17696,16247
2022-01-27 09:30:00+00,15140,1466,5090,16610,532,2748,1652,179,751,0,44168,182,24635,22983,17893,16606
2022-01-27 10:00:00+00,15438,1468,5085,16357,487,2122,1684,189,1106,226,44162,185,24719,23035,17950,16906
2022-01-27 10:30:00+00,15209,1453,5087,16462,478,1956,1676,471,1401,0,44192,184,25104,23428,18340,16662
2022-01-27 11:00:00+00,15194,1459,5085,16310,438,2054,1676,300,2033,0,44549,182,25542,23866,18781,16653
2022-01-27 11:30:00+00,15087,1295,5086,16082,442,2054,1678,211,2436,0,44371,178,25724,24046,18960,16382
2022-01-27 12:00:00+00,15083,1251,5084,16179,444,1878,1678,212,2556,0,44365,176,25941,24263,19179,16334
2022-01-27 12:30:00+00,14829,1131,5084,16296,417,1876,1680,209,3312,0,44834,170,26789,25109,20025,15960
2022-01-27 13:00:00+00,14533,1036,5082,16116,415,2194,1663,208,3136,90,44473,166,26412,24749,19667,15569
2022-01-27 13:30:00+00,14417,892,5085,15651,413,2352,1602,156,3463,0,44031,163,26214,24612,19527,15309
2022-01-27 14:00:00+00,15048,947,5083,14815,416,2082,1598,163,2876,102,43130,172,24788,23190,18107,15995
2022-01-27 14:30:00+00,15906,1032,5086,14127,492,2084,1607,181,2634,0,43149,182,23946,22339,17253,16938
2022-01-27 15:00:00+00,16077,1176,5088,13637,521,2466,1829,263,1991,4,43052,189,23066,21237,16149,17253
2022-01-27 15:30:00+00,17071,1588,5086,12927,563,2468,1986,269,979,88,43025,208,21541,19555,14469,18659
2022-01-27 16:00:00+00,18001,1552,5085,12468,590,2574,2043,309,192,322,43136,215,20378,18335,13250,19553
2022-01-27 16:30:00+00,19422,1671,5085,11532,627,2608,2074,423,1,852,44295,226,19319,17245,12160,21093
2022-01-27 17:00:00+00,19803,1702,5088,11147,674,2762,2078,708,0,1886,45848,225,18987,16909,11821,21505
2022-01-27 17:30:00+00,20097,1696,5090,10622,748,2768,2089,932,0,2046,46088,228,18549,16460,11370,21793
2022-01-27 18:00:00+00,20436,1701,5088,9830,764,2764,2079,938,0,2084,45684,233,17761,15682,10594,22137
2022-01-27 18:30:00+00,20819,1701,5086,8950,766,2764,2078,792,0,2030,44986,239,16880,14802,9716,22520
2022-01-27 19:00:00+00,20929,1694,5090,8359,764,2768,2081,506,0,1558,43749,245,16294,14213,9123,22623
2022-01-27 19:30:00+00,21031,1691,5091,7937,759,2768,2047,353,0,554,42231,253,15834,13787,8696,22722
2022-01-27 20:00:00+00,20363,1701,5087,7620,688,2896,1781,237,0,348,40721,255,15176,13395,8308,22064
2022-01-27 20:30:00+00,19862,1703,5087,7354,670,2900,1779,236,0,182,39773,256,14890,13111,8024,21565
2022-01-27 21:00:00+00,18855,1664,5088,7017,575,2670,1777,225,0,2,37873,257,14457,12680,7592,20519
2022-01-27 21:30:00+00,17735,1468,5084,6708,572,2670,1778,188,0,110,36313,250,14142,12364,7280,19203
2022-01-27 22:00:00+00,15877,1473,5081,6586,535,2514,1780,177,0,82,34105,245,13982,12202,7121,17350
2022-01-27 22:30:00+00,14363,1475,5082,6554,442,2514,1777,177,0,46,32430,239,13855,12078,6996,15838
2022-01-27 23:00:00+00,13946,1474,5080,6462,426,2744,1776,160,0,160,32228,236,13744,11968,6888,15420
2022-01-27 23:30:00+00,13526,1473,5080,6189,419,2748,1782,160,0,0,31377,237,13470,11688,6608,14999
2022-01-28 00:00:00+00,13633,1480,5080,5760,384,2602,1782,176,0,14,30911,244,13006,11224,6144,15113
2022-01-28 00:30:00+00,13962,1469,5080,5298,383,2602,1781,306,0,90,30971,248,12542,10761,5681,15431
2022-01-28 01:00:00+00,13704,1467,5082,5354,380,2746,1777,349,0,0,30859,248,12593,10816,5734,15171
2022-01-28 01:30:00+00,13358,1471,5082,5383,377,2748,1778,204,0,0,30401,246,12620,10842,5760,14829
2022-01-28 02:00:00+00,12836,1477,5082,5367,345,2748,1768,164,0,0,29787,243,12562,10794,5712,14313
2022-01-28 02:30:00+00,12941,1479,5083,4912,345,2748,1783,164,0,0,29455,248,12123,10340,5257,14420
2022-01-28 03:00:00+00,13518,1472,5086,4558,345,2750,1784,165,0,0,29678,253,11773,9989,4903,14990
2022-01-28 03:30:00+00,13664,1476,5088,4624,345,2748,1786,165,0,0,29896,254,11843,10057,4969,15140
2022-01-28 04:00:00+00,13906,1476,5088,4529,344,2650,1836,165,0,0,29994,256,11797,9961,4873,15382
2022-01-28 04:30:00+00,13889,1468,5090,4465,347,2650,1883,164,0,0,29956,256,11785,9902,4812,15357
2022-01-28 05:00:00+00,14233,1469,5088,4484,412,2030,1958,161,0,0,29835,258,11942,9984,4896,15702
2022-01-28 05:30:00+00,15133,1458,5088,4485,414,2014,2159,157,0,0,30908,261,12146,9987,4899,16591
2022-01-28 06:00:00+00,16628,1471,5082,4827,638,1856,2541,160,0,78,33281,260,13088,10547,5465,18099
2022-01-28 06:30:00+00,18957,1476,5081,4984,670,1842,2901,160,0,80,36151,266,13636,10735,5654,20433
2022-01-28 07:00:00+00,20304,1472,5080,5273,732,1922,3001,319,0,674,38777,261,14086,11085,6005,21776
2022-01-28 07:30:00+00,20674,1462,5083,5796,817,1940,3003,622,0,848,40245,257,14699,11696,6613,22136
2022-01-28 08:00:00+00,20108,1459,5083,6363,741,2328,3002,572,112,826,40594,251,15301,12299,7216,21567
2022-01-28 08:30:00+00,20020,1481,5081,6916,742,2414,3001,452,396,1056,41559,245,16136,13135,8054,21501
2022-01-28 09:00:00+00,20456,1468,5081,7720,716,2608,3000,494,867,1052,43462,241,17384,14384,9303,21924
2022-01-28 09:30:00+00,20460,1460,5088,8782,658,2580,3001,449,1128,450,44056,237,18657,15656,10568,21920
2022-01-28 10:00:00+00,20452,1468,5084,9273,504,3084,2994,454,1409,224,44946,237,19264,16270,11186,21920
2022-01-28 10:30:00+00,19796,1470,5087,9940,489,3146,3000,359,1994,78,45359,229,20510,17510,12423,21266
2022-01-28 11:00:00+00,18869,1468,5086,10472,436,3206,3001,226,2275,170,45209,221,21270,18269,13183,20337
2022-01-28 11:30:00+00,17703,1471,5086,11158,436,3250,2980,156,2345,178,44763,213,22005,19025,13939,19174
2022-01-28 12:00:00+00,17390,1475,5086,11781,418,2948,3001,162,2551,0,44812,211,22837,19836,14750,18865
2022-01-28 12:30:00+00,16553,1480,5084,12587,399,2936,2935,175,2399,0,44548,204,23404,20469,15385,18033
2022-01-28 13:00:00+00,15563,1469,5085,13225,400,2762,2909,150,2359,0,43922,196,23978,21069,15984,17032
2022-01-28 13:30:00+00,14562,1464,5084,13862,400,2862,2903,140,1916,0,43193,191,24165,21262,16178,16026
2022-01-28 14:00:00+00,14626,1454,5082,14388,388,2322,2933,140,1543,0,42876,190,24334,21401,16319,16080
2022-01-28 14:30:00+00,14241,1467,5079,14726,402,2306,2920,142,1069,0,42352,189,24196,21276,16197,15708
2022-01-28 15:00:00+00,14313,1461,5079,15340,424,1986,2969,146,832,26,42576,187,24644,21675,16596,15774
2022-01-28 15:30:00+00,14140,1468,5076,15851,407,1982,2928,151,364,338,42705,185,24626,21698,16622,15608
2022-01-28 16:00:00+00,14396,1465,5079,15992,396,1882,2929,198,144,1030,43511,183,24540,21611,16532,15861
2022-01-28 16:30:00+00,14743,1470,5077,16527,391,1918,2929,247,4,1372,44678,182,24928,21999,16922,16213
2022-01-28 17:00:00+00,14785,1473,5076,16850,448,2732,2931,285,0,1640,46220,179,25304,22374,17298,16258
2022-01-28 17:30:00+00,14608,1476,5081,17109,493,2704,2932,278,0,1606,46287,177,25615,22683,17602,16084
2022-01-28 18:00:00+00,14051,1475,5079,17218,492,3198,2933,212,0,1124,45782,177,25722,22789,17710,15526
2022-01-28 18:30:00+00,13913,1472,5083,17301,474,3084,2934,188,0,312,44761,178,25792,22858,17775,15385
2022-01-28 19:00:00+00,12936,1473,5084,17634,418,3270,2804,156,0,60,43835,175,25940,23136,18052,14409
2022-01-28 19:30:00+00,11678,1475,5087,17697,357,3428,2370,146,0,0,42238,170,25511,23141,18054,13153
2022-01-28 20:00:00+00,10587,1472,5083,17714,299,3440,1919,146,0,108,40768,164,25015,23096,18013,12059
2022-01-28 20:30:00+00,9141,1335,5083,17985,278,3304,1783,148,0,34,39091,151,25129,23346,18263,10476
2022-01-28 21:00:00+00,7409,953,5083,17933,270,3502,1783,163,0,74,37170,134,25069,23286,18203,8362
2022-01-28 21:30:00+00,6560,662,5084,17702,257,3542,1757,150,0,0,35714,122,24800,23043,17959,7222
2022-01-28 22:00:00+00,5567,269,5085,17644,267,3500,1684,146,0,0,34162,105,24680,22996,17911,5836
2022-01-28 22:30:00+00,4296,230,5084,17704,265,3318,1601,146,0,0,32644,91,24654,23053,17969,4526
2022-01-28 23:00:00+00,3814,69,5082,18064,238,2682,1480,141,0,0,31570,75,24864,23384,18302,3883
2022-01-28 23:30:00+00,3394,0,5083,17976,237,2490,1390,141,0,0,30711,67,24686,23296,18213,3394
2022-01-29 00:00:00+00,3461,0,5087,18152,236,2814,1389,142,0,0,31281,67,24864,23475,18388,3461
2022-01-29 00:30:00+00,3572,0,5104,18154,236,3044,1485,140,0,0,31735,71,24979,23494,18390,3572
2022-01-29 01:00:00+00,3411,0,5162,18174,235,3038,1501,142,0,0,31664,71,25072,23572,18410,3411
2022-01-29 01:30:00+00,3039,0,5138,18130,235,2824,1476,145,0,0,30987,65,24979,23503,18365,3039
2022-01-29 02:00:00+00,2924,0,5134,18285,219,2110,1433,155,0,0,30260,66,25071,23638,18504,2924
2022-01-29 02:30:00+00,2883,0,5129,18341,217,1836,1382,151,0,0,29939,63,25069,23687,18558,2883
2022-01-29 03:00:00+00,2684,0,5131,18465,211,1680,1388,151,0,0,29710,63,25195,23807,18676,2684
2022-01-29 03:30:00+00,2654,0,5135,18493,191,1512,1373,151,0,0,29509,61,25192,23819,18684,2654
2022-01-29 04:00:00+00,2654,0,5155,18905,192,1600,1375,151,0,0,30032,62,25627,24252,19097,2654
2022-01-29 04:30:00+00,2653,0,5149,18969,193,1500,1374,152,0,0,29990,60,25685,24311,19162,2653
2022-01-29 05:00:00+00,2652,0,5126,19052,226,794,1371,150,0,0,29371,53,25775,24404,19278,2652
2022-01-29 05:30:00+00,2669,0,5146,19076,227,800,1389,153,0,0,29460,54,25838,24449,19303,2669
2022-01-29 06:00:00+00,2714,0,5126,18393,240,2286,1398,152,0,0,30309,64,25157,23759,18633,2714
2022-01-29 06:30:00+00,2868,0,5120,18597,252,2374,1416,148,0,0,30775,65,25385,23969,18849,2868
2022-01-29 07:00:00+00,3190,0,5124,18673,311,2480,1454,164,0,0,31396,64,25562,24108,18984,3190
2022-01-29 07:30:00+00,4150,145,5123,17639,439,2502,1598,180,0,182,31958,80,24799,23201,18078,4295
2022-01-29 08:00:00+00,4179,248,5126,17064,513,3552,1611,171,128,130,32722,85,24442,22831,17705,4427
2022-01-29 08:30:00+00,4874,243,5124,17116,578,3592,1738,174,477,250,34166,90,25033,23295,18171,5117
2022-01-29 09:00:00+00,4672,238,5124,17211,534,4976,1745,161,1010,212,35883,87,25624,23879,18755,4910
2022-01-29 09:30:00+00,5067,327,5120,17054,506,5020,1745,174,1360,486,36859,92,25785,24040,18920,5394
2022-01-29 10:00:00+00,5111,476,5114,17312,482,5020,1740,168,2037,522,37982,93,26685,24945,19831,5587
2022-01-29 10:30:00+00,4563,381,5116,18471,483,4910,1737,157,2301,438,38557,82,28108,26371,21255,4944
2022-01-29 11:00:00+00,4285,296,5115,19132,461,4870,1737,146,2665,210,38917,76,29110,27373,22258,4581
2022-01-29 11:30:00+00,4114,272,5116,19286,459,4852,1738,146,2751,210,38944,74,29350,27612,22496,4386
2022-01-29 12:00:00+00,4254,247,5115,19271,458,4702,1739,146,2912,178,39022,73,29495,27756,22641,4501
2022-01-29 12:30:00+00,4014,247,5119,19318,459,4640,1746,142,2868,54,38607,70,29510,27764,22645,4261
2022-01-29 13:00:00+00,3855,247,5125,19521,448,4312,1733,142,2474,0,37857,67,29301,27568,22443,4102
2022-01-29 13:30:00+00,3832,247,5128,19530,448,4192,1746,185,2173,0,37481,66,29025,27279,22151,4079
2022-01-29 14:00:00+00,3753,246,5118,19467,429,4102,1655,148,2007,0,36925,65,28676,27021,21903,3999
2022-01-29 14:30:00+00,4036,248,5120,19372,370,4098,1500,146,1857,0,36747,68,28219,26719,21599,4284
2022-01-29 15:00:00+00,4790,270,5127,19223,370,3912,1403,143,1393,0,36631,74,27516,26113,20986,5060
2022-01-29 15:30:00+00,5411,450,5107,19069,371,3892,1394,148,818,0,36660,86,26759,25365,20258,5861
2022-01-29 16:00:00+00,6502,693,5125,19045,395,3368,1462,161,243,0,36994,100,26270,24808,19683,7195
2022-01-29 16:30:00+00,7909,934,5119,18764,391,3326,1655,170,8,52,38328,117,25937,24282,19163,8843
2022-01-29 17:00:00+00,9065,996,5136,18596,486,3606,1687,203,0,1010,40785,126,25905,24218,19082,10061
2022-01-29 17:30:00+00,9930,992,5140,18331,484,3656,1717,293,0,1044,41587,133,25672,23955,18815,10922
2022-01-29 18:00:00+00,10014,985,5142,17922,471,3752,1703,350,0,1126,41465,135,25238,23535,18393,10999
2022-01-29 18:30:00+00,9789,993,5140,17652,471,3754,1723,310,0,816,40648,136,24986,23263,18123,10782
2022-01-29 19:00:00+00,8992,933,5140,17390,436,4244,1687,244,0,796,39862,129,24653,22966,17826,9925
2022-01-29 19:30:00+00,9092,819,5142,16593,410,4242,1725,217,0,404,38644,132,23870,22145,17003,9911
2022-01-29 20:00:00+00,9068,980,5140,15908,340,3776,1727,192,0,148,37279,139,23115,21388,16248,10048
2022-01-29 20:30:00+00,8643,997,5141,15289,343,3740,1721,149,0,206,36229,138,22494,20773,15632,9640
2022-01-29 21:00:00+00,8348,999,5145,14969,313,3188,1704,145,0,86,34897,140,22131,20427,15282,9347
2022-01-29 21:30:00+00,7759,975,5139,14401,309,3154,1646,146,0,272,33801,136,21495,19849,14710,8734
2022-01-29 22:00:00+00,7790,955,5143,13459,372,2748,1674,164,0,228,32533,141,20648,18974,13831,8745
2022-01-29 22:30:00+00,7094,998,5140,12905,451,2748,1687,172,0,144,31339,139,20183,18496,13356,8092
2022-01-29 23:00:00+00,6610,993,5142,12230,432,2748,1621,162,0,96,30034,138,19425,17804,12662,7603
2022-01-29 23:30:00+00,6081,895,5139,11968,422,2748,1589,165,0,14,29021,133,19118,17529,12390,6976
2022-01-30 00:00:00+00,5511,752,5140,11287,359,3584,1447,167,0,94,28341,127,18233,16786,11646,6263
2022-01-30 00:30:00+00,6314,886,5142,10502,384,3642,1526,164,0,52,28612,142,17554,16028,10886,7200
2022-01-30 01:00:00+00,6441,995,5137,9783,383,4034,1649,159,0,0,28581,148,16952,15303,10166,7436
2022-01-30 01:30:00+00,6310,995,5146,9292,381,4038,1683,162,0,0,28007,150,16502,14819,9673,7305
2022-01-30 02:00:00+00,6257,1052,5144,8641,364,4052,1699,162,0,0,27371,154,15848,14149,9005,7309
2022-01-30 02:30:00+00,6251,1246,5159,7946,364,4050,1746,164,0,0,26926,164,15215,13469,8310,7497
2022-01-30 03:00:00+00,6449,1392,5172,7150,363,4026,1752,161,0,0,26465,175,14437,12685,7513,7841
2022-01-30 03:30:00+00,6426,1478,5201,6639,345,4030,1728,158,0,0,26005,180,13913,12185,6984,7904
2022-01-30 04:00:00+00,6364,1476,5209,5960,345,4168,1502,161,0,0,25185,185,13016,11514,6305,7840
2022-01-30 04:30:00+00,6514,1475,5210,5330,354,4178,1483,164,0,0,24708,190,12377,10894,5684,7989
2022-01-30 05:00:00+00,6931,1477,5209,4695,430,4244,1532,167,0,14,24699,198,11866,10334,5125,8408
2022-01-30 05:30:00+00,7640,1476,5209,4104,434,4314,1722,160,0,0,25059,208,11469,9747,4538,9116
2022-01-30 06:00:00+00,9001,1478,5208,3636,461,4102,1754,164,0,98,25902,223,11059,9305,4097,10479
2022-01-30 06:30:00+00,10032,1476,5208,2898,482,4218,1710,193,0,252,26469,235,10298,8588,3380,11508
2022-01-30 07:00:00+00,11527,1482,5203,2573,666,3822,1683,331,0,328,27615,247,10125,8442,3239,13009
2022-01-30 07:30:00+00,12621,1476,5201,2408,667,3910,1743,300,0,262,28588,255,10019,8276,3075,14097
2022-01-30 08:00:00+00,13287,1479,5202,2149,691,4522,1728,304,217,702,30281,251,9987,8259,3057,14766
2022-01-30 08:30:00+00,14031,1479,5203,2006,690,4708,1713,554,1109,570,32063,251,10721,9008,3805,15510
2022-01-30 09:00:00+00,14546,1473,5202,2029,689,4714,1712,549,2237,1070,34221,241,11869,10157,4955,16019
2022-01-30 09:30:00+00,14325,1476,5198,2192,692,4824,1713,479,3231,1304,35434,231,13026,11313,6115,15801
2022-01-30 10:00:00+00,14373,1475,5200,2548,692,4868,1689,367,3998,1300,36510,225,14127,12438,7238,15848
2022-01-30 10:30:00+00,14379,1476,5199,2810,667,4952,1655,249,4680,1028,37095,221,15011,13356,8157,15855
2022-01-30 11:00:00+00,14412,1477,5212,3472,526,4970,1692,228,5119,192,37300,220,16021,14329,9117,15889
2022-01-30 11:30:00+00,13617,1477,5225,4439,491,4896,1693,227,5253,48,37366,210,17101,15408,10183,15094
2022-01-30 12:00:00+00,12713,1478,5239,5761,423,4986,1712,216,5322,64,37914,199,18457,16745,11506,14191
2022-01-30 12:30:00+00,11625,1480,5233,6975,422,4984,1619,241,5178,86,37843,188,19427,17808,12575,13105
2022-01-30 13:00:00+00,11047,1478,5238,7557,390,5094,1501,163,4481,126,37075,186,19167,17666,12428,12525
2022-01-30 13:30:00+00,10927,1247,5231,8594,379,5066,1561,161,3807,0,36973,179,19572,18011,12780,12174
2022-01-30 14:00:00+00,10756,1022,5219,9687,379,4792,1617,161,2860,0,36493,174,19762,18145,12926,11778
2022-01-30 14:30:00+00,10431,971,5211,10973,316,4756,1713,152,2035,0,36558,169,20248,18535,13324,11402
2022-01-30 15:00:00+00,10859,1095,5194,12083,293,4216,1745,160,1312,258,37215,171,20627,18882,13688,11954
2022-01-30 15:30:00+00,11404,1199,5181,12750,280,4166,1747,172,620,98,37617,178,20578,18831,13650,12603
2022-01-30 16:00:00+00,12092,1429,5169,13320,361,3972,1747,174,138,244,38646,178,20735,18988,13819,13521
2022-01-30 16:30:00+00,12669,1475,5154,14015,404,3944,1748,180,3,1024,40616,176,21324,19576,14422,14144
2022-01-30 17:00:00+00,12962,1476,5136,14667,473,3684,1751,243,0,1924,42316,175,22027,20276,15140,14438
2022-01-30 17:30:00+00,13047,1477,5128,15274,467,3714,1751,294,0,1700,42852,175,22620,20869,15741,14524
2022-01-30 18:00:00+00,13479,1477,5115,15701,465,2438,1749,376,0,1772,42572,179,23030,21281,16166,14956
2022-01-30 18:30:00+00,12307,1475,5112,16238,461,2444,1747,211,0,1468,41463,171,23558,21811,16699,13782
2022-01-30 19:00:00+00,10565,1458,5104,17158,448,2958,1695,149,0,640,40175,161,24405,22710,17606,12023
2022-01-30 19:30:00+00,8947,1323,5092,17664,443,2964,1676,160,0,422,38691,147,24875,23199,18107,10270
2022-01-30 20:00:00+00,7063,886,5079,18083,437,3698,1674,152,0,508,37580,124,25273,23599,18520,7949
2022-01-30 20:30:00+00,5788,535,5081,18258,401,3734,1675,156,0,352,35980,107,25416,23740,18660,6323
2022-01-30 21:00:00+00,4991,365,5082,18337,435,3532,1667,152,0,92,34653,97,25521,23854,18772,5356
2022-01-30 21:30:00+00,3640,231,5078,18496,403,3488,1647,158,0,0,33141,82,25624,23977,18899,3871
2022-01-30 22:00:00+00,3310,229,5079,18400,397,3376,1654,158,0,214,32817,78,25530,23876,18797,3539
2022-01-30 22:30:00+00,3065,27,5065,17818,422,3322,1586,150,0,0,31455,72,24891,23305,18240,3092
2022-01-30 23:00:00+00,3177,0,5058,17949,392,2670,1417,130,0,0,30793,70,24816,23399,18341,3177
2022-01-30 23:30:00+00,2970,0,5051,17997,387,2658,1407,130,0,0,30600,67,24842,23435,18384,2970
2022-01-31 00:00:00+00,2702,0,5061,18073,358,2820,1504,129,0,0,30647,63,24996,23492,18431,2702
2022-01-31 00:30:00+00,3032,0,5057,18143,353,2832,1663,137,0,0,31217,67,25216,23553,18496,3032
2022-01-31 01:00:00+00,2868,0,4886,18282,351,3000,1746,132,0,0,31265,69,25265,23519,18633,2868
2022-01-31 01:30:00+00,2386,0,4892,18362,340,2870,1682,135,0,0,30667,63,25276,23594,18702,2386
2022-01-31 02:00:00+00,2313,0,4926,18321,294,2782,1541,139,0,0,30316,63,25082,23541,18615,2313
2022-01-31 02:30:00+00,2327,0,4928,18134,288,2722,1408,143,0,0,29950,63,24758,23350,18422,2327
2022-01-31 03:00:00+00,2301,0,4934,17930,288,2738,1410,142,0,0,29743,63,24562,23152,18218,2301
2022-01-31 03:30:00+00,2243,0,4936,18046,287,2652,1406,141,0,0,29711,61,24675,23269,18333,2243
2022-01-31 04:00:00+00,2545,0,4932,18310,283,1508,1535,141,0,0,29254,60,25060,23525,18593,2545
2022-01-31 04:30:00+00,2630,112,4932,18040,278,1488,1546,146,0,0,29172,65,24796,23250,18318,2742
2022-01-31 05:00:00+00,2883,357,4936,17841,277,2220,1438,138,0,0,30090,73,24492,23054,18118,3240
2022-01-31 05:30:00+00,3428,587,4945,17839,289,2276,1540,140,0,0,31044,85,24613,23073,18128,4015
2022-01-31 06:00:00+00,4738,852,4941,17860,291,2040,1755,143,0,0,32620,101,24847,23092,18151,5590
2022-01-31 06:30:00+00,6781,1143,4946,17908,290,2108,1792,130,0,0,35098,125,24936,23144,18198,7924
2022-01-31 07:00:00+00,9490,997,4940,18124,379,1888,1797,132,0,0,37747,137,25240,23443,18503,10487
2022-01-31 07:30:00+00,11023,1246,4941,18140,385,1944,1788,131,0,0,39598,152,25254,23466,18525,12269
2022-01-31 08:00:00+00,11485,1478,4939,17811,415,2570,1793,131,160,10,40792,159,25118,23325,18386,12963
2022-01-31 08:30:00+00,12041,1475,4939,17632,414,2564,1794,140,760,0,41759,160,25539,23745,18806,13516
2022-01-31 09:00:00+00,12270,1476,4943,17512,415,2830,1791,149,1633,10,43030,159,26294,24504,19560,13746
2022-01-31 09:30:00+00,12256,1477,4945,17384,415,2828,1790,153,2501,0,43749,156,27035,25245,20300,13733
2022-01-31 10:00:00+00,12463,1476,4951,17152,415,2372,1789,143,3237,0,43998,154,27544,25755,20804,13939
2022-01-31 10:30:00+00,12290,1475,4947,17317,377,2370,1793,144,3932,0,44645,150,28366,26573,21626,13765
2022-01-31 11:00:00+00,12077,1475,4947,17213,316,2548,1796,158,4449,4,44983,149,28721,26925,21978,13552
2022-01-31 11:30:00+00,11948,1478,4946,17197,395,2544,1789,144,4603,0,45044,148,28930,27141,22195,13426
2022-01-31 12:00:00+00,11874,1476,4945,17418,441,2624,1791,146,4347,0,45062,148,28942,27151,22206,13350
2022-01-31 12:30:00+00,11958,1476,4948,17446,307,2626,1795,146,4229,0,44931,149,28725,26930,21982,13434
2022-01-31 13:00:00+00,12032,1474,4951,16986,299,2708,1794,151,4010,0,44405,150,28040,26246,21295,13506
2022-01-31 13:30:00+00,12437,1469,4957,16542,300,2626,1789,148,3586,0,43854,155,27174,25385,20428,13906
2022-01-31 14:00:00+00,12845,1438,4955,16342,319,2232,1781,149,2923,0,42984,157,26320,24539,19584,14283
2022-01-31 14:30:00+00,12936,1469,4948,16097,476,2246,1774,149,2361,0,42456,161,25656,23882,18934,14405
2022-01-31 15:00:00+00,13618,1396,4951,15304,510,2368,1782,162,1605,682,42378,169,24152,22370,17419,15014
2022-01-31 15:30:00+00,14785,1471,4952,14820,514,2442,1804,157,900,880,42725,181,22990,21186,16234,16256
2022-01-31 16:00:00+00,15335,1475,4950,14277,633,3180,1809,252,235,1238,43384,186,21904,20095,15145,16810
2022-01-31 16:30:00+00,16538,1475,4950,13481,767,3208,1811,532,9,1538,44309,195,21018,19207,14257,18013
2022-01-31 17:00:00+00,17399,1272,4954,12828,860,3796,1812,793,0,2296,46010,194,20454,18642,13688,18671
2022-01-31 17:30:00+00,18149,1235,4958,12175,863,3820,1812,825,0,2332,46169,199,19808,17996,13038,19384
2022-01-31 18:00:00+00,17903,1353,4975,11596,867,4004,1817,783,0,2244,45542,203,19255,17438,12463,19256
2022-01-31 18:30:00+00,17527,970,4974,11965,746,4310,1816,557,0,1978,44843,196,19501,17685,12711,18497
2022-01-31 19:00:00+00,17187,841,4975,12138,723,4728,1814,345,0,672,43423,199,19650,17836,12861,18028
2022-01-31 19:30:00+00,16186,748,4971,12672,707,4824,1807,205,0,340,42460,193,20157,18350,13379,16934
2022-01-31 20:00:00+00,14380,870,4975,13589,585,4470,1805,169,0,318,41161,185,20954,19149,14174,15250
2022-01-31 20:30:00+00,12562,884,4980,14003,459,4380,1806,167,0,264,39505,174,21248,19442,14462,13446
2022-01-31 21:00:00+00,11026,879,4981,14252,369,4196,1805,148,0,62,37718,166,21407,19602,14621,11905
2022-01-31 21:30:00+00,8636,808,4982,14862,360,4076,1803,143,0,0,35670,146,22007,20204,15222,9444
2022-01-31 22:00:00+00,6677,572,4993,14996,344,4014,1672,148,0,90,33506,125,22005,20333,15340,7249
2022-01-31 22:30:00+00,5345,260,4997,14881,256,4074,1519,148,0,0,31480,108,21653,20134,15137,5605
2022-01-31 23:00:00+00,3989,253,5011,14977,233,3750,1382,140,0,0,29735,93,21603,20221,15210,4242
2022-01-31 23:30:00+00,3017,251,5010,15013,227,3598,1199,146,0,0,28461,83,21449,20250,15240,3268
2022-02-01 00:00:00+00,3287,297,5011,15255,217,3236,1210,147,0,0,28660,87,21693,20483,15472,3584
2022-02-01 00:30:00+00,3408,344,5007,15644,212,3232,1248,149,0,0,29244,89,22111,20863,15856,3752
2022-02-01 01:00:00+00,3536,414,5006,16046,210,2972,1396,141,0,0,29721,92,22658,21262,16256,3950
2022-02-01 01:30:00+00,3243,317,5010,16339,209,2966,1398,141,0,0,29623,86,22956,21558,16548,3560
2022-02-01 02:00:00+00,3465,374,5009,16665,189,2616,1374,148,0,0,29840,85,23237,21863,16854,3839
2022-02-01 02:30:00+00,3329,383,5013,17054,186,2544,1314,145,0,0,29968,82,23567,22253,17240,3712
2022-02-01 03:00:00+00,3736,439,5016,17260,186,1668,1315,148,0,0,29768,84,23777,22462,17446,4175
2022-02-01 03:30:00+00,3702,478,5014,17300,186,1632,1291,153,0,0,29756,85,23791,22500,17486,4180
2022-02-01 04:00:00+00,4028,499,5013,17389,199,1512,1410,157,0,0,30207,89,24011,22601,17588,4527
2022-02-01 04:30:00+00,3987,501,5017,17378,201,1506,1421,153,0,0,30164,89,24017,22596,17579,4488
2022-02-01 05:00:00+00,4105,501,5016,17347,217,1536,1292,147,0,0,30161,89,23872,22580,17564,4606
2022-02-01 05:30:00+00,4525,608,5021,17364,217,1470,1282,143,0,0,30630,95,23884,22602,17581,5133
2022-02-01 06:00:00+00,5494,650,5020,17440,262,2088,1377,147,0,0,32478,108,24099,22722,17702,6144
2022-02-01 06:30:00+00,7244,793,5023,17658,262,2126,1557,142,0,0,34805,125,24500,22943,17920,8037
2022-02-01 07:00:00+00,9168,1019,5022,17830,349,2330,1559,147,0,0,37424,144,24760,23201,18179,10187
2022-02-01 07:30:00+00,10300,1335,5023,17753,364,2330,1565,157,0,0,38827,158,24705,23140,18117,11635
2022-02-01 08:00:00+00,10550,1458,5022,17863,366,2634,1564,170,150,0,39777,158,24965,23401,18379,12008
2022-02-01 08:30:00+00,10572,1443,5019,18044,366,2652,1569,225,559,0,40449,156,25557,23988,18969,12015
2022-02-01 09:00:00+00,10036,1242,5018,17973,350,3938,1568,234,1174,38,41571,146,26083,24515,19497,11278
2022-02-01 09:30:00+00,9475,1110,5018,18289,343,3964,1564,152,1843,0,41758,136,27057,25493,20475,10585
2022-02-01 10:00:00+00,9005,991,5015,18489,346,3430,1556,157,2632,16,41637,128,28038,26482,21467,9996
2022-02-01 10:30:00+00,8654,868,5017,18450,391,3340,1552,172,3386,96,41926,120,28796,27244,22227,9522
2022-02-01 11:00:00+00,8129,828,5016,18503,411,3396,1421,195,3974,96,41969,116,29325,27904,22888,8957
2022-02-01 11:30:00+00,7863,606,5016,18640,353,3368,1318,170,4206,0,41540,109,29533,28215,23199,8469
2022-02-01 12:00:00+00,7902,607,5020,18662,358,3386,1342,168,4204,0,41649,107,29586,28244,23224,8509
2022-02-01 12:30:00+00,7863,701,5020,18689,341,3316,1288,172,4492,0,41882,108,29830,28542,23522,8564
2022-02-01 13:00:00+00,8173,647,5020,18684,314,3228,1262,175,4109,0,41612,110,29389,28127,23107,8820
2022-02-01 13:30:00+00,8171,692,5023,18748,317,3180,1261,170,3561,0,41123,112,28910,27649,22626,8863
2022-02-01 14:00:00+00,8246,678,5021,18941,311,3630,1267,171,2725,0,40990,111,28265,26998,21977,8924
2022-02-01 14:30:00+00,8462,712,5024,18920,312,3672,1289,172,2024,0,40587,115,27569,26280,21256,9174
2022-02-01 15:00:00+00,8800,728,5022,18870,319,3214,1462,172,1346,0,39933,122,27019,25557,20535,9528
2022-02-01 15:30:00+00,9467,742,5019,18744,319,3328,1554,178,821,0,40172,130,26457,24903,19884,10209
2022-02-01 16:00:00+00,9970,709,5018,18587,378,3966,1508,218,307,22,40683,135,25798,24290,19272,10679
2022-02-01 16:30:00+00,10624,772,5014,18310,392,4098,1473,234,28,970,41915,140,25217,23744,18730,11396
2022-02-01 17:00:00+00,11419,771,5012,18278,474,4270,1495,442,0,1898,44059,141,25259,23764,18752,12190
2022-02-01 17:30:00+00,11816,922,5011,18303,489,4310,1501,586,0,1966,44904,146,25304,23803,18792,12738
2022-02-01 18:00:00+00,11822,944,5011,18235,488,3868,1502,647,0,1958,44475,147,25236,23734,18723,12766
2022-02-01 18:30:00+00,11655,877,5014,17980,497,3820,1510,468,0,1584,43405,146,25001,23491,18477,12532
2022-02-01 19:00:00+00,11370,915,5012,17782,506,4284,1507,423,0,756,42555,149,24807,23300,18288,12285
2022-02-01 19:30:00+00,10759,992,5011,17535,517,4196,1498,338,0,314,41160,148,24561,23063,18052,11751
2022-02-01 20:00:00+00,10384,931,5012,17336,432,3952,1506,230,0,30,39813,147,24286,22780,17768,11315
2022-02-01 20:30:00+00,9166,750,5011,16990,426,4042,1502,216,0,0,38103,138,23929,22427,17416,9916
2022-02-01 21:00:00+00,7302,704,5019,16892,382,4262,1462,218,0,0,36241,127,23755,22293,17274,8006
2022-02-01 21:30:00+00,5576,526,5017,16460,391,4350,1439,188,0,38,33985,111,23307,21868,16851,6102
2022-02-01 22:00:00+00,5272,224,5019,15581,375,4012,1528,196,0,18,32225,104,22503,20975,15956,5496
2022-02-01 22:30:00+00,4756,1,5015,14891,485,3898,1473,198,0,0,30717,94,21864,20391,15376,4757
2022-02-01 23:00:00+00,4554,0,5017,14221,375,3184,1437,223,0,42,29053,93,21050,19613,14596,4554
2022-02-01 23:30:00+00,4167,0,5017,14155,365,2968,1397,182,0,0,28251,86,20934,19537,14520,4167
2022-02-02 00:00:00+00,3912,0,5018,14382,328,3092,1341,231,0,0,28304,85,21069,19728,14710,3912
2022-02-02 00:30:00+00,4016,0,5012,14203,328,3214,1366,196,0,0,28335,88,20909,19543,14531,4016
2022-02-02 01:00:00+00,4057,0,5012,13834,327,3840,1553,192,0,0,28815,90,20726,19173,14161,4057
2022-02-02 01:30:00+00,4001,0,5015,13975,325,3820,1506,237,0,0,28879,88,20821,19315,14300,4001
2022-02-02 02:00:00+00,3884,0,5009,13723,308,3930,1306,195,0,0,28355,88,20346,19040,14031,3884
2022-02-02 02:30:00+00,4051,0,5011,13435,306,3838,1293,189,0,0,28123,89,20045,18752,13741,4051
2022-02-02 03:00:00+00,3608,0,5013,13900,306,3738,1322,188,0,0,28075,84,20541,19219,14206,3608
2022-02-02 03:30:00+00,3444,0,5014,14062,306,3620,1257,238,0,0,27941,81,20639,19382,14368,3444
2022-02-02 04:00:00+00,3894,0,5015,13522,290,3008,1432,194,0,0,27355,88,20259,18827,13812,3894
2022-02-02 04:30:00+00,4444,0,5014,12656,295,2982,1467,238,0,0,27096,97,19432,17965,12951,4444
2022-02-02 05:00:00+00,5598,0,5014,12426,343,3110,1483,192,0,0,28166,111,19266,17783,12769,5598
2022-02-02 05:30:00+00,6589,0,5014,12154,345,3100,1713,196,0,0,29111,122,19226,17513,12499,6589
2022-02-02 06:00:00+00,8155,72,5016,12081,562,2900,2056,498,0,126,31466,137,19715,17659,12643,8227
2022-02-02 06:30:00+00,10118,255,5016,12107,527,3086,2457,626,0,0,34192,159,20107,17650,12634,10373
2022-02-02 07:00:00+00,13010,606,5014,11959,587,2552,2807,631,0,108,37274,183,20367,17560,12546,13616
2022-02-02 07:30:00+00,14919,891,5011,11041,799,2378,2930,472,0,192,38633,200,19781,16851,11840,15810
2022-02-02 08:00:00+00,15816,1127,5013,10800,848,2566,2942,375,78,148,39713,207,19681,16739,11726,16943
2022-02-02 08:30:00+00,15821,1213,5015,10971,857,2546,2944,321,405,148,40241,206,20192,17248,12233,17034
2022-02-02 09:00:00+00,15808,1204,5009,11667,857,2746,2935,320,759,80,41385,201,21227,18292,13283,17012
2022-02-02 09:30:00+00,15817,1065,5012,11909,836,2770,2938,300,1107,0,41754,196,21802,18864,13852,16882
2022-02-02 10:00:00+00,16356,1064,5008,11433,829,2346,2934,304,1354,364,41992,200,21558,18624,13616,17420
2022-02-02 10:30:00+00,16571,1294,5011,11057,677,2274,2936,388,1641,30,41879,208,21322,18386,13375,17865
2022-02-02 11:00:00+00,16661,1359,5014,10924,716,1880,2949,477,1920,10,41910,211,21523,18574,13560,18020
2022-02-02 11:30:00+00,16521,1265,5009,11099,683,1858,2947,464,1905,44,41795,208,21643,18696,13687,17786
2022-02-02 12:00:00+00,16068,1067,5009,10522,544,2480,2947,440,2085,326,41488,201,21107,18160,13151,17135
2022-02-02 12:30:00+00,16172,1035,5009,10464,612,2522,2947,463,2382,38,41644,201,21414,18467,13458,17207
2022-02-02 13:00:00+00,15672,1123,5012,10828,578,2650,2845,398,2168,0,41274,199,21431,18586,13574,16795
2022-02-02 13:30:00+00,15683,1080,5009,10620,565,2680,2792,264,2094,168,40955,198,21080,18288,13279,16763
2022-02-02 14:00:00+00,16025,949,5013,10259,543,2938,2746,257,1740,24,40494,201,20301,17555,12542,16974
2022-02-02 14:30:00+00,16495,852,5019,9816,545,2956,2731,315,1394,132,40255,205,19505,16774,11755,17347
2022-02-02 15:00:00+00,17860,1190,5009,9458,559,2104,2775,276,963,14,40208,224,18764,15989,10980,19050
2022-02-02 15:30:00+00,18809,1298,5005,9088,577,2064,2833,261,506,0,40441,234,18009,15176,10171,20107
2022-02-02 16:00:00+00,18982,1269,5004,9127,693,2649,2919,325,193,130,41290,233,17936,15017,10013,20251
2022-02-02 16:30:00+00,18600,1240,5007,9561,889,2781,2937,456,18,872,42361,224,18412,15475,10468,19840
2022-02-02 17:00:00+00,19145,1049,5007,9426,849,3484,2941,477,0,1808,44186,217,18223,15282,10275,20194
2022-02-02 17:30:00+00,19330,1052,5006,9595,882,3534,2938,586,0,1870,44793,216,18421,15483,10477,20382
2022-02-02 18:00:00+00,19331,1291,5005,9783,882,2490,2943,556,0,1896,44177,222,18613,15670,10665,20622
2022-02-02 18:30:00+00,18521,1228,5008,10573,884,2440,2941,475,0,1530,43600,216,19406,16465,11457,19749
2022-02-02 19:00:00+00,18300,1275,5005,10915,845,2691,2924,411,0,506,42872,219,19689,16765,11760,19575
2022-02-02 19:30:00+00,17896,1396,5005,10523,834,2614,2918,295,0,74,41555,224,19280,16362,11357,19292
2022-02-02 20:00:00+00,17379,1279,5002,10663,742,1761,3026,267,0,0,40119,220,19433,16407,11405,18658
2022-02-02 20:30:00+00,15380,740,5002,11156,717,1690,3066,272,0,118,38141,198,19941,16875,11873,16120
2022-02-02 21:00:00+00,13414,479,5001,11154,672,2254,3067,268,0,66,36375,183,19894,16827,11826,13893
2022-02-02 21:30:00+00,11558,412,5004,11357,576,2396,3065,264,0,54,34686,171,20002,16937,11933,11970
2022-02-02 22:00:00+00,9405,325,5003,11802,569,2494,3040,273,0,22,32933,151,20414,17374,12371,9730
2022-02-02 22:30:00+00,8270,261,5004,11540,398,2404,2748,276,0,158,31059,141,19690,16942,11938,8531
2022-02-02 23:00:00+00,6667,242,5004,11422,350,2582,2379,265,0,22,28933,129,19155,16776,11772,6909
2022-02-02 23:30:00+00,5912,236,5006,11189,343,2584,2353,257,0,0,27880,122,18891,16538,11532,6148
2022-02-03 00:00:00+00,5803,320,5009,11460,310,2590,2322,266,0,0,28080,123,19101,16779,11770,6123
2022-02-03 00:30:00+00,6259,332,5006,11105,295,2650,2344,251,0,100,28342,129,18750,16406,11400,6591
2022-02-03 01:00:00+00,6281,392,5008,10643,301,2668,2363,240,0,38,27934,133,18315,15952,10944,6673
2022-02-03 01:30:00+00,5990,420,5006,11092,305,2664,2366,255,0,0,28098,130,18769,16403,11397,6410
2022-02-03 02:00:00+00,6306,422,5005,11360,274,2410,2338,257,0,0,28372,132,18977,16639,11634,6728
2022-02-03 02:30:00+00,5803,364,5004,11745,283,2482,2187,256,0,0,28124,124,19219,17032,12028,6167
2022-02-03 03:00:00+00,5246,261,5004,12367,281,1916,2141,262,0,0,27478,112,19793,17652,12648,5507
2022-02-03 03:30:00+00,5068,281,5005,12514,271,1914,2141,275,0,0,27469,110,19931,17790,12785,5349
2022-02-03 04:00:00+00,4963,296,5006,12685,258,1946,2173,254,0,0,27581,111,20122,17949,12943,5259
2022-02-03 04:30:00+00,5062,230,5010,12801,277,1968,2093,307,0,0,27748,110,20181,18088,13078,5292
2022-02-03 05:00:00+00,5816,229,5009,12894,311,1750,2244,252,0,0,28505,115,20458,18214,13205,6045
2022-02-03 05:30:00+00,6581,362,5012,13137,300,1726,2172,245,0,0,29535,125,20621,18449,13437,6943
2022-02-03 06:00:00+00,9050,616,5011,13375,532,1450,2112,236,0,0,32382,148,21030,18918,13907,9666
2022-02-03 06:30:00+00,11105,700,5009,13224,497,1454,2511,241,0,0,34741,165,21241,18730,13721,11805
2022-02-03 07:00:00+00,13109,826,5009,13142,551,1536,2845,210,0,278,37506,178,21547,18702,13693,13935
2022-02-03 07:30:00+00,14445,907,5010,13283,579,1640,2935,182,0,378,39359,186,21807,18872,13862,15352
2022-02-03 08:00:00+00,14459,929,5010,13744,683,2054,2943,201,34,220,40277,186,22414,19471,14461,15388
2022-02-03 08:30:00+00,14251,979,5027,14056,691,2098,2944,205,296,304,40851,183,23014,20070,15043,15230
2022-02-03 09:00:00+00,14207,979,5068,14187,720,2244,2947,155,582,184,41273,179,23504,20557,15489,15186
2022-02-03 09:30:00+00,14227,980,5091,14062,743,2212,2946,168,965,256,41650,178,23807,20861,15770,15207
2022-02-03 10:00:00+00,14183,959,5095,14267,761,1940,2923,232,1367,150,41877,176,24413,21490,16395,15142
2022-02-03 10:30:00+00,14158,980,5099,14278,704,1862,2943,199,1685,158,42066,175,24709,21766,16667,15138
2022-02-03 11:00:00+00,14217,978,5104,14156,606,1906,2954,206,1878,348,42353,175,24698,21744,16640,15195
2022-02-03 11:30:00+00,14263,979,5105,14289,443,2016,2946,290,1818,16,42165,178,24601,21655,16550,15242
2022-02-03 12:00:00+00,14373,979,5102,14363,419,2020,2930,220,1994,214,42614,177,24808,21878,16776,15352
2022-02-03 12:30:00+00,14354,979,5112,14605,418,2028,2936,176,1986,0,42594,176,25057,22121,17009,15333
2022-02-03 13:00:00+00,14359,878,5115,14881,418,2132,2924,179,1797,64,42747,175,25135,22211,17096,15237
2022-02-03 13:30:00+00,14159,710,5113,14898,418,2178,2931,143,1593,0,42143,172,24953,22022,16909,14869
2022-02-03 14:00:00+00,14434,727,5116,14680,422,1726,2954,146,1463,64,41732,172,24635,21681,16565,15161
2022-02-03 14:30:00+00,14724,755,5133,14719,426,1692,2950,142,1343,0,41884,175,24571,21621,16488,15479
2022-02-03 15:00:00+00,14688,880,5138,14652,436,1616,2938,143,919,0,41410,179,24083,21145,16007,15568
2022-02-03 15:30:00+00,15092,1104,5154,14653,474,1714,2949,153,510,62,41865,187,23740,20791,15637,16196
2022-02-03 16:00:00+00,15589,1243,5161,14639,543,1584,2950,232,208,436,42585,191,23501,20551,15390,16832
2022-02-03 16:30:00+00,15899,1294,5160,14778,544,1606,2949,373,16,1128,43747,191,23447,20498,15338,17193
2022-02-03 17:00:00+00,16018,1383,5160,14711,601,2138,2951,433,0,1596,44991,192,23423,20472,15312,17401
2022-02-03 17:30:00+00,15895,1308,5191,15629,605,2122,2950,460,0,1528,45688,187,24375,21425,16234,17203
2022-02-03 18:00:00+00,15347,1221,5205,15853,590,2176,2949,353,0,1630,45324,180,24597,21648,16443,16568
2022-02-03 18:30:00+00,15403,1221,5216,15973,566,2018,2952,268,0,930,44547,182,24707,21755,16539,16624
2022-02-03 19:00:00+00,14514,1350,5217,16274,514,2208,2953,190,0,274,43494,181,24958,22005,16788,15864
2022-02-03 19:30:00+00,12983,1379,5215,16957,515,2212,2956,170,0,16,42403,172,25643,22687,17472,14362
2022-02-03 20:00:00+00,11463,1356,5214,16823,622,2020,2922,160,0,110,40690,163,25581,22659,17445,12819
2022-02-03 20:30:00+00,10146,1314,5215,17343,526,2020,2866,164,0,32,39626,153,25950,23084,17869,11460
2022-02-03 21:00:00+00,8275,1021,5215,17404,506,2174,2828,151,0,58,37632,134,25953,23125,17910,9296
2022-02-03 21:30:00+00,6907,756,5217,17177,465,2178,2960,154,0,0,35814,119,25819,22859,17642,7663
2022-02-03 22:00:00+00,5370,503,5217,17136,460,2258,2908,155,0,8,34015,101,25721,22813,17596,5873
2022-02-03 22:30:00+00,4210,461,5221,17024,459,2258,2550,166,0,52,32401,90,25254,22704,17483,4671
2022-02-03 23:00:00+00,3276,256,5221,16989,424,2612,1697,148,0,0,30623,75,24331,22634,17413,3532
2022-02-03 23:30:00+00,2953,229,5219,16702,402,2620,1365,149,0,0,29638,71,23688,22322,17104,3182
2022-02-04 00:00:00+00,3003,229,5218,15852,380,2736,1374,161,0,52,29005,70,22824,21450,16232,3232
2022-02-04 00:30:00+00,3371,266,5222,15508,483,2738,1374,148,0,276,29386,75,22587,21213,15991,3637
2022-02-04 01:00:00+00,3410,360,5219,15682,402,2596,1361,159,0,8,29197,79,22664,21303,16084,3770
2022-02-04 01:30:00+00,3367,315,5218,15407,345,2596,1349,150,0,8,28755,78,22319,20970,15752,3682
2022-02-04 02:00:00+00,2931,236,5217,15083,337,2692,1357,151,0,0,28004,71,21994,20637,15420,3167
2022-02-04 02:30:00+00,2986,230,5215,14939,337,2726,1355,147,0,0,27935,73,21846,20491,15276,3216
2022-02-04 03:00:00+00,2861,230,5216,15154,337,2866,1353,166,0,0,28183,73,22060,20707,15491,3091
2022-02-04 03:30:00+00,2776,238,5215,14791,323,2744,1358,153,0,0,27598,71,21687,20329,15114,3014
2022-02-04 04:00:00+00,3060,357,5218,14082,425,2754,1356,152,0,0,27404,80,21081,19725,14507,3417
2022-02-04 04:30:00+00,3430,369,5223,14042,434,2846,1358,149,0,0,27851,86,21057,19699,14476,3799
2022-02-04 05:00:00+00,3598,421,5220,13958,449,2810,1352,150,0,0,27958,91,20979,19627,14407,4019
2022-02-04 05:30:00+00,4139,419,5223,14409,449,2868,1541,164,0,0,29212,96,21622,20081,14858,4558
2022-02-04 06:00:00+00,5806,610,5228,14630,681,2814,1847,163,0,0,31779,117,22386,20539,15311,6416
2022-02-04 06:30:00+00,7624,807,5224,14879,681,2782,2180,175,0,0,34352,135,22964,20784,15560,8431
2022-02-04 07:00:00+00,9140,872,5228,14825,713,2966,2239,183,0,176,36342,144,23005,20766,15538,10012
2022-02-04 07:30:00+00,9953,973,5227,15162,715,3038,2265,271,0,396,38000,149,23369,21104,15877,10926
2022-02-04 08:00:00+00,10007,977,5223,15305,755,4216,2437,268,42,518,39748,144,23762,21325,16102,10984
2022-02-04 08:30:00+00,10166,977,5226,15297,746,4258,2772,279,381,594,40696,143,24422,21650,16424,11143
2022-02-04 09:00:00+00,10612,979,5227,15204,744,4452,2944,287,973,494,41916,144,25092,22148,16921,11591
2022-02-04 09:30:00+00,10560,978,5231,15004,762,4414,2973,344,1590,304,42160,143,25560,22587,17356,11538
2022-02-04 10:00:00+00,10727,978,5241,14594,757,3498,2971,617,2390,430,42203,145,25953,22982,17741,11705
2022-02-04 10:30:00+00,9698,976,5287,15507,759,3406,2959,619,3560,30,42801,133,28072,25113,19826,10674
2022-02-04 11:00:00+00,9050,962,5295,16597,722,2504,2951,229,4146,0,42456,126,29711,26760,21465,10012
2022-02-04 11:30:00+00,7904,968,5295,17550,703,2580,2735,168,4693,50,42646,115,30976,28241,22946,8872
2022-02-04 12:00:00+00,8294,904,5296,17067,688,2364,2879,146,4626,268,42532,115,30556,27677,22381,9198
2022-02-04 12:30:00+00,7947,964,5300,17255,692,2386,2942,141,4765,0,42392,114,30954,28012,22712,8911
2022-02-04 13:00:00+00,8506,752,5298,17659,692,2754,2892,144,4494,230,43421,113,31035,28143,22845,9258
2022-02-04 13:30:00+00,8275,575,5314,17974,691,2880,2908,153,4024,62,42856,110,30911,28003,22689,8850
2022-02-04 14:00:00+00,7918,613,5339,18198,690,2566,2905,166,3323,102,41820,108,30455,27550,22211,8531
2022-02-04 14:30:00+00,8276,825,5348,18092,563,2566,2885,178,2844,0,41577,116,29732,26847,21499,9101
2022-02-04 15:00:00+00,8025,928,5346,18070,430,2298,2839,184,2174,0,40294,117,28859,26020,20674,8953
2022-02-04 15:30:00+00,9181,949,5347,17920,462,2398,2737,179,1389,30,40592,129,27855,25118,19771,10130
2022-02-04 16:00:00+00,9975,1104,5348,17950,553,2484,2724,216,524,32,40910,140,27099,24375,19027,11079
2022-02-04 16:30:00+00,10842,1353,5348,17740,700,2532,2865,223,47,204,41854,151,26700,23835,18487,12195
2022-02-04 17:00:00+00,11201,1322,5349,17475,798,3142,2859,291,0,1292,43729,146,26481,23622,18273,12523
2022-02-04 17:30:00+00,11925,1286,5348,17577,800,3198,2873,445,0,1508,44960,149,26598,23725,18377,13211
2022-02-04 18:00:00+00,11338,1296,5344,17447,819,3366,2930,458,0,1686,44684,148,26540,23610,18266,12634
2022-02-04 18:30:00+00,11236,1273,5353,17060,820,3354,2929,298,0,1514,43837,148,26162,23233,17880,12509
2022-02-04 19:00:00+00,10905,1289,5354,17013,795,3502,2931,251,0,404,42444,151,26093,23162,17808,12194
2022-02-04 19:30:00+00,10027,1300,5349,17234,789,3482,2932,215,0,50,41378,146,26304,23372,18023,11327
2022-02-04 20:00:00+00,9141,1301,5348,17319,735,3036,2924,186,0,36,40026,141,26326,23402,18054,10442
2022-02-04 20:30:00+00,8061,1299,5346,17089,720,3032,2924,232,0,78,38781,135,26079,23155,17809,9360
2022-02-04 21:00:00+00,6797,1296,5354,16905,651,2756,2925,165,0,30,36879,127,25835,22910,17556,8093
2022-02-04 21:30:00+00,5883,989,5353,16770,464,2708,2872,163,0,94,35296,115,25459,22587,17234,6872
2022-02-04 22:00:00+00,5458,496,5354,16758,480,2748,2597,152,0,18,34061,100,25189,22592,17238,5954
2022-02-04 22:30:00+00,4340,495,5358,16754,468,2748,2267,145,0,0,32575,89,24847,22580,17222,4835
2022-02-04 23:00:00+00,3000,338,5361,16667,410,2740,2104,143,0,0,30763,72,24542,22438,17077,3338
2022-02-04 23:30:00+00,2430,232,5364,16353,388,2740,1690,149,0,0,29346,63,23795,22105,16741,2662
2022-02-05 00:00:00+00,2399,232,5363,15682,365,2854,1438,151,0,0,28484,62,22848,21410,16047,2631
2022-02-05 00:30:00+00,2425,233,5365,15814,354,3020,1502,147,0,0,28860,65,23035,21533,16168,2658
2022-02-05 01:00:00+00,2304,235,5361,15506,340,3002,1561,155,0,0,28464,65,22768,21207,15846,2539
2022-02-05 01:30:00+00,2237,239,5361,15563,340,3216,1440,154,0,0,28550,67,22704,21264,15903,2476
2022-02-05 02:00:00+00,2595,322,5360,15545,324,3382,1482,147,0,0,29157,76,22711,21229,15869,2917
2022-02-05 02:30:00+00,2440,486,5364,15603,324,3480,1103,151,0,0,28951,80,22394,21291,15927,2926
2022-02-05 03:00:00+00,2937,498,5388,15426,324,3372,965,162,0,0,29072,86,22103,21138,15750,3435
2022-02-05 03:30:00+00,2579,491,5390,15485,324,3372,955,151,0,0,28747,82,22154,21199,15809,3070
2022-02-05 04:00:00+00,2380,402,5387,15182,324,3216,921,151,0,0,27963,78,21814,20893,15506,2782
2022-02-05 04:30:00+00,2557,289,5409,15144,323,3214,789,151,0,0,27876,76,21665,20876,15467,2846
2022-02-05 05:00:00+00,2600,234,5425,15103,322,3260,999,148,0,0,28091,73,21849,20850,15425,2834
2022-02-05 05:30:00+00,2458,284,5428,15203,323,3252,1270,142,0,0,28360,73,22224,20954,15526,2742
2022-02-05 06:00:00+00,2948,462,5426,15350,406,2972,1385,151,0,0,29100,82,22567,21182,15756,3410
2022-02-05 06:30:00+00,3702,497,5432,15604,421,2950,1551,159,0,0,30316,90,23008,21457,16025,4199
2022-02-05 07:00:00+00,5187,498,5470,15479,458,2556,1556,306,0,52,31562,104,22963,21407,15937,5685
2022-02-05 07:30:00+00,5655,498,5484,15955,437,2556,1557,393,8,76,32619,107,23441,21884,16400,6153
2022-02-05 08:00:00+00,5438,501,5485,16308,494,2796,1538,265,245,198,33268,100,24070,22532,17047,5939
2022-02-05 08:30:00+00,6050,499,5487,16432,522,2904,1561,235,778,274,34742,103,24780,23219,17732,6549
2022-02-05 09:00:00+00,5991,500,5490,16758,524,4038,1560,229,1385,72,36547,105,25717,24157,18667,6491
2022-02-05 09:30:00+00,5860,500,5492,17199,524,4040,1552,219,2246,0,37632,100,27013,25461,19969,6360
2022-02-05 10:00:00+00,5769,500,5491,17404,509,3858,1554,223,2853,0,38161,98,27811,26257,20766,6269
2022-02-05 10:30:00+00,5523,500,5491,17582,507,3850,1546,215,3034,32,38280,95,28160,26614,21123,6023
2022-02-05 11:00:00+00,4591,499,5485,18192,463,4138,1501,214,3591,0,38674,85,29232,27731,22246,5090
2022-02-05 11:30:00+00,4539,495,5489,18321,448,4070,1520,217,3536,22,38657,83,29314,27794,22305,5034
2022-02-05 12:00:00+00,5209,499,5498,18294,422,3588,1614,215,3485,162,38986,90,29313,27699,22201,5708
2022-02-05 12:30:00+00,5063,472,5539,18523,391,3574,1628,213,2639,206,38248,89,28720,27092,21553,5535
2022-02-05 13:00:00+00,5063,466,5541,18606,391,3572,1572,217,2135,218,37781,90,28245,26673,21132,5529
2022-02-05 13:30:00+00,5232,464,5545,18605,399,3568,1579,216,1739,166,37513,93,27867,26288,20743,5696
2022-02-05 14:00:00+00,5234,463,5562,18351,425,3610,1580,216,1228,302,36971,94,27146,25566,20004,5697
2022-02-05 14:30:00+00,5212,463,5608,18553,447,3618,1583,217,1098,116,36915,94,27289,25706,20098,5675
2022-02-05 15:00:00+00,4908,481,5611,18890,452,4424,1479,220,833,14,37312,91,27265,25786,20175,5389
2022-02-05 15:30:00+00,5219,673,5611,18738,467,4416,1513,218,390,0,37245,99,26719,25206,19595,5892
2022-02-05 16:00:00+00,5628,883,5609,18771,507,4542,1591,216,110,4,37861,103,26588,24997,19388,6511
2022-02-05 16:30:00+00,6256,957,5606,18351,508,4626,1703,243,6,788,39044,109,26174,24471,18865,7213
2022-02-05 17:00:00+00,6644,980,5609,18121,575,5232,1718,256,0,1776,40911,111,26023,24305,18696,7624
2022-02-05 17:30:00+00,6765,979,5604,18027,595,5266,1719,253,0,2300,41508,111,25945,24226,18622,7744
2022-02-05 18:00:00+00,6408,980,5611,17976,599,5296,1715,252,0,2232,41069,109,25901,24186,18575,7388
2022-02-05 18:30:00+00,5955,980,5604,17989,596,5252,1710,252,0,1804,40142,107,25899,24189,18585,6935
2022-02-05 19:00:00+00,6409,978,5604,18004,582,5010,1712,231,0,698,39228,115,25902,24190,18586,7387
2022-02-05 19:30:00+00,5650,980,5600,17940,607,4966,1716,222,0,26,37707,111,25863,24147,18547,6630
2022-02-05 20:00:00+00,5014,976,5598,17931,784,4090,1712,213,0,0,36318,107,26025,24313,18715,5990
2022-02-05 20:30:00+00,3969,882,5596,17837,784,4032,1684,222,0,82,35088,95,25901,24217,18621,4851
2022-02-05 21:00:00+00,3259,663,5600,17603,755,4286,1551,213,0,0,33930,86,25509,23958,18358,3922
2022-02-05 21:30:00+00,2777,521,5606,17685,643,4226,1417,224,0,0,33099,78,25351,23934,18328,3298
2022-02-05 22:00:00+00,2836,460,5605,17760,523,3516,1509,219,0,0,32428,78,25397,23888,18283,3296
2022-02-05 22:30:00+00,2240,459,5603,17276,498,3516,1434,231,0,0,31257,73,24811,23377,17774,2699
2022-02-05 23:00:00+00,2198,458,5602,17437,456,3524,1362,210,0,0,31247,72,24857,23495,17893,2656
2022-02-05 23:30:00+00,2128,474,5606,16878,429,3470,1265,177,0,0,30427,72,24178,22913,17307,2602
2022-02-06 00:00:00+00,2241,523,5607,16719,417,3454,1320,174,0,0,30455,75,24063,22743,17136,2764
2022-02-06 00:30:00+00,2354,482,5611,17152,414,3456,1324,176,0,0,30969,75,24501,23177,17566,2836
2022-02-06 01:00:00+00,2310,464,5611,17071,408,3084,1295,180,0,0,30423,75,24385,23090,17479,2774
2022-02-06 01:30:00+00,2265,459,5623,16849,386,3008,1224,173,0,0,29987,75,24082,22858,17235,2724
2022-02-06 02:00:00+00,2285,461,5636,16978,360,2832,1224,172,0,0,29948,75,24198,22974,17338,2746
2022-02-06 02:30:00+00,2306,460,5635,16935,360,2572,1228,173,0,0,29669,73,24158,22930,17295,2766
2022-02-06 03:00:00+00,2422,468,5631,17537,357,2094,1258,184,0,0,29951,71,24783,23525,17894,2890
2022-02-06 03:30:00+00,2322,463,5631,17283,357,1570,1229,183,0,0,29038,66,24500,23271,17640,2785
2022-02-06 04:00:00+00,2346,466,5625,17400,340,1476,1233,185,0,0,29071,65,24598,23365,17740,2812
2022-02-06 04:30:00+00,2416,464,5627,17294,337,1390,1232,183,0,0,28943,65,24490,23258,17631,2880
2022-02-06 05:00:00+00,2545,464,5625,16840,332,1456,1232,182,0,0,28676,71,24029,22797,17172,3009
2022-02-06 05:30:00+00,2603,467,5626,16734,337,1502,1245,184,0,0,28698,73,23942,22697,17071,3070
2022-02-06 06:00:00+00,2539,461,5629,16287,377,2624,1231,173,0,0,29321,78,23524,22293,16664,3000
2022-02-06 06:30:00+00,2542,464,5626,16372,408,2698,1234,177,0,0,29521,79,23640,22406,16780,3006
2022-02-06 07:00:00+00,2373,461,5627,16519,489,3032,1240,217,0,0,29958,77,23875,22635,17008,2834
2022-02-06 07:30:00+00,2329,486,5628,16686,486,3084,1234,181,0,0,30114,76,24034,22800,17172,2815
2022-02-06 08:00:00+00,2359,603,5629,17198,543,3478,1230,176,73,0,31289,77,24673,23443,17814,2962
2022-02-06 08:30:00+00,2745,643,5623,17035,531,3524,1298,206,343,672,32620,80,24830,23532,17909,3388
2022-02-06 09:00:00+00,2462,580,5625,17029,535,4296,1304,184,820,146,32981,75,25313,24009,18384,3042
2022-02-06 09:30:00+00,2424,841,5626,17394,530,4408,1413,250,1138,342,34366,80,26101,24688,19062,3265
2022-02-06 10:00:00+00,2211,606,5623,17532,510,5414,1261,182,1654,366,35359,68,26580,25319,19696,2817
2022-02-06 10:30:00+00,2174,605,5631,18351,507,5454,1229,175,2408,108,36642,66,28126,26897,21266,2779
2022-02-06 11:00:00+00,2561,710,5629,18609,457,4754,1334,181,2958,216,37409,71,28987,27653,22024,3271
2022-02-06 11:30:00+00,2671,633,5631,18833,456,4734,1515,176,2748,86,37483,70,29183,27668,22037,3304
2022-02-06 12:00:00+00,2943,729,5627,18764,439,4958,1482,178,2629,318,38067,74,28941,27459,21832,3672
2022-02-06 12:30:00+00,3516,754,5635,18930,439,4970,1501,175,2543,0,38463,80,29048,27547,21912,4270
2022-02-06 13:00:00+00,3412,773,5630,18920,424,5098,1506,179,2806,0,38748,79,29286,27780,22150,4185
2022-02-06 13:30:00+00,3236,766,5631,18979,423,5104,1503,171,2387,0,38200,78,28923,27420,21789,4002
2022-02-06 14:00:00+00,3283,545,5630,18979,456,5510,1506,175,2075,0,38159,74,28646,27140,21510,3828
2022-02-06 14:30:00+00,3595,716,5633,18932,460,5486,1497,173,1833,0,38325,80,28355,26858,21225,4311
2022-02-06 15:00:00+00,4175,615,5633,18841,490,5266,1504,182,1481,0,38187,82,27949,26445,20812,4790
2022-02-06 15:30:00+00,4904,591,5637,18697,500,5306,1479,174,1050,0,38338,89,27363,25884,20247,5495
2022-02-06 16:00:00+00,5601,697,5643,18737,534,5340,1504,197,398,0,38651,98,26816,25312,19669,6298
2022-02-06 16:30:00+00,6751,885,5639,18384,541,5466,1520,223,46,348,39803,113,26130,24610,18971,7636
2022-02-06 17:00:00+00,7227,962,5645,18457,586,5302,1519,248,0,1794,41740,112,26207,24688,19043,8189
2022-02-06 17:30:00+00,7856,977,5649,18379,591,5234,1517,359,0,2058,42620,116,26136,24619,18970,8833
2022-02-06 18:00:00+00,8001,976,5655,18283,588,4986,1518,358,0,1742,42107,116,26044,24526,18871,8977
2022-02-06 18:30:00+00,7788,975,5660,18450,587,4808,1520,351,0,1112,41251,114,26217,24697,19037,8763
2022-02-06 19:00:00+00,7505,972,5660,18469,587,4838,1510,281,0,316,40138,114,26226,24716,19056,8477
2022-02-06 19:30:00+00,6884,919,5657,18211,587,4768,1515,230,0,50,38821,109,25970,24455,18798,7803
2022-02-06 20:00:00+00,6618,665,5654,17863,589,4768,1466,235,0,50,37908,103,25572,24106,18452,7283
2022-02-06 20:30:00+00,5873,483,5652,17601,748,4764,1230,193,0,186,36730,92,25231,24001,18349,6356
2022-02-06 21:00:00+00,4820,773,5654,17185,689,4748,1371,203,0,80,35523,92,24899,23528,17874,5593
2022-02-06 21:30:00+00,3977,966,5657,16784,611,4748,1464,211,0,30,34448,91,24516,23052,17395,4943
2022-02-06 22:00:00+00,3426,865,5656,16840,559,3578,1471,184,0,8,32587,85,24526,23055,17399,4291
2022-02-06 22:30:00+00,3062,591,5656,16731,444,3528,1437,204,0,0,31653,75,24268,22831,17175,3653
2022-02-06 23:00:00+00,2516,460,5658,16394,397,3050,1472,170,0,0,30117,67,23921,22449,16791,2976
2022-02-06 23:30:00+00,2494,588,5656,15566,396,3038,1489,177,0,0,29404,73,23107,21618,15962,3082
2022-02-07 00:00:00+00,2853,653,5656,15082,421,3058,1502,214,0,0,29439,83,22661,21159,15503,3506
2022-02-07 00:30:00+00,3106,934,5659,14459,436,3070,1628,209,0,0,29501,95,22182,20554,14895,4040
2022-02-07 01:00:00+00,3172,976,5663,14062,433,3188,1633,206,0,0,29333,99,21791,20158,14495,4148
2022-02-07 01:30:00+00,3468,981,5660,13373,408,3086,1583,209,0,0,28768,104,21024,19441,13781,4449
2022-02-07 02:00:00+00,3523,977,5662,12880,378,2816,1689,208,0,0,28133,107,20609,18920,13258,4500
2022-02-07 02:30:00+00,3554,976,5657,12135,364,3004,1723,178,0,0,27591,110,19879,18156,12499,4530
2022-02-07 03:00:00+00,3712,979,5659,11293,372,2824,1750,159,0,58,26806,115,19074,17324,11665,4691
2022-02-07 03:30:00+00,3734,991,5655,10409,587,2828,1862,157,0,52,26275,119,18513,16651,10996,4725
2022-02-07 04:00:00+00,3803,1017,5654,9882,686,2808,2107,157,0,0,26114,123,18329,16222,10568,4820
2022-02-07 04:30:00+00,4009,1112,5656,9501,635,2934,2264,171,0,0,26282,133,18056,15792,10136,5121
2022-02-07 05:00:00+00,4724,1242,5652,9474,753,3160,2280,211,0,0,27496,147,18159,15879,10227,5966
2022-02-07 05:30:00+00,5806,1216,5655,9384,731,3340,2282,161,0,0,28575,158,18052,15770,10115,7022
2022-02-07 06:00:00+00,8748,1284,5652,8834,837,3334,2277,168,0,100,31234,179,17600,15323,9671,10032
2022-02-07 06:30:00+00,11856,1451,5655,8551,891,3320,2278,188,0,0,34190,204,17375,15097,9442,13307
2022-02-07 07:00:00+00,14095,1475,5658,8422,911,3440,2275,425,0,740,37441,208,17266,14991,9333,15570
2022-02-07 07:30:00+00,14867,1470,5658,8467,901,3386,2273,581,35,1230,38868,209,17334,15061,9403,16337
2022-02-07 08:00:00+00,15387,1477,5656,8475,936,3100,2270,732,529,1764,40326,206,17866,15596,9940,16864
2022-02-07 08:30:00+00,15298,1476,5660,9309,938,3070,2253,747,1375,1558,41684,198,19535,17282,11622,16774
2022-02-07 09:00:00+00,15250,1480,5658,9578,929,3540,2206,611,2031,1496,42779,193,20402,18196,12538,16730
2022-02-07 09:30:00+00,15269,1481,5657,9954,931,3510,2163,494,2441,1170,43070,191,21146,18983,13326,16750
2022-02-07 10:00:00+00,15294,1369,5663,10234,915,3866,2217,314,2946,92,42910,194,21975,19758,14095,16663
2022-02-07 10:30:00+00,15127,1315,5666,10457,747,3890,2217,357,3457,218,43451,190,22544,20327,14661,16442
2022-02-07 11:00:00+00,14746,1477,5669,11199,503,3990,2214,287,3559,0,43644,190,23144,20930,15261,16223
2022-02-07 11:30:00+00,14437,1478,5673,11646,490,3864,2213,160,3478,0,43439,186,23500,21287,15614,15915
2022-02-07 12:00:00+00,14003,1481,5614,12363,450,4288,2173,154,3045,30,43601,182,23645,21472,15858,15484
2022-02-07 12:30:00+00,13672,1431,5587,13113,437,4180,2030,149,2434,8,43041,178,23601,21571,15984,15103
2022-02-07 13:00:00+00,13840,1428,5592,13749,454,3490,2067,174,1995,18,42807,180,23857,21790,16198,15268
2022-02-07 13:30:00+00,13097,1238,5595,14813,460,3394,2033,158,1827,0,42615,168,24728,22695,17100,14335
2022-02-07 14:00:00+00,13052,1369,5594,15328,449,2856,2031,161,1617,0,42457,169,25019,22988,17394,14421
2022-02-07 14:30:00+00,12416,1449,5594,15931,431,2876,2067,156,1185,0,42105,167,25208,23141,17547,13865
2022-02-07 15:00:00+00,12832,1434,5605,16286,452,2824,2234,149,656,0,42472,170,25233,22999,17394,14266
2022-02-07 15:30:00+00,13252,1381,5619,16580,469,2948,2174,160,366,0,42949,172,25208,23034,17415,14633
2022-02-07 16:00:00+00,14292,1467,5637,16847,700,1860,2222,204,131,0,43360,175,25537,23315,17678,15759
2022-02-07 16:30:00+00,14788,1472,5641,16738,744,1952,2264,254,12,390,44255,177,25399,23135,17494,16260
2022-02-07 17:00:00+00,15285,1470,5650,17164,769,1780,2273,298,0,1276,45965,175,25856,23583,17933,16755
2022-02-07 17:30:00+00,15152,1472,5654,17258,770,1916,2276,403,0,1714,46615,174,25958,23682,18028,16624
2022-02-07 18:00:00+00,14925,1470,5659,17339,771,2270,2271,465,0,1500,46670,174,26040,23769,18110,16395
2022-02-07 18:30:00+00,14576,1473,5658,17509,778,2332,2279,504,0,732,45841,175,26224,23945,18287,16049
2022-02-07 19:00:00+00,12900,1475,5658,17591,671,3238,2304,326,0,250,44413,168,26224,23920,18262,14375
2022-02-07 19:30:00+00,11936,1468,5667,17496,587,3216,2304,183,0,20,42877,163,26054,23750,18083,13404
2022-02-07 20:00:00+00,10214,1460,5669,17395,515,3462,2326,154,0,12,41207,156,25905,23579,17910,11674
2022-02-07 20:30:00+00,8680,1376,5667,17454,511,3474,2331,157,0,0,39650,145,25963,23632,17965,10056
2022-02-07 21:00:00+00,7461,1175,5664,17261,491,3560,2192,153,0,0,37957,134,25608,23416,17752,8636
2022-02-07 21:30:00+00,6727,745,5671,17062,492,3378,1842,153,0,0,36070,118,25067,23225,17554,7472
2022-02-07 22:00:00+00,6135,491,5676,16654,494,2494,1706,176,0,42,33868,107,24530,22824,17148,6626
2022-02-07 22:30:00+00,4639,497,5675,16459,490,2282,1709,181,0,0,31932,93,24333,22624,16949,5136
2022-02-07 23:00:00+00,3128,493,5678,16550,485,3022,1700,167,0,0,31223,77,24413,22713,17035,3621
2022-02-07 23:30:00+00,2424,495,5679,16369,477,3332,1622,149,0,0,30547,74,24147,22525,16846,2919
2022-02-08 00:00:00+00,2293,488,5686,16187,467,3388,1665,147,0,0,30321,75,24005,22340,16654,2781
2022-02-08 00:30:00+00,2660,486,5685,16105,472,3504,1673,147,0,0,30732,80,23935,22262,16577,3146
2022-02-08 01:00:00+00,2614,379,5688,16366,487,3248,1625,148,0,0,30555,76,24166,22541,16853,2993
2022-02-08 01:30:00+00,2427,301,5686,16329,482,3168,1530,147,0,0,30070,71,24027,22497,16811,2728
2022-02-08 02:00:00+00,2590,305,5685,16127,482,2842,1477,150,0,0,29658,68,23771,22294,16609,2895
2022-02-08 02:30:00+00,2571,289,5686,16251,465,2816,1311,148,0,0,29537,67,23713,22402,16716,2860
2022-02-08 03:00:00+00,2619,292,5683,16250,445,2478,1312,151,0,0,29230,71,23690,22378,16695,2911
2022-02-08 03:30:00+00,2605,290,5685,16061,441,2424,1322,151,0,0,28979,71,23509,22187,16502,2895
2022-02-08 04:00:00+00,2634,298,5682,15959,441,2574,1324,154,0,0,29066,73,23406,22082,16400,2932
2022-02-08 04:30:00+00,2664,307,5679,15772,443,2610,1325,157,0,0,28957,75,23219,21894,16215,2971
2022-02-08 05:00:00+00,2656,296,5680,15496,462,3138,1305,154,0,0,29187,74,22943,21638,15958,2952
2022-02-08 05:30:00+00,2870,294,5681,15895,488,3422,1317,150,0,0,30117,78,23381,22064,16383,3164
2022-02-08 06:00:00+00,4698,567,5678,16025,543,3162,1525,156,0,0,32354,103,23771,22246,16568,5265
2022-02-08 06:30:00+00,6499,809,5679,16114,555,3172,1973,158,0,0,34959,124,24321,22348,16669,7308
2022-02-08 07:00:00+00,8372,923,5682,16323,578,2328,2161,176,0,0,36543,136,24744,22583,16901,9295
2022-02-08 07:30:00+00,9966,974,5681,15993,617,2164,2196,182,20,264,38057,146,24507,22311,16630,10940
2022-02-08 08:00:00+00,10091,975,5681,15926,618,2944,2252,154,315,210,39166,144,24792,22540,16859,11066
2022-02-08 08:30:00+00,10126,971,5684,15914,665,3142,2175,183,956,102,39918,143,25394,23219,17535,11097
2022-02-08 09:00:00+00,10780,972,5684,16009,829,3388,2193,232,1565,100,41752,145,26280,24087,18403,11752
2022-02-08 09:30:00+00,10739,968,5686,15874,852,3274,2211,248,2122,100,42074,143,26745,24534,18848,11707
2022-02-08 10:00:00+00,10877,971,5690,15883,810,3040,2289,222,2649,102,42533,141,27321,25032,19342,11848
2022-02-08 10:30:00+00,10875,976,5685,15735,793,3080,2309,220,3026,102,42801,141,27548,25239,19554,11851
2022-02-08 11:00:00+00,10794,966,5684,15857,739,2798,2325,243,3164,0,42570,139,27769,25444,19760,11760
2022-02-08 11:30:00+00,10592,974,5682,16036,716,2732,2327,260,2932,0,42251,138,27693,25366,19684,11566
2022-02-08 12:00:00+00,10645,981,5683,15864,711,2824,2362,250,2570,0,41890,141,27190,24828,19145,11626
2022-02-08 12:30:00+00,10946,983,5685,15872,718,2800,2355,238,2244,0,41841,144,26874,24519,18834,11929
2022-02-08 13:00:00+00,10523,982,5685,15708,726,3034,2354,258,1866,0,41136,143,26339,23985,18300,11505
2022-02-08 13:30:00+00,10562,900,5691,15711,726,2952,2336,236,1584,0,40698,142,26048,23712,18021,11462
2022-02-08 14:00:00+00,10920,759,5685,15306,723,3000,2338,189,1320,66,40306,143,25372,23034,17349,11679
2022-02-08 14:30:00+00,11445,631,5688,15103,589,2998,2319,175,1153,0,40101,146,24852,22533,16845,12076
2022-02-08 15:00:00+00,11762,713,5682,14944,592,2768,2316,172,825,0,39774,151,24359,22043,16361,12475
2022-02-08 15:30:00+00,12530,774,5687,14644,701,2772,2307,201,484,30,40130,159,23823,21516,15829,13304
2022-02-08 16:00:00+00,13224,1048,5685,14242,801,2742,2293,227,179,174,40615,170,23200,20907,15222,14272
2022-02-08 16:30:00+00,14021,1499,5690,14253,821,2754,2291,277,34,376,42016,182,23089,20798,15108,15520
2022-02-08 17:00:00+00,14095,2000,5687,14261,806,2852,2290,478,0,898,43367,190,23044,20754,15067,16095
2022-02-08 17:30:00+00,14196,2160,5690,14435,801,2860,2283,548,0,1634,44607,189,23209,20926,15236,16356
2022-02-08 18:00:00+00,13787,2081,5693,14906,799,3274,2285,564,0,1502,44891,184,23683,21398,15705,15868
2022-02-08 18:30:00+00,13469,2037,5694,15228,817,3282,2303,463,0,1184,44477,181,24042,21739,16045,15506
2022-02-08 19:00:00+00,12938,2117,5693,15619,831,2994,2305,364,0,820,43681,180,24448,22143,16450,15055
2022-02-08 19:30:00+00,11885,2068,5694,16007,838,2988,2269,255,0,236,42240,175,24808,22539,16845,13953
2022-02-08 20:00:00+00,11347,2076,5691,16236,666,2346,2271,267,0,38,40938,172,24864,22593,16902,13423
2022-02-08 20:30:00+00,9635,1976,5698,16578,636,2310,2276,262,0,32,39403,159,25188,22912,17214,11611
2022-02-08 21:00:00+00,7744,1865,5698,16385,547,2600,2271,260,0,54,37424,146,24901,22630,16932,9609
2022-02-08 21:30:00+00,6481,1354,5697,16193,543,2736,2271,252,0,0,35527,128,24704,22433,16736,7835
2022-02-08 22:00:00+00,4930,855,5696,15854,512,3172,2260,256,0,80,33615,109,24322,22062,16366,5785
2022-02-08 22:30:00+00,4059,436,5695,15406,511,2972,2174,253,0,70,31576,89,23786,21612,15917,4495
2022-02-08 23:00:00+00,2816,522,5661,15362,472,2978,1915,246,0,0,29972,79,23410,21495,15834,3338
2022-02-08 23:30:00+00,2475,577,5648,15197,451,2967,1652,190,0,0,29157,76,22948,21296,15648,3052
2022-02-09 00:00:00+00,2545,591,5645,15044,441,2596,1659,185,0,0,28706,78,22789,21130,15485,3136
2022-02-09 00:30:00+00,2620,569,5651,15323,440,2768,1698,186,0,0,29255,79,23112,21414,15763,3189
2022-02-09 01:00:00+00,2595,530,5711,15338,439,2712,1676,190,0,0,29191,77,23164,21488,15777,3125
2022-02-09 01:30:00+00,2487,511,5719,15123,440,2578,1674,187,0,0,28719,74,22956,21282,15563,2998
2022-02-09 02:00:00+00,2652,414,5721,15275,440,2330,1690,191,0,0,28713,69,23126,21436,15715,3066
2022-02-09 02:30:00+00,2992,78,5722,15290,440,2300,1813,189,0,0,28824,63,23265,21452,15730,3070
2022-02-09 03:00:00+00,2988,0,5719,15377,449,1854,1844,189,0,0,28420,62,23389,21545,15826,2988
2022-02-09 03:30:00+00,2729,0,5724,15475,458,1837,1726,187,0,0,28136,58,23383,21657,15933,2729
2022-02-09 04:00:00+00,2778,0,5725,15622,460,1761,1615,187,0,0,28148,57,23422,21807,16082,2778
2022-02-09 04:30:00+00,2635,0,5728,15334,440,1744,1803,187,0,0,27871,56,23305,21502,15774,2635
2022-02-09 05:00:00+00,2465,0,5731,15017,474,1865,2014,187,0,0,27754,56,23236,21222,15491,2465
2022-02-09 05:30:00+00,3057,154,5726,15009,493,1935,2053,189,0,34,28650,68,23281,21228,15502,3211
2022-02-09 06:00:00+00,5026,230,5727,15101,519,2488,2185,186,0,0,31462,92,23532,21347,15620,5256
2022-02-09 06:30:00+00,6907,487,5724,15408,518,2649,2410,184,0,0,34287,115,24060,21650,15926,7394
2022-02-09 07:00:00+00,9484,862,5725,15189,551,2293,2721,196,0,150,37171,144,24186,21465,15740,10346
2022-02-09 07:30:00+00,11186,980,5726,14649,638,2123,2893,232,22,192,38641,157,23928,21035,15309,12166
2022-02-09 08:00:00+00,11409,979,5726,14106,831,1650,2929,190,284,184,38288,161,23876,20947,15221,12388
2022-02-09 08:30:00+00,11754,979,5727,14076,876,799,2920,185,902,136,38354,163,24501,21581,15854,12733
2022-02-09 09:00:00+00,11510,980,5725,14162,879,2840,2927,193,1541,208,40965,153,25234,22307,16582,12490
2022-02-09 09:30:00+00,11252,980,5726,14122,891,2852,2934,165,2100,212,41234,149,25773,22839,17113,12232
2022-02-09 10:00:00+00,10904,979,5731,13941,827,2916,2931,163,2576,142,41110,147,26006,23075,17344,11883
2022-02-09 10:30:00+00,10613,904,5733,14076,809,2918,2952,165,3047,136,41354,142,26617,23665,17932,11517
2022-02-09 11:00:00+00,10395,690,5731,14357,763,3084,2966,195,3078,2,41262,136,26895,23929,18198,11085
2022-02-09 11:30:00+00,10886,660,5728,13739,645,3075,2971,167,2646,0,40517,142,25729,22758,17030,11546
2022-02-09 12:00:00+00,10651,637,5728,13385,629,3743,2946,167,2672,112,40670,141,25360,22414,16686,11288
2022-02-09 12:30:00+00,10999,733,5725,13174,638,3774,2945,179,2799,50,41016,145,25281,22336,16611,11732
2022-02-09 13:00:00+00,11182,743,5725,12894,679,3989,2939,171,2710,0,41032,148,24947,22008,16283,11925
2022-02-09 13:30:00+00,11294,816,5725,12261,735,4035,2939,173,2079,0,40057,155,23739,20800,15075,12110
2022-02-09 14:00:00+00,11572,917,5724,11816,741,4302,2941,172,1746,18,39949,159,22968,20027,14303,12489
2022-02-09 14:30:00+00,12477,1018,5728,10957,723,4242,2924,190,1289,214,39762,171,21621,18697,12969,13495
2022-02-09 15:00:00+00,13698,1046,5726,10502,797,3116,2932,328,963,354,39462,182,20920,17988,12262,14744
2022-02-09 15:30:00+00,14699,1125,5727,10142,869,3082,2938,513,475,398,39968,193,20151,17213,11486,15824
2022-02-09 16:00:00+00,15553,1238,5723,9665,995,3116,2938,615,215,554,40612,201,19536,16598,10875,16791
2022-02-09 16:30:00+00,16298,1332,5726,9060,1007,3120,2939,715,41,1228,41466,207,18773,15834,10108,17630
2022-02-09 17:00:00+00,16524,1367,5727,9377,927,3576,2948,818,0,1800,43064,204,18979,16031,10304,17891
2022-02-09 17:30:00+00,16943,1376,5725,9355,925,3594,2941,884,0,2218,43961,204,18946,16005,10280,18319
2022-02-09 18:00:00+00,16626,1380,5729,9080,923,3724,2966,886,0,2180,43494,205,18698,15732,10003,18006
2022-02-09 18:30:00+00,15842,1377,5731,9474,925,3688,2966,667,0,1980,42650,200,19096,16130,10399,17219
2022-02-09 19:00:00+00,15286,1378,5731,9491,923,3892,2969,406,0,1630,41706,199,19114,16145,10414,16664
2022-02-09 19:30:00+00,14791,1379,5733,9971,922,3774,2970,275,0,944,40759,197,19596,16626,10893,16170
2022-02-09 20:00:00+00,15027,1374,5731,10402,873,3256,2974,234,0,172,40043,206,19980,17006,11275,16401
2022-02-09 20:30:00+00,13943,1376,5728,10514,849,3118,2972,179,0,56,38735,201,20063,17091,11363,15319
2022-02-09 21:00:00+00,13160,1330,5730,10630,678,2860,2951,168,0,20,37527,199,19989,17038,11308,14490
2022-02-09 21:30:00+00,12043,1177,5736,10761,661,2892,2933,170,0,0,36373,191,20091,17158,11422,13220
2022-02-09 22:00:00+00,10531,882,5649,10844,617,2718,2935,167,0,0,34343,175,20045,17110,11461,11413
2022-02-09 22:30:00+00,8833,855,5427,10904,617,2784,2931,169,0,0,32520,165,19879,16948,11521,9688
2022-02-09 23:00:00+00,6665,784,5099,10950,618,3184,2916,167,0,0,30383,147,19583,16667,11568,7449
2022-02-09 23:30:00+00,5565,951,5087,10459,617,3084,2914,177,0,0,28854,143,19077,16163,11076,6516
2022-02-10 00:00:00+00,5280,864,5087,10391,583,3234,2894,163,0,0,28496,139,18955,16061,10974,6144
2022-02-10 00:30:00+00,5479,771,5090,10499,574,3428,2847,162,0,0,28850,140,19010,16163,11073,6250
2022-02-10 01:00:00+00,4905,665,5091,11071,572,3286,2792,162,0,0,28544,130,19526,16734,11643,5570
2022-02-10 01:30:00+00,4491,584,5089,11230,571,3240,2644,165,0,0,28014,123,19534,16890,11801,5075
2022-02-10 02:00:00+00,4867,665,5091,11173,571,3276,2672,166,0,0,28481,131,19507,16835,11744,5532
2022-02-10 02:30:00+00,4734,464,5093,11372,556,3278,2821,166,0,0,28484,123,19842,17021,11928,5198
2022-02-10 03:00:00+00,5014,463,5095,11444,555,3180,2835,162,0,0,28748,123,19929,17094,11999,5477
2022-02-10 03:30:00+00,5028,463,5095,11644,557,3166,2811,167,0,0,28931,122,20107,17296,12201,5491
2022-02-10 04:00:00+00,5283,645,5092,11630,555,2552,2811,161,0,0,28729,130,20088,17277,12185,5928
2022-02-10 04:30:00+00,5269,746,5094,11662,558,2552,2808,163,0,0,28852,132,20122,17314,12220,6015
2022-02-10 05:00:00+00,6063,1040,5097,11960,625,1850,2811,163,0,0,29609,139,20493,17682,12585,7103
2022-02-10 05:30:00+00,7060,1200,5095,11971,630,1850,2877,161,0,0,30844,151,20573,17696,12601,8260
2022-02-10 06:00:00+00,8899,1377,5095,12386,684,1850,2862,162,0,0,33315,167,21027,18165,13070,10276
2022-02-10 06:30:00+00,10584,1488,5089,12829,685,1860,2879,169,0,200,35783,177,21482,18603,13514,12072
2022-02-10 07:00:00+00,11916,1604,5090,13250,747,2002,2875,173,0,216,37873,184,21962,19087,13997,13520
2022-02-10 07:30:00+00,12141,1769,5089,13705,901,2050,2920,212,23,200,39010,185,22638,19718,14629,13910
2022-02-10 08:00:00+00,11935,1900,5092,14103,941,2410,2920,184,266,88,39839,183,23322,20402,15310,13835
2022-02-10 08:30:00+00,11996,1911,5089,14265,881,2420,2936,189,926,144,40757,180,24097,21161,16072,13907
2022-02-10 09:00:00+00,11874,1865,5087,14605,973,2854,2943,169,1494,0,41864,173,25102,22159,17072,13739
2022-02-10 09:30:00+00,11456,1467,5090,15203,986,2774,2938,164,2193,0,42271,158,26410,23472,18382,12923
2022-02-10 10:00:00+00,11172,1371,5087,15270,814,2450,2886,174,2733,150,42108,153,26790,23904,18818,12543
2022-02-10 10:30:00+00,10611,1661,5092,15318,801,2518,2854,165,3140,112,42272,154,27205,24351,19259,12272
2022-02-10 11:00:00+00,10626,1779,5092,15270,730,2174,2793,167,3491,62,42184,160,27376,24583,19491,12405
2022-02-10 11:30:00+00,10292,1622,5096,15573,768,2432,2850,168,4102,0,42903,153,28389,25539,20443,11914
2022-02-10 12:00:00+00,10239,1595,5094,15679,772,2856,2848,172,4167,64,43486,153,28560,25712,20618,11834
2022-02-10 12:30:00+00,9885,1759,5095,15725,778,2854,2834,169,3944,0,43043,155,28376,25542,20447,11644
2022-02-10 13:00:00+00,9830,1577,5097,16204,711,2956,2845,184,4175,0,43579,149,29032,26187,21090,11407
2022-02-10 13:30:00+00,9674,1209,5096,16436,631,2956,2878,177,3790,0,42847,142,28831,25953,20857,10883
2022-02-10 14:00:00+00,9728,1182,5095,16554,633,2422,2906,180,3559,0,42259,140,28747,25841,20746,10910
2022-02-10 14:30:00+00,9862,1189,5090,16672,619,2414,2933,171,3042,0,41992,142,28356,25423,20333,11051
2022-02-10 15:00:00+00,10705,1471,5089,16679,624,1940,2905,185,2393,2,41993,152,27690,24785,19696,12176
2022-02-10 15:30:00+00,11699,1948,5094,16365,639,1902,2893,186,1690,28,42444,170,26681,23788,18694,13647
2022-02-10 16:00:00+00,13168,2228,5095,16069,761,1846,2942,217,814,46,43186,186,25681,22739,17644,15396
2022-02-10 16:30:00+00,14535,2324,5094,15742,805,1586,2941,246,165,608,44046,194,24747,21806,16712,16859
2022-02-10 17:00:00+00,14581,2366,5094,15265,891,2080,2944,466,0,1212,44899,197,24194,21250,16156,16947
2022-02-10 17:30:00+00,15120,2370,5096,15043,1125,2136,2936,632,0,1544,46002,199,24200,21264,16168,17490
2022-02-10 18:00:00+00,15166,2372,5094,14751,1145,2469,2946,497,0,1764,46204,197,23936,20990,15896,17538
2022-02-10 18:30:00+00,15086,2371,5098,14526,1148,2765,2946,389,0,1638,45967,197,23718,20772,15674,17457
2022-02-10 19:00:00+00,13899,2058,5098,14304,1139,3956,2944,309,0,938,44645,187,23485,20541,15443,15957
2022-02-10 19:30:00+00,14095,1971,5101,14099,963,4026,2937,297,0,216,43705,191,23100,20163,15062,16066
2022-02-10 20:00:00+00,14246,1970,5101,13612,910,3218,2943,211,0,0,42211,196,22566,19623,14522,16216
2022-02-10 20:30:00+00,13264,1971,5102,13347,847,3176,2943,174,0,0,40824,193,22239,19296,14194,15235
2022-02-10 21:00:00+00,12225,1976,5099,12902,822,2808,2939,174,0,56,39001,192,21762,18823,13724,14201
2022-02-10 21:30:00+00,11213,1935,5101,12346,822,2794,2928,174,0,0,37313,189,21197,18269,13168,13148
2022-02-10 22:00:00+00,10240,1920,5101,11881,809,3016,2918,173,0,0,36058,188,20709,17791,12690,12160
2022-02-10 22:30:00+00,9266,1881,5098,11378,790,3016,2892,171,0,0,34492,184,20158,17266,12168,11147
2022-02-10 23:00:00+00,8796,1859,5098,10682,772,3030,2895,170,0,30,33332,185,19447,16552,11454,10655
2022-02-10 23:30:00+00,8101,1933,5096,9950,759,3032,2891,174,0,10,31946,187,18696,15805,10709,10034
2022-02-11 00:00:00+00,8200,1892,5096,9292,706,2964,2890,177,0,0,31217,190,17984,15094,9998,10092
2022-02-11 00:30:00+00,8647,1952,5101,9260,704,2964,2889,173,0,0,31690,194,17954,15065,9964,10599
2022-02-11 01:00:00+00,8214,1701,5102,8960,704,3056,2884,175,0,0,30796,187,17650,14766,9664,9915
2022-02-11 01:30:00+00,8262,1658,5098,8526,701,3058,2888,173,0,0,30364,188,17213,14325,9227,9920
2022-02-11 02:00:00+00,8217,1685,5100,8062,693,3314,2887,174,0,0,30132,191,16742,13855,8755,9902
2022-02-11 02:30:00+00,8746,1590,5102,7810,631,3334,2890,173,0,0,30276,194,16433,13543,8441,10336
2022-02-11 03:00:00+00,8957,1502,5105,7456,622,3004,2889,172,0,0,29707,196,16072,13183,8078,10459
2022-02-11 03:30:00+00,8946,1423,5107,7449,623,3002,2880,194,0,0,29624,194,16059,13179,8072,10369
2022-02-11 04:00:00+00,8882,1503,5110,7622,623,2870,2888,171,0,0,29669,195,16243,13355,8245,10385
2022-02-11 04:30:00+00,8987,1583,5109,7424,627,2870,2888,167,0,0,29655,199,16048,13160,8051,10570
2022-02-11 05:00:00+00,9758,1753,5110,7238,711,2484,2888,166,0,0,30108,210,15947,13059,7949,11511
2022-02-11 05:30:00+00,10891,1810,5113,7176,719,2478,2889,169,0,0,31245,218,15897,13008,7895,12701
2022-02-11 06:00:00+00,14044,1959,5114,7108,750,2454,2888,170,0,6,34493,238,15860,12972,7858,16003
2022-02-11 06:30:00+00,16845,1967,5111,6951,765,2456,2907,170,0,30,37202,250,15734,12827,7716,18812
2022-02-11 07:00:00+00,18762,1976,5107,6518,975,2650,2807,184,0,118,39097,258,15407,12600,7493,20738
2022-02-11 07:30:00+00,20075,1976,5107,6359,1026,2724,2908,569,86,88,40918,263,15486,12578,7471,22051
2022-02-11 08:00:00+00,19897,1979,5107,6210,1005,2884,2907,833,765,292,41879,257,15994,13087,7980,21876
2022-02-11 08:30:00+00,19938,1983,5110,6223,1002,2956,2903,537,1922,286,42860,250,17160,14257,9147,21921
2022-02-11 09:00:00+00,19048,1981,5109,5774,937,4228,2904,372,3053,400,43806,238,17777,14873,9764,21029
2022-02-11 09:30:00+00,18569,1980,5112,5200,996,4332,2909,364,4098,146,43706,235,18315,15406,10294,20549
2022-02-11 10:00:00+00,19645,1973,5113,4826,809,3356,2906,208,4721,18,43575,243,18375,15469,10356,21618
2022-02-11 10:30:00+00,19323,1976,5109,4488,796,3284,2890,188,5205,74,43333,241,18488,15598,10489,21299
2022-02-11 11:00:00+00,18837,1975,5115,4435,708,3414,2904,177,5564,16,43145,240,18726,15822,10707,20812
2022-02-11 11:30:00+00,18610,1976,5122,4676,674,3512,2902,175,5691,0,43338,237,19065,16163,11041,20586
2022-02-11 12:00:00+00,18538,1975,5123,4957,654,3660,2908,177,5503,14,43509,237,19145,16237,11114,20513
2022-02-11 12:30:00+00,18112,1838,5124,5496,546,3618,2912,176,4900,108,42830,234,18978,16066,10942,19950
2022-02-11 13:00:00+00,17824,1710,5124,5820,492,3774,2896,178,4243,0,42061,234,18575,15679,10555,19534
2022-02-11 13:30:00+00,17565,1707,5125,6130,449,3868,2858,177,3704,10,41593,235,18266,15408,10283,19272
2022-02-11 14:00:00+00,17200,1791,5122,6627,474,3970,2817,175,2973,0,41149,237,18013,15196,10074,18991
2022-02-11 14:30:00+00,16923,1951,5121,7234,494,3926,2809,178,2224,0,40860,240,17882,15073,9952,18874
2022-02-11 15:00:00+00,17169,1975,5117,7620,559,3072,2813,176,1551,34,40086,242,17660,14847,9730,19144
2022-02-11 15:30:00+00,17646,1977,5115,7823,557,3080,2868,196,1017,136,40415,245,17380,14512,9397,19623
2022-02-11 16:00:00+00,18205,1976,5119,8102,666,3442,2879,215,504,0,41108,249,17270,14391,9272,20181
2022-02-11 16:30:00+00,18208,1977,5116,8846,742,3440,2925,227,142,464,42087,244,17771,14846,9730,20185
2022-02-11 17:00:00+00,18624,1978,5115,9213,754,3424,2931,314,0,1404,43757,239,18013,15082,9967,20602
2022-02-11 17:30:00+00,18871,1976,5118,9884,750,3424,2929,324,0,1672,44948,235,18681,15752,10634,20847
2022-02-11 18:00:00+00,18243,1977,5116,11014,730,2830,2932,347,0,1602,44791,228,19792,16860,11744,20220
2022-02-11 18:30:00+00,17658,1978,5120,11724,702,2828,2934,332,0,974,44250,226,20480,17546,12426,19636
2022-02-11 19:00:00+00,16929,1978,5119,12458,741,2708,2936,186,0,694,43749,220,21254,18318,13199,18907
2022-02-11 19:30:00+00,15296,1977,5120,13353,694,2662,2936,198,0,0,42236,212,22103,19167,14047,17273
2022-02-11 20:00:00+00,14330,1981,5117,14100,561,2224,2939,188,0,18,41458,203,22717,19778,14661,16311
2022-02-11 20:30:00+00,12815,1981,5119,14460,530,2224,2940,175,0,0,40244,194,23049,20109,14990,14796
2022-02-11 21:00:00+00,10937,1887,5118,14862,501,2282,2733,184,0,0,38504,181,23214,20481,15363,12824
2022-02-11 21:30:00+00,9651,1647,5058,15029,502,2262,2704,184,0,0,37037,169,23293,20589,15531,11298
2022-02-11 22:00:00+00,9092,1093,4504,15186,433,1926,2854,200,0,84,35372,153,22977,20123,15619,10185
2022-02-11 22:30:00+00,8196,660,4500,15224,416,1926,2681,206,0,0,33809,137,22821,20140,15640,8856
2022-02-11 23:00:00+00,6310,202,4503,15420,387,2792,2097,195,0,0,31906,111,22407,20310,15807,6512
2022-02-11 23:30:00+00,5469,0,4502,15424,364,2898,1563,194,0,0,30414,98,21853,20290,15788,5469
2022-02-12 00:00:00+00,4376,0,4502,15389,364,3464,1261,198,0,0,29554,88,21516,20255,15753,4376
2022-02-12 00:30:00+00,4645,0,4501,15488,362,3462,1359,200,0,0,30017,90,21710,20351,15850,4645
2022-02-12 01:00:00+00,3896,0,4503,15733,348,3336,1284,205,0,0,29305,83,21868,20584,16081,3896
2022-02-12 01:30:00+00,3401,0,4503,15890,348,3336,1097,187,0,0,28762,77,21838,20741,16238,3401
2022-02-12 02:00:00+00,3311,0,4502,16000,349,3142,1045,179,0,0,28528,76,21896,20851,16349,3311
2022-02-12 02:30:00+00,3283,0,4503,16094,346,3128,1010,177,0,0,28541,75,21953,20943,16440,3283
2022-02-12 03:00:00+00,3522,0,4501,16218,362,2348,1030,203,0,0,28184,73,22111,21081,16580,3522
2022-02-12 03:30:00+00,3293,0,4504,16440,362,2200,1014,183,0,0,27996,69,22320,21306,16802,3293
2022-02-12 04:00:00+00,3276,0,4508,16829,391,1824,1018,178,0,0,28024,65,22746,21728,17220,3276
2022-02-12 04:30:00+00,3309,0,4508,17067,392,1824,1019,184,0,0,28303,65,22986,21967,17459,3309
2022-02-12 05:00:00+00,3320,0,4509,17184,392,1824,1022,190,0,0,28441,65,23107,22085,17576,3320
2022-02-12 05:30:00+00,3464,0,4508,17340,393,1824,1037,193,0,0,28759,66,23278,22241,17733,3464
2022-02-12 06:00:00+00,3382,0,4509,17565,451,2592,1075,167,0,0,29741,69,23600,22525,18016,3382
2022-02-12 06:30:00+00,3594,0,4510,17963,470,2694,1131,169,0,0,30531,71,24074,22943,18433,3594
2022-02-12 07:00:00+00,4639,145,4510,17944,550,2644,1282,172,0,0,31886,83,24286,23004,18494,4784
2022-02-12 07:30:00+00,5188,286,4508,17972,571,2620,1420,178,64,2,32809,92,24535,23115,18607,5474
2022-02-12 08:00:00+00,5517,539,4509,17905,645,3678,1427,173,292,58,34743,103,24778,23351,18842,6056
2022-02-12 08:30:00+00,6051,869,4507,17892,685,3744,1430,177,747,188,36290,113,25261,23831,19324,6920
2022-02-12 09:00:00+00,5852,977,4508,18125,717,3680,1434,171,1278,0,36742,111,26062,24628,20120,6829
2022-02-12 09:30:00+00,5750,969,4509,18544,702,3688,1433,169,1689,0,37453,108,26877,25444,20935,6719
2022-02-12 10:00:00+00,5411,973,4508,18857,633,3662,1427,177,1706,72,37426,103,27131,25704,21196,6384
2022-02-12 10:30:00+00,5483,967,4509,18885,615,3600,1437,167,2268,0,37931,101,27714,26277,21768,6450
2022-02-12 11:00:00+00,5411,964,4506,19029,561,3482,1436,174,2991,0,38554,98,28523,27087,22581,6375
2022-02-12 11:30:00+00,5186,964,4505,19078,548,3530,1436,173,3247,0,38667,96,28814,27378,22873,6150
2022-02-12 12:00:00+00,4735,965,4507,19175,515,3796,1434,172,3454,0,38753,92,29085,27651,23144,5700
2022-02-12 12:30:00+00,4141,968,4512,19134,486,3818,1435,172,3536,0,38202,88,29103,27668,23156,5109
2022-02-12 13:00:00+00,3960,800,4510,19169,491,3984,1434,173,3462,0,37983,82,29066,27632,23122,4760
2022-02-12 13:30:00+00,3897,727,4511,19204,511,3980,1432,170,3091,0,37523,81,28749,27317,22806,4624
2022-02-12 14:00:00+00,3866,748,4510,19231,513,3962,1434,180,2455,0,36899,83,28143,26709,22199,4614
2022-02-12 14:30:00+00,4371,817,4510,19112,501,3952,1433,182,1967,0,36845,90,27523,26090,21580,5188
2022-02-12 15:00:00+00,5221,738,4512,18945,474,4110,1433,170,1266,0,36869,96,26630,25197,20685,5959
2022-02-12 15:30:00+00,5879,644,4511,18742,487,4174,1434,169,701,0,36741,102,25875,24441,19930,6523
2022-02-12 16:00:00+00,6952,669,4510,18394,578,4034,1435,168,289,0,37029,112,25206,23771,19261,7621
2022-02-12 16:30:00+00,8323,848,4507,18271,627,3874,1436,175,48,16,38125,125,24889,23453,18946,9171
2022-02-12 17:00:00+00,8764,963,4509,18012,654,4140,1435,211,0,814,39502,124,24610,23175,18666,9727
2022-02-12 17:30:00+00,9799,976,4511,17664,771,4090,1437,199,0,1608,41055,129,24383,22946,18435,10775
2022-02-12 18:00:00+00,10176,964,4512,17600,797,3876,1438,179,0,1534,41076,133,24347,22909,18397,11140
2022-02-12 18:30:00+00,9847,970,4510,17552,808,3870,1437,164,0,1162,40320,132,24307,22870,18360,10817
2022-02-12 19:00:00+00,9515,962,4511,17569,758,3502,1437,245,0,538,39037,135,24275,22838,18327,10477
2022-02-12 19:30:00+00,8978,942,4511,17460,645,3414,1436,265,0,162,37813,133,24052,22616,18105,9920
2022-02-12 20:00:00+00,9093,943,4513,17402,562,2930,1437,223,0,328,37431,134,23914,22477,17964,10036
2022-02-12 20:30:00+00,8544,784,4510,17238,540,2930,1429,232,0,88,36295,129,23717,22288,17778,9328
2022-02-12 21:00:00+00,6823,507,4511,17130,539,2914,1435,209,0,0,34068,109,23615,22180,17669,7330
2022-02-12 21:30:00+00,5516,387,4514,17277,539,2934,1437,236,0,0,32840,94,23767,22330,17816,5903
2022-02-12 22:00:00+00,4588,156,4511,17124,471,2960,1438,246,0,0,31494,80,23544,22106,17595,4744
2022-02-12 22:30:00+00,4017,104,4512,16976,467,2956,1417,224,0,0,30673,73,23372,21955,17443,4121
2022-02-12 23:00:00+00,3335,52,4512,16797,443,2934,1392,233,0,0,29698,65,23144,21752,17240,3387
2022-02-12 23:30:00+00,3035,0,4514,16180,444,2936,1390,220,0,0,28719,61,22528,21138,16624,3035
2022-02-13 00:00:00+00,3301,0,4512,15564,443,3036,1393,233,0,0,28482,65,21912,20519,16007,3301
2022-02-13 00:30:00+00,3453,0,4515,15388,443,3050,1391,227,0,0,28467,67,21737,20346,15831,3453
2022-02-13 01:00:00+00,3338,0,4516,15517,456,2852,1364,224,0,0,28267,64,21853,20489,15973,3338
2022-02-13 01:30:00+00,3087,0,4507,15650,461,2844,1324,221,0,0,28094,60,21942,20618,16111,3087
2022-02-13 02:00:00+00,3179,0,4509,15424,458,2876,1156,228,0,0,27830,62,21547,20391,15882,3179
2022-02-13 02:30:00+00,3305,0,4512,14979,456,2876,1092,225,0,0,27445,64,21039,19947,15435,3305
2022-02-13 03:00:00+00,3655,0,4512,14677,456,2106,1128,175,0,0,26709,64,20773,19645,15133,3655
2022-02-13 03:30:00+00,3933,0,4514,14415,456,2048,1263,170,0,0,26799,68,20648,19385,14871,3933
2022-02-13 04:00:00+00,4242,0,4515,14071,525,2048,1421,171,0,0,26993,72,20532,19111,14596,4242
2022-02-13 04:30:00+00,4232,0,4517,13945,576,2048,1431,166,0,0,26915,72,20469,19038,14521,4232
2022-02-13 05:00:00+00,3963,0,4515,13626,614,2048,1436,164,0,0,26366,70,20191,18755,14240,3963
2022-02-13 05:30:00+00,4037,0,4517,13545,622,2050,1497,169,0,0,26437,71,20181,18684,14167,4037
2022-02-13 06:00:00+00,4274,0,4517,13318,663,2050,1530,166,0,0,26518,75,20028,18498,13981,4274
2022-02-13 06:30:00+00,4603,0,4516,13268,657,2066,1564,167,0,0,26841,79,20005,18441,13925,4603
2022-02-13 07:00:00+00,4111,0,4515,13246,551,2810,1630,172,0,0,27035,72,19942,18312,13797,4111
2022-02-13 07:30:00+00,4505,0,4515,13496,502,2876,1901,172,5,0,27972,77,20419,18518,14003,4505
2022-02-13 08:00:00+00,4804,48,4514,13643,610,4000,2155,171,75,0,30020,80,20997,18842,14328,4852
2022-02-13 08:30:00+00,5367,203,4515,13843,786,4048,2289,173,184,0,31408,88,21617,19328,14813,5570
2022-02-13 09:00:00+00,6360,533,4515,13590,847,4660,2376,178,290,0,33349,110,21618,19242,14727,6893
2022-02-13 09:30:00+00,6890,793,4515,13573,845,4880,2355,169,392,168,34580,121,21680,19325,14810,7683
2022-02-13 10:00:00+00,7689,1041,4516,13809,851,4772,2191,166,505,242,35782,131,21872,19681,15165,8730
2022-02-13 10:30:00+00,8168,1352,4515,13777,845,4780,2355,168,546,140,36646,142,22038,19683,15168,9520
2022-02-13 11:00:00+00,8156,1459,4515,13936,817,5052,2475,170,527,100,37207,143,22270,19795,15280,9615
2022-02-13 11:30:00+00,8652,1474,4516,14009,816,5054,2484,170,562,112,37849,146,22387,19903,15387,10126
2022-02-13 12:00:00+00,9053,1476,4516,14155,792,5032,2490,184,614,132,38444,148,22567,20077,15561,10529
2022-02-13 12:30:00+00,9417,1474,4515,13942,793,5030,2552,179,595,122,38619,151,22397,19845,15330,10891
2022-02-13 13:00:00+00,9491,1473,4516,13694,768,5100,2675,169,582,0,38468,153,22235,19560,15044,10964
2022-02-13 13:30:00+00,9740,1476,4516,13362,762,5104,2713,172,562,0,38407,156,21915,19202,14686,11216
2022-02-13 14:00:00+00,9827,1479,4514,13049,759,5190,2724,171,470,0,38183,159,21516,18792,14278,11306
2022-02-13 14:30:00+00,10142,1480,4512,12795,760,5198,2723,164,354,0,38128,163,21144,18421,13909,11622
2022-02-13 15:00:00+00,10430,1480,4513,12456,788,5286,2708,167,249,0,38077,167,20714,18006,13493,11910
2022-02-13 15:30:00+00,10679,1482,4512,12295,807,5334,2722,169,148,0,38148,170,20484,17762,13250,12161
2022-02-13 16:00:00+00,11887,1479,4511,11616,862,4956,2726,182,61,266,38546,177,19776,17050,12539,13366
2022-02-13 16:30:00+00,12468,1478,4512,11153,895,4958,2726,198,12,980,39380,179,19298,16572,12060,13946
2022-02-13 17:00:00+00,12845,1479,4512,11152,953,4920,2726,297,0,1732,40616,178,19343,16617,12105,14324
2022-02-13 17:30:00+00,12752,1479,4511,11197,1081,4936,2724,344,0,2086,41110,175,19513,16789,12278,14231
2022-02-13 18:00:00+00,12170,1479,4511,11377,1106,5076,2722,396,0,2156,40993,171,19716,16994,12483,13649
2022-02-13 18:30:00+00,12225,1478,4510,11068,1058,5076,2712,219,0,1884,40230,174,19348,16636,12126,13703
2022-02-13 19:00:00+00,12529,1474,4511,11030,1059,4954,2706,196,0,690,39149,180,19306,16600,12089,14003
2022-02-13 19:30:00+00,11773,1473,4511,11556,919,4948,2723,172,0,0,38075,178,19709,16986,12475,13246
2022-02-13 20:00:00+00,10652,1402,4508,11522,787,4808,2725,192,0,72,36668,170,19542,16817,12309,12054
2022-02-13 20:30:00+00,9743,1380,4510,11435,749,4808,2644,163,0,0,35432,165,19338,16694,12184,11123
2022-02-13 21:00:00+00,8579,1067,4511,11718,721,4880,2430,167,0,0,34073,149,19380,16950,12439,9646
2022-02-13 21:30:00+00,7282,688,4511,11873,748,4886,2317,167,0,0,32472,129,19449,17132,12621,7970
2022-02-13 22:00:00+00,5714,689,4511,11894,733,5034,2122,166,0,0,30863,116,19260,17138,12627,6403
2022-02-13 22:30:00+00,4368,696,4510,11881,704,5030,1785,168,0,0,29142,104,18880,17095,12585,5064
2022-02-13 23:00:00+00,3142,692,4511,11945,622,4722,1734,184,0,0,27552,90,18812,17078,12567,3834
2022-02-13 23:30:00+00,2504,693,4512,11872,604,4716,1729,170,0,0,26800,83,18717,16988,12476,3197
2022-02-14 00:00:00+00,2448,700,4512,11858,666,4558,1731,162,0,0,26635,86,18767,17036,12524,3148
2022-02-14 00:30:00+00,2765,809,4511,11670,674,4742,1748,186,0,0,27105,97,18603,16855,12344,3574
2022-02-14 01:00:00+00,2850,797,4514,11516,662,4666,1661,178,0,0,26844,102,18353,16692,12178,3647
2022-02-14 01:30:00+00,2817,737,4513,11363,664,4576,1595,167,0,0,26432,99,18135,16540,12027,3554
2022-02-14 02:00:00+00,2754,788,4513,11421,640,4808,1645,172,0,0,26741,102,18219,16574,12061,3542
2022-02-14 02:30:00+00,2572,696,4511,11414,563,4924,1721,175,0,0,26576,99,18209,16488,11977,3268
2022-02-14 03:00:00+00,2522,757,4511,11381,511,5018,1744,172,0,0,26616,103,18147,16403,11892,3279
2022-02-14 03:30:00+00,2379,783,4511,11560,478,5036,1648,168,0,0,26563,102,18197,16549,12038,3162
2022-02-14 04:00:00+00,2285,810,4510,11511,490,4940,1519,169,0,0,26234,101,18030,16511,12001,3095
2022-02-14 04:30:00+00,2151,759,4512,11982,460,4926,1484,165,0,0,26439,96,18438,16954,12442,2910
2022-02-14 05:00:00+00,2173,696,4513,12430,490,4496,1474,162,0,0,26434,95,18907,17433,12920,2869
2022-02-14 05:30:00+00,2882,771,4513,12861,508,4472,1528,167,0,0,27702,104,19410,17882,13369,3653
2022-02-14 06:00:00+00,3965,1176,4513,13331,776,4378,1737,172,0,0,30048,123,20357,18620,14107,5141
2022-02-14 06:30:00+00,5297,1608,4511,13444,795,4378,2036,170,0,0,32239,145,20786,18750,14239,6905
2022-02-14 07:00:00+00,6839,1836,4511,13447,860,4744,2313,172,0,0,34722,160,21131,18818,14307,8675
2022-02-14 07:30:00+00,8329,1659,4512,13276,911,4728,2637,178,97,220,36547,164,21433,18796,14284,9988
2022-02-14 08:00:00+00,9688,1875,4513,13157,923,4298,2735,254,593,250,38286,174,21921,19186,14673,11563
2022-02-14 08:30:00+00,10079,1970,4510,13354,924,4294,2714,229,1394,136,39604,174,22896,20182,15672,12049
2022-02-14 09:00:00+00,10535,1887,4511,13564,926,4504,2738,165,2038,150,41018,173,23777,21039,16528,12422
2022-02-14 09:30:00+00,10486,1962,4508,13639,918,4498,2748,155,2464,36,41414,172,24277,21529,17021,12448
2022-02-14 10:00:00+00,10379,1970,4506,13674,885,4354,2749,160,2585,216,41478,170,24399,21650,17144,12349
2022-02-14 10:30:00+00,10485,1974,4505,14063,893,4274,2746,152,2541,180,41813,169,24748,22002,17497,12459
2022-02-14 11:00:00+00,9834,1971,4508,14815,833,4700,2713,152,2468,48,42042,163,25337,22624,18116,11805
2022-02-14 11:30:00+00,9620,1969,4510,15225,822,4692,2684,179,2432,114,42247,160,25673,22989,18479,11589
2022-02-14 12:00:00+00,9413,1979,4510,15536,775,5318,2606,185,2136,12,42470,157,25563,22957,18447,11392
2022-02-14 12:30:00+00,9199,1956,4508,15940,767,5308,2572,186,2069,0,42505,154,25856,23284,18776,11155
2022-02-14 13:00:00+00,9048,1722,4506,16254,793,5368,2531,189,2194,0,42605,146,26278,23747,19241,10770
2022-02-14 13:30:00+00,8823,1515,4511,16337,782,5262,2561,186,1995,0,41972,140,26186,23625,19114,10338
2022-02-14 14:00:00+00,8793,1702,4509,16296,772,4904,2533,191,1749,44,41493,144,25859,23326,18817,10495
2022-02-14 14:30:00+00,9074,1611,4509,16059,756,4836,2441,180,1547,26,41039,146,25312,22871,18362,10685
2022-02-14 15:00:00+00,10111,1261,4509,16002,816,4254,2486,171,1177,0,40787,146,24990,22504,17995,11372
2022-02-14 15:30:00+00,11069,1137,4509,15644,826,4244,2547,183,881,88,41128,152,24407,21860,17351,12206
2022-02-14 16:00:00+00,13167,1552,4509,15000,853,3634,2653,223,633,0,42224,175,23648,20995,16486,14719
2022-02-14 16:30:00+00,14591,1706,4509,14426,874,3648,2677,281,206,174,43092,189,22692,20015,15506,16297
2022-02-14 17:00:00+00,14851,1612,4514,14021,892,4638,2690,362,5,1020,44605,185,22122,19432,14918,16463
2022-02-14 17:30:00+00,15290,1635,4513,13651,1071,4668,2706,472,0,2090,46096,184,21941,19235,14722,16925
2022-02-14 18:00:00+00,15552,1660,4514,13030,1097,4836,2748,472,0,2038,45947,188,21389,18641,14127,17212
2022-02-14 18:30:00+00,15624,1759,4518,12119,1153,4840,2758,345,0,2168,45284,193,20548,17790,13272,17383
2022-02-14 19:00:00+00,15470,1967,4517,11284,1119,4972,2763,206,0,1382,43680,202,19683,16920,12403,17437
2022-02-14 19:30:00+00,14880,1971,4520,10947,1003,4962,2767,152,0,992,42194,204,19237,16470,11950,16851
2022-02-14 20:00:00+00,14488,1973,4519,10493,973,4532,2840,132,0,652,40602,207,18825,15985,11466,16461
2022-02-14 20:30:00+00,13810,1969,4520,10270,959,4518,2832,128,0,128,39134,208,18581,15749,11229,15779
2022-02-14 21:00:00+00,12306,1975,4520,10107,899,4332,2821,127,0,98,37185,203,18347,15526,11006,14281
2022-02-14 21:30:00+00,10508,1976,4520,9855,844,4470,2857,123,0,0,35153,196,18076,15219,10699,12484
2022-02-14 22:00:00+00,8606,1975,4521,9532,846,4786,2890,122,0,88,33366,188,17789,14899,10378,10581
2022-02-14 22:30:00+00,7227,1974,4521,9348,824,4848,2857,119,0,24,31742,181,17550,14693,10172,9201
2022-02-14 23:00:00+00,5565,1953,4520,9426,787,5004,2619,112,0,0,29986,169,17352,14733,10213,7518
2022-02-14 23:30:00+00,4604,1973,4518,9282,781,5166,2185,110,0,134,28753,165,16766,14581,10063,6577
2022-02-15 00:00:00+00,4251,1970,4518,9498,561,5494,2069,109,0,16,28486,165,16646,14577,10059,6221
2022-02-15 00:30:00+00,4260,1977,4517,9678,559,5556,2045,122,0,268,28982,163,16799,14754,10237,6237
2022-02-15 01:00:00+00,4683,1973,4518,9856,559,4900,2059,113,0,0,28661,169,16992,14933,10415,6656
2022-02-15 01:30:00+00,4180,1939,4519,10270,548,4872,2113,110,0,0,28551,162,17450,15337,10818,6119
2022-02-15 02:00:00+00,4164,1810,4529,11260,499,4352,2110,110,0,0,28834,153,18398,16288,11759,5974
2022-02-15 02:30:00+00,3771,1043,4556,12358,498,4292,2089,109,0,0,28716,123,19501,17412,12856,4814
2022-02-15 03:00:00+00,4187,959,4555,13390,593,3046,2150,110,0,0,28990,116,20688,18538,13983,5146
2022-02-15 03:30:00+00,3458,918,4576,14216,444,3012,2007,110,0,0,28741,105,21243,19236,14660,4376
2022-02-15 04:00:00+00,4062,922,4582,14365,436,2062,2000,111,0,0,28540,110,21383,19383,14801,4984
2022-02-15 04:30:00+00,4144,1073,4616,14092,432,2028,2076,108,0,0,28569,116,21216,19140,14524,5217
2022-02-15 05:00:00+00,4631,1506,4627,14242,460,1826,2225,108,0,0,29625,131,21554,19329,14702,6137
2022-02-15 05:30:00+00,4793,1887,4628,14490,438,1826,2342,112,0,0,30516,142,21898,19556,14928,6680
2022-02-15 06:00:00+00,6701,1962,4632,14784,565,1824,2526,323,0,262,33579,156,22507,19981,15349,8663
2022-02-15 06:30:00+00,9003,1954,4632,15194,630,1816,2788,327,0,176,36520,169,23244,20456,15824,10957
2022-02-15 07:00:00+00,9821,1916,4630,15867,806,1716,2888,218,0,184,38046,168,24191,21303,16673,11737
2022-02-15 07:30:00+00,10202,1957,4631,16737,813,1750,2904,199,67,168,39428,167,25152,22248,17617,12159
2022-02-15 08:00:00+00,10586,1970,4631,16597,756,2202,2880,141,182,210,40155,169,25046,22166,17535,12556
2022-02-15 08:30:00+00,10808,1973,4631,16855,700,2226,2854,203,281,358,40889,168,25321,22467,17836,12781
2022-02-15 09:00:00+00,10349,1974,4630,17210,610,2818,2849,131,447,476,41494,163,25746,22897,18267,12323
2022-02-15 09:30:00+00,10341,1978,4630,17668,620,2774,2851,153,599,548,42162,160,26368,23517,18887,12319
2022-02-15 10:00:00+00,10173,1970,4629,18117,603,3236,2848,127,735,278,42716,157,26932,24084,19455,12143
2022-02-15 10:30:00+00,10506,1967,4628,17744,636,3262,2846,136,987,468,43180,158,26842,23996,19368,12473
2022-02-15 11:00:00+00,10642,1958,4632,17388,598,3542,2827,182,1272,816,43857,157,26717,23890,19258,12600
2022-02-15 11:30:00+00,10853,1966,4629,17616,552,3560,2800,217,1411,364,43968,159,27008,24208,19579,12819
2022-02-15 12:00:00+00,10910,1976,4631,17467,549,3828,2796,151,1326,380,44014,159,26769,23973,19342,12886
2022-02-15 12:30:00+00,10941,1977,4632,17431,584,3850,2792,117,1360,406,44090,159,26799,24007,19375,12918
2022-02-15 13:00:00+00,11003,1977,4633,17457,580,4066,2689,115,1312,54,43886,161,26671,23982,19349,12980
2022-02-15 13:30:00+00,10856,1909,4629,17070,569,4074,2735,122,1424,156,43544,159,26427,23692,19063,12765
2022-02-15 14:00:00+00,10903,1962,4632,17037,568,4050,2788,114,1216,18,43288,161,26241,23453,18821,12865
2022-02-15 14:30:00+00,11234,1798,4629,16671,597,4050,2834,116,1028,0,42957,162,25759,22925,18296,13032
2022-02-15 15:00:00+00,11925,1735,4632,16393,600,3840,2846,133,874,0,42978,167,25345,22499,17867,13660
2022-02-15 15:30:00+00,13086,1335,4630,16023,607,3824,2847,136,585,88,43161,168,24692,21845,17215,14421
2022-02-15 16:00:00+00,13824,1669,4631,15322,683,3894,2839,165,286,62,43375,182,23761,20922,16291,15493
2022-02-15 16:30:00+00,14861,1866,4640,14170,720,3882,2847,179,73,390,43628,194,22450,19603,14963,16727
2022-02-15 17:00:00+00,15427,1970,4666,13471,745,4618,2850,232,1,890,44870,198,21733,18883,14217,17397
2022-02-15 17:30:00+00,15708,1946,4669,12958,750,4700,2849,368,0,1540,45488,198,21226,18376,13708,17654
2022-02-15 18:00:00+00,15214,1571,4671,13127,786,4958,2845,402,0,1514,45088,188,21429,18584,13913,16785
2022-02-15 18:30:00+00,15340,963,4670,12802,787,5130,2850,304,0,1600,44446,180,21109,18259,13589,16303
2022-02-15 19:00:00+00,14932,922,4672,12746,762,5512,2843,203,0,886,43478,182,21023,18180,13508,15854
2022-02-15 19:30:00+00,14268,947,4669,12505,751,5692,2743,146,0,392,42113,183,20668,17925,13256,15215
2022-02-15 20:00:00+00,14264,1131,4672,12098,835,4378,2755,136,0,130,40399,195,20360,17605,12933,15395
2022-02-15 20:30:00+00,13031,1155,4671,11820,815,4262,2740,138,0,58,38690,191,20046,17306,12635,14186
2022-02-15 21:00:00+00,10831,1049,4674,11849,683,5254,2577,134,0,0,37051,175,19783,17206,12532,11880
2022-02-15 21:30:00+00,9062,716,4672,11862,678,5270,2512,128,0,4,34904,157,19724,17212,12540,9778
2022-02-15 22:00:00+00,8623,264,4702,11879,648,4258,2316,131,0,0,32821,147,19545,17229,12527,8887
2022-02-15 22:30:00+00,6719,34,4764,12112,610,4258,2221,130,0,0,30848,124,19707,17486,12722,6753
2022-02-15 23:00:00+00,4017,0,4764,12167,561,5848,1953,132,0,0,29442,95,19445,17492,12728,4017
2022-02-15 23:30:00+00,2809,0,4765,12227,515,5908,1934,126,0,0,28284,82,19441,17507,12742,2809
2022-02-16 00:00:00+00,2623,0,4766,12226,473,5908,1925,126,0,0,28046,76,19390,17464,12698,2623
2022-02-16 00:30:00+00,2549,0,4766,12749,468,5874,1921,126,0,0,28453,74,19904,17983,13217,2549
2022-02-16 01:00:00+00,2581,0,4765,13623,431,4660,1867,127,0,0,28054,71,20686,18819,14054,2581
2022-02-16 01:30:00+00,2432,0,4771,13856,432,4566,1748,126,0,0,27931,68,20807,19059,14288,2432
2022-02-16 02:00:00+00,2362,0,4770,14602,432,3410,1695,126,0,0,27397,65,21499,19804,15034,2362
2022-02-16 02:30:00+00,2412,0,4769,14475,437,3272,1707,128,0,0,27200,65,21388,19681,14912,2412
2022-02-16 03:00:00+00,2915,0,4766,15124,447,2454,1766,141,0,0,27613,65,22103,20337,15571,2915
2022-02-16 03:30:00+00,2470,0,4768,15544,444,2446,1932,130,0,0,27734,59,22688,20756,15988,2470
2022-02-16 04:00:00+00,2420,0,4769,16566,402,2096,1938,136,0,0,28327,57,23675,21737,16968,2420
2022-02-16 04:30:00+00,2485,0,4769,16417,402,2082,1934,134,0,0,28223,58,23522,21588,16819,2485
2022-02-16 05:00:00+00,2543,0,4773,15512,400,3136,1834,120,0,0,28318,65,22519,20685,15912,2543
2022-02-16 05:30:00+00,2656,0,4776,15883,402,3160,1947,125,0,0,28949,65,23008,21061,16285,2656
2022-02-16 06:00:00+00,2837,111,4776,16590,537,3404,1946,127,0,0,30328,69,23849,21903,17127,2948
2022-02-16 06:30:00+00,3934,341,4772,16890,613,3480,2035,142,0,156,32363,86,24310,22275,17503,4275
2022-02-16 07:00:00+00,5183,280,4772,17042,689,4690,2165,124,0,0,34945,97,24668,22503,17731,5463
2022-02-16 07:30:00+00,6520,309,4771,17170,790,4574,2205,130,76,0,36545,106,25012,22807,18036,6829
2022-02-16 08:00:00+00,7194,350,4770,17242,792,5014,2206,124,520,0,38212,107,25530,23324,18554,7544
2022-02-16 08:30:00+00,7129,342,4769,17371,754,5106,2119,127,1255,126,39098,104,26268,24149,19380,7471
2022-02-16 09:00:00+00,7389,326,4767,17254,738,5292,2022,124,1900,126,39938,102,26681,24659,19892,7715
2022-02-16 09:30:00+00,7533,247,4770,16968,762,5164,1983,125,2420,126,40098,99,26903,24920,20150,7780
2022-02-16 10:00:00+00,7464,230,4771,16761,757,5334,1980,132,2734,132,40295,99,27003,25023,20252,7694
2022-02-16 10:30:00+00,7093,231,4767,16644,823,5350,2026,174,2805,226,40139,97,27065,25039,20272,7324
2022-02-16 11:00:00+00,7047,232,4766,16201,807,5436,1987,143,2747,588,39954,97,26508,24521,19755,7279
2022-02-16 11:30:00+00,7452,232,4834,15843,807,5550,1984,135,2818,738,40393,102,26286,24302,19468,7684
2022-02-16 12:00:00+00,7661,280,4850,15485,809,5622,2072,167,2498,1042,40486,106,25714,23642,18792,7941
2022-02-16 12:30:00+00,7791,408,4848,15438,806,5674,2117,151,1971,964,40168,111,25180,23063,18215,8199
2022-02-16 13:00:00+00,8006,725,4846,15655,828,5272,2093,215,1557,1100,40297,118,24979,22886,18040,8731
2022-02-16 13:30:00+00,7986,934,4849,15826,903,5320,2075,207,1141,552,39793,124,24794,22719,17870,8920
2022-02-16 14:00:00+00,7927,997,4852,15978,909,5268,2090,158,797,540,39516,126,24626,22536,17684,8924
2022-02-16 14:30:00+00,7641,905,4855,16218,908,5188,2106,140,641,336,38938,121,24728,22622,17767,8546
2022-02-16 15:00:00+00,8243,806,4865,16320,865,5348,2137,154,604,408,39750,124,24791,22654,17789,9049
2022-02-16 15:30:00+00,8286,827,4867,17177,871,5384,2148,160,655,336,40711,123,25718,23570,18703,9113
2022-02-16 16:00:00+00,8112,1026,4859,17665,947,5708,2038,204,291,306,41156,126,25800,23762,18903,9138
2022-02-16 16:30:00+00,8705,1128,4860,17797,913,5756,2145,223,80,688,42295,132,25795,23650,18790,9833
2022-02-16 17:00:00+00,8512,1164,4858,17967,872,5728,2191,344,5,1780,43421,128,25893,23702,18844,9676
2022-02-16 17:30:00+00,8884,1349,4864,17610,954,5776,2196,388,0,2200,44221,134,25624,23428,18564,10233
2022-02-16 18:00:00+00,9565,1368,4901,17052,984,5528,2177,443,0,2186,44204,139,25114,22937,18036,10933
2022-02-16 18:30:00+00,9326,1371,4911,17228,984,5452,2163,402,0,1900,43737,138,25286,23123,18212,10697
2022-02-16 19:00:00+00,8619,1365,4916,16584,958,5644,2164,275,0,1672,42197,137,24622,22458,17542,9984
2022-02-16 19:30:00+00,7992,1368,4916,16647,803,5590,2165,345,0,920,40746,136,24531,22366,17450,9360
2022-02-16 20:00:00+00,7190,1213,4916,17260,705,5712,2162,263,0,92,39513,128,25043,22881,17965,8403
2022-02-16 20:30:00+00,5984,820,4919,17568,705,5584,2096,285,0,32,37993,109,25288,23192,18273,6804
2022-02-16 21:00:00+00,5262,484,4947,17776,680,4866,2126,299,0,0,36440,97,25529,23403,18456,5746
2022-02-16 21:30:00+00,4096,243,4962,17972,580,4866,1864,292,0,0,34875,81,25378,23514,18552,4339
2022-02-16 22:00:00+00,3798,0,4984,17914,586,3398,1788,300,0,0,32768,70,25272,23484,18500,3798
2022-02-16 22:30:00+00,3228,0,4991,17687,480,3060,1642,271,0,0,31359,62,24800,23158,18167,3228
2022-02-16 23:00:00+00,3280,0,5001,17963,472,2002,1674,271,0,0,30663,61,25110,23436,18435,3280
2022-02-16 23:30:00+00,3022,0,5009,18224,469,1754,1423,276,0,0,30177,55,25125,23702,18693,3022
2022-02-17 00:00:00+00,2866,0,5010,18404,474,1728,1212,282,0,0,29976,54,25100,23888,18878,2866
2022-02-17 00:30:00+00,3103,0,5072,18556,546,1860,1211,286,0,0,30634,59,25385,24174,19102,3103
2022-02-17 01:00:00+00,3009,0,5110,18704,633,1888,1252,248,0,0,30844,59,25699,24447,19337,3009
2022-02-17 01:30:00+00,2655,0,5113,18861,599,1748,1263,201,0,0,30440,53,25836,24573,19460,2655
2022-02-17 02:00:00+00,2540,0,5113,18562,498,1910,1291,201,0,0,30115,52,25464,24173,19060,2540
2022-02-17 02:30:00+00,2522,0,5121,18265,509,1874,1294,205,0,0,29790,52,25189,23895,18774,2522
2022-02-17 03:00:00+00,2777,0,5205,18745,637,1158,1304,204,0,0,30030,55,25891,24587,19382,2777
2022-02-17 03:30:00+00,2559,0,5222,19115,515,998,1281,202,0,0,29892,50,26133,24852,19630,2559
2022-02-17 04:00:00+00,3053,0,5217,19157,495,538,1331,218,0,0,30009,56,26200,24869,19652,3053
2022-02-17 04:30:00+00,3235,0,5224,19226,525,470,1422,196,0,0,30298,57,26397,24975,19751,3235
2022-02-17 05:00:00+00,2594,0,5232,19146,507,916,1430,201,0,0,30026,49,26315,24885,19653,2594
2022-02-17 05:30:00+00,2855,0,5231,18952,514,974,1473,211,0,0,30210,52,26170,24697,19466,2855
2022-02-17 06:00:00+00,2587,0,5286,18942,547,1442,1523,207,0,0,30534,46,26298,24775,19489,2587
2022-02-17 06:30:00+00,3824,0,5315,18897,659,1708,1725,315,0,106,32549,63,26596,24871,19556,3824
2022-02-17 07:00:00+00,3956,0,5316,18929,702,4044,1874,260,0,266,35347,61,26821,24947,19631,3956
2022-02-17 07:30:00+00,4665,0,5316,18825,631,4194,2038,256,197,722,36844,67,27007,24969,19653,4665
2022-02-17 08:00:00+00,4662,0,5312,18805,627,5148,2240,257,1004,446,38501,70,27988,25748,20436,4662
2022-02-17 08:30:00+00,4350,0,5313,18934,544,5374,2269,233,1950,324,39291,67,29010,26741,21428,4350
2022-02-17 09:00:00+00,4652,0,5376,18952,533,5190,2112,210,2720,226,39971,66,29693,27581,22205,4652
2022-02-17 09:30:00+00,4480,0,5403,19166,531,5100,1971,209,3173,278,40311,62,30244,28273,22870,4480
2022-02-17 10:00:00+00,4253,0,5466,19337,532,5026,1941,203,3491,0,40249,60,30767,28826,23360,4253
2022-02-17 10:30:00+00,3943,0,5505,19434,543,5040,1941,206,4207,0,40819,56,31630,29689,24184,3943
2022-02-17 11:00:00+00,4039,0,5523,19471,532,4710,1956,215,4466,0,40912,57,31948,29992,24469,4039
2022-02-17 11:30:00+00,3970,0,5539,19457,536,4714,2023,209,4517,0,40965,57,32072,30049,24510,3970
2022-02-17 12:00:00+00,4259,0,5578,19363,488,4424,2120,205,4597,0,41034,59,32146,30026,24448,4259
2022-02-17 12:30:00+00,4213,0,5582,19406,478,4490,2148,221,4713,0,41251,60,32327,30179,24597,4213
2022-02-17 13:00:00+00,4003,0,5585,19098,463,4788,2226,181,3906,0,40250,58,31278,29052,23467,4003
2022-02-17 13:30:00+00,4187,0,5647,18702,463,4766,2286,210,3581,40,39882,61,30679,28393,22746,4187
2022-02-17 14:00:00+00,4998,157,5687,17601,490,4900,2230,221,3158,352,39794,72,29166,26936,21249,5155
2022-02-17 14:30:00+00,5508,303,5690,17366,486,4904,2220,218,2695,406,39796,81,28457,26237,20547,5811
2022-02-17 15:00:00+00,6226,476,5692,16868,492,5024,2278,247,2469,266,40038,92,27799,25521,19829,6702
2022-02-17 15:30:00+00,7756,702,5693,16093,502,5026,2295,246,1517,516,40346,111,26100,23805,18112,8458
2022-02-17 16:00:00+00,9351,973,5692,15649,621,4648,2296,283,782,1012,41307,129,25040,22744,17052,10324
2022-02-17 16:30:00+00,10715,1196,5681,14833,628,4644,2296,389,183,1202,41767,146,23621,21325,15644,11911
2022-02-17 17:00:00+00,11435,1373,5669,14916,826,4126,2295,680,6,1666,42992,152,23712,21417,15748,12808
2022-02-17 17:30:00+00,12411,1381,5681,14376,843,4182,2297,716,0,2228,44115,158,23197,20900,15219,13792
2022-02-17 18:00:00+00,12459,1381,5728,13804,842,5072,1952,778,0,2304,44320,161,22326,20374,14646,13840
2022-02-17 18:30:00+00,12965,1379,5726,13184,844,5082,2048,699,0,2300,44227,165,21802,19754,14028,14344
2022-02-17 19:00:00+00,12880,1379,5727,12776,833,5066,2137,425,0,2100,43323,166,21473,19336,13609,14259
2022-02-17 19:30:00+00,12868,1380,5726,12274,825,5068,2193,281,0,1580,42195,170,21018,18825,13099,14248
2022-02-17 20:00:00+00,12534,1374,5727,11725,822,5062,2182,257,0,818,40501,173,20456,18274,12547,13908
2022-02-17 20:30:00+00,12213,1374,5724,10728,923,5062,2184,250,0,838,39296,175,19559,17375,11651,13587
2022-02-17 21:00:00+00,11846,1377,5729,9639,999,4856,2178,236,0,530,37390,179,18545,16367,10638,13223
2022-02-17 21:30:00+00,11037,1135,5736,9650,896,4852,2172,224,0,0,35702,172,18454,16282,10546,12172
2022-02-17 22:00:00+00,10340,620,5734,9308,709,4558,2101,229,0,0,33599,159,17852,15751,10017,10960
2022-02-17 22:30:00+00,9125,223,5735,8947,645,4628,2077,226,0,0,31606,143,17404,15327,9592,9348
2022-02-17 23:00:00+00,7045,112,5742,9118,652,4838,2067,216,0,0,29789,123,17579,15512,9770,7156
2022-02-17 23:30:00+00,5489,0,5741,8935,634,5136,2045,215,0,0,28195,109,17355,15310,9569,5489
2022-02-18 00:00:00+00,4640,0,5738,8901,618,5380,2098,234,0,0,27609,105,17355,15257,9519,4640
2022-02-18 00:30:00+00,4863,0,5740,8960,776,5454,2100,226,0,36,28154,107,17576,15476,9736,4863
2022-02-18 01:00:00+00,4973,0,5737,8938,750,5646,2094,261,0,0,28399,110,17519,15425,9688,4973
2022-02-18 01:30:00+00,4840,0,5736,8718,747,5640,2092,233,0,0,28006,110,17293,15201,9465,4840
2022-02-18 02:00:00+00,4206,0,5746,9412,601,5486,2088,220,0,0,27759,99,17847,15759,10013,4206
2022-02-18 02:30:00+00,3359,0,5758,10279,578,5476,1946,214,0,0,27610,87,18561,16615,10857,3359
2022-02-18 03:00:00+00,3185,0,5761,10871,482,5048,1794,215,0,0,27356,77,18908,17114,11353,3185
2022-02-18 03:30:00+00,2946,0,5767,11345,453,4786,1666,211,0,0,27174,70,19231,17565,11798,2946
2022-02-18 04:00:00+00,2977,0,5769,12712,486,3390,1772,212,0,0,27318,66,20739,18967,13198,2977
2022-02-18 04:30:00+00,3022,0,5770,13070,468,3144,1679,211,0,0,27364,63,20987,19308,13538,3022
2022-02-18 05:00:00+00,3261,0,5775,14136,505,2296,1823,210,0,0,28006,65,22239,20416,14641,3261
2022-02-18 05:30:00+00,3621,0,5774,14338,519,2284,1845,217,0,0,28598,68,22476,20631,14857,3621
2022-02-18 06:00:00+00,4346,173,5778,14705,721,2622,1875,212,0,0,30432,81,23079,21204,15426,4519
2022-02-18 06:30:00+00,4984,242,5776,15288,733,2766,1782,260,0,0,31831,89,23579,21797,16021,5226
2022-02-18 07:00:00+00,5847,377,5780,15959,868,3048,1890,214,0,0,33983,96,24497,22607,16827,6224
2022-02-18 07:30:00+00,6562,467,5781,16331,809,3106,1985,244,29,46,35360,104,24935,22950,17169,7029
2022-02-18 08:00:00+00,7373,561,5778,16143,757,3654,2097,231,340,104,37038,114,25115,23018,17240,7934
2022-02-18 08:30:00+00,8259,581,5779,16047,851,3704,2122,232,962,42,38579,119,25761,23639,17860,8840
2022-02-18 09:00:00+00,8537,585,5778,16091,883,3942,2116,227,1659,184,40002,117,26527,24411,18633,9122
2022-02-18 09:30:00+00,8998,628,5780,15832,883,3916,2121,219,2601,0,40978,119,27217,25096,19316,9626
2022-02-18 10:00:00+00,8579,590,5777,15307,843,4708,2069,223,2616,90,40802,116,26612,24543,18766,9169
2022-02-18 10:30:00+00,8721,554,5781,15780,823,4678,2113,215,2238,150,41053,115,26735,24622,18841,9275
2022-02-18 11:00:00+00,8853,484,5784,16007,823,4970,2071,215,2011,400,41618,115,26696,24625,18841,9337
2022-02-18 11:30:00+00,9194,467,5787,16409,806,5025,2074,200,2029,8,41999,117,27105,25031,19244,9661
2022-02-18 12:00:00+00,9533,486,5787,16434,782,4654,2118,203,2187,88,42272,118,27308,25190,19403,10019
2022-02-18 12:30:00+00,9973,548,5790,15695,775,4504,2109,174,2461,256,42285,122,26830,24721,18931,10521
2022-02-18 13:00:00+00,9483,646,5790,15227,698,4622,2117,180,3126,166,42056,121,26958,24841,19051,10129
2022-02-18 13:30:00+00,9279,570,5306,15149,707,4630,2121,183,3188,410,41542,119,26471,24350,19044,9849
2022-02-18 14:00:00+00,9685,842,5118,14730,717,4123,2122,173,2965,714,41190,127,25652,23530,18412,10527
2022-02-18 14:30:00+00,10204,1213,5116,14508,720,4061,2119,170,2263,338,40711,141,24726,22606,17490,11417
2022-02-18 15:00:00+00,10645,1362,5115,14804,743,3334,2121,188,1852,0,40163,150,24635,22514,17399,12007
2022-02-18 15:30:00+00,11073,1385,5108,14487,947,2734,2129,263,1421,0,39547,157,24092,21963,16855,12458
2022-02-18 16:00:00+00,11378,1379,5107,14422,1065,2990,2120,376,720,146,39703,161,23434,21314,16207,12757
2022-02-18 16:30:00+00,11877,1371,5121,14353,1074,1653,2106,441,289,762,39048,166,22943,20837,15716,13248
2022-02-18 17:00:00+00,11988,1375,5205,14228,1085,4492,2119,503,26,1432,42453,162,22663,20544,15339,13363
2022-02-18 17:30:00+00,12218,1384,5239,14101,1084,4551,2126,678,0,2198,43579,162,22550,20424,15185,13602
2022-02-18 18:00:00+00,12656,1376,5240,13777,1084,4381,2115,657,0,2162,43448,167,22216,20101,14861,14032
2022-02-18 18:30:00+00,12543,1375,5239,13822,1083,4219,2105,589,0,1770,42746,166,22249,20144,14905,13918
2022-02-18 19:00:00+00,12104,1355,5240,13762,1088,4380,2119,417,0,776,41241,168,22209,20090,14850,13459
2022-02-18 19:30:00+00,11245,1039,5238,14119,1088,4351,2119,268,0,260,39727,156,22564,20445,15207,12284
2022-02-18 20:00:00+00,9778,765,5237,14430,946,5226,2117,184,0,168,38850,143,22730,20613,15376,10543
2022-02-18 20:30:00+00,8499,602,5234,14788,945,5185,2117,163,0,0,37533,129,23084,20967,15733,9101
2022-02-18 21:00:00+00,6918,394,5235,15094,795,5408,2118,143,0,0,36105,113,23242,21124,15889,7312
2022-02-18 21:30:00+00,5604,267,5241,15134,765,5176,2089,152,0,16,34443,97,23229,21140,15899,5871
2022-02-18 22:00:00+00,4763,0,5245,15108,735,4524,2074,154,0,46,32649,80,23162,21088,15843,4763
2022-02-18 22:30:00+00,3442,0,5251,15663,670,4386,1784,150,0,0,31346,64,23368,21584,16333,3442
2022-02-18 23:00:00+00,3502,0,5270,16078,558,2982,1449,154,0,0,29993,63,23355,21906,16636,3502
2022-02-18 23:30:00+00,2818,0,5279,16347,543,2772,1295,149,0,0,29203,52,23464,22169,16890,2818
2022-02-19 00:00:00+00,2638,0,5278,16624,547,3074,1157,148,0,0,29466,48,23606,22449,17171,2638
2022-02-19 00:30:00+00,2776,0,5278,16795,547,3126,1105,155,0,0,29782,50,23725,22620,17342,2776
2022-02-19 01:00:00+00,2896,0,5274,16806,524,2976,1103,154,0,0,29733,54,23707,22604,17330,2896
2022-02-19 01:30:00+00,2743,0,5272,16704,517,2902,1100,150,0,0,29388,53,23593,22493,17221,2743
2022-02-19 02:00:00+00,2743,0,5266,16792,516,2316,1101,151,0,0,28885,54,23675,22574,17308,2743
2022-02-19 02:30:00+00,2820,0,5260,16680,507,2252,1102,153,0,0,28774,56,23549,22447,17187,2820
2022-02-19 03:00:00+00,2844,0,5261,16557,494,1980,1102,152,0,0,28390,57,23414,22312,17051,2844
2022-02-19 03:30:00+00,2824,0,5261,16334,502,1962,1101,148,0,0,28132,57,23198,22097,16836,2824
2022-02-19 04:00:00+00,2836,0,5260,16113,497,1756,1102,155,0,0,27719,58,22972,21870,16610,2836
2022-02-19 04:30:00+00,2727,0,5264,16006,509,1796,1104,150,0,0,27556,57,22883,21779,16515,2727
2022-02-19 05:00:00+00,3011,0,5261,15844,562,1700,1104,157,0,0,27639,60,22771,21667,16406,3011
2022-02-19 05:30:00+00,3208,0,5266,15810,569,1776,1103,156,0,0,27888,62,22748,21645,16379,3208
2022-02-19 06:00:00+00,3049,0,5271,15822,596,3139,1219,149,0,0,29245,59,22908,21689,16418,3049
2022-02-19 06:30:00+00,3012,17,5268,15543,605,3257,1449,159,0,0,29310,60,22865,21416,16148,3029
2022-02-19 07:00:00+00,3091,43,5275,14944,633,4542,1401,153,0,0,30082,59,22253,20852,15577,3134
2022-02-19 07:30:00+00,3579,230,5276,14826,737,4618,1328,152,315,0,31061,69,22482,21154,15878,3809
2022-02-19 08:00:00+00,5200,498,5271,13729,955,4428,1403,161,1071,94,32810,97,22429,21026,15755,5698
2022-02-19 08:30:00+00,6871,768,5269,12813,990,4478,1494,169,1492,174,34518,119,22058,20564,15295,7639
2022-02-19 09:00:00+00,8590,1259,5273,11638,992,4992,1483,154,1275,292,35948,146,20661,19178,13905,9849
2022-02-19 09:30:00+00,9772,1453,5270,10765,1022,5042,1476,184,1007,466,36457,162,19540,18064,12794,11225
2022-02-19 10:00:00+00,10754,1477,5272,10189,1060,5238,1475,442,911,628,37446,172,18907,17432,12160,12231
2022-02-19 10:30:00+00,11456,1478,5265,9893,1120,5238,1476,448,791,592,37757,178,18545,17069,11804,12934
2022-02-19 11:00:00+00,12161,1480,5267,9669,1101,5202,1476,439,829,650,38274,182,18342,16866,11599,13641
2022-02-19 11:30:00+00,12624,1482,5264,9324,1101,5216,1482,435,951,716,38595,186,18122,16640,11376,14106
2022-02-19 12:00:00+00,13012,1481,5270,9402,1100,5404,1476,442,943,532,39062,189,18191,16715,11445,14493
2022-02-19 12:30:00+00,12966,1480,5268,9306,1096,5418,1472,445,1260,584,39295,187,18402,16930,11662,14446
2022-02-19 13:00:00+00,12596,1482,5274,9474,1068,5262,1463,394,1721,288,39022,183,19000,17537,12263,14078
2022-02-19 13:30:00+00,12451,1480,5270,9087,1068,5244,1469,356,1971,232,38628,182,18865,17396,12126,13931
2022-02-19 14:00:00+00,12297,1473,5269,8310,1056,5412,1474,293,2151,250,37985,185,18260,16786,11517,13770
2022-02-19 14:30:00+00,13033,1403,5274,7384,1055,5386,1474,217,1996,178,37400,193,17183,15709,10435,14436
2022-02-19 15:00:00+00,13166,1398,5273,6866,1071,5232,1473,181,1985,366,37011,194,16668,15195,9922,14564
2022-02-19 15:30:00+00,13212,1436,5271,6576,1093,5206,1476,183,1512,888,36853,196,15928,14452,9181,14648
2022-02-19 16:00:00+00,13449,1472,5272,6723,1149,5226,1469,351,876,944,36931,201,15489,14020,8748,14921
2022-02-19 16:30:00+00,14174,1475,4811,7216,1164,5288,1467,706,258,796,37355,211,14916,13449,8638,15649
2022-02-19 17:00:00+00,14236,1434,4779,7715,1164,5262,1517,726,25,1600,38458,205,15200,13683,8904,15670
2022-02-19 17:30:00+00,14239,1414,4772,8477,1165,5300,1527,645,0,1934,39473,199,15941,14414,9642,15653
2022-02-19 18:00:00+00,14138,1442,4772,8873,1166,4928,1523,668,0,2144,39654,197,16334,14811,10039,15580
2022-02-19 18:30:00+00,13707,1478,4772,9269,1150,5070,1518,527,0,1538,39029,197,16709,15191,10419,15185
2022-02-19 19:00:00+00,13175,1420,4767,10085,904,5608,1526,299,0,708,38492,193,17282,15756,10989,14595
2022-02-19 19:30:00+00,12296,1271,4770,10643,848,5524,1523,192,0,538,37605,183,17784,16261,11491,13567
2022-02-19 20:00:00+00,10844,1266,4772,11472,820,5510,1523,156,0,170,36533,173,18587,17064,12292,12110
2022-02-19 20:30:00+00,9215,933,4771,11997,719,5750,1527,151,0,0,35063,157,19014,17487,12716,10148
2022-02-19 21:00:00+00,8305,896,4773,12174,687,5358,1525,155,0,0,33873,149,19159,17634,12861,9201
2022-02-19 21:30:00+00,6725,984,4772,12237,660,5354,1525,176,0,0,32433,140,19194,17669,12897,7709
2022-02-19 22:00:00+00,6202,914,4774,11923,601,4898,1529,174,0,0,31015,134,18827,17298,12524,7116
2022-02-19 22:30:00+00,5705,838,4772,11093,600,4856,1518,190,0,152,29724,130,17983,16465,11693,6543
2022-02-19 23:00:00+00,3853,574,4780,11014,600,5810,1449,157,0,0,28237,107,17843,16394,11614,4427
2022-02-19 23:30:00+00,3355,334,4779,10954,591,5762,1267,159,0,0,27201,95,17591,16324,11545,3689
2022-02-20 00:00:00+00,3773,442,4782,11366,586,4646,1182,160,0,0,26937,103,17916,16734,11952,4215
2022-02-20 00:30:00+00,3481,442,4782,12523,582,4534,966,152,0,0,27462,96,18853,17887,13105,3923
2022-02-20 01:00:00+00,3324,442,4774,13766,580,3438,808,152,0,0,27284,92,19928,19120,14346,3766
2022-02-20 01:30:00+00,2579,406,4775,14662,571,3322,808,151,0,0,27274,80,20816,20008,15233,2985
2022-02-20 02:00:00+00,2538,398,4775,15773,594,1886,957,145,0,0,27066,75,22099,21142,16367,2936
2022-02-20 02:30:00+00,2332,373,4774,16198,594,1838,1146,140,0,0,27395,70,22712,21566,16792,2705
2022-02-20 03:00:00+00,3478,408,4765,16732,594,1460,1262,150,0,0,28849,83,23353,22091,17326,3886
2022-02-20 03:30:00+00,3348,408,4767,16926,598,1458,1346,154,0,0,29005,81,23637,22291,17524,3756
2022-02-20 04:00:00+00,3598,408,4769,17113,602,904,1400,155,0,0,28949,82,23884,22484,17715,4006
2022-02-20 04:30:00+00,3500,401,4770,17260,613,900,1404,149,0,0,28997,80,24047,22643,17873,3901
2022-02-20 05:00:00+00,3001,405,4768,17467,616,810,1356,149,0,0,28572,74,24207,22851,18083,3406
2022-02-20 05:30:00+00,2894,399,4770,17720,619,810,1358,148,0,0,28718,72,24467,23109,18339,3293
2022-02-20 06:00:00+00,2484,355,4772,17973,653,1158,1490,147,0,0,29032,66,24888,23398,18626,2839
2022-02-20 06:30:00+00,2694,485,4766,18024,669,1162,1488,148,0,0,29436,72,24947,23459,18693,3179
2022-02-20 07:00:00+00,2562,546,4780,17755,674,1070,1360,152,0,0,28899,73,24569,23209,18429,3108
2022-02-20 07:30:00+00,2763,661,4775,17568,637,1068,1379,161,33,0,29045,79,24392,23013,18238,3424
2022-02-20 08:00:00+00,2477,908,4777,17445,554,2356,1457,157,189,0,30320,85,24422,22965,18188,3385
2022-02-20 08:30:00+00,2736,1009,4783,17538,543,2438,1494,156,421,0,31118,90,24779,23285,18502,3745
2022-02-20 09:00:00+00,2210,873,4776,17450,553,4414,1498,143,502,78,32497,78,24779,23281,18505,3083
2022-02-20 09:30:00+00,2671,1119,4779,17472,563,4770,1500,131,616,0,33621,90,24930,23430,18651,3790
2022-02-20 10:00:00+00,2804,1284,4775,17393,572,5658,1499,131,636,48,34800,94,24875,23376,18601,4088
2022-02-20 10:30:00+00,3293,1371,4775,17372,573,5732,1456,131,835,110,35648,100,25011,23555,18780,4664
2022-02-20 11:00:00+00,3442,1438,4770,17317,553,5864,1471,166,887,160,36068,102,24998,23527,18757,4880
2022-02-20 11:30:00+00,3771,1475,4774,17276,561,5878,1515,272,806,212,36540,107,24932,23417,18643,5246
2022-02-20 12:00:00+00,4122,1473,4772,17508,555,5878,1526,339,747,378,37298,109,25108,23582,18810,5595
2022-02-20 12:30:00+00,4403,1473,4777,17517,555,5878,1528,337,756,256,37480,111,25133,23605,18828,5876
2022-02-20 13:00:00+00,4439,1469,4772,17545,558,5880,1525,309,637,218,37352,111,25037,23512,18740,5908
2022-02-20 13:30:00+00,4378,1468,4780,17633,563,5876,1523,168,589,300,37278,110,25088,23565,18785,5846
2022-02-20 14:00:00+00,4483,1470,4774,17560,565,5878,1523,151,453,216,37073,112,24875,23352,18578,5953
2022-02-20 14:30:00+00,4475,1465,4775,17500,565,5878,1527,142,356,218,36901,112,24723,23196,18421,5940
2022-02-20 15:00:00+00,4552,1469,4780,17460,566,5610,1529,170,306,870,37312,112,24641,23112,18332,6021
2022-02-20 15:30:00+00,4995,1472,4780,17544,570,4874,1528,317,215,1218,37513,117,24637,23109,18329,6467
2022-02-20 16:00:00+00,5576,1473,4779,17489,587,4894,1528,494,126,1274,38220,122,24509,22981,18202,7049
2022-02-20 16:30:00+00,6612,1476,4785,17343,568,4894,1528,588,33,1638,39465,129,24257,22729,17944,8088
2022-02-20 17:00:00+00,7395,1477,4784,16879,617,4892,1528,593,2,2016,40183,135,23810,22282,17498,8872
2022-02-20 17:30:00+00,7806,1477,4785,17396,627,4892,1527,605,0,1970,41085,136,24335,22808,18023,9283
2022-02-20 18:00:00+00,6897,1477,4777,17354,630,5354,1524,596,0,2224,40833,128,24285,22761,17984,8374
2022-02-20 18:30:00+00,6971,1473,4777,16860,628,5210,1522,482,0,2278,40201,129,23787,22265,17488,8444
2022-02-20 19:00:00+00,7258,1478,4773,16437,624,4866,1520,440,0,1878,39274,132,23354,21834,17061,8736
2022-02-20 19:30:00+00,6886,1456,4775,16756,611,4854,1518,389,0,902,38147,131,23660,22142,17367,8342
2022-02-20 20:00:00+00,6422,1301,4772,16911,574,4880,1519,253,0,242,36874,125,23776,22257,17485,7723
2022-02-20 20:30:00+00,5461,1178,4775,17084,568,4876,1518,140,0,0,35600,115,23945,22427,17652,6639
2022-02-20 21:00:00+00,4654,792,4773,16999,568,4820,1517,129,0,0,34252,99,23857,22340,17567,5446
2022-02-20 21:30:00+00,4032,463,4770,16994,559,4122,1517,123,0,324,32904,83,23840,22323,17553,4495
2022-02-20 22:00:00+00,3694,430,4776,17120,577,3304,1491,120,0,82,31594,83,23964,22473,17697,4124
2022-02-20 22:30:00+00,3618,333,4775,17303,581,3130,1413,117,0,0,31270,79,24072,22659,17884,3951
2022-02-20 23:00:00+00,3619,323,4772,17408,572,2420,1346,116,0,0,30576,80,24098,22752,17980,3942
2022-02-20 23:30:00+00,3031,275,4776,17585,583,2396,1162,119,0,0,29927,73,24106,22944,18168,3306
2022-02-21 00:00:00+00,3030,278,4776,17481,586,2302,1159,134,0,0,29746,74,24002,22843,18067,3308
2022-02-21 00:30:00+00,3245,314,4777,17633,609,2416,1159,149,0,0,30302,78,24178,23019,18242,3559
2022-02-21 01:00:00+00,2392,252,4777,17285,643,3518,1158,148,0,0,30173,65,23863,22705,17928,2644
2022-02-21 01:30:00+00,2324,293,4779,17047,657,3510,1157,136,0,0,29903,66,23640,22483,17704,2617
2022-02-21 02:00:00+00,2408,327,4772,16329,662,3512,1157,143,0,0,29310,69,22920,21763,16991,2735
2022-02-21 02:30:00+00,2640,317,4776,15305,659,3474,1171,139,0,0,28481,73,21911,20740,15964,2957
2022-02-21 03:00:00+00,3121,403,4769,14703,659,2846,1325,141,0,0,27967,86,21456,20131,15362,3524
2022-02-21 03:30:00+00,2714,407,4765,15103,666,2700,1325,140,0,0,27820,79,21859,20534,15769,3121
2022-02-21 04:00:00+00,3256,479,4767,15365,718,2192,1363,144,0,0,28284,89,22213,20850,16083,3735
2022-02-21 04:30:00+00,3094,500,4763,15830,693,2266,1382,145,0,0,28673,86,22668,21286,16523,3594
2022-02-21 05:00:00+00,2870,433,4767,16128,683,2834,1270,146,0,0,29131,80,22848,21578,16811,3303
2022-02-21 05:30:00+00,3343,531,4766,16165,658,2892,1441,151,0,0,29947,88,23030,21589,16823,3874
2022-02-21 06:00:00+00,3821,779,4771,16006,683,3890,1864,142,0,0,31956,98,23324,21460,16689,4600
2022-02-21 06:30:00+00,5592,985,4766,15964,709,3964,2042,143,0,0,34165,118,23481,21439,16673,6577
2022-02-21 07:00:00+00,6755,1281,4774,15965,738,4346,2142,142,10,80,36233,131,23629,21487,16713,8036
2022-02-21 07:30:00+00,7382,1430,4776,16219,717,4484,2216,349,206,300,38079,138,24134,21918,17142,8812
2022-02-21 08:00:00+00,7571,1515,4775,17011,688,4820,2216,374,548,296,39814,136,25238,23022,18247,9086
2022-02-21 08:30:00+00,7731,1602,4778,17149,684,4836,2209,434,922,658,41003,136,25742,23533,18755,9333
2022-02-21 09:00:00+00,8330,1715,4778,17190,646,4816,2187,428,1430,636,42156,141,26231,24044,19266,10045
2022-02-21 09:30:00+00,8424,1788,4783,17278,677,4756,2195,399,2057,408,42765,140,26990,24795,20012,10212
2022-02-21 10:00:00+00,8258,1803,4776,17455,663,4620,2170,399,2707,340,43191,136,27771,25601,20825,10061
2022-02-21 10:30:00+00,8288,1674,4779,17684,653,4490,2206,416,3069,138,43397,132,28391,26185,21406,9962
2022-02-21 11:00:00+00,7585,1904,4789,18176,654,4196,2190,404,3593,136,43627,127,29402,27212,22423,9489
2022-02-21 11:30:00+00,6941,1969,4785,18470,667,3972,2187,350,4420,100,43861,120,30529,28342,23557,8910
2022-02-21 12:00:00+00,6862,2059,4776,18775,669,3810,2171,212,4325,0,43659,120,30716,28545,23769,8921
2022-02-21 12:30:00+00,6750,1905,4771,18846,670,3810,2167,191,4612,0,43722,115,31066,28899,24128,8655
2022-02-21 13:00:00+00,6570,1973,4776,18690,696,3886,2156,186,4536,0,43469,116,30854,28698,23922,8543
2022-02-21 13:30:00+00,6291,2071,4773,18559,745,3888,2162,143,4246,0,42878,117,30485,28323,23550,8362
2022-02-21 14:00:00+00,6449,1978,4775,18087,761,3914,2164,132,3739,78,42077,118,29526,27362,22587,8427
2022-02-21 14:30:00+00,7312,1733,4783,17846,820,3916,2164,117,3188,0,41879,121,28801,26637,21854,9045
2022-02-21 15:00:00+00,8369,1388,4794,17303,912,4058,2165,143,2518,0,41650,125,27692,25527,20733,9757
2022-02-21 15:30:00+00,9819,1304,4798,16382,966,4058,2167,133,1926,0,41553,137,26239,24072,19274,11123
2022-02-21 16:00:00+00,11422,1563,4797,15548,979,4064,2168,179,1264,0,41984,157,24756,22588,17791,12985
2022-02-21 16:30:00+00,12181,2021,4784,14811,1057,4060,2175,275,585,704,42653,172,23412,21237,16453,14202
2022-02-21 17:00:00+00,13583,2197,4783,13613,1072,3772,2167,330,61,1742,43320,186,21696,19529,14746,15780
2022-02-21 17:30:00+00,15105,2283,4782,12434,1077,3770,2167,670,0,1936,44224,200,20460,18293,13511,17388
2022-02-21 18:00:00+00,16230,2376,4777,11345,1077,3402,2221,786,0,2236,44450,211,19420,17199,12422,18606
2022-02-21 18:30:00+00,16441,2338,4772,10005,1092,3396,2223,760,0,2146,43173,218,18092,15869,11097,18779
2022-02-21 19:00:00+00,16391,2325,4760,9042,1093,3572,2197,667,0,1898,41945,224,17092,14895,10135,18716
2022-02-21 19:30:00+00,15812,2310,4753,8483,1092,3604,2204,554,0,1662,40474,225,16532,14328,9575,18122
2022-02-21 20:00:00+00,14598,2265,4730,8178,1093,4220,2221,360,0,1656,39321,221,16222,14001,9271,16863
2022-02-21 20:30:00+00,14095,2157,4720,8098,1093,4418,2228,283,0,1238,38330,220,16139,13911,9191,16252
2022-02-21 21:00:00+00,14039,2075,4704,7482,1082,4678,2239,240,0,408,36947,229,15507,13268,8564,16114
2022-02-21 21:30:00+00,12975,2051,4698,7019,1100,4754,2280,218,0,0,35095,229,15097,12817,8119,15026
2022-02-21 22:00:00+00,11747,1527,4692,6983,965,4568,2279,214,0,0,32975,214,14919,12640,7948,13274
2022-02-21 22:30:00+00,10020,957,4682,7656,963,4566,2269,210,0,0,31323,186,15570,13301,8619,10977
2022-02-21 23:00:00+00,7656,559,4684,8667,912,4608,2185,212,0,0,29483,151,16448,14263,9579,8215
2022-02-21 23:30:00+00,6604,332,4683,9325,843,4458,1978,213,0,0,28436,131,16829,14851,10168,6936
2022-02-22 00:00:00+00,6470,230,4686,9691,709,4602,2013,209,0,0,28610,129,17099,15086,10400,6700
2022-02-22 00:30:00+00,6462,230,4695,10024,610,4636,2203,208,0,0,29068,128,17532,15329,10634,6692
2022-02-22 01:00:00+00,6073,349,4691,10413,609,4484,2244,219,0,0,29082,126,17957,15713,11022,6422
2022-02-22 01:30:00+00,5428,314,4691,10791,606,4478,2242,217,0,0,28767,117,18330,16088,11397,5742
2022-02-22 02:00:00+00,5041,385,4693,11151,604,4272,2236,204,0,0,28586,113,18684,16448,11755,5426
2022-02-22 02:30:00+00,4499,439,4693,11532,603,4174,2241,202,0,0,28383,108,19069,16828,12135,4938
2022-02-22 03:00:00+00,5334,478,4688,11591,603,2726,2280,204,0,0,27904,120,19162,16882,12194,5812
2022-02-22 03:30:00+00,5198,423,4685,11548,604,2706,2323,212,0,0,27699,118,19160,16837,12152,5621
2022-02-22 04:00:00+00,5939,464,4685,11584,602,2070,2333,253,0,0,27930,127,19204,16871,12186,6403
2022-02-22 04:30:00+00,5869,472,4686,12090,609,2046,2362,343,0,0,28477,126,19747,17385,12699,6341
2022-02-22 05:00:00+00,5880,437,4689,12782,614,1924,2417,356,0,0,29099,121,20502,18085,13396,6317
2022-02-22 05:30:00+00,5527,392,4687,13398,620,1926,2654,367,0,0,29571,114,21359,18705,14018,5919
2022-02-22 06:00:00+00,5409,434,4692,13868,618,2420,2798,225,0,0,30464,109,21976,19178,14486,5843
2022-02-22 06:30:00+00,6327,795,4690,14781,631,2366,2828,210,0,0,32628,122,22930,20102,15412,7122
2022-02-22 07:00:00+00,7015,1162,4689,15472,639,2676,2839,208,5,18,34723,133,23644,20805,16116,8177
2022-02-22 07:30:00+00,7233,1386,4687,16126,759,2692,2847,257,88,368,36443,135,24507,21660,16973,8619
2022-02-22 08:00:00+00,8344,1445,4692,16607,995,2782,2842,275,241,172,38395,141,25377,22535,17843,9789
2022-02-22 08:30:00+00,7900,1629,4692,17268,1023,2913,2836,430,560,92,39343,140,26379,23543,18851,9529
2022-02-22 09:00:00+00,7025,1774,4694,17339,949,4392,2839,496,1301,146,40955,132,27122,24283,19589,8799
2022-02-22 09:30:00+00,6875,1619,4699,17778,825,4314,2833,426,2339,192,41900,123,28474,25641,20942,8494
2022-02-22 10:00:00+00,6672,1669,4696,17871,739,4362,2791,235,3043,134,42212,121,29140,26349,21653,8341
2022-02-22 10:30:00+00,6695,1424,4692,17804,704,4296,2719,214,3071,236,41855,116,28990,26271,21579,8119
2022-02-22 11:00:00+00,6424,1414,4693,17919,717,4470,2814,216,2718,144,41529,114,28861,26047,21354,7838
2022-02-22 11:30:00+00,6146,1447,4686,17965,750,4442,2837,210,2837,0,41320,113,29075,26238,21552,7593
2022-02-22 12:00:00+00,6334,1679,4685,18010,690,4112,2834,211,3012,0,41567,118,29231,26397,21712,8013
2022-02-22 12:30:00+00,6133,1732,4686,18068,680,4056,2824,198,4063,0,42440,113,30321,27497,22811,7865
2022-02-22 13:00:00+00,5947,1641,4688,18139,694,3612,2765,196,4664,0,42346,106,30950,28185,23497,7588
2022-02-22 13:30:00+00,5446,1379,4688,18166,711,3486,2730,196,4496,0,41298,97,30791,28061,23373,6825
2022-02-22 14:00:00+00,4863,1308,4686,18147,709,3941,2724,195,4506,0,41079,93,30772,28048,23362,6171
2022-02-22 14:30:00+00,5040,1368,4684,17886,666,3934,2735,174,3761,0,40248,99,29732,26997,22313,6408
2022-02-22 15:00:00+00,5576,1386,4691,17619,687,3826,2728,172,3179,0,39864,106,28904,26176,21485,6962
2022-02-22 15:30:00+00,6218,1394,4684,17398,697,3820,2670,193,2454,58,39586,113,27903,25233,20549,7612
2022-02-22 16:00:00+00,7365,1708,4689,16965,710,3606,2664,190,1663,136,39696,129,26691,24027,19338,9073
2022-02-22 16:30:00+00,8455,2110,4693,16908,714,3662,2807,179,671,198,40397,148,25793,22986,18293,10565
2022-02-22 17:00:00+00,9431,2092,4691,16227,733,3868,2838,203,94,1244,41421,154,24583,21745,17054,11523
2022-02-22 17:30:00+00,10983,2118,4693,15539,779,3844,2838,290,0,1766,42850,164,23849,21011,16318,13101
2022-02-22 18:00:00+00,11637,2185,4698,15415,953,3910,2837,507,0,1686,43828,170,23903,21066,16368,13822
2022-02-22 18:30:00+00,11523,2042,4692,15539,944,3912,2837,521,0,1636,43646,167,24012,21175,16483,13565
2022-02-22 19:00:00+00,10856,1901,4689,15830,926,3916,2838,443,0,1448,42847,160,24283,21445,16756,12757
2022-02-22 19:30:00+00,10541,1816,4687,15850,924,3904,2837,248,0,990,41797,158,24298,21461,16774,12357
2022-02-22 20:00:00+00,10608,1998,4684,15162,883,3358,2781,188,0,618,40280,164,23510,20729,16045,12606
2022-02-22 20:30:00+00,10156,1808,4682,15425,880,3304,2699,175,0,0,39129,159,23686,20987,16305,11964
2022-02-22 21:00:00+00,8588,1658,4677,15079,793,3400,2792,179,0,0,37166,150,23341,20549,15872,10246
2022-02-22 21:30:00+00,7166,1323,4681,14685,759,3417,2764,166,0,234,35195,133,22889,20125,15444,8489
2022-02-22 22:00:00+00,6043,683,4679,14387,760,3470,2818,167,0,64,33071,114,22644,19826,15147,6726
2022-02-22 22:30:00+00,4576,514,4682,14481,754,3380,2804,162,0,8,31361,96,22721,19917,15235,5090
2022-02-22 23:00:00+00,3249,598,4678,14187,746,3302,2724,157,0,0,29641,89,22335,19611,14933,3847
2022-02-22 23:30:00+00,2881,662,4680,13671,732,3360,2841,154,0,0,28981,90,21924,19083,14403,3543
2022-02-23 00:00:00+00,3214,775,4680,13538,731,3142,2847,290,0,0,29217,101,21796,18949,14269,3989
2022-02-23 00:30:00+00,3337,876,4683,13387,732,3346,2827,338,0,0,29526,108,21629,18802,14119,4213
2022-02-23 01:00:00+00,3340,958,4697,13433,731,3258,2819,361,0,0,29597,110,21680,18861,14164,4298
2022-02-23 01:30:00+00,3124,905,4690,13411,754,3238,2847,370,0,0,29339,106,21702,18855,14165,4029
2022-02-23 02:00:00+00,3346,973,4692,12990,784,3052,2849,390,0,0,29076,111,21315,18466,13774,4319
2022-02-23 02:30:00+00,3444,944,4690,13121,730,3048,2854,396,0,0,29227,111,21395,18541,13851,4388
2022-02-23 03:00:00+00,3167,942,4689,13153,727,2766,2904,366,0,0,28714,108,21473,18569,13880,4109
2022-02-23 03:30:00+00,3120,934,4690,13080,728,2762,2907,328,0,0,28549,107,21405,18498,13808,4054
2022-02-23 04:00:00+00,3378,982,4689,12972,733,2510,2906,276,0,0,28446,109,21300,18394,13705,4360
2022-02-23 04:30:00+00,3532,1198,4681,12797,732,2510,2906,191,0,0,28547,117,21116,18210,13529,4730
2022-02-23 05:00:00+00,2932,1254,4682,12665,733,2138,2907,152,0,0,27463,114,20987,18080,13398,4186
2022-02-23 05:30:00+00,3650,1313,4681,12870,734,2172,2902,157,0,50,28529,122,21187,18285,13604,4963
2022-02-23 06:00:00+00,5733,1663,4687,13094,733,2390,2904,157,0,158,31519,146,21418,18514,13827,7396
2022-02-23 06:30:00+00,7188,1812,4695,13311,740,2410,2902,249,0,422,33729,159,21648,18746,14051,9000
2022-02-23 07:00:00+00,7692,1931,4706,13585,773,3440,2902,342,31,610,36012,160,21997,19095,14389,9623
2022-02-23 07:30:00+00,8274,2267,4719,14167,1044,3586,2893,389,480,298,38117,167,23303,20410,15691,10541
2022-02-23 08:00:00+00,8666,2360,4724,14549,1046,3272,2895,397,1270,322,39501,165,24484,21589,16865,11026
2022-02-23 08:30:00+00,8723,2352,4737,14831,878,3358,2886,280,2092,282,40419,162,25424,22538,17801,11075
2022-02-23 09:00:00+00,8033,2226,4750,15286,869,4150,2851,211,2538,294,41208,152,26294,23442,18692,10259
2022-02-23 09:30:00+00,7302,2261,4760,15980,891,4062,2562,211,3407,52,41488,144,27600,25038,20278,9563
2022-02-23 10:00:00+00,8048,2347,4764,16553,877,3261,2465,219,4069,30,42633,147,28728,26263,21499,10395
2022-02-23 10:30:00+00,7467,2372,4766,16964,910,3370,2432,192,4167,200,42841,143,29239,26807,22041,9839
2022-02-23 11:00:00+00,7163,2047,4772,17122,886,3220,2523,182,4098,222,42235,133,29401,26878,22106,9210
2022-02-23 11:30:00+00,7245,1971,4771,17426,896,3226,2604,188,3890,0,42217,133,29587,26983,22212,9216
2022-02-23 12:00:00+00,6708,1967,4772,17506,767,3413,2755,187,2675,234,40984,131,28475,25720,20948,8675
2022-02-23 12:30:00+00,7035,1954,4773,17642,766,3466,2674,211,2553,94,41168,133,28408,25734,20961,8989
2022-02-23 13:00:00+00,6390,1966,4770,17840,737,3964,2667,174,2373,128,41009,128,28387,25720,20950,8356
2022-02-23 13:30:00+00,6225,1963,4768,17985,727,3961,2706,174,2012,30,40551,128,28198,25492,20724,8188
2022-02-23 14:00:00+00,6262,1968,4772,18015,893,4103,2744,165,1626,186,40735,129,28050,25306,20534,8230
2022-02-23 14:30:00+00,6597,1967,4770,18067,900,4084,2721,165,1526,0,40798,131,27984,25263,20493,8564
2022-02-23 15:00:00+00,6484,1960,4771,17871,758,3029,2867,179,1328,248,39495,134,27595,24728,19957,8444
2022-02-23 15:30:00+00,7092,1933,4771,17869,739,4188,2824,169,1180,224,40989,136,27383,24559,19788,9025
2022-02-23 16:00:00+00,7967,1959,4773,18073,760,4202,2900,248,869,92,41843,145,27375,24475,19702,9926
2022-02-23 16:30:00+00,8754,1961,4770,18278,735,4270,2906,250,351,336,42611,149,27040,24134,19364,10715
2022-02-23 17:00:00+00,9331,1961,4775,18195,735,4196,2906,266,51,1036,43451,149,26662,23756,18981,11292
2022-02-23 17:30:00+00,9997,1963,4777,18093,798,4181,2906,342,0,1692,44749,151,26574,23668,18891,11960
2022-02-23 18:00:00+00,10246,1968,4775,17842,888,3207,2903,435,0,1884,44148,155,26408,23505,18730,12214
2022-02-23 18:30:00+00,10426,1967,4775,17738,923,4287,2906,376,0,1342,44741,155,26342,23436,18661,12393
2022-02-23 19:00:00+00,10147,1965,4780,17815,937,2604,2849,313,0,488,41897,161,26381,23532,18752,12112
2022-02-23 19:30:00+00,9445,1957,4775,17779,953,4284,2740,276,0,0,42209,154,26247,23507,18732,11402
2022-02-23 20:00:00+00,8831,1921,4774,17859,1061,3346,2596,274,0,12,40674,151,26290,23694,18920,10752
2022-02-23 20:30:00+00,7970,1738,4769,17592,972,3323,2571,223,0,18,39177,143,25904,23333,18564,9708
2022-02-23 21:00:00+00,6684,1474,4763,17440,870,3505,2085,224,0,46,37091,131,25158,23073,18310,8158
2022-02-23 21:30:00+00,5418,1599,4763,16950,720,3551,2101,215,0,14,35331,128,24534,22433,17670,7017
2022-02-23 22:00:00+00,4863,1368,4765,16852,759,3460,2122,211,0,44,34444,119,24498,22376,17611,6231
2022-02-23 22:30:00+00,3468,1243,4768,17001,740,3358,1923,203,0,0,32704,103,24432,22509,17741,4711
2022-02-23 23:00:00+00,3180,1007,4767,16464,744,3228,1824,205,0,0,31419,95,23799,21975,17208,4187
2022-02-23 23:30:00+00,2677,923,4768,16329,747,3092,1851,204,0,0,30590,86,23695,21844,17076,3600
2022-02-24 00:00:00+00,2383,1118,4773,16254,748,3194,1963,203,0,0,30636,90,23738,21775,17002,3501
2022-02-24 00:30:00+00,2794,1146,4764,15859,750,3352,2093,210,0,0,30968,98,23466,21373,16609,3940
2022-02-24 01:00:00+00,2835,1200,4774,15751,746,3534,2068,202,0,0,31110,101,23339,21271,16497,4035
2022-02-24 01:30:00+00,2612,1226,4773,15398,741,3504,2113,208,0,0,30575,101,23025,20912,16139,3838
2022-02-24 02:00:00+00,2691,1250,4775,14546,738,3640,2117,209,0,0,29966,107,22176,20059,15284,3941
2022-02-24 02:30:00+00,3053,1294,4777,13869,739,3596,2174,213,0,0,29715,114,21559,19385,14608,4347
2022-02-24 03:00:00+00,3139,1304,4780,12800,738,3628,2146,301,0,0,28836,120,20464,18318,13538,4443
2022-02-24 03:30:00+00,3065,1332,4776,12592,737,3524,2145,338,0,0,28509,120,20250,18105,13329,4397
2022-02-24 04:00:00+00,2694,1344,4778,12482,753,3548,2002,338,0,0,27939,118,20015,18013,13235,4038
2022-02-24 04:30:00+00,2632,1323,4774,12305,754,3662,2032,202,0,0,27684,118,19865,17833,13059,3955
2022-02-24 05:00:00+00,2835,1370,4770,12908,753,3296,2227,203,0,0,28362,116,20658,18431,13661,4205
2022-02-24 05:30:00+00,3204,1384,4767,13324,754,3380,2261,202,0,0,29276,119,21106,18845,14078,4588
2022-02-24 06:00:00+00,4089,1451,4762,13511,794,3788,2479,209,0,268,31351,125,21546,19067,14305,5540
2022-02-24 06:30:00+00,5273,1693,4770,13775,947,3888,2740,300,0,134,33520,141,22232,19492,14722,6966
2022-02-24 07:00:00+00,6038,1885,4768,14139,995,4664,2790,550,2,132,35963,146,22694,19904,15136,7923
2022-02-24 07:30:00+00,6817,1966,4767,14045,997,4734,2798,706,56,440,37326,152,22663,19865,15098,8783
2022-02-24 08:00:00+00,6784,1974,4764,14005,997,5242,2798,810,255,1314,38943,146,22819,20021,15257,8758
2022-02-24 08:30:00+00,6974,1967,4770,13947,985,5752,2788,718,682,1518,40101,144,23172,20384,15614,8941
2022-02-24 09:00:00+00,7041,1961,4768,14347,980,5668,2867,858,1280,1542,41312,140,24242,21375,16607,9002
2022-02-24 09:30:00+00,6979,1945,4774,15155,977,5614,2892,734,1896,468,41434,137,25694,22802,18028,8924
2022-02-24 10:00:00+00,6482,1957,4774,15935,955,5600,2893,520,2906,396,42418,128,27463,24570,19796,8439
2022-02-24 10:30:00+00,5860,1941,4777,16347,956,5600,2859,415,3464,36,42255,121,28403,25544,20767,7801
2022-02-24 11:00:00+00,4835,1916,4774,17116,967,5600,2816,221,4861,0,43106,108,30534,27718,22944,6751
2022-02-24 11:30:00+00,4535,1952,4773,16982,977,5600,2813,167,5273,104,43176,105,30818,28005,23232,6487
2022-02-24 12:00:00+00,4049,1938,4772,17568,779,5600,2879,166,5675,14,43440,100,31673,28794,24022,5987
2022-02-24 12:30:00+00,3712,1588,4771,18099,734,5600,2721,170,5387,0,42782,90,31712,28991,24220,5300
2022-02-24 13:00:00+00,3492,1541,4768,18733,775,5026,2727,175,4993,0,42230,84,31996,29269,24501,5033
2022-02-24 13:30:00+00,3276,1799,4762,18718,788,4904,2766,179,5571,2,42765,86,32605,29839,25077,5075
2022-02-24 14:00:00+00,3730,1877,4766,18636,803,4266,2864,154,5036,0,42132,91,32105,29241,24475,5607
2022-02-24 14:30:00+00,4093,1870,4763,18489,786,4318,2873,148,3871,0,41211,97,30782,27909,23146,5963
2022-02-24 15:00:00+00,3929,1896,4766,18627,813,4712,2843,139,3472,28,41225,98,30521,27678,22912,5825
2022-02-24 15:30:00+00,4613,1958,4760,18673,805,4116,2870,146,2622,0,40563,109,29730,26860,22100,6571
2022-02-24 16:00:00+00,5867,1951,4764,18717,726,4254,2736,357,1751,54,41177,121,28694,25958,21194,7818
2022-02-24 16:30:00+00,7214,1912,4759,18595,866,4406,2812,473,818,312,42167,133,27850,25038,20279,9126
2022-02-24 17:00:00+00,8066,1748,4771,18439,865,4814,2721,508,119,1232,43283,137,26915,24194,19423,9814
2022-02-24 17:30:00+00,8284,1889,4760,18351,884,4952,2814,620,0,1592,44146,141,26809,23995,19235,10173
2022-02-24 18:00:00+00,8766,1973,4762,18225,882,4996,2834,657,0,1748,44843,145,26703,23869,19107,10739
2022-02-24 18:30:00+00,8613,1975,4760,17963,882,4944,2835,667,0,1790,44429,145,26440,23605,18845,10588
2022-02-24 19:00:00+00,8378,1963,4766,17896,911,5074,2828,574,0,1414,43804,145,26401,23573,18807,10341
2022-02-24 19:30:00+00,8334,1972,4767,17697,973,5056,2857,382,0,468,42506,148,26294,23437,18670,10306
2022-02-24 20:00:00+00,7330,1969,4765,17784,973,5000,2880,279,0,0,40980,143,26402,23522,18757,9299
2022-02-24 20:30:00+00,6409,1776,4766,17810,972,5064,2782,240,0,0,39819,133,26330,23548,18782,8185
2022-02-24 21:00:00+00,4977,1647,4762,17747,935,5102,2583,182,0,14,37949,121,26027,23444,18682,6624
2022-02-24 21:30:00+00,3741,1594,4765,17782,933,5104,2219,187,0,0,36326,111,25700,23480,18716,5335
2022-02-24 22:00:00+00,3210,1449,4766,17876,770,3924,2228,186,0,0,34409,104,25640,23412,18646,4659
2022-02-24 22:30:00+00,2608,1232,4765,17923,723,3648,2150,182,0,0,33231,92,25561,23411,18646,3840
2022-02-24 23:00:00+00,2665,1313,4768,17744,715,2810,2218,185,0,0,32418,93,25445,23227,18459,3978
2022-02-24 23:30:00+00,2597,1413,4772,17378,714,2654,2250,181,0,0,31959,94,25114,22864,18092,4010
2022-02-25 00:00:00+00,2025,1365,4776,17379,714,3224,2255,181,0,0,31919,91,25124,22869,18093,3390
2022-02-25 00:30:00+00,1924,1280,4769,17578,714,3418,2261,188,0,0,32132,89,25322,23061,18292,3204
2022-02-25 01:00:00+00,1848,1041,4771,17702,715,3312,2258,183,0,0,31830,81,25446,23188,18417,2889
2022-02-25 01:30:00+00,1848,912,4773,17709,717,3118,2157,181,0,0,31415,75,25356,23199,18426,2760
2022-02-25 02:00:00+00,1889,882,4771,17514,717,2976,2100,185,0,0,31034,74,25102,23002,18231,2771
2022-02-25 02:30:00+00,1922,771,4771,17435,737,2976,2084,184,0,0,30880,72,25027,22943,18172,2693
2022-02-25 03:00:00+00,1999,693,4772,17454,767,2652,2088,182,0,0,30607,68,25081,22993,18221,2692
2022-02-25 03:30:00+00,1933,762,4806,17136,814,2640,2144,182,0,0,30417,70,24900,22756,17950,2695
2022-02-25 04:00:00+00,2040,745,4802,17110,816,2648,2251,199,0,0,30611,71,24979,22728,17926,2785
2022-02-25 04:30:00+00,2148,828,4808,16852,815,2648,2261,183,0,0,30543,75,24736,22475,17667,2976
2022-02-25 05:00:00+00,2956,1205,4802,16179,815,2102,2263,190,0,0,30512,94,24059,21796,16994,4161
2022-02-25 05:30:00+00,3891,1477,4805,15803,970,2082,2259,187,0,0,31474,111,23837,21578,16773,5368
2022-02-25 06:00:00+00,4728,1720,4805,15498,1058,2562,2420,196,0,0,32987,127,23781,21361,16556,6448
2022-02-25 06:30:00+00,6854,1806,4846,14999,1061,2562,2718,186,0,14,35046,146,23624,20906,16060,8660
2022-02-25 07:00:00+00,9234,1850,4847,14274,1062,2834,2860,192,57,120,37330,162,23100,20240,15393,11084
2022-02-25 07:30:00+00,10396,1905,4849,13943,1061,2850,2904,251,637,162,38958,169,23394,20490,15641,12301
2022-02-25 08:00:00+00,10950,1579,4849,13549,1062,4028,2835,208,1769,134,40963,162,24064,21229,16380,12529
2022-02-25 08:30:00+00,11139,1507,4847,13196,1062,4074,2896,232,2993,0,41946,158,24994,22098,17251,12646
2022-02-25 09:00:00+00,11294,1706,4853,12377,1118,4374,2861,157,4115,0,42855,162,25324,22463,17610,13000
2022-02-25 09:30:00+00,11215,1731,4898,11557,1129,4388,2876,154,4967,0,42915,161,25427,22551,17653,12946
2022-02-25 10:00:00+00,11739,1621,4900,10795,971,3904,2738,168,5599,0,42435,165,25003,22265,17365,13360
2022-02-25 10:30:00+00,11730,1629,4901,10239,963,3876,2558,156,6028,0,42080,166,24689,22131,17230,13359
2022-02-25 11:00:00+00,11804,1767,4899,9915,952,3498,2561,167,6389,14,41966,170,24716,22155,17256,13571
2022-02-25 11:30:00+00,11910,1817,4898,9241,951,3520,2560,152,6612,0,41661,173,24262,21702,16804,13727
2022-02-25 12:00:00+00,11933,1713,4894,8514,977,4428,2560,150,6579,234,41982,171,23524,20964,16070,13646
2022-02-25 12:30:00+00,12209,1663,4902,8155,1102,4460,2512,136,6193,28,41360,174,22864,20352,15450,13872
2022-02-25 13:00:00+00,12003,1617,4903,7887,1101,4182,2550,138,5768,2,40151,177,22209,19659,14756,13620
2022-02-25 13:30:00+00,12298,1608,4893,7341,1101,4096,2563,142,5629,0,39671,181,21527,18964,14071,13906
2022-02-25 14:00:00+00,12441,1473,4893,6642,951,4632,2559,143,5340,0,39074,184,20385,17826,12933,13914
2022-02-25 14:30:00+00,12814,1293,4893,6250,949,4838,2558,153,4527,0,38275,189,19177,16619,11726,14107
2022-02-25 15:00:00+00,13296,1209,4884,5839,1115,4942,2573,157,3506,30,37551,197,17917,15344,10460,14505
2022-02-25 15:30:00+00,14159,1369,4912,5496,1116,4952,2581,174,2506,126,37391,212,16611,14030,9118,15528
2022-02-25 16:00:00+00,15289,1836,4912,5637,1084,4490,2692,163,1553,400,38056,228,15878,13186,8274,17125
2022-02-25 16:30:00+00,15685,1951,4966,5836,1060,4702,2860,227,756,984,39027,232,15478,12618,7652,17636
2022-02-25 17:00:00+00,15918,1973,4963,6054,1154,4876,2865,338,131,1502,39774,233,15167,12302,7339,17891
2022-02-25 17:30:00+00,16225,1974,4972,6404,1068,5028,2901,430,0,1992,40994,232,15345,12444,7472,18199
2022-02-25 18:00:00+00,16421,1971,4995,6682,1061,4794,2939,561,0,2212,41636,232,15678,12738,7744,18392
2022-02-25 18:30:00+00,16098,1970,4998,7285,1110,4792,2931,577,0,1826,41587,230,16324,13393,8395,18068
2022-02-25 19:00:00+00,15546,1972,4998,7850,1079,4778,2903,614,0,1304,41044,228,16830,13927,8929,17518
2022-02-25 19:30:00+00,15319,1970,4999,8037,1075,4704,2904,612,0,600,40220,229,17015,14111,9112,17289
2022-02-25 20:00:00+00,15504,1969,4999,8374,1046,3354,2904,606,0,176,38932,235,17323,14419,9420,17473
2022-02-25 20:30:00+00,14636,1926,4991,8420,939,3334,2905,269,0,220,37640,230,17255,14350,9359,16562
2022-02-25 21:00:00+00,14353,1733,4997,8199,808,2900,2908,156,0,54,36108,229,16912,14004,9007,16086
2022-02-25 21:30:00+00,13221,1349,5005,8449,831,2868,2866,155,0,40,34784,214,17151,14285,9280,14570
2022-02-25 22:00:00+00,12169,1009,5076,8726,767,2452,2554,142,0,92,32987,198,17123,14569,9493,13178
2022-02-25 22:30:00+00,11210,811,5097,8986,680,2508,1949,172,0,34,31447,189,16712,14763,9666,12021
2022-02-25 23:00:00+00,8414,553,5092,9232,670,4132,1617,194,0,0,29904,161,16611,14994,9902,8967
2022-02-25 23:30:00+00,7060,445,5098,9395,670,4182,1618,201,0,0,28669,146,16781,15163,10065,7505
2022-02-26 00:00:00+00,6519,236,5097,9472,665,4360,1618,220,0,0,28187,133,16852,15234,10137,6755
2022-02-26 00:30:00+00,6841,237,5104,9525,643,4360,1617,221,0,68,28616,135,16889,15272,10168,7078
2022-02-26 01:00:00+00,6678,243,5100,9399,623,4438,1615,225,0,0,28321,139,16737,15122,10022,6921
2022-02-26 01:30:00+00,6141,234,5104,9206,618,4444,1614,216,0,0,27577,135,16542,14928,9824,6375
2022-02-26 02:00:00+00,6366,239,5104,8996,602,4038,1615,157,0,0,27117,140,16317,14702,9598,6605
2022-02-26 02:30:00+00,6332,240,5106,8758,608,4022,1614,139,0,0,26819,140,16086,14472,9366,6572
2022-02-26 03:00:00+00,6563,318,5103,8688,611,3218,1617,141,0,0,26259,144,16019,14402,9299,6881
2022-02-26 03:30:00+00,6331,239,5107,8702,622,3208,1618,134,0,0,25961,139,16049,14431,9324,6570
2022-02-26 04:00:00+00,6740,331,5102,8992,617,2406,1618,136,0,0,25942,142,16329,14711,9609,7071
2022-02-26 04:30:00+00,6582,393,5102,9103,606,2374,1617,136,0,0,25913,142,16428,14811,9709,6975
2022-02-26 05:00:00+00,6790,387,5106,9522,604,2166,1617,136,0,0,26328,141,16849,15232,10126,7177
2022-02-26 05:30:00+00,6755,387,5104,10021,592,2166,1618,137,0,0,26780,138,17335,15717,10613,7142
2022-02-26 06:00:00+00,6884,570,5103,10367,590,1934,1617,137,0,0,27202,143,17677,16060,10957,7454
2022-02-26 06:30:00+00,7009,870,5105,10842,600,1926,1617,137,0,0,28106,150,18164,16547,11442,7879
2022-02-26 07:00:00+00,6937,978,5097,11304,611,2778,1617,152,98,0,29572,152,18727,17110,12013,7915
2022-02-26 07:30:00+00,7376,978,5102,11351,625,2870,1617,148,771,90,30928,152,19466,17849,12747,8354
2022-02-26 08:00:00+00,8037,979,5100,11533,611,3086,1617,150,1907,16,33036,151,20768,19151,14051,9016
2022-02-26 08:30:00+00,7709,979,5104,11926,611,3086,1617,143,3070,32,34277,141,22328,20711,15607,8688
2022-02-26 09:00:00+00,7127,979,5103,12354,611,3596,1617,158,4005,50,35600,131,23690,22073,16970,8106
2022-02-26 09:30:00+00,6545,977,5107,12562,611,3574,1617,148,4949,0,36090,123,24846,23229,18122,7522
2022-02-26 10:00:00+00,6404,978,5115,12839,599,2958,1617,151,5459,18,36138,117,25629,24012,18897,7382
2022-02-26 10:30:00+00,5393,956,5155,13441,633,2898,1617,142,5629,0,35864,105,26475,24858,19703,6349
2022-02-26 11:00:00+00,4146,806,5153,13778,636,4060,1582,140,5787,0,36088,94,26936,25354,20201,4952
2022-02-26 11:30:00+00,3279,913,5155,14206,634,4030,1568,138,6119,0,36042,86,27682,26114,20959,4192
2022-02-26 12:00:00+00,3806,792,5150,14318,624,3414,1507,138,6478,0,36227,87,28077,26570,21420,4598
2022-02-26 12:30:00+00,3512,789,5168,14293,629,3328,1469,144,6579,0,35911,84,28138,26669,21501,4301
2022-02-26 13:00:00+00,3273,778,5176,14439,668,3268,1270,141,6742,0,35755,79,28295,27025,21849,4051
2022-02-26 13:30:00+00,3053,702,5168,14431,695,3262,1267,153,6038,0,34769,77,27599,26332,21164,3755
2022-02-26 14:00:00+00,3915,803,5168,14166,695,2882,1370,164,5325,0,34488,90,26724,25354,20186,4718
2022-02-26 14:30:00+00,4241,792,5170,14043,694,2986,1571,142,4767,0,34406,95,26245,24674,19504,5033
2022-02-26 15:00:00+00,5442,964,5166,14153,797,2076,1591,150,3809,0,34148,109,25516,23925,18759,6406
2022-02-26 15:30:00+00,6105,977,5165,14225,794,2092,1618,192,2909,36,34113,117,24711,23093,17928,7082
2022-02-26 16:00:00+00,7061,950,5172,14385,860,2058,1618,399,1884,22,34409,125,23919,22301,17129,8011
2022-02-26 16:30:00+00,7768,970,5189,14533,829,2182,1615,480,922,276,34764,135,23088,21473,16284,8738
2022-02-26 17:00:00+00,7468,975,5196,14501,814,4084,1539,213,205,1272,36267,132,22255,20716,15520,8443
2022-02-26 17:30:00+00,8197,970,5201,14856,814,4284,1600,232,0,1692,37846,136,22471,20871,15670,9167
2022-02-26 18:00:00+00,8743,974,5202,15217,768,4032,1615,276,0,1814,38641,139,22802,21187,15985,9717
2022-02-26 18:30:00+00,8684,962,5208,15460,697,3950,1609,266,0,1538,38374,138,22974,21365,16157,9646
2022-02-26 19:00:00+00,8487,974,5205,15635,700,4156,1614,273,0,268,37312,142,23154,21540,16335,9461
2022-02-26 19:30:00+00,7446,978,5205,15860,701,4150,1618,288,0,42,36288,134,23384,21766,16561,8424
2022-02-26 20:00:00+00,6233,982,5204,15870,686,4368,1620,259,0,176,35398,124,23380,21760,16556,7215
2022-02-26 20:30:00+00,5334,919,5203,16091,650,4358,1567,213,0,10,34345,116,23511,21944,16741,6253
2022-02-26 21:00:00+00,4633,972,5202,15951,650,3690,1600,153,0,28,32879,111,23403,21803,16601,5605
2022-02-26 21:30:00+00,3758,918,5211,15994,637,3678,1622,157,0,0,31975,102,23464,21842,16631,4676
2022-02-26 22:00:00+00,2791,799,5224,16008,623,3306,1622,151,0,0,30524,92,23477,21855,16631,3590
2022-02-26 22:30:00+00,2455,622,5248,15809,621,3234,1474,139,0,0,29602,84,23152,21678,16430,3077
2022-02-26 23:00:00+00,2526,641,5290,15633,612,3202,1390,140,0,0,29434,85,22925,21535,16245,3167
2022-02-26 23:30:00+00,2389,586,5302,15591,609,3054,1437,139,0,0,29107,80,22939,21502,16200,2975
2022-02-27 00:00:00+00,2445,330,5310,15527,605,3022,1468,139,0,0,28846,70,22910,21442,16132,2775
2022-02-27 00:30:00+00,2807,384,5310,15574,604,2956,1535,138,0,0,29308,75,23023,21488,16178,3191
2022-02-27 01:00:00+00,2760,386,5318,15566,604,2912,1472,139,0,0,29157,71,22960,21488,16170,3146
2022-02-27 01:30:00+00,2494,311,5339,15551,603,2744,1305,139,0,0,28486,63,22798,21493,16154,2805
2022-02-27 02:00:00+00,2416,241,5362,15668,617,2854,1286,147,0,0,28591,60,22933,21647,16285,2657
2022-02-27 02:30:00+00,2377,233,5370,15823,624,2854,1278,143,0,0,28702,59,23095,21817,16447,2610
2022-02-27 03:00:00+00,2484,243,5381,15040,598,2746,1292,145,0,0,27929,61,22311,21019,15638,2727
2022-02-27 03:30:00+00,2489,247,5390,14509,580,2738,1298,143,0,0,27394,63,21777,20479,15089,2736
2022-02-27 04:00:00+00,2593,249,5426,14494,581,2378,1364,144,0,0,27229,62,21865,20501,15075,2842
2022-02-27 04:30:00+00,2431,245,5453,14803,592,2378,1294,141,0,0,27337,59,22142,20848,15395,2676
2022-02-27 05:00:00+00,2354,231,5450,14951,587,2588,1279,136,0,0,27576,57,22267,20988,15538,2585
2022-02-27 05:30:00+00,2455,240,5441,14734,587,2592,1284,143,0,0,27476,60,22046,20762,15321,2695
2022-02-27 06:00:00+00,2320,244,5441,14979,588,2830,1295,144,0,0,27841,60,22303,21008,15567,2564
2022-02-27 06:30:00+00,2386,317,5438,15078,587,2852,1281,138,0,0,28077,63,22384,21103,15665,2703
2022-02-27 07:00:00+00,2448,253,5433,14930,618,3344,1302,143,104,0,28575,63,22387,21085,15652,2701
2022-02-27 07:30:00+00,2702,256,5449,14917,650,3404,1330,145,849,0,29702,64,23195,21865,16416,2958
2022-02-27 08:00:00+00,2739,255,5444,14789,672,4484,1330,147,2153,0,32013,62,24388,23058,17614,2994
2022-02-27 08:30:00+00,2798,236,5450,15143,705,4522,1276,139,3414,0,33683,59,25988,24712,19262,3034
2022-02-27 09:00:00+00,2901,242,5446,15246,634,4596,1330,141,4490,0,35026,58,27146,25816,20370,3143
2022-02-27 09:30:00+00,2949,241,5463,15242,583,4590,1318,139,5504,0,36029,57,28110,26792,21329,3190
2022-02-27 10:00:00+00,2869,248,5502,15256,588,4166,1292,139,6372,0,36432,55,29010,27718,22216,3117
2022-02-27 10:30:00+00,2246,303,5518,15393,617,4156,1295,138,7132,0,36798,49,29955,28660,23142,2549
2022-02-27 11:00:00+00,1763,234,5523,15319,629,4312,1283,136,7722,0,36921,42,30476,29193,23670,1997
2022-02-27 11:30:00+00,1761,230,5535,14716,669,4316,1276,136,8103,0,36742,42,30299,29023,23488,1991
2022-02-27 12:00:00+00,1689,231,5530,14340,625,4470,1278,136,8207,0,36506,42,29980,28702,23172,1920
2022-02-27 12:30:00+00,1737,229,5536,14083,598,4514,1275,136,8126,0,36234,43,29618,28343,22807,1966
2022-02-27 13:00:00+00,1843,235,5534,14990,555,3174,1280,147,7822,0,35580,45,30181,28901,23367,2078
2022-02-27 13:30:00+00,1788,229,5533,15395,559,3152,1271,135,7282,0,35344,44,30040,28769,23236,2017
2022-02-27 14:00:00+00,2056,261,5528,15492,563,2738,1307,163,6468,240,34816,48,29358,28051,22523,2317
2022-02-27 14:30:00+00,2434,446,5546,15468,575,2844,1380,141,5596,2,34432,60,28565,27185,21639,2880
2022-02-27 15:00:00+00,3216,356,5554,15359,595,3052,1505,154,4587,0,34378,68,27600,26095,20541,3572
2022-02-27 15:30:00+00,4508,394,5556,15503,609,3006,1504,154,3516,90,34840,81,26688,25184,19628,4902
2022-02-27 16:00:00+00,5590,544,5558,15593,663,3664,1360,162,2283,140,35557,95,25457,24097,18539,6134
2022-02-27 16:30:00+00,6777,774,5552,15435,668,3922,1455,190,1066,474,36313,115,24176,22721,17169,7551
2022-02-27 17:00:00+00,7490,962,5555,15348,685,4218,1618,199,197,1424,37696,127,23403,21785,16230,8452
2022-02-27 17:30:00+00,7994,974,5561,15663,680,4294,1622,504,0,1770,39062,132,23526,21904,16343,8968
2022-02-27 18:00:00+00,8283,972,5594,15817,679,4152,1622,629,0,1816,39564,133,23712,22090,16496,9255
2022-02-27 18:30:00+00,8296,974,5614,15963,679,4046,1618,628,0,1792,39610,132,23874,22256,16642,9270
2022-02-27 19:00:00+00,7822,979,5619,16224,679,4542,1617,315,0,1026,38823,128,24139,22522,16903,8801
2022-02-27 19:30:00+00,7466,977,5619,16229,664,4510,1621,216,0,550,37852,126,24133,22512,16893,8443
2022-02-27 20:00:00+00,7618,977,5621,16195,606,3588,1622,178,0,602,37007,131,24044,22422,16801,8595
2022-02-27 20:30:00+00,6942,951,5616,15944,578,3594,1621,162,0,334,35742,128,23759,22138,16522,7893
2022-02-27 21:00:00+00,5475,937,5624,15722,568,3806,1611,144,0,28,33915,118,23525,21914,16290,6412
2022-02-27 21:30:00+00,4080,797,5622,15575,567,3802,1536,147,0,10,32136,103,23300,21764,16142,4877
2022-02-27 22:00:00+00,3891,705,5615,15449,552,3436,1611,137,0,140,31536,100,23227,21616,16001,4596
2022-02-27 22:30:00+00,3024,841,5619,15529,551,3406,1602,134,0,0,30706,95,23301,21699,16080,3865
2022-02-27 23:00:00+00,2527,862,5615,15410,552,2782,1534,137,0,0,29419,87,23111,21577,15962,3389
2022-02-27 23:30:00+00,2584,763,5614,15206,549,2512,1579,134,0,0,28941,82,22948,21369,15755,3347
2022-02-28 00:00:00+00,2234,768,5617,15094,535,2704,1569,133,0,0,28654,81,22815,21246,15629,3002
2022-02-28 00:30:00+00,2680,883,5611,14894,537,2736,1619,136,0,0,29096,90,22661,21042,15431,3563
2022-02-28 01:00:00+00,2786,978,5640,14803,539,2798,1624,134,0,0,29302,95,22606,20982,15342,3764
2022-02-28 01:30:00+00,2513,978,5686,14830,540,2522,1582,133,0,0,28784,89,22638,21056,15370,3491
2022-02-28 02:00:00+00,2628,976,5729,14816,532,1856,1616,134,0,0,28287,87,22693,21077,15348,3604
2022-02-28 02:30:00+00,2735,974,5757,14628,524,1650,1579,133,0,0,27980,87,22488,20909,15152,3709
2022-02-28 03:00:00+00,2873,941,5760,14773,524,1082,1531,133,0,0,27617,82,22588,21057,15297,3814
2022-02-28 03:30:00+00,2926,767,5758,15115,523,1084,1390,134,0,0,27697,76,22786,21396,15638,3693
2022-02-28 04:00:00+00,3240,636,5804,15160,524,1038,1387,149,0,0,27939,75,22876,21488,15684,3876
2022-02-28 04:30:00+00,3595,600,5816,15140,523,1048,1570,136,0,0,28428,78,23049,21479,15663,4195
2022-02-28 05:00:00+00,4390,658,5810,14956,564,1048,1758,147,0,0,29330,89,23088,21330,15520,5048
2022-02-28 05:30:00+00,5333,830,5811,14484,575,1068,2037,142,0,22,30302,105,22907,20870,15059,6163
2022-02-28 06:00:00+00,6693,1165,5807,14144,593,1048,2312,146,0,382,32289,126,22856,20544,14737,7858
2022-02-28 06:30:00+00,7894,1384,5813,14323,593,1048,2637,141,0,132,33965,140,23366,20729,14916,9278
2022-02-28 07:00:00+00,8982,1358,5807,14605,593,1048,2871,145,41,150,35600,146,23917,21046,15239,10340
2022-02-28 07:30:00+00,9640,1397,5799,14510,609,1048,2915,155,188,260,36521,151,24021,21106,15307,11037
2022-02-28 08:00:00+00,10112,1444,5805,14698,596,1962,2902,136,490,208,38353,154,24491,21589,15784,11556
2022-02-28 08:30:00+00,10432,1468,5798,14500,621,2618,2842,145,778,176,39378,159,24539,21697,15899,11900
2022-02-28 09:00:00+00,10696,1468,5799,14135,602,3320,2873,143,1244,414,40694,158,24653,21780,15981,12164
2022-02-28 09:30:00+00,10860,1458,5804,14020,605,3416,2840,135,1787,316,41241,158,25056,22216,16412,12318
2022-02-28 10:00:00+00,11022,1383,5794,13629,618,3564,2849,138,2161,76,41234,158,25051,22202,16408,12405
2022-02-28 10:30:00+00,11150,1372,5792,13524,610,3854,2910,139,2386,0,41737,157,25222,22312,16520,12522
2022-02-28 11:00:00+00,11325,1315,5823,13287,592,4514,2848,147,2147,0,41998,158,24697,21849,16026,12640
2022-02-28 11:30:00+00,11394,1276,5839,13046,591,4544,2832,139,1957,0,41619,159,24265,21433,15594,12670
2022-02-28 12:00:00+00,11476,1358,5842,12801,595,4426,2889,148,1796,124,41455,162,23923,21034,15192,12834
2022-02-28 12:30:00+00,11447,1459,5849,12353,612,4446,2914,144,1785,152,41161,166,23513,20599,14750,12906
2022-02-28 13:00:00+00,11507,1434,5848,11948,672,5166,2914,144,1463,218,41314,166,22845,19931,14083,12941
2022-02-28 13:30:00+00,11912,1311,5848,11383,696,5190,2910,137,1327,168,40882,169,22164,19254,13406,13223
2022-02-28 14:00:00+00,12033,1168,5850,11451,705,5492,2927,140,1134,0,40900,167,22067,19140,13290,13201
2022-02-28 14:30:00+00,12208,1182,5851,11660,663,5276,2920,143,827,0,40730,170,21921,19001,13150,13390
2022-02-28 15:00:00+00,13893,1246,5856,11657,746,3668,2912,162,588,0,40728,185,21759,18847,12991,15139
2022-02-28 15:30:00+00,14583,1363,5851,11223,749,3658,2914,194,375,0,40910,194,21112,18198,12347,15946
2022-02-28 16:00:00+00,15601,1466,5867,10580,699,3880,2913,269,188,118,41581,203,20247,17334,11467,17067
2022-02-28 16:30:00+00,16131,1464,5880,10342,810,3840,2912,311,76,676,42442,204,20020,17108,11228,17595
2022-02-28 17:00:00+00,16170,1456,5879,10346,865,4234,2912,527,19,1228,43636,201,20021,17109,11230,17626
2022-02-28 17:30:00+00,15924,1463,5881,10237,867,4240,2914,772,0,1822,44120,198,19899,16985,11104,17387
2022-02-28 18:00:00+00,16447,1466,5879,9831,884,4122,2917,825,0,2054,44425,201,19511,16594,10715,17913
2022-02-28 18:30:00+00,16348,1464,5878,9824,869,4128,2913,812,0,1974,44210,201,19484,16571,10693,17812
2022-02-28 19:00:00+00,16294,1463,5883,9706,869,3836,2913,793,0,1076,42833,207,19371,16458,10575,17757
2022-02-28 19:30:00+00,16153,1469,5881,9692,754,3822,2916,619,0,458,41764,210,19243,16327,10446,17622
2022-02-28 20:00:00+00,15710,1461,5885,9624,675,3084,2911,515,0,328,40193,211,19095,16184,10299,17171
2022-02-28 20:30:00+00,14845,1471,5883,9382,719,3052,2918,375,0,150,38795,209,18902,15984,10101,16316
2022-02-28 21:00:00+00,14089,1477,5883,8984,755,2931,2918,291,0,172,37500,208,18540,15622,9739,15566
2022-02-28 21:30:00+00,13156,1348,5880,8323,748,2886,2917,243,0,332,35833,204,17868,14951,9071,14504
2022-02-28 22:00:00+00,13067,901,5880,7804,686,2160,2917,173,0,254,33842,199,17287,14370,8490,13968
2022-02-28 22:30:00+00,12413,409,5878,7392,702,2162,2916,162,0,134,32168,187,16888,13972,8094,12822
2022-02-28 23:00:00+00,11120,36,5880,7097,672,2888,2915,155,0,180,30943,169,16564,13649,7769,11156
2022-02-28 23:30:00+00,10406,0,5880,6875,703,2976,2898,156,0,0,29894,165,16356,13458,7578,10406
2022-03-01 00:00:00+00,9960,0,5880,6590,721,3102,2510,156,0,0,28919,169,15701,13191,7311,9960
2022-03-01 00:30:00+00,10448,0,5883,6625,728,3024,2671,157,0,0,29536,171,15907,13236,7353,10448
2022-03-01 01:00:00+00,10324,0,5896,6699,716,2658,2651,153,0,0,29097,164,15962,13311,7415,10324
2022-03-01 01:30:00+00,10338,0,5895,6052,719,2624,2730,153,0,0,28511,167,15396,12666,6771,10338
2022-03-01 02:00:00+00,10555,0,5896,5925,751,2290,2899,147,0,0,28463,165,15471,12572,6676,10555
2022-03-01 02:30:00+00,10403,0,5881,5662,783,2288,2916,147,0,0,28080,166,15242,12326,6445,10403
2022-03-01 03:00:00+00,10160,0,5885,5538,750,2312,2917,142,0,0,27704,164,15090,12173,6288,10160
2022-03-01 03:30:00+00,10055,0,5884,5434,739,2312,2916,134,0,0,27474,164,14973,12057,6173,10055
2022-03-01 04:00:00+00,10370,104,5884,5241,751,2046,2917,137,0,0,27450,173,14793,11876,5992,10474
2022-03-01 04:30:00+00,10082,369,5894,5252,754,2078,2913,134,0,0,27476,179,14813,11900,6006,10451
2022-03-01 05:00:00+00,11409,605,5892,5334,772,1486,2906,144,0,0,28548,198,14904,11998,6106,12014
2022-03-01 05:30:00+00,12156,806,5895,5240,771,1486,2823,135,0,0,29312,209,14729,11906,6011,12962
2022-03-01 06:00:00+00,13863,1064,5888,5180,863,1760,2632,160,0,66,31476,226,14563,11931,6043,14927
2022-03-01 06:30:00+00,16180,1347,5887,5185,858,1762,2888,185,0,36,34328,242,14818,11930,6043,17527
2022-03-01 07:00:00+00,17349,1473,5878,5252,895,1832,2913,384,46,454,36476,245,14984,12071,6193,18822
2022-03-01 07:30:00+00,17976,1480,5885,5090,1082,1836,2903,817,278,502,37849,246,15238,12335,6450,19456
2022-03-01 08:00:00+00,17664,1480,5878,4851,907,3564,2900,571,705,688,39208,238,15241,12341,6463,19144
2022-03-01 08:30:00+00,17636,1478,5879,4807,880,3706,2915,656,1285,678,39920,234,15766,12851,6972,19114
2022-03-01 09:00:00+00,17825,1480,5876,4749,858,4388,2913,530,1753,392,40764,235,16149,13236,7360,19305
2022-03-01 09:30:00+00,17927,1479,5880,4655,827,4392,2913,482,2156,534,41245,233,16431,13518,7638,19406
2022-03-01 10:00:00+00,17881,1478,5881,4544,826,5096,2912,314,2706,60,41698,231,16869,13957,8076,19359
2022-03-01 10:30:00+00,17793,1480,5878,4609,855,5498,2911,256,3009,0,42289,227,17262,14351,8473,19273
2022-03-01 11:00:00+00,17832,1478,5883,4578,872,5454,2913,235,3139,0,42384,227,17385,14472,8589,19310
2022-03-01 11:30:00+00,17731,1433,5875,4412,872,5456,2915,241,3204,0,42139,226,17278,14363,8488,19164
2022-03-01 12:00:00+00,18037,1231,5879,4369,886,5540,2911,240,3080,0,42173,224,17125,14214,8335,19268
2022-03-01 12:30:00+00,18137,1229,5879,4193,873,5538,2903,237,3000,0,41989,226,16848,13945,8066,19366
2022-03-01 13:00:00+00,18113,1229,5885,4137,874,5112,2811,308,2784,108,41361,229,16491,13680,7795,19342
2022-03-01 13:30:00+00,18075,1299,5884,4062,868,4658,2806,353,2486,0,40491,235,16106,13300,7416,19374
2022-03-01 14:00:00+00,17856,1350,5883,4114,851,4586,2812,281,2223,0,39956,237,15883,13071,7188,19206
2022-03-01 14:30:00+00,18147,1263,5872,4042,827,4602,2816,284,1801,14,39668,239,15358,12542,6670,19410
2022-03-01 15:00:00+00,17890,1449,5879,4103,853,4826,2891,279,1407,30,39607,242,15133,12242,6363,19339
2022-03-01 15:30:00+00,18326,1476,5875,4052,898,4838,2915,348,987,130,39845,248,14727,11812,5937,19802
2022-03-01 16:00:00+00,18495,1468,5882,3943,1034,4572,2914,564,647,820,40339,246,14420,11506,5624,19963
2022-03-01 16:30:00+00,18562,1472,5877,4176,1042,4558,2916,600,316,1118,40637,245,14327,11411,5534,20034
2022-03-01 17:00:00+00,18704,1462,5883,4450,1040,4442,2906,717,81,1832,41517,241,14360,11454,5571,20166
2022-03-01 17:30:00+00,18702,1468,5884,4849,1106,4444,2913,997,0,2118,42481,239,14752,11839,5955,20170
2022-03-01 18:00:00+00,18714,1466,5882,5204,1112,4578,2893,1007,0,2182,43038,236,15091,12198,6316,20180
2022-03-01 18:30:00+00,18146,1468,5884,5640,1108,4584,2914,985,0,2180,42909,232,15546,12632,6748,19614
2022-03-01 19:00:00+00,18026,1468,5882,6042,1091,4608,2908,904,0,1394,42323,233,15923,13015,7133,19494
2022-03-01 19:30:00+00,17672,1456,5892,6543,1038,4622,2915,556,0,256,40950,234,16388,13473,7581,19128
2022-03-01 20:00:00+00,17579,1468,5888,6861,1000,3240,2914,415,0,176,39541,241,16663,13749,7861,19047
2022-03-01 20:30:00+00,16134,1470,5890,7085,891,3336,2909,252,0,146,38113,235,16775,13866,7976,17604
2022-03-01 21:00:00+00,14898,1466,5897,7299,863,3062,2890,213,0,36,36624,230,16949,14059,8162,16364
2022-03-01 21:30:00+00,13384,1346,5899,7504,864,3054,2452,210,0,0,34713,221,16719,14267,8368,14730
2022-03-01 22:00:00+00,11847,890,5880,7828,858,3476,2281,222,0,0,33282,202,16847,14566,8686,12737
2022-03-01 22:30:00+00,10476,414,5870,8011,857,3406,2459,212,0,0,31705,180,17197,14738,8868,10890
2022-03-01 23:00:00+00,8996,40,5874,8315,841,2804,2198,209,0,0,29277,155,17228,15030,9156,9036
2022-03-01 23:30:00+00,7993,0,5878,8374,833,2664,2187,222,0,0,28151,144,17272,15085,9207,7993
2022-03-02 00:00:00+00,7466,0,5878,8882,753,2492,2302,199,0,0,27972,137,17815,15513,9635,7466
2022-03-02 00:30:00+00,7519,0,5876,9154,740,2532,2075,219,0,0,28115,137,17845,15770,9894,7519
2022-03-02 01:00:00+00,6966,0,5877,9493,744,3046,1991,212,0,0,28329,131,18105,16114,10237,6966
2022-03-02 01:30:00+00,6723,0,5877,9845,742,2974,2142,228,0,0,28531,127,18606,16464,10587,6723
2022-03-02 02:00:00+00,6573,0,5879,10038,737,2822,2303,213,0,0,28565,126,18957,16654,10775,6573
2022-03-02 02:30:00+00,6322,0,5878,10156,735,2798,2249,221,0,0,28359,122,19018,16769,10891,6322
2022-03-02 03:00:00+00,6844,0,5881,10297,734,2174,2302,279,0,0,28511,126,19214,16912,11031,6844
2022-03-02 03:30:00+00,6433,0,5876,10184,733,2150,2571,273,0,0,28220,122,19364,16793,10917,6433
2022-03-02 04:00:00+00,7524,0,5880,10024,734,1930,2680,210,0,0,28982,130,19318,16638,10758,7524
2022-03-02 04:30:00+00,7520,0,5884,10085,738,1874,2818,159,0,0,29078,128,19525,16707,10823,7520
2022-03-02 05:00:00+00,7601,0,5881,10267,747,1708,2917,167,0,0,29288,126,19812,16895,11014,7601
2022-03-02 05:30:00+00,8600,198,5883,10330,705,1788,2915,165,0,0,30584,141,19833,16918,11035,8798
2022-03-02 06:00:00+00,10849,421,5879,10374,820,1672,2793,344,0,34,33186,163,19866,17073,11194,11270
2022-03-02 06:30:00+00,13024,671,5884,10577,850,1722,2910,395,0,0,36033,181,20221,17311,11427,13695
2022-03-02 07:00:00+00,14162,907,5877,10724,848,2174,2915,441,9,146,38203,195,20373,17458,11581,15069
2022-03-02 07:30:00+00,14579,1126,5881,11082,841,2284,2895,518,74,148,39428,200,20773,17878,11997,15705
2022-03-02 08:00:00+00,14591,1356,5876,11229,833,2496,2818,336,181,300,40016,201,20937,18119,12243,15947
2022-03-02 08:30:00+00,15135,1472,5879,11627,804,2432,2832,317,331,60,40889,204,21473,18641,12762,16607
2022-03-02 09:00:00+00,14732,1475,5876,11982,785,3052,2832,314,498,248,41794,197,21973,19141,13265,16207
2022-03-02 09:30:00+00,14978,1476,5879,12404,754,3084,2908,318,622,10,42433,197,22567,19659,13780,16454
2022-03-02 10:00:00+00,14632,1476,5876,12730,736,3926,2913,339,745,170,43543,191,23000,20087,14211,16108
2022-03-02 10:30:00+00,14720,1457,5884,13026,732,3962,2914,443,930,32,44100,189,23486,20572,14688,16177
2022-03-02 11:00:00+00,14627,1465,5880,13048,708,4196,2915,343,1005,0,44187,187,23556,20641,14761,16092
2022-03-02 11:30:00+00,14594,1466,5886,13235,693,4212,2915,315,1075,0,44391,186,23804,20889,15003,16060
2022-03-02 12:00:00+00,14506,1471,5883,13291,730,4272,2917,316,1206,0,44592,185,24027,21110,15227,15977
2022-03-02 12:30:00+00,14391,1475,5884,13356,782,4276,2917,316,1342,0,44739,183,24281,21364,15480,15866
2022-03-02 13:00:00+00,13982,1475,5884,13596,699,4340,2915,325,1371,0,44587,181,24465,21550,15666,15457
2022-03-02 13:30:00+00,13687,1472,5885,13612,669,4340,2914,296,1254,0,44129,180,24334,21420,15535,15159
2022-03-02 14:00:00+00,14248,1475,5885,13381,672,3490,2914,171,1092,0,43328,186,23944,21030,15145,15723
2022-03-02 14:30:00+00,13985,1475,5884,13465,672,3438,2916,165,818,0,42818,185,23755,20839,14955,15460
2022-03-02 15:00:00+00,14451,1458,5878,13432,674,2534,2917,193,633,0,42170,190,23534,20617,14739,15909
2022-03-02 15:30:00+00,15325,1465,5872,13402,662,2562,2916,214,515,86,43019,195,23367,20451,14579,16790
2022-03-02 16:00:00+00,16084,1474,5875,13374,705,2462,2908,203,298,166,43549,201,23160,20252,14377,17558
2022-03-02 16:30:00+00,16509,1477,5876,13399,680,2488,2907,230,119,202,43887,203,22981,20074,14198,17986
2022-03-02 17:00:00+00,17001,1477,5871,13176,710,2188,2918,598,26,1306,45271,202,22701,19783,13912,18478
2022-03-02 17:30:00+00,17153,1477,5874,13220,855,2312,2914,630,0,1352,45787,203,22863,19949,14075,18630
2022-03-02 18:00:00+00,17076,1478,5868,13251,841,2594,2917,620,0,1330,45975,202,22877,19960,14092,18554
2022-03-02 18:30:00+00,16698,1479,5867,13130,847,2504,2915,633,0,1084,45157,201,22759,19844,13977,18177
2022-03-02 19:00:00+00,16458,1482,5869,13099,762,2318,2916,375,0,396,43675,203,22646,19730,13861,17940
2022-03-02 19:30:00+00,16192,1480,5873,12868,669,2252,2917,235,0,0,42486,204,22327,19410,13537,17672
2022-03-02 20:00:00+00,15120,1479,5871,12658,669,2156,2915,233,0,328,41429,199,22113,19198,13327,16599
2022-03-02 20:30:00+00,13773,1480,5877,12553,650,2148,2915,173,0,18,39587,194,21995,19080,13203,15253
2022-03-02 21:00:00+00,12547,1479,5874,12379,606,2156,2916,173,0,82,38212,188,21775,18859,12985,14026
2022-03-02 21:30:00+00,10806,1480,5876,12367,602,2142,2915,179,0,34,36401,179,21760,18845,12969,12286
2022-03-02 22:00:00+00,9328,1355,5875,12268,584,1980,2857,179,0,0,34426,167,21584,18727,12852,10683
2022-03-02 22:30:00+00,8374,1201,5874,11965,578,1940,2687,185,0,0,32804,158,21104,18417,12543,9575
2022-03-02 23:00:00+00,7282,1051,5893,12012,522,1708,2660,165,0,0,31293,144,21087,18427,12534,8333
2022-03-02 23:30:00+00,6848,1007,5912,11996,491,1624,2593,164,0,0,30635,139,20992,18399,12487,7855
2022-03-03 00:00:00+00,6515,1269,5913,11987,469,1640,2722,164,0,0,30679,144,21091,18369,12456,7784
2022-03-03 00:30:00+00,6756,1358,5905,11758,468,1786,2732,169,0,0,30932,151,20863,18131,12226,8114
2022-03-03 01:00:00+00,6732,998,5908,11669,466,2364,2843,169,0,0,31149,143,20886,18043,12135,7730
2022-03-03 01:30:00+00,6512,1005,5903,11499,461,2240,2860,169,0,0,30649,141,20723,17863,11960,7517
2022-03-03 02:00:00+00,6180,959,5902,11577,472,2060,2592,169,0,0,29911,133,20543,17951,12049,7139
2022-03-03 02:30:00+00,6051,959,5902,11348,469,1972,2654,170,0,0,29525,132,20373,17719,11817,7010
2022-03-03 03:00:00+00,6000,960,5904,11191,466,1784,2548,171,0,0,29024,134,20109,17561,11657,6960
2022-03-03 03:30:00+00,5966,960,5907,11373,445,1740,2702,168,0,0,29261,133,20427,17725,11818,6926
2022-03-03 04:00:00+00,6028,976,5940,11433,442,1404,2747,166,0,0,29136,132,20562,17815,11875,7004
2022-03-03 04:30:00+00,6025,954,5963,11050,451,1404,2632,171,0,0,28650,133,20096,17464,11501,6979
2022-03-03 05:00:00+00,6488,1065,5963,10498,506,1134,2748,186,0,36,28624,139,19715,16967,11004,7553
2022-03-03 05:30:00+00,7433,1295,5971,10183,556,1340,2871,171,0,248,30068,155,19581,16710,10739,8728
2022-03-03 06:00:00+00,10301,1232,5969,9991,650,1326,2866,175,0,356,32866,175,19476,16610,10641,11533
2022-03-03 06:30:00+00,12343,1314,5970,9799,669,1305,2870,337,0,232,34838,191,19308,16438,10468,13657
2022-03-03 07:00:00+00,14255,1396,5970,9179,718,1573,2869,350,106,384,36801,206,18842,15973,10003,15651
2022-03-03 07:30:00+00,14978,1464,5966,8626,824,1578,2869,437,452,616,37810,210,18737,15868,9902,16442
2022-03-03 08:00:00+00,14721,1465,5970,8096,801,4262,2857,538,875,228,39813,210,18599,15742,9772,16186
2022-03-03 08:30:00+00,15003,1476,5972,8113,775,4364,2865,579,1110,236,40493,210,18835,15970,9998,16479
2022-03-03 09:00:00+00,15039,1473,5969,8241,768,4576,2868,560,1296,506,41296,207,19142,16274,10305,16512
2022-03-03 09:30:00+00,14850,1470,5984,8231,882,4584,2872,486,1528,386,41273,205,19497,16625,10641,16320
2022-03-03 10:00:00+00,14833,1458,5972,7815,918,5250,2912,339,1780,240,41517,203,19397,16485,10513,16291
2022-03-03 10:30:00+00,14792,1463,5972,7830,776,5584,2915,472,2210,20,42034,202,19703,16788,10816,16255
2022-03-03 11:00:00+00,14795,1469,5970,7997,640,5598,2916,373,2346,146,42250,200,19869,16953,10983,16264
2022-03-03 11:30:00+00,14888,1471,6000,8115,639,5600,2915,204,2420,144,42396,199,20089,17174,11174,16359
2022-03-03 12:00:00+00,14930,1471,6006,8096,659,5600,2918,176,2532,260,42648,198,20211,17293,11287,16401
2022-03-03 12:30:00+00,15017,1471,5991,8117,666,5596,2917,172,2330,212,42489,200,20021,17104,11113,16488
2022-03-03 13:00:00+00,14804,1473,5998,7919,767,5600,2914,178,2126,356,42135,200,19724,16810,10812,16277
2022-03-03 13:30:00+00,14813,1472,6002,7629,809,5598,2888,176,1721,144,41252,204,19049,16161,10159,16285
2022-03-03 14:00:00+00,15150,1476,5998,7106,836,5594,2887,175,1458,276,40956,209,18285,15398,9400,16626
2022-03-03 14:30:00+00,15550,1470,6003,6645,863,5600,2592,170,1401,58,40352,215,17504,14912,8909,17020
2022-03-03 15:00:00+00,16140,1445,6047,6515,886,5174,2640,168,1116,0,40131,220,17204,14564,8517,17585
2022-03-03 15:30:00+00,16819,1466,6047,6483,983,4382,2879,167,756,40,40022,227,17148,14269,8222,18285
2022-03-03 16:00:00+00,16726,1473,6074,6167,1044,4568,2917,285,501,486,40241,227,16703,13786,7712,18199
2022-03-03 16:30:00+00,16697,1468,6115,5880,1148,4620,2919,741,239,738,40565,229,16301,13382,7267,18165
2022-03-03 17:00:00+00,16992,1467,6133,5478,1148,4608,2918,772,66,1824,41406,227,15744,12826,6692,18459
2022-03-03 17:30:00+00,17871,1462,6137,5258,1141,4610,2918,635,0,2112,42144,230,15454,12536,6399,19333
2022-03-03 18:00:00+00,18150,1449,6133,5200,1138,4620,2917,838,0,2102,42547,231,15388,12471,6338,19599
2022-03-03 18:30:00+00,18183,1459,6130,5393,1115,4620,2771,885,0,2028,42584,232,15409,12638,6508,19642
2022-03-03 19:00:00+00,18619,1458,6133,5490,1128,4618,2861,634,0,706,41647,239,15612,12751,6618,20077
2022-03-03 19:30:00+00,18150,1469,6126,5498,1118,4602,2919,306,0,292,40480,239,15661,12742,6616,19619
2022-03-03 20:00:00+00,17423,1470,6137,5474,1062,4544,2916,190,0,90,39306,238,15589,12673,6536,18893
2022-03-03 20:30:00+00,16288,1471,6131,5402,1036,4536,2894,176,0,14,37948,235,15463,12569,6438,17759
2022-03-03 21:00:00+00,14852,1466,6167,5248,983,4236,2915,178,0,82,36127,230,15313,12398,6231,16318
2022-03-03 21:30:00+00,13612,1302,6184,5046,959,4220,2916,179,0,0,34418,223,15105,12189,6005,14914
2022-03-03 22:00:00+00,12870,828,6185,4877,825,3960,2911,176,0,14,32646,211,14798,11887,5702,13698
2022-03-03 22:30:00+00,12379,341,6188,4613,640,3946,2813,191,0,20,31131,200,14254,11441,5253,12720
2022-03-03 23:00:00+00,12100,6,6215,4449,623,3820,2804,174,0,0,30191,192,14091,11287,5072,12106
2022-03-03 23:30:00+00,11437,0,6226,4450,577,3822,2713,168,0,0,29393,188,13966,11253,5027,11437
2022-03-04 00:00:00+00,11202,0,6259,4533,496,4096,2522,169,0,0,29277,185,13810,11288,5029,11202
2022-03-04 00:30:00+00,11578,0,6271,4541,496,4116,2219,168,0,0,29389,188,13527,11308,5037,11578
2022-03-04 01:00:00+00,11362,0,6273,4590,495,4386,2189,168,0,0,29463,185,13547,11358,5085,11362
2022-03-04 01:30:00+00,10900,0,6271,4560,494,4360,2307,168,0,0,29060,182,13632,11325,5054,10900
2022-03-04 02:00:00+00,11266,0,6273,4472,492,3122,2474,171,0,0,28270,189,13711,11237,4964,11266
2022-03-04 02:30:00+00,11137,0,6281,4490,490,3084,2578,168,0,0,28228,187,13839,11261,4980,11137
2022-03-04 03:00:00+00,11165,0,6271,4375,490,2686,2556,184,0,0,27727,189,13692,11136,4865,11165
2022-03-04 03:30:00+00,11116,0,6278,4260,487,2690,2462,167,0,0,27460,189,13487,11025,4747,11116
2022-03-04 04:00:00+00,11369,0,6276,3942,487,2286,2625,174,0,0,27159,193,13330,10705,4429,11369
2022-03-04 04:30:00+00,11533,0,6278,3730,486,2286,2625,180,0,0,27118,195,13119,10494,4216,11533
2022-03-04 05:00:00+00,12036,169,6302,3720,537,2006,2420,175,0,0,27365,206,12979,10559,4257,12205
2022-03-04 05:30:00+00,12693,399,6308,3673,574,1998,2311,193,0,0,28149,217,12866,10555,4247,13092
2022-03-04 06:00:00+00,14686,676,6313,3473,763,1844,2530,170,0,0,30455,235,13079,10549,4236,15362
2022-03-04 06:30:00+00,16463,902,6318,3512,764,1854,2860,169,0,0,32842,247,13454,10594,4276,17365
2022-03-04 07:00:00+00,17414,1142,6313,3712,799,3120,2900,174,39,18,35631,250,13763,10863,4550,18556
2022-03-04 07:30:00+00,18342,1401,6315,3704,886,3188,2913,186,206,118,37259,255,14024,11111,4796,19743
2022-03-04 08:00:00+00,18590,1477,6305,3686,968,3996,2916,197,515,110,38760,252,14390,11474,5169,20067
2022-03-04 08:30:00+00,18488,1477,6306,3659,1036,4038,2915,261,1008,314,39502,247,14924,12009,5703,19965
2022-03-04 09:00:00+00,18514,1478,6303,3575,1085,4526,2915,190,1528,436,40550,241,15406,12491,6188,19992
2022-03-04 09:30:00+00,18685,1479,6311,3492,1101,4546,2918,176,1873,310,40891,241,15695,12777,6466,20164
2022-03-04 10:00:00+00,18822,1478,6305,3474,1059,4544,2917,175,2236,74,41084,241,15991,13074,6769,20300
2022-03-04 10:30:00+00,18773,1479,6309,3526,1018,4544,2915,221,2481,14,41280,239,16249,13334,7025,20252
2022-03-04 11:00:00+00,18675,1480,6304,3670,1012,4346,2917,355,2624,0,41383,239,16527,13610,7306,20155
2022-03-04 11:30:00+00,18464,1479,6308,3804,1009,4344,2917,327,2764,0,41416,236,16802,13885,7577,19943
2022-03-04 12:00:00+00,18444,1463,6304,3904,986,4156,2917,384,2869,0,41427,236,16980,14063,7759,19907
2022-03-04 12:30:00+00,18006,1467,6304,4162,974,4154,2917,343,2842,0,41169,233,17199,14282,7978,19473
2022-03-04 13:00:00+00,17661,1475,6304,4275,750,4274,2912,236,2649,0,40536,233,16890,13978,7674,19136
2022-03-04 13:30:00+00,17208,1470,6330,4284,686,4276,2912,210,2674,0,40050,231,16886,13974,7644,18678
2022-03-04 14:00:00+00,16617,1461,6354,4498,854,4508,2878,173,2583,0,39926,225,17167,14289,7935,18078
2022-03-04 14:30:00+00,16415,1477,6363,4483,920,4510,2888,185,2513,30,39784,225,17167,14279,7916,17892
2022-03-04 15:00:00+00,16652,1450,6375,4643,977,4102,2913,174,2288,0,39574,227,17196,14283,7908,18102
2022-03-04 15:30:00+00,16739,1458,6370,4646,1036,4084,2883,192,1849,12,39269,230,16784,13901,7531,18197
2022-03-04 16:00:00+00,16920,1466,6372,4894,1087,4498,2819,225,1469,0,39750,230,16642,13822,7450,18386
2022-03-04 16:30:00+00,17044,1460,6372,5041,1089,4518,2903,335,797,46,39605,233,16202,13299,6927,18504
2022-03-04 17:00:00+00,17270,1459,6371,5009,1153,4562,2915,437,250,900,40326,232,15698,12783,6412,18729
2022-03-04 17:30:00+00,17562,1456,6368,5058,1138,4566,2919,627,10,1258,40962,233,15493,12574,6206,19018
2022-03-04 18:00:00+00,17813,1475,6363,5127,1151,4560,2919,862,0,1450,41720,234,15560,12641,6278,19288
2022-03-04 18:30:00+00,17752,1459,6369,5108,1168,4560,2949,863,0,1700,41928,232,15594,12645,6276,19211
2022-03-04 19:00:00+00,17686,1470,6361,4976,1181,4514,2947,687,0,612,40434,239,15465,12518,6157,19156
2022-03-04 19:30:00+00,17275,1474,6367,4692,1174,4514,2919,498,0,194,39107,241,15152,12233,5866,18749
2022-03-04 20:00:00+00,16702,1468,6366,4633,1104,4506,2907,282,0,68,38036,239,15010,12103,5737,18170
2022-03-04 20:30:00+00,15534,1433,6372,4691,1068,4506,2816,230,0,42,36692,233,14947,12131,5759,16967
2022-03-04 21:00:00+00,14265,1378,6367,4681,948,4424,2856,198,0,202,35319,226,14852,11996,5629,15643
2022-03-04 21:30:00+00,12717,1375,6374,4871,913,4422,2918,178,0,118,33886,218,15076,12158,5784,14092
2022-03-04 22:00:00+00,11595,998,6355,4997,896,4256,2917,169,0,8,32191,205,15165,12248,5893,12593
2022-03-04 22:30:00+00,10727,588,6352,4777,878,4204,2918,171,0,0,30615,191,14925,12007,5655,11315
2022-03-04 23:00:00+00,9700,254,6359,4638,867,4433,2758,186,0,0,29195,176,14622,11864,5505,9954
2022-03-04 23:30:00+00,9102,230,6359,4654,853,4422,2398,206,0,0,28224,171,14264,11866,5507,9332
2022-03-05 00:00:00+00,9042,231,6354,4548,732,4542,2263,193,0,0,27905,171,13897,11634,5280,9273
2022-03-05 00:30:00+00,9074,181,6357,4738,714,4544,2261,225,0,44,28138,168,14070,11809,5452,9255
2022-03-05 01:00:00+00,8322,0,6353,4988,709,4546,2263,211,0,0,27392,156,14313,12050,5697,8322
2022-03-05 01:30:00+00,7628,0,6355,5297,708,4546,2205,173,0,0,26912,148,14565,12360,6005,7628
2022-03-05 02:00:00+00,7386,0,6348,5411,704,4548,2172,169,0,0,26738,145,14635,12463,6115,7386
2022-03-05 02:30:00+00,7223,0,6349,5654,617,4546,2073,169,0,0,26631,143,14693,12620,6271,7223
2022-03-05 03:00:00+00,7256,0,6355,5679,400,4248,1899,165,0,0,26002,144,14333,12434,6079,7256
2022-03-05 03:30:00+00,6696,0,6349,5964,400,4244,1897,160,0,0,25710,137,14610,12713,6364,6696
2022-03-05 04:00:00+00,6889,0,6358,5995,400,3726,1895,150,0,0,25413,139,14648,12753,6395,6889
2022-03-05 04:30:00+00,6928,2,6352,6100,399,3696,1908,138,0,0,25523,139,14759,12851,6499,6930
2022-03-05 05:00:00+00,7439,156,6359,6089,400,3022,1916,132,0,0,25513,151,14764,12848,6489,7595
2022-03-05 05:30:00+00,7315,394,6362,6024,403,3004,1910,137,0,0,25549,158,14699,12789,6427,7709
2022-03-05 06:00:00+00,7623,649,6362,6135,479,3650,1964,145,0,0,27007,164,14940,12976,6614,8272
2022-03-05 06:30:00+00,8179,690,6365,6273,541,3662,1806,188,0,0,27704,169,14985,13179,6814,8869
2022-03-05 07:00:00+00,9320,939,6362,6416,765,3584,1548,170,125,0,29228,184,15216,13668,7306,10259
2022-03-05 07:30:00+00,9928,928,6367,6494,837,3576,1643,171,650,0,30594,184,15991,14348,7981,10856
2022-03-05 08:00:00+00,10673,986,6362,6629,1030,3712,1967,184,1281,0,32824,183,17269,15302,8940,11659
2022-03-05 08:30:00+00,10935,1149,6365,6675,1035,3728,2155,181,2008,0,34231,183,18238,16083,9718,12084
2022-03-05 09:00:00+00,10878,1360,6372,6478,1040,4242,2304,176,2509,246,35605,183,18703,16399,10027,12238
2022-03-05 09:30:00+00,11136,1415,6375,6719,1056,4258,2310,170,2846,0,36285,184,19306,16996,10621,12551
2022-03-05 10:00:00+00,11084,1290,6370,6945,1049,4542,2303,174,3417,0,37174,177,20084,17781,11411,12374
2022-03-05 10:30:00+00,11125,1139,6368,6906,1046,4548,2313,215,3470,56,37186,174,20103,17790,11422,12264
2022-03-05 11:00:00+00,11095,1112,6365,6967,1007,4534,2301,218,3687,68,37354,172,20327,18026,11661,12207
2022-03-05 11:30:00+00,11210,1126,6372,7142,965,4532,2089,209,3687,0,37332,173,20255,18166,11794,12336
2022-03-05 12:00:00+00,11217,1140,6366,7131,951,4520,2080,205,3837,0,37447,172,20365,18285,11919,12357
2022-03-05 12:30:00+00,11095,1071,6354,7327,922,4520,2006,208,3827,0,37330,170,20436,18430,12076,12166
2022-03-05 13:00:00+00,10940,1042,6356,7359,841,4548,1904,177,3799,0,36966,168,20259,18355,11999,11982
2022-03-05 13:30:00+00,10665,1149,6358,7154,829,4546,2148,171,3528,0,36548,171,20017,17869,11511,11814
2022-03-05 14:00:00+00,10578,1113,6358,7142,584,4548,2307,161,3229,0,36020,172,19620,17313,10955,11691
2022-03-05 14:30:00+00,10525,1018,6352,7183,565,4546,2317,182,2813,32,35533,171,19230,16913,10561,11543
2022-03-05 15:00:00+00,11131,1360,5933,7342,456,4274,2319,234,2479,148,35676,186,18529,16210,10277,12491
2022-03-05 15:30:00+00,11684,1207,5861,7654,478,4270,2283,221,1804,0,35462,189,18080,15797,9936,12891
2022-03-05 16:00:00+00,12067,1265,5857,8047,617,4350,2330,175,1228,0,35936,192,18079,15749,9892,13332
2022-03-05 16:30:00+00,12834,1373,5856,7943,989,4352,2331,170,636,0,36484,201,17755,15424,9568,14207
2022-03-05 17:00:00+00,13407,1454,5857,7948,1085,4556,2329,175,173,498,37482,205,17392,15063,9206,14861
2022-03-05 17:30:00+00,13812,1403,5851,7982,1084,4622,2320,228,9,908,38219,205,17246,14926,9075,15215
2022-03-05 18:00:00+00,13978,1436,5852,8167,1082,4596,2381,229,0,1450,39171,203,17482,15101,9249,15414
2022-03-05 18:30:00+00,13899,1429,5849,8022,1083,4566,2443,247,0,1538,39076,202,17397,14954,9105,15328
2022-03-05 19:00:00+00,13692,1346,5846,7920,1083,4566,2671,204,0,692,38020,203,17520,14849,9003,15038
2022-03-05 19:30:00+00,13468,1355,5842,7707,1061,4558,2504,192,0,424,37111,205,17114,14610,8768,14823
2022-03-05 20:00:00+00,13534,1423,5845,7374,922,4200,2714,177,0,36,36225,212,16855,14141,8296,14957
2022-03-05 20:30:00+00,12721,1256,5852,7459,662,4182,2946,161,0,0,35239,205,16919,13973,8121,13977
2022-03-05 21:00:00+00,11948,993,5848,7639,555,3818,2882,162,0,0,33845,197,16924,14042,8194,12941
2022-03-05 21:30:00+00,11184,688,5850,7936,517,3778,2534,164,0,0,32651,184,16837,14303,8453,11872
2022-03-05 22:00:00+00,10229,654,5850,8192,502,3230,2345,181,0,10,31193,178,16889,14544,8694,10883
2022-03-05 22:30:00+00,9234,384,5846,8274,484,3250,2435,183,0,16,30106,163,17039,14604,8758,9618
2022-03-05 23:00:00+00,7898,36,5849,8053,463,4358,1943,174,0,58,28832,141,16308,14365,8516,7934
2022-03-05 23:30:00+00,6942,0,5856,7937,404,4386,1789,166,0,0,27480,132,15986,14197,8341,6942
2022-03-06 00:00:00+00,6806,0,5851,7865,412,4224,1857,163,0,126,27304,128,15985,14128,8277,6806
2022-03-06 00:30:00+00,6935,0,5852,7855,448,4244,2114,165,0,0,27613,130,16269,14155,8303,6935
2022-03-06 01:00:00+00,6972,0,5851,7767,350,4550,2135,163,0,0,27788,131,16103,13968,8117,6972
2022-03-06 01:30:00+00,6997,0,5844,7501,340,4530,1874,172,0,0,27258,132,15559,13685,7841,6997
2022-03-06 02:00:00+00,6854,0,5849,7357,304,4558,1701,165,0,0,26788,131,15211,13510,7661,6854
2022-03-06 02:30:00+00,6815,0,5841,7261,302,4542,1576,169,0,0,26506,131,14980,13404,7563,6815
2022-03-06 03:00:00+00,6759,0,5838,7008,302,4550,1607,168,0,0,26232,132,14755,13148,7310,6759
2022-03-06 03:30:00+00,6712,0,5845,6634,301,4544,1689,171,0,0,25896,133,14469,12780,6935,6712
2022-03-06 04:00:00+00,6595,0,5850,6714,301,4428,1596,162,0,0,25646,132,14461,12865,7015,6595
2022-03-06 04:30:00+00,6197,0,5851,7024,301,4422,1472,163,0,0,25430,127,14648,13176,7325,6197
2022-03-06 05:00:00+00,6242,0,5848,7121,338,4348,1429,162,0,0,25488,127,14736,13307,7459,6242
2022-03-06 05:30:00+00,6383,0,5855,7323,342,4334,1376,161,0,0,25774,127,14896,13520,7665,6383
2022-03-06 06:00:00+00,7116,136,5854,7121,400,3970,1451,160,0,0,26208,141,14826,13375,7521,7252
2022-03-06 06:30:00+00,7205,355,5854,7027,436,3960,1464,160,0,0,26461,148,14781,13317,7463,7560
2022-03-06 07:00:00+00,7798,628,5852,7154,529,3894,1474,174,117,0,27620,160,15126,13652,7800,8426
2022-03-06 07:30:00+00,8550,790,5855,6862,629,3890,1573,171,570,0,28890,169,15489,13916,8061,9340
2022-03-06 08:00:00+00,9166,884,5860,6966,720,3974,1495,180,1230,0,30475,171,16271,14776,8916,10050
2022-03-06 08:30:00+00,9650,1065,5861,6893,723,4092,1589,187,1890,0,31950,176,16956,15367,9506,10715
2022-03-06 09:00:00+00,10095,1146,5854,6799,725,4532,1571,187,2459,38,33406,175,17408,15837,9983,11241
2022-03-06 09:30:00+00,10383,1208,5857,7048,716,4548,1739,166,2894,0,34559,175,18254,16515,10658,11591
2022-03-06 10:00:00+00,10833,1008,5847,7095,760,4516,1844,167,3760,0,35830,169,19306,17462,11615,11841
2022-03-06 10:30:00+00,10959,1263,5841,7035,762,4516,1964,172,3509,20,36041,176,19111,17147,11306,12222
2022-03-06 11:00:00+00,11000,1345,5840,6779,798,4546,2000,181,3803,0,36292,178,19220,17220,11380,12345
2022-03-06 11:30:00+00,11408,1368,5837,6354,808,4546,2067,176,3811,4,36379,182,18877,16810,10973,12776
2022-03-06 12:00:00+00,11736,1456,5837,6256,861,4544,2137,235,3999,0,37061,186,19090,16953,11116,13192
2022-03-06 12:30:00+00,11692,1471,5843,6109,822,4538,2222,189,3980,50,36916,186,18976,16754,10911,13163
2022-03-06 13:00:00+00,11663,1394,5839,6021,716,4562,2060,171,3773,0,36199,187,18409,16349,10510,13057
2022-03-06 13:30:00+00,11822,1197,5838,5821,662,4564,1927,163,4009,0,36003,184,18257,16330,10492,13019
2022-03-06 14:00:00+00,11792,1019,5841,5775,635,4596,1949,163,3743,0,35513,182,17943,15994,10153,12811
2022-03-06 14:30:00+00,11701,1038,5845,5908,653,4614,1824,164,3650,0,35397,182,17880,16056,10211,12739
2022-03-06 15:00:00+00,12029,1187,5846,6172,653,4620,1828,173,3197,0,35705,188,17696,15868,10022,13216
2022-03-06 15:30:00+00,13013,1132,5849,6151,658,4560,1832,165,2648,0,36008,195,17138,15306,9457,14145
2022-03-06 16:00:00+00,13783,1179,5846,6140,773,4664,2142,191,2015,0,36733,203,16916,14774,8928,14962
2022-03-06 16:30:00+00,14824,1448,5853,6161,817,4888,2321,179,1214,168,37873,218,16366,14045,8192,16272
2022-03-06 17:00:00+00,15435,1474,5846,6180,903,4854,2322,213,429,966,38622,221,15680,13358,7512,16909
2022-03-06 17:30:00+00,15996,1476,5845,6232,906,4882,2322,205,31,1408,39303,223,15336,13014,7169,17472
2022-03-06 18:00:00+00,16201,1480,5839,6152,1070,4954,2354,300,0,1802,40152,222,15415,13061,7222,17681
2022-03-06 18:30:00+00,16281,1477,5837,6007,1067,4970,2353,406,0,2038,40436,222,15264,12911,7074,17758
2022-03-06 19:00:00+00,16162,1476,5839,6030,937,5108,2352,319,0,1392,39615,226,15158,12806,6967,17638
2022-03-06 19:30:00+00,16043,1475,5839,5911,915,4906,2314,257,0,750,38410,229,14979,12665,6826,17518
2022-03-06 20:00:00+00,15996,1475,5843,6011,772,4750,2309,216,0,372,37744,231,14935,12626,6783,17471
2022-03-06 20:30:00+00,15067,1476,5840,6048,686,4546,2312,192,0,0,36167,227,14886,12574,6734,16543
2022-03-06 21:00:00+00,13718,1430,5842,5969,629,4644,2312,180,0,0,34724,221,14752,12440,6598,15148
2022-03-06 21:30:00+00,12845,1217,5845,5995,603,4506,2163,157,0,0,33331,212,14606,12443,6598,14062
2022-03-06 22:00:00+00,11958,814,5846,6162,513,4038,2180,163,0,0,31674,199,14701,12521,6675,12772
2022-03-06 22:30:00+00,11023,345,5841,6035,504,4002,2247,172,0,0,30169,182,14627,12380,6539,11368
2022-03-06 23:00:00+00,10740,20,5848,6239,340,3422,1953,156,0,0,28718,175,14380,12427,6579,10760
2022-03-06 23:30:00+00,10147,0,5837,6057,336,3424,1705,163,0,0,27669,172,13935,12230,6393,10147
2022-03-07 00:00:00+00,10285,0,5845,5535,321,4030,1672,153,0,0,27841,176,13373,11701,5856,10285
2022-03-07 00:30:00+00,10730,0,5844,5503,302,4073,1718,157,0,0,28327,179,13367,11649,5805,10730
2022-03-07 01:00:00+00,10717,0,5843,5476,298,3696,1849,159,0,0,28038,180,13466,11617,5774,10717
2022-03-07 01:30:00+00,10403,0,5845,5441,297,3710,1701,154,0,0,27551,178,13284,11583,5738,10403
2022-03-07 02:00:00+00,10018,0,5839,5426,297,3840,1683,155,0,0,27258,178,13245,11562,5723,10018
2022-03-07 02:30:00+00,10014,0,5839,5243,295,3744,1729,160,0,0,27024,178,13106,11377,5538,10014
2022-03-07 03:00:00+00,10538,0,5842,5145,293,2686,2081,169,0,0,26754,182,13361,11280,5438,10538
2022-03-07 03:30:00+00,10500,0,5844,4913,291,2678,2101,165,0,0,26492,184,13149,11048,5204,10500
2022-03-07 04:00:00+00,10710,0,5849,4947,291,2202,2244,161,0,0,26404,188,13331,11087,5238,10710
2022-03-07 04:30:00+00,10732,0,5846,5066,291,2260,2125,160,0,0,26480,188,13328,11203,5357,10732
2022-03-07 05:00:00+00,11099,170,5850,5346,292,2350,1805,161,0,0,27073,196,13293,11488,5638,11269
2022-03-07 05:30:00+00,12090,359,5849,5504,291,2340,1690,161,0,0,28284,207,13334,11644,5796,12449
2022-03-07 06:00:00+00,14069,622,5847,5822,422,2488,1997,161,0,0,31428,218,14088,12091,6244,14691
2022-03-07 06:30:00+00,15397,822,5844,5824,620,2494,2117,178,5,354,33655,226,14410,12293,6449,16219
2022-03-07 07:00:00+00,16745,1048,5843,5662,799,3664,2112,186,156,306,36521,232,14572,12460,6617,17793
2022-03-07 07:30:00+00,17107,1352,5847,5836,828,3732,2159,236,531,466,38094,235,15201,13042,7195,18459
2022-03-07 08:00:00+00,17118,1460,5845,6011,862,4424,2282,316,1095,460,39873,230,16095,13813,7968,18578
2022-03-07 08:30:00+00,17394,1475,5843,6169,852,4466,2304,414,1849,432,41198,227,17017,14713,8870,18869
2022-03-07 09:00:00+00,17444,1468,5846,6374,826,4792,2304,440,2675,522,42691,221,18025,15721,9875,18912
2022-03-07 09:30:00+00,17484,1473,5840,6549,851,4800,2308,429,2606,314,42654,222,18154,15846,10006,18957
2022-03-07 10:00:00+00,17448,1464,5844,6808,852,4950,2297,255,3275,0,43193,219,19076,16779,10935,18912
2022-03-07 10:30:00+00,17204,1465,5844,6803,843,4934,2290,191,3774,0,43348,215,19554,17264,11420,18669
2022-03-07 11:00:00+00,16551,1450,5842,6681,827,4968,2286,200,4369,0,43174,210,20005,17719,11877,18001
2022-03-07 11:30:00+00,16324,1467,5843,6640,811,4978,2296,202,4865,0,43426,208,20455,18159,12316,17791
2022-03-07 12:00:00+00,16192,1472,5842,6609,534,5010,2271,206,5629,6,43771,205,20885,18614,12772,17664
2022-03-07 12:30:00+00,15758,1466,5851,6631,491,4958,2137,173,6235,0,43700,200,21345,19208,13357,17224
2022-03-07 13:00:00+00,14835,1246,5843,6840,462,5104,2100,170,6479,0,43079,191,21724,19624,13781,16081
2022-03-07 13:30:00+00,13996,1094,5850,7127,455,5112,2116,161,6362,0,42273,183,21910,19794,13944,15090
2022-03-07 14:00:00+00,13534,1156,5845,7526,458,5138,1785,163,6087,0,41692,183,21702,19916,14072,14690
2022-03-07 14:30:00+00,13693,1193,5845,7640,459,5080,1614,170,5584,0,41278,186,21142,19528,13683,14886
2022-03-07 15:00:00+00,13367,1135,5840,8099,480,4690,1890,180,4838,0,40519,186,21147,19257,13417,14502
2022-03-07 15:30:00+00,13203,1410,5841,8560,490,4696,1941,178,3902,4,40225,192,20734,18793,12952,14613
2022-03-07 16:00:00+00,14021,1798,5840,8993,565,4168,1690,165,2817,694,40751,205,19905,18215,12375,15819
2022-03-07 16:30:00+00,14965,1869,5844,9484,741,4152,1654,206,1611,900,41426,212,19334,17680,11836,16834
2022-03-07 17:00:00+00,15433,1868,5845,10150,781,3747,1986,225,527,1776,42338,212,19289,17303,11458,17301
2022-03-07 17:30:00+00,15057,1871,5845,11144,802,3724,2242,429,39,1756,42909,208,20072,17830,11985,16928
2022-03-07 18:00:00+00,14480,1888,5844,12143,930,4214,2312,583,0,1512,43906,201,21229,18917,13073,16368
2022-03-07 18:30:00+00,14352,1804,5840,13303,810,4244,2141,565,0,1550,44609,194,22094,19953,14113,16156
2022-03-07 19:00:00+00,13721,1676,5836,14396,747,4764,1841,237,0,628,43846,185,22820,20979,15143,15397
2022-03-07 19:30:00+00,12700,1414,5839,15240,601,4644,1779,162,0,198,42577,173,23459,21680,15841,14114
2022-03-07 20:00:00+00,12225,1664,5839,15655,520,3098,2028,169,0,0,41198,177,24042,22014,16175,13889
2022-03-07 20:30:00+00,10329,1805,5836,16036,471,2990,1987,174,0,72,39700,167,24330,22343,16507,12134
2022-03-07 21:00:00+00,8037,1675,5840,16457,365,3146,2260,162,0,0,37942,152,24922,22662,16822,9712
2022-03-07 21:30:00+00,6809,1016,5840,16605,315,3154,2121,160,0,0,36020,129,24881,22760,16920,7825
2022-03-07 22:00:00+00,6968,631,5845,16471,319,2656,2177,145,0,0,35212,124,24812,22635,16790,7599
2022-03-07 22:30:00+00,5680,468,5845,16391,322,2694,1831,144,0,0,33375,110,24389,22558,16713,6148
2022-03-07 23:00:00+00,4042,450,5846,16181,319,3024,1537,136,0,0,31535,96,23883,22346,16500,4492
2022-03-07 23:30:00+00,3712,244,5845,15812,303,3066,1377,143,0,0,30502,89,23337,21960,16115,3956
2022-03-08 00:00:00+00,3739,234,5847,15783,284,3370,1347,132,0,0,30736,88,23261,21914,16067,3973
2022-03-08 00:30:00+00,4052,311,5843,15810,283,3356,1371,139,0,0,31165,93,23307,21936,16093,4363
2022-03-08 01:00:00+00,4225,424,5847,15993,283,2764,1350,131,0,0,31017,97,23473,22123,16276,4649
2022-03-08 01:30:00+00,3859,370,5842,15910,282,2760,1473,136,0,0,30632,93,23507,22034,16192,4229
2022-03-08 02:00:00+00,4005,454,5841,15874,281,2480,1553,138,0,0,30626,94,23549,21996,16155,4459
2022-03-08 02:30:00+00,3628,484,5836,15898,280,2476,1579,146,0,0,30327,91,23593,22014,16178,4112
2022-03-08 03:00:00+00,3289,467,5835,15872,280,2564,1521,141,0,0,29969,88,23508,21987,16152,3756
2022-03-08 03:30:00+00,3013,392,5845,16103,287,2566,1437,136,0,0,29779,82,23672,22235,16390,3405
2022-03-08 04:00:00+00,3419,477,5840,15995,301,1834,1857,148,0,0,29871,81,23993,22136,16296,3896
2022-03-08 04:30:00+00,3498,487,5845,15936,301,1834,2063,150,0,0,30114,83,24145,22082,16237,3985
2022-03-08 05:00:00+00,3333,455,5850,15742,321,2118,2048,136,0,0,30003,84,23961,21913,16063,3788
2022-03-08 05:30:00+00,3870,490,5850,15716,346,2134,2138,142,0,0,30686,91,24050,21912,16062,4360
2022-03-08 06:00:00+00,5429,600,5848,15776,423,2194,2207,162,0,148,32787,108,24254,22047,16199,6029
2022-03-08 06:30:00+00,6599,839,5849,15842,472,2176,2278,332,30,506,34923,123,24471,22193,16344,7438
2022-03-08 07:00:00+00,7873,1078,5853,16210,506,2490,2265,401,507,602,37785,137,25341,23076,17223,8951
2022-03-08 07:30:00+00,8185,1548,5859,16562,498,2500,2263,453,1450,316,39634,145,26632,24369,18510,9733
2022-03-08 08:00:00+00,7963,1852,5850,16679,440,3602,2277,265,2463,174,41565,145,27709,25432,19582,9815
2022-03-08 08:30:00+00,7696,1859,5853,16825,443,3644,2269,239,3436,214,42478,140,28826,26557,20704,9555
2022-03-08 09:00:00+00,7687,1864,5847,16623,422,4222,2273,201,4458,430,44027,135,29623,27350,21503,9551
2022-03-08 09:30:00+00,7440,1869,5851,16625,417,4500,2267,200,5326,70,44565,130,30486,28219,22368,9309
2022-03-08 10:00:00+00,7045,1875,5842,16761,416,4454,2264,163,5997,0,44817,126,31280,29016,23174,8920
2022-03-08 10:30:00+00,6574,1835,5846,16884,383,4314,2282,164,6401,0,44683,121,31796,29514,23668,8409
2022-03-08 11:00:00+00,6029,1491,5830,16925,368,4402,2140,169,6829,0,44183,112,32092,29952,24122,7520
2022-03-08 11:30:00+00,5997,1452,5822,16701,348,4294,2109,166,7111,0,44000,111,32091,29982,24160,7449
2022-03-08 12:00:00+00,6324,1381,5828,16751,347,3990,2201,167,7065,0,44054,112,32192,29991,24163,7705
2022-03-08 12:30:00+00,6241,1179,5826,16772,342,3926,2226,173,6875,46,43606,108,32041,29815,23989,7420
2022-03-08 13:00:00+00,6329,1411,5834,16848,342,3696,2088,166,6268,62,43044,114,31380,29292,23458,7740
2022-03-08 13:30:00+00,6448,1729,5833,16631,353,3444,1920,165,5711,38,42272,123,30448,28528,22695,8177
2022-03-08 14:00:00+00,6608,1839,5833,16634,354,2864,2056,157,5220,228,41793,128,30097,28041,22208,8447
2022-03-08 14:30:00+00,6969,1786,5831,16823,344,2862,2064,146,4290,240,41355,131,29352,27288,21457,8755
2022-03-08 15:00:00+00,8139,1803,5831,16781,331,2578,2139,155,3084,274,41115,143,28166,26027,20196,9942
2022-03-08 15:30:00+00,8841,1761,5831,16705,367,2594,2283,198,2083,478,41141,149,27269,24986,19155,10602
2022-03-08 16:00:00+00,10283,1816,5834,16548,426,1948,2300,350,1355,512,41372,159,26463,24163,18329,12099
2022-03-08 16:30:00+00,11585,1810,5833,16341,432,1934,2320,492,754,586,42087,170,25680,23360,17527,13395
2022-03-08 17:00:00+00,12561,1743,5834,16481,431,2178,2328,585,201,700,43042,177,25275,22947,17113,14304
2022-03-08 17:30:00+00,12872,1787,5831,16472,433,2180,2331,654,21,818,43399,180,25088,22757,16926,14659
2022-03-08 18:00:00+00,12741,1809,5829,16574,455,2296,2338,574,0,1326,43942,176,25196,22858,17029,14550
2022-03-08 18:30:00+00,12676,1806,5825,16578,464,2513,2341,489,0,1696,44388,173,25208,22867,17042,14482
2022-03-08 19:00:00+00,12366,1816,5821,16555,486,2942,2338,207,0,440,42971,177,25200,22862,17041,14182
2022-03-08 19:30:00+00,11782,1816,5823,16393,475,2756,2340,188,0,82,41655,175,25031,22691,16868,13598
2022-03-08 20:00:00+00,11426,1825,5822,16382,418,2464,2316,199,0,138,40990,175,24938,22622,16800,13251
2022-03-08 20:30:00+00,10397,1830,5824,16269,361,2312,2311,189,0,120,39613,169,24765,22454,16630,12227
2022-03-08 21:00:00+00,9004,1806,5824,15749,321,2504,2306,208,0,100,37822,164,24200,21894,16070,10810
2022-03-08 21:30:00+00,7734,1591,5832,15567,263,2456,2308,149,0,0,35900,153,23970,21662,15830,9325
2022-03-08 22:00:00+00,7082,983,5843,15426,241,2566,2106,151,0,0,34398,136,23616,21510,15668,8065
2022-03-08 22:30:00+00,5859,803,5826,15182,240,2668,1675,175,0,0,32428,124,22923,21248,15422,6662
2022-03-08 23:00:00+00,4116,687,5831,14571,246,3532,1374,149,0,0,30506,108,22022,20648,14817,4803
2022-03-08 23:30:00+00,3395,468,5831,14061,267,3620,1349,143,0,0,29134,97,21508,20159,14328,3863
2022-03-09 00:00:00+00,3672,380,5828,13766,253,3438,1437,156,0,0,28930,98,21284,19847,14019,4052
2022-03-09 00:30:00+00,3806,396,5832,13709,253,3436,1630,127,0,0,29189,100,21424,19794,13962,4202
2022-03-09 01:00:00+00,3777,390,5828,13999,252,3262,1526,114,0,0,29148,97,21605,20079,14251,4167
2022-03-09 01:30:00+00,3478,374,5830,13950,251,3246,1347,127,0,0,28603,94,21378,20031,14201,3852
2022-03-09 02:00:00+00,3375,297,5820,13860,251,2722,1394,151,0,0,27870,91,21325,19931,14111,3672
2022-03-09 02:30:00+00,3532,305,5825,13473,251,2614,1426,149,0,0,27575,93,20975,19549,13724,3837
2022-03-09 03:00:00+00,4221,408,5823,13379,267,1824,1646,149,0,0,27717,95,21115,19469,13646,4629
2022-03-09 03:30:00+00,4282,400,5821,13158,280,1824,1624,144,0,0,27533,97,20883,19259,13438,4682
2022-03-09 04:00:00+00,4349,415,5821,13235,280,1924,1836,152,0,0,28012,99,21172,19336,13515,4764
2022-03-09 04:30:00+00,4388,404,5822,13185,261,1924,1865,146,0,0,27995,99,21133,19268,13446,4792
2022-03-09 05:00:00+00,4681,445,5826,13297,270,1824,1831,142,0,0,28316,102,21224,19393,13567,5126
2022-03-09 05:30:00+00,5740,446,5828,13243,305,1822,1718,144,0,100,29346,112,21094,19376,13548,6186
2022-03-09 06:00:00+00,7297,618,5860,13288,392,1776,1956,143,0,182,31512,130,21496,19540,13680,7915
2022-03-09 06:30:00+00,8633,729,5863,13662,411,1742,2169,261,25,400,33895,141,22130,19961,14098,9362
2022-03-09 07:00:00+00,9154,1002,5862,14055,413,1688,2320,270,340,322,35426,148,22990,20670,14808,10156
2022-03-09 07:30:00+00,9790,1300,5863,14512,417,1708,2324,461,953,200,37528,155,24069,21745,15882,11090
2022-03-09 08:00:00+00,8978,1196,5861,14746,443,3654,1920,232,1897,166,39093,145,24867,22947,17086,10174
2022-03-09 08:30:00+00,8870,1096,5864,15044,421,3854,1715,147,2628,24,39663,140,25672,23957,18093,9966
2022-03-09 09:00:00+00,9073,1146,5856,15380,428,3976,1796,160,3293,68,41176,136,26753,24957,19101,10219
2022-03-09 09:30:00+00,8708,1189,5864,15878,422,3876,2112,164,3323,0,41536,131,27599,25487,19623,9897
2022-03-09 10:00:00+00,8421,1224,5875,16153,368,3794,2049,159,3991,0,42034,127,28436,26387,20512,9645
2022-03-09 10:30:00+00,8210,952,5919,16483,313,3798,1730,161,4315,0,41881,119,28760,27030,21111,9162
2022-03-09 11:00:00+00,8316,963,5917,16645,305,3360,1608,173,4974,50,42311,118,29449,27841,21924,9279
2022-03-09 11:30:00+00,8385,1081,5925,16312,266,3322,1653,167,5301,48,42460,121,29457,27804,21879,9466
2022-03-09 12:00:00+00,8733,1275,5922,16461,274,2754,2051,172,5017,18,42677,128,29725,27674,21752,10008
2022-03-09 12:30:00+00,8610,1177,5948,16543,276,2724,2128,164,4891,0,42461,126,29786,27658,21710,9787
2022-03-09 13:00:00+00,8440,1175,5940,16448,298,2916,2131,167,4517,0,42032,126,29334,27203,21263,9615
2022-03-09 13:30:00+00,8066,1155,5953,16252,293,2918,2217,166,4071,0,41091,125,28786,26569,20616,9221
2022-03-09 14:00:00+00,8189,1178,5950,15982,304,2762,2102,165,3666,0,40298,128,28004,25902,19952,9367
2022-03-09 14:30:00+00,8382,1034,5979,16042,333,2752,2092,166,3282,0,40062,128,27728,25636,19657,9416
2022-03-09 15:00:00+00,9429,934,5979,15982,373,2052,2178,172,2426,68,39593,133,26938,24760,18781,10363
2022-03-09 15:30:00+00,10547,837,5980,15873,388,2034,2208,166,1775,0,39808,141,26224,24016,18036,11384
2022-03-09 16:00:00+00,12703,1156,5963,15328,642,1048,2337,186,1235,192,40790,158,25505,23168,17205,13859
2022-03-09 16:30:00+00,13962,1327,5968,14247,789,1048,2344,256,649,458,41048,173,23997,21653,15685,15289
2022-03-09 17:00:00+00,14423,1332,5976,13469,811,1426,2357,350,189,928,41261,179,22802,20445,14469,15755
2022-03-09 17:30:00+00,14532,1405,5973,12999,816,1438,2357,482,14,1390,41406,182,22159,19802,13829,15937
2022-03-09 18:00:00+00,14500,1389,5984,12513,840,2706,2352,510,0,1666,42460,183,21689,19337,13353,15889
2022-03-09 18:30:00+00,14795,1337,5989,12275,817,2776,2354,506,0,1636,42485,185,21435,19081,13092,16132
2022-03-09 19:00:00+00,14714,1296,5986,12066,802,3414,2346,450,0,618,41692,192,21200,18854,12868,16010
2022-03-09 19:30:00+00,14534,1105,5983,12061,821,3394,2168,335,0,224,40625,190,21033,18865,12882,15639
2022-03-09 20:00:00+00,14520,915,5983,12234,790,2424,2298,249,0,80,39493,188,21305,19007,13024,15435
2022-03-09 20:30:00+00,13947,674,5981,12103,466,2298,2302,165,0,0,37936,183,20852,18550,12569,14621
2022-03-09 21:00:00+00,13487,448,5980,12218,366,2028,2304,172,0,88,37091,176,20868,18564,12584,13935
2022-03-09 21:30:00+00,11685,227,5982,12461,327,2026,2278,171,0,70,35227,159,21048,18770,12788,11912
2022-03-09 22:00:00+00,10672,1,6018,12605,271,1798,2098,172,0,34,33669,144,20992,18894,12876,10673
2022-03-09 22:30:00+00,9108,0,6034,12617,293,1798,1866,208,0,40,31964,132,20810,18944,12910,9108
2022-03-09 23:00:00+00,6079,0,6034,12537,309,2336,1454,169,0,0,28918,108,20334,18880,12846,6079
2022-03-09 23:30:00+00,5282,0,6036,12286,271,2372,1337,162,0,0,27746,101,19930,18593,12557,5282
2022-03-10 00:00:00+00,5075,0,6049,12024,267,3160,1351,171,0,0,28097,98,19691,18340,12291,5075
2022-03-10 00:30:00+00,5058,0,6124,11932,267,3190,1449,167,0,0,28187,98,19772,18323,12199,5058
2022-03-10 01:00:00+00,4999,0,6131,11661,249,3398,1507,163,0,0,28108,98,19548,18041,11910,4999
2022-03-10 01:30:00+00,4939,0,6129,11507,248,3386,1524,161,0,0,27894,98,19408,17884,11755,4939
2022-03-10 02:00:00+00,5311,0,6126,11363,248,2868,1471,167,0,0,27554,101,19208,17737,11611,5311
2022-03-10 02:30:00+00,5029,0,6129,11322,248,2858,1459,164,0,0,27209,98,19158,17699,11570,5029
2022-03-10 03:00:00+00,5228,0,6122,11444,244,2436,1457,159,0,0,27090,99,19267,17810,11688,5228
2022-03-10 03:30:00+00,4860,0,6181,11607,243,2408,1451,158,0,0,26908,94,19482,18031,11850,4860
2022-03-10 04:00:00+00,4783,0,6199,11955,243,1846,1461,173,0,0,26660,88,19858,18397,12198,4783
2022-03-10 04:30:00+00,4699,0,6200,12146,243,1849,1455,156,0,0,26748,86,20044,18589,12389,4699
2022-03-10 05:00:00+00,5704,0,6200,12371,260,1062,1644,164,0,0,27405,91,20475,18831,12631,5704
2022-03-10 05:30:00+00,6857,0,6197,12716,274,1100,1699,166,0,0,29009,103,20886,19187,12990,6857
2022-03-10 06:00:00+00,8376,0,6244,13068,354,1049,1748,166,0,176,31181,114,21414,19666,13422,8376
2022-03-10 06:30:00+00,9352,138,6258,13469,405,1105,2078,229,27,358,33419,125,22237,20159,13901,9490
2022-03-10 07:00:00+00,9458,486,6253,13980,437,1318,2050,216,355,654,35207,128,23075,21025,14772,9944
2022-03-10 07:30:00+00,10299,656,6262,14247,438,1350,2165,261,898,100,36676,138,24010,21845,15583,10955
2022-03-10 08:00:00+00,10788,743,6253,14272,470,2060,2293,287,1601,22,38789,140,24889,22596,16343,11531
2022-03-10 08:30:00+00,10933,762,6263,14138,456,2116,2355,164,2065,54,39306,140,25277,22922,16659,11695
2022-03-10 09:00:00+00,10409,701,6261,14198,455,3005,2067,172,2814,0,40083,132,25795,23728,17467,11110
2022-03-10 09:30:00+00,9917,647,6258,14336,458,3393,1664,162,3453,0,40288,125,26169,24505,18247,10564
2022-03-10 10:00:00+00,9743,647,6242,14668,372,3350,1641,165,3741,0,40569,123,26664,25023,18781,10390
2022-03-10 10:30:00+00,9429,582,6235,14522,321,3388,1857,170,4249,56,40809,119,27184,25327,19092,10011
2022-03-10 11:00:00+00,9188,710,6242,14652,285,3383,1991,172,4943,0,41566,118,28113,26122,19880,9898
2022-03-10 11:30:00+00,8616,768,6234,14936,287,3399,1756,164,5071,0,41231,114,28284,26528,20294,9384
2022-03-10 12:00:00+00,9000,797,6232,14621,287,3349,1772,168,4747,0,40974,119,27659,25887,19655,9797
2022-03-10 12:30:00+00,9213,808,6228,14511,285,3228,1756,168,4823,0,41020,122,27603,25847,19619,10021
2022-03-10 13:00:00+00,8588,887,6225,14314,279,3184,1689,175,4756,0,40097,123,27263,25574,19349,9475
2022-03-10 13:30:00+00,8800,885,6231,13884,305,3311,1653,176,4846,0,40091,127,26919,25266,19035,9685
2022-03-10 14:00:00+00,8641,900,6232,13751,296,3643,1659,171,3935,0,39228,131,25873,24214,17982,9541
2022-03-10 14:30:00+00,9011,810,6263,13794,280,3626,1752,167,3011,0,38714,134,25100,23348,17085,9821
2022-03-10 15:00:00+00,9295,805,6280,13717,361,3402,1749,153,2432,96,38290,138,24539,22790,16510,10100
2022-03-10 15:30:00+00,10677,956,6283,13427,391,2919,1992,158,1802,54,38660,155,23895,21903,15620,11633
2022-03-10 16:00:00+00,11692,1251,6284,13158,451,2774,1943,151,1255,268,39227,169,23091,21148,14864,12943
2022-03-10 16:30:00+00,12150,1349,6284,12928,467,2808,2238,257,701,454,39636,177,22618,20380,14096,13499
2022-03-10 17:00:00+00,12929,1328,6291,12816,557,2884,2223,464,207,822,40522,182,22094,19871,13580,14257
2022-03-10 17:30:00+00,13187,1362,6286,12810,672,2928,2241,480,20,1006,40993,184,22029,19788,13502,14549
2022-03-10 18:00:00+00,13411,1356,6286,12869,717,2772,2330,500,0,1462,41704,184,22202,19872,13586,14767
2022-03-10 18:30:00+00,13313,1349,6289,13165,696,2826,2313,471,0,1502,41924,183,22463,20150,13861,14662
2022-03-10 19:00:00+00,12999,1334,6283,13356,651,3330,2319,195,0,590,41057,184,22609,20290,14007,14333
2022-03-10 19:30:00+00,12446,1324,6286,13337,654,3254,2315,162,0,106,39884,181,22592,20277,13991,13770
2022-03-10 20:00:00+00,10632,1327,6281,13365,552,3226,2323,173,0,42,37921,171,22521,20198,13917,11959
2022-03-10 20:30:00+00,9189,1332,6279,13676,496,3238,2141,165,0,26,36542,161,22592,20451,14172,10521
2022-03-10 21:00:00+00,7263,1316,6278,13753,418,3048,2190,182,0,162,34610,148,22639,20449,14171,8579
2022-03-10 21:30:00+00,6040,1122,6279,13662,364,3012,2132,154,0,160,32925,135,22437,20305,14026,7162
2022-03-10 22:00:00+00,5557,785,6282,13647,327,3346,2099,146,0,76,32265,124,22355,20256,13974,6342
2022-03-10 22:30:00+00,4081,591,6279,13824,290,3378,2047,156,0,0,30646,106,22440,20393,14114,4672
2022-03-10 23:00:00+00,3400,388,6281,14148,267,2514,1644,161,0,18,28821,84,22340,20696,14415,3788
2022-03-10 23:30:00+00,2622,334,6294,14021,265,2560,1350,155,0,30,27631,73,21930,20580,14286,2956
2022-03-11 00:00:00+00,2528,279,6301,14010,264,3008,1027,140,0,0,27557,69,21602,20575,14274,2807
2022-03-11 00:30:00+00,2771,294,6303,13947,264,3012,1075,154,0,0,27820,72,21589,20514,14211,3065
2022-03-11 01:00:00+00,2662,342,6307,14147,263,3240,1082,156,0,0,28199,74,21799,20717,14410,3004
2022-03-11 01:30:00+00,2427,294,6312,14251,238,3230,1080,151,0,0,27983,69,21881,20801,14489,2721
2022-03-11 02:00:00+00,2363,239,6304,14284,232,2932,1098,143,0,0,27595,65,21918,20820,14516,2602
2022-03-11 02:30:00+00,2358,229,6305,14613,232,2920,1044,142,0,0,27843,64,22194,21150,14845,2587
2022-03-11 03:00:00+00,2390,230,6300,14695,231,2770,1057,153,0,0,27826,63,22283,21226,14926,2620
2022-03-11 03:30:00+00,2376,228,6295,14473,231,2770,1053,147,0,0,27573,63,22052,20999,14704,2604
2022-03-11 04:00:00+00,2483,246,6300,14794,251,2702,1063,147,0,0,27986,64,22408,21345,15045,2729
2022-03-11 04:30:00+00,2632,230,6298,15175,250,2702,1028,140,0,0,28455,64,22751,21723,15425,2862
2022-03-11 05:00:00+00,2799,319,6296,15216,250,1962,1035,145,0,0,28022,69,22797,21762,15466,3118
2022-03-11 05:30:00+00,2892,596,6304,15855,256,1926,1032,143,0,0,29004,77,23447,22415,16111,3488
2022-03-11 06:00:00+00,3356,637,6298,16172,334,3062,1055,149,0,0,31063,85,23859,22804,16506,3993
2022-03-11 06:30:00+00,4527,622,6298,16622,350,3256,1136,150,51,0,33012,96,24457,23321,17023,5149
2022-03-11 07:00:00+00,5730,475,6298,17157,357,3448,1069,158,407,0,35099,99,25288,24219,17921,6205
2022-03-11 07:30:00+00,6407,461,6300,17453,357,3444,1051,150,930,0,36553,102,26091,25040,18740,6868
2022-03-11 08:00:00+00,6970,473,6296,17568,368,3318,1052,150,1507,18,37720,102,26791,25739,19443,7443
2022-03-11 08:30:00+00,7024,472,6295,17678,368,3226,1075,161,2037,56,38392,100,27453,26378,20083,7496
2022-03-11 09:00:00+00,7037,551,6295,17854,369,3214,1143,151,2416,40,39070,99,28077,26934,20639,7588
2022-03-11 09:30:00+00,6530,687,6300,18296,360,3176,1215,144,2581,0,39289,96,28752,27537,21237,7217
2022-03-11 10:00:00+00,6474,707,6294,18464,334,3052,1366,166,2746,0,39603,96,29204,27838,21544,7181
2022-03-11 10:30:00+00,6633,695,6258,18609,297,3050,1354,145,3207,30,40278,95,29725,28371,22113,7328
2022-03-11 11:00:00+00,6853,799,6187,18700,262,3140,1416,160,2849,134,40500,99,29414,27998,21811,7652
2022-03-11 11:30:00+00,6893,947,6185,18660,262,3142,1567,158,2581,280,40675,103,29255,27688,21503,7840
2022-03-11 12:00:00+00,6979,912,6180,18640,273,3050,1578,159,2188,410,40369,104,28859,27281,21101,7891
2022-03-11 12:30:00+00,7128,722,6181,18571,256,3052,1567,229,1943,322,39971,103,28518,26951,20770,7850
2022-03-11 13:00:00+00,7034,659,6178,18818,245,3152,1553,232,1680,210,39761,101,28474,26921,20743,7693
2022-03-11 13:30:00+00,7224,666,6178,18792,258,3154,1599,145,1575,92,39683,102,28402,26803,20625,7890
2022-03-11 14:00:00+00,7535,719,6177,18746,258,3190,1585,155,1345,162,39872,106,28111,26526,20349,8254
2022-03-11 14:30:00+00,7724,775,6182,18640,271,3192,1574,146,903,32,39439,111,27570,25996,19814,8499
2022-03-11 15:00:00+00,8124,859,6187,18461,318,3050,1590,147,829,78,39643,116,27385,25795,19608,8983
2022-03-11 15:30:00+00,8692,916,6189,18376,347,3050,1560,153,734,26,40043,122,27206,25646,19457,9608
2022-03-11 16:00:00+00,8998,755,6188,18402,410,3070,1461,162,714,0,40160,120,27175,25714,19526,9753
2022-03-11 16:30:00+00,9433,814,6187,18348,386,3076,1420,191,548,250,40653,125,26889,25469,19282,10247
2022-03-11 17:00:00+00,10000,976,6190,18178,386,2942,1551,191,213,1048,41675,130,26518,24967,18777,10976
2022-03-11 17:30:00+00,10402,996,6193,17816,443,2940,1690,204,26,1188,41898,134,26168,24478,18285,11398
2022-03-11 18:00:00+00,10646,928,6191,17435,695,2798,1684,429,0,1346,42152,136,26005,24321,18130,11574
2022-03-11 18:30:00+00,10714,957,6192,16825,699,2796,1687,431,0,1490,41791,139,25403,23716,17524,11671
2022-03-11 19:00:00+00,10642,996,6185,16139,686,3068,1689,407,0,1330,41142,141,24699,23010,16825,11638
2022-03-11 19:30:00+00,10332,996,6191,15812,679,3070,1680,328,0,898,39986,142,24362,22682,16491,11328
2022-03-11 20:00:00+00,9975,992,6186,15636,645,3020,1595,220,0,446,38715,141,24062,22467,16281,10967
2022-03-11 20:30:00+00,9489,992,6185,15379,457,3020,1485,173,0,40,37220,141,23506,22021,15836,10481
2022-03-11 21:00:00+00,8172,997,6183,15202,447,3050,1231,185,0,62,35529,133,23063,21832,15649,9169
2022-03-11 21:30:00+00,6932,873,6185,15158,429,3050,1253,169,0,0,34049,121,23025,21772,15587,7805
2022-03-11 22:00:00+00,6693,663,6181,15027,350,3050,1193,180,0,0,33337,114,22751,21558,15377,7356
2022-03-11 22:30:00+00,5550,522,6185,15068,334,3052,1070,164,0,0,31945,100,22657,21587,15402,6072
2022-03-11 23:00:00+00,3629,270,6179,15238,364,3048,1049,163,0,0,29940,74,22830,21781,15602,3899
2022-03-11 23:30:00+00,3154,230,6084,15132,336,3048,1045,162,0,0,29191,68,22597,21552,15468,3384
2022-03-12 00:00:00+00,2891,229,5744,14973,259,3052,1043,162,0,0,28353,68,22019,20976,15232,3120
2022-03-12 00:30:00+00,2757,231,5725,15087,246,3052,1053,163,0,0,28314,66,22111,21058,15333,2988
2022-03-12 01:00:00+00,2847,230,5698,15084,262,3052,1045,163,0,0,28381,67,22089,21044,15346,3077
2022-03-12 01:30:00+00,2633,230,5636,14883,261,3052,1041,162,0,0,27898,65,21821,20780,15144,2863
2022-03-12 02:00:00+00,2635,229,5628,14791,260,3050,1043,162,0,0,27798,65,21722,20679,15051,2864
2022-03-12 02:30:00+00,2656,229,5625,14767,261,3050,1043,163,0,0,27794,66,21696,20653,15028,2885
2022-03-12 03:00:00+00,2711,230,5620,14272,260,3050,1041,163,0,0,27347,68,21193,20152,14532,2941
2022-03-12 03:30:00+00,2766,230,5616,13858,261,3048,1062,175,0,0,27016,70,20797,19735,14119,2996
2022-03-12 04:00:00+00,2731,230,5617,14130,261,2940,1049,167,0,0,27125,68,21057,20008,14391,2961
2022-03-12 04:30:00+00,2631,229,5613,14498,262,2938,1040,167,0,0,27378,66,21413,20373,14760,2860
2022-03-12 05:00:00+00,2598,230,5612,14678,267,2758,1041,164,0,0,27348,64,21598,20557,14945,2828
2022-03-12 05:30:00+00,2650,229,5609,14472,277,2756,1044,163,0,0,27200,65,21402,20358,14749,2879
2022-03-12 06:00:00+00,2791,229,5604,14613,317,2984,1084,180,0,0,27802,67,21618,20534,14930,3020
2022-03-12 06:30:00+00,3270,230,5605,14354,464,2986,1167,178,56,66,28376,73,21646,20479,14874,3500
2022-03-12 07:00:00+00,3992,235,5612,14282,518,3050,1150,178,493,314,29824,80,22055,20905,15293,4227
2022-03-12 07:30:00+00,5050,542,5612,13449,486,3050,1401,160,1436,220,31406,99,22384,20983,15371,5592
2022-03-12 08:00:00+00,5634,866,5613,13032,481,3206,1518,147,2492,0,32989,111,23136,21618,16005,6500
2022-03-12 08:30:00+00,5478,887,5614,13423,482,3238,1520,180,3281,0,34103,106,24320,22800,17186,6365
2022-03-12 09:00:00+00,5527,573,5614,13822,480,3872,1239,158,4109,60,35454,94,25264,24025,18411,6100
2022-03-12 09:30:00+00,5369,458,5621,14359,459,3908,1072,147,4556,0,35949,87,26067,24995,19374,5827
2022-03-12 10:00:00+00,5414,573,5615,14202,382,3648,1088,175,4923,0,36020,91,26210,25122,19507,5987
2022-03-12 10:30:00+00,4973,668,5622,14341,353,3594,1119,143,5024,0,35837,89,26459,25340,19718,5641
2022-03-12 11:00:00+00,4540,627,5623,14913,351,3050,1181,141,5455,0,35881,82,27523,26342,20719,5167
2022-03-12 11:30:00+00,3921,516,5618,15182,361,3050,1109,160,5838,0,35755,73,28108,26999,21381,4437
2022-03-12 12:00:00+00,3584,597,5619,15375,374,3068,1060,149,5779,0,35605,71,28207,27147,21528,4181
2022-03-12 12:30:00+00,3540,621,5624,15037,375,3068,1077,157,5583,0,35082,73,27696,26619,20995,4161
2022-03-12 13:00:00+00,3842,560,5620,14750,374,3050,1087,157,5560,0,35000,75,27391,26304,20684,4402
2022-03-12 13:30:00+00,3875,557,5607,14354,375,3050,1106,144,4800,0,33868,77,26242,25136,19529,4432
2022-03-12 14:00:00+00,4155,623,5520,13835,384,2852,1189,156,4296,0,33010,83,25224,24035,18515,4778
2022-03-12 14:30:00+00,4242,802,5470,13377,386,2902,1285,163,4459,12,33098,90,24977,23692,18222,5044
2022-03-12 15:00:00+00,4241,874,5468,13006,429,3324,1404,172,3497,142,32557,99,23804,22400,16932,5115
2022-03-12 15:30:00+00,4748,948,5466,12591,450,3552,1505,190,2744,298,32492,111,22756,21251,15785,5696
2022-03-12 16:00:00+00,5751,966,5488,12441,550,3480,1521,226,1949,822,33194,123,21949,20428,14940,6717
2022-03-12 16:30:00+00,7190,992,5567,12580,713,3508,1522,275,1000,1046,34393,137,21382,19860,14293,8182
2022-03-12 17:00:00+00,8288,996,5649,13072,730,3306,1524,309,372,1180,35426,143,21347,19823,14174,9284
2022-03-12 17:30:00+00,8788,989,5678,13162,744,3340,1522,324,46,1736,36329,146,21152,19630,13952,9777
2022-03-12 18:00:00+00,8409,990,5676,13630,645,4378,1521,303,0,1786,37338,142,21472,19951,14275,9399
2022-03-12 18:30:00+00,8815,988,5676,14075,590,4414,1509,225,0,1632,37924,144,21850,20341,14665,9803
2022-03-12 19:00:00+00,8330,967,5679,14629,577,4516,1407,226,0,722,37053,139,22292,20885,15206,9297
2022-03-12 19:30:00+00,7565,845,5677,15247,592,4402,1256,224,0,166,35974,130,22772,21516,15839,8410
2022-03-12 20:00:00+00,7507,932,5675,15742,608,3892,1145,193,0,118,35812,132,23170,22025,16350,8439
2022-03-12 20:30:00+00,6840,865,5674,15904,603,3506,1042,188,0,0,34622,124,23223,22181,16507,7705
2022-03-12 21:00:00+00,5963,404,5667,15884,577,3610,1077,245,0,0,33427,108,23205,22128,16461,6367
2022-03-12 21:30:00+00,5333,32,5670,16082,537,3424,1046,188,0,0,32312,89,23335,22289,16619,5365
2022-03-12 22:00:00+00,3906,0,5659,16057,496,3550,1069,211,0,0,30948,76,23281,22212,16553,3906
2022-03-12 22:30:00+00,3238,0,5593,16018,479,3478,1049,188,0,0,30043,69,23139,22090,16497,3238
2022-03-12 23:00:00+00,2884,0,5509,16449,459,2332,1053,188,0,0,28874,59,23470,22417,16908,2884
2022-03-12 23:30:00+00,2791,0,5471,16350,515,2218,1042,180,0,0,28567,57,23378,22336,16865,2791
2022-03-13 00:00:00+00,2811,0,5465,16177,522,2226,1053,170,0,0,28424,57,23217,22164,16699,2811
2022-03-13 00:30:00+00,3290,0,5456,16182,521,2226,1062,180,0,0,28917,64,23221,22159,16703,3290
2022-03-13 01:00:00+00,3916,0,5445,16189,513,1638,1060,178,0,0,28939,72,23207,22147,16702,3916
2022-03-13 01:30:00+00,3713,0,5472,16241,515,1362,1042,166,0,0,28511,67,23270,22228,16756,3713
2022-03-13 02:00:00+00,3978,0,5559,16123,525,706,1068,181,0,0,28140,71,23275,22207,16648,3978
2022-03-13 02:30:00+00,3843,0,5642,16081,515,588,1048,169,0,0,27886,69,23286,22238,16596,3843
2022-03-13 03:00:00+00,3435,0,5666,16418,482,640,1056,171,0,0,27868,64,23622,22566,16900,3435
2022-03-13 03:30:00+00,2817,0,5664,16508,482,528,1040,184,0,0,27223,55,23694,22654,16990,2817
2022-03-13 04:00:00+00,2949,0,5659,16555,483,458,1052,188,0,0,27344,57,23749,22697,17038,2949
2022-03-13 04:30:00+00,2946,0,5664,16747,487,298,1104,185,0,0,27431,54,24002,22898,17234,2946
2022-03-13 05:00:00+00,3532,0,5669,16880,491,440,1356,196,0,0,28564,64,24396,23040,17371,3532
2022-03-13 05:30:00+00,3868,0,5664,16792,499,560,1367,196,0,0,28946,69,24322,22955,17291,3868
2022-03-13 06:00:00+00,3246,0,5667,16853,531,668,1321,184,0,0,28470,62,24372,23051,17384,3246
2022-03-13 06:30:00+00,3156,0,5663,16795,550,858,1261,172,35,0,28490,62,24304,23043,17380,3156
2022-03-13 07:00:00+00,2895,0,5665,16783,552,1346,1070,167,314,0,28792,56,24384,23314,17649,2895
2022-03-13 07:30:00+00,3032,0,5666,16793,538,1422,1066,183,681,0,29381,58,24744,23678,18012,3032
2022-03-13 08:00:00+00,3182,0,5667,16759,552,1474,1105,186,1143,0,30068,56,25226,24121,18454,3182
2022-03-13 08:30:00+00,3388,0,5664,17305,546,1626,1311,185,1744,20,31789,58,26570,25259,19595,3388
2022-03-13 09:00:00+00,3240,0,5670,17363,558,2508,1418,170,2278,0,33205,58,27287,25869,20199,3240
2022-03-13 09:30:00+00,3154,0,5667,17426,570,2888,1393,181,2858,0,34137,58,27914,26521,20854,3154
2022-03-13 10:00:00+00,2767,0,5614,17245,574,3344,1182,173,3430,0,34329,54,28045,26863,21249,2767
2022-03-13 10:30:00+00,2901,0,5519,16738,572,3476,1195,187,4025,42,34655,56,28049,26854,21335,2901
2022-03-13 11:00:00+00,3291,0,5474,16328,572,3410,1361,170,4330,130,35066,59,28065,26704,21230,3291
2022-03-13 11:30:00+00,3966,0,5468,16045,553,3480,1369,173,3890,76,35020,68,27325,25956,20488,3966
2022-03-13 12:00:00+00,4419,0,5467,15799,552,3668,1404,175,3567,274,35325,70,26789,25385,19918,4419
2022-03-13 12:30:00+00,4350,0,5511,15784,550,3798,1422,229,3380,384,35408,70,26647,25225,19714,4350
2022-03-13 13:00:00+00,3969,0,5606,15285,542,4300,1430,203,3405,194,34934,66,26268,24838,19232,3969
2022-03-13 13:30:00+00,4139,0,5670,14839,541,4336,1441,167,3291,230,34654,68,25782,24341,18671,4139
2022-03-13 14:00:00+00,3970,0,5674,14724,541,4684,1514,171,2837,140,34255,68,25290,23776,18102,3970
2022-03-13 14:30:00+00,4284,0,5674,14595,542,4652,1408,175,2538,140,34008,71,24757,23349,17675,4284
2022-03-13 15:00:00+00,5533,68,5673,14098,542,3980,1519,178,2311,276,34178,88,24143,22624,16951,5601
2022-03-13 15:30:00+00,6317,287,5674,13757,546,4124,1707,193,1861,138,34604,104,23545,21838,16164,6604
2022-03-13 16:00:00+00,7319,566,5678,13319,569,3982,1873,193,1540,328,35367,118,22979,21106,15428,7885
2022-03-13 16:30:00+00,8592,766,5679,13302,585,4116,1987,206,1021,402,36656,135,22574,20587,14908,9358
2022-03-13 17:00:00+00,10142,954,5682,13012,650,3616,2081,192,506,678,37513,149,21931,19850,14168,11096
2022-03-13 17:30:00+00,10689,992,5681,12699,655,3724,2083,214,103,1178,38018,155,21221,19138,13457,11681
2022-03-13 18:00:00+00,10874,991,5707,12682,657,3936,2082,206,0,1520,38655,155,21128,19046,13339,11865
2022-03-13 18:30:00+00,10984,992,5753,12269,656,3970,2082,305,0,1848,38859,157,20760,18678,12925,11976
2022-03-13 19:00:00+00,10781,991,5692,11813,654,4418,2081,350,0,1442,38222,161,20240,18159,12467,11772
2022-03-13 19:30:00+00,10528,992,5567,11241,695,4266,2081,223,0,1188,36781,162,19584,17503,11936,11520
2022-03-13 20:00:00+00,10442,992,5563,11061,845,3854,2081,238,0,876,35952,166,19550,17469,11906,11434
2022-03-13 20:30:00+00,10292,993,5517,10268,700,3834,2081,224,0,866,34775,167,18566,16485,10968,11285
2022-03-13 21:00:00+00,9525,883,5427,9830,712,4248,2078,195,0,472,33370,164,18047,15969,10542,10408
2022-03-13 21:30:00+00,8797,703,5354,9704,869,4122,2069,199,0,74,31891,155,17996,15927,10573,9500
2022-03-13 22:00:00+00,8067,459,5278,9402,905,3850,2075,244,0,322,30602,148,17660,15585,10307,8526
2022-03-13 22:30:00+00,7556,325,5285,8487,900,3764,2084,215,0,440,29056,144,16756,14672,9387,7881
2022-03-13 23:00:00+00,8034,11,5368,7900,786,3296,2083,196,0,438,28112,143,16137,14054,8686,8045
2022-03-13 23:30:00+00,7794,0,5475,7737,676,3164,2088,198,0,0,27132,142,15976,13888,8413,7794
2022-03-14 00:00:00+00,7499,0,5517,7444,675,3380,2087,196,0,0,26798,149,15723,13636,8119,7499
2022-03-14 00:30:00+00,7486,0,5524,7407,794,3476,2084,195,0,0,26966,150,15809,13725,8201,7486
2022-03-14 01:00:00+00,6956,0,5532,7381,811,4314,2066,194,0,0,27254,141,15790,13724,8192,6956
2022-03-14 01:30:00+00,6720,0,5539,7047,741,4280,2134,204,0,0,26665,140,15461,13327,7788,6720
2022-03-14 02:00:00+00,6710,0,5552,6909,640,4478,2100,190,0,0,26579,140,15201,13101,7549,6710
2022-03-14 02:30:00+00,6459,0,5557,7024,630,4410,1988,192,0,0,26260,137,15199,13211,7654,6459
2022-03-14 03:00:00+00,6699,12,5572,7344,641,3666,1934,192,0,0,26060,141,15491,13557,7985,6711
2022-03-14 03:30:00+00,6553,35,5587,7331,642,3558,1746,197,0,0,25649,140,15306,13560,7973,6588
2022-03-14 04:00:00+00,6593,250,5612,6994,641,3568,1681,199,0,0,25538,149,14928,13247,7635,6843
2022-03-14 04:30:00+00,6754,641,5605,6648,644,3436,1807,204,0,0,25739,164,14704,12897,7292,7395
2022-03-14 05:00:00+00,8009,1055,5610,6542,758,2704,2101,199,0,110,27088,187,15011,12910,7300,9064
2022-03-14 05:30:00+00,8941,1355,5610,6701,872,2760,2129,220,0,0,28588,201,15312,13183,7573,10296
2022-03-14 06:00:00+00,10397,1470,5602,6912,897,2138,2134,242,0,404,30196,205,15545,13411,7809,11867
2022-03-14 06:30:00+00,12424,1478,5603,7173,897,2058,2135,262,130,558,32718,213,15938,13803,8200,13902
2022-03-14 07:00:00+00,14640,1481,5608,7140,861,2686,2127,215,847,458,36063,223,16583,14456,8848,16121
2022-03-14 07:30:00+00,15427,1478,5605,7268,853,2780,2132,276,1900,248,37967,221,17758,15626,10021,16905
2022-03-14 08:00:00+00,15338,1478,5606,7486,765,3096,2134,219,3141,30,39293,214,19132,16998,11392,16816
2022-03-14 08:30:00+00,14982,1477,5512,7724,724,2996,2129,196,4111,0,39851,206,20200,18071,12559,16459
2022-03-14 09:00:00+00,14666,1477,5424,8076,836,2886,2148,196,5040,0,40749,197,21524,19376,13952,16143
2022-03-14 09:30:00+00,14000,1469,5412,8499,687,2877,2046,194,5869,0,41053,189,22513,20467,15055,15469
2022-03-14 10:00:00+00,13860,1128,5409,8853,660,2441,1963,218,6560,0,41093,178,23445,21482,16073,14988
2022-03-14 10:30:00+00,13235,690,5485,9449,662,2431,1770,209,6972,0,40903,162,24338,22568,17083,13925
2022-03-14 11:00:00+00,12547,691,5590,9646,657,2692,1803,197,7257,0,41080,156,24953,23150,17560,13238
2022-03-14 11:30:00+00,12073,691,5615,10012,646,2682,1827,226,7251,0,41023,152,25351,23524,17909,12764
2022-03-14 12:00:00+00,12852,689,5624,10176,644,2408,1786,197,6953,0,41329,157,25183,23397,17773,13541
2022-03-14 12:30:00+00,12869,688,5621,10299,646,2396,1707,199,6789,0,41215,157,25062,23355,17734,13557
2022-03-14 13:00:00+00,12338,690,5631,10451,644,1939,1814,198,6334,0,40038,150,24874,23060,17429,13028
2022-03-14 13:30:00+00,12216,691,5637,10319,643,1922,2008,207,5959,0,39602,151,24566,22558,16921,12907
2022-03-14 14:00:00+00,13011,689,5647,10284,646,1222,2024,202,5491,0,39215,156,24092,22068,16421,13700
2022-03-14 14:30:00+00,13019,691,5647,10392,639,1211,2022,193,4788,0,38603,158,23488,21466,15820,13710
2022-03-14 15:00:00+00,13527,904,5598,10506,642,1047,2031,198,3989,0,38442,169,22766,20735,15137,14431
2022-03-14 15:30:00+00,14353,1357,5533,10647,652,1049,2022,194,3191,0,38998,185,22045,20023,14490,15710
2022-03-14 16:00:00+00,15753,1468,5537,10613,716,1050,2124,208,2394,0,39863,198,21384,19260,13723,17221
2022-03-14 16:30:00+00,16227,1469,5536,10418,926,1051,2293,282,1605,650,40457,201,20778,18485,12949,17696
2022-03-14 17:00:00+00,17449,1469,5542,10324,989,1051,2287,274,664,1090,41139,209,19806,17519,11977,18918
2022-03-14 17:30:00+00,18148,1363,5648,10081,1014,1051,2273,359,130,1746,41813,211,19146,16873,11225,19511
2022-03-14 18:00:00+00,18397,1215,5681,9681,1023,1050,2266,377,0,2034,41724,211,18651,16385,10704,19612
2022-03-14 18:30:00+00,19369,1277,5682,9161,1025,1050,2250,313,0,2196,42323,218,18118,15868,10186,20646
2022-03-14 19:00:00+00,19232,1383,5689,8644,957,1986,2233,268,0,1284,41676,228,17523,15290,9601,20615
2022-03-14 19:30:00+00,19165,1375,5693,7939,932,2095,2235,192,0,564,40190,237,16799,14564,8871,20540
2022-03-14 20:00:00+00,18701,1444,5690,7347,848,2288,2265,219,0,510,39312,240,16150,13885,8195,20145
2022-03-14 20:30:00+00,18219,1474,5691,6561,842,2292,2268,191,0,32,37570,247,15362,13094,7403,19693
2022-03-14 21:00:00+00,16936,1475,5689,6148,817,2392,2274,209,0,52,35992,245,14928,12654,6965,18411
2022-03-14 21:30:00+00,15503,1473,5641,5996,773,2426,2267,164,0,48,34291,240,14677,12410,6769,16976
2022-03-14 22:00:00+00,14614,1152,5578,5736,734,2280,2264,163,0,30,32551,233,14312,12048,6470,15766
2022-03-14 22:30:00+00,13688,455,5587,5610,687,2194,2243,167,0,50,30681,213,14127,11884,6297,14143
2022-03-14 23:00:00+00,11068,152,5590,5669,653,2838,2094,162,0,0,28226,186,14006,11912,6322,11220
2022-03-14 23:30:00+00,10010,0,5643,5487,623,2920,1963,168,0,0,26814,174,13716,11753,6110,10010
2022-03-15 00:00:00+00,10329,0,5758,4942,599,3056,1729,165,0,42,26620,181,13028,11299,5541,10329
2022-03-15 00:30:00+00,10969,0,5815,4757,596,3174,1730,164,0,0,27205,189,12898,11168,5353,10969
2022-03-15 01:00:00+00,11043,0,5825,4810,581,2672,2128,163,0,0,27222,188,13344,11216,5391,11043
2022-03-15 01:30:00+00,10916,0,5822,4856,580,2618,2221,166,0,0,27179,186,13479,11258,5436,10916
2022-03-15 02:00:00+00,10854,0,5825,5029,565,2996,2184,164,0,0,27617,188,13603,11419,5594,10854
2022-03-15 02:30:00+00,10685,0,5822,5028,565,2926,2189,164,0,0,27379,186,13604,11415,5593,10685
2022-03-15 03:00:00+00,10858,0,5822,5188,551,2522,2133,161,0,0,27235,185,13694,11561,5739,10858
2022-03-15 03:30:00+00,10447,0,5828,5546,551,2536,2122,162,0,0,27192,180,14047,11925,6097,10447
2022-03-15 04:00:00+00,10986,0,5834,5815,551,1810,2180,167,0,0,27343,179,14380,12200,6366,10986
2022-03-15 04:30:00+00,10755,133,5838,6097,551,1804,2153,161,0,0,27492,179,14639,12486,6648,10888
2022-03-15 05:00:00+00,10837,387,5842,6382,527,1662,1907,174,0,0,27718,184,14658,12751,6909,11224
2022-03-15 05:30:00+00,11366,621,5844,6554,451,1662,1837,168,0,0,28503,194,14686,12849,7005,11987
2022-03-15 06:00:00+00,13256,887,5844,6786,546,2080,2111,171,0,0,31681,213,15287,13176,7332,14143
2022-03-15 06:30:00+00,14616,1110,5842,6867,579,2112,2262,244,123,140,33895,222,15673,13411,7569,15726
2022-03-15 07:00:00+00,16129,1381,5826,6979,611,1840,2257,275,757,276,36331,228,16430,14173,8347,17510
2022-03-15 07:30:00+00,16372,1471,5823,7127,725,1840,2248,453,1523,272,37854,225,17446,15198,9375,17843
2022-03-15 08:00:00+00,16582,1472,5809,7523,768,2124,2259,289,2459,0,39285,220,18818,16559,10750,18054
2022-03-15 08:30:00+00,16284,1472,5800,7702,761,2030,2264,269,3179,50,39811,213,19706,17442,11642,17756
2022-03-15 09:00:00+00,16151,1473,5789,7909,739,1952,2269,353,3774,580,40989,206,20480,18211,12422,17624
2022-03-15 09:30:00+00,16201,1473,5750,8126,736,1864,2263,339,4017,216,40985,205,20892,18629,12879,17674
2022-03-15 10:00:00+00,16114,1474,5650,7837,718,1260,2269,328,4513,748,40911,198,20987,18718,13068,17588
2022-03-15 10:30:00+00,15784,1471,5581,8176,708,1260,2265,306,5207,348,41106,194,21937,19672,14091,17255
2022-03-15 11:00:00+00,15404,1473,5578,8529,649,1260,2259,224,5825,0,41201,189,22840,20581,15003,16877
2022-03-15 11:30:00+00,15021,1472,5579,8590,600,1260,2247,151,6386,14,41320,184,23402,21155,15576,16493
2022-03-15 12:00:00+00,14598,1468,5628,8674,572,1488,2097,120,6232,0,40877,184,23203,21106,15478,16066
2022-03-15 12:30:00+00,14334,1470,5695,8954,572,1488,2016,115,6033,0,40677,182,23270,21254,15559,15804
2022-03-15 13:00:00+00,14091,1320,5690,9071,573,1510,2137,162,5875,0,40429,177,23346,21209,15519,15411
2022-03-15 13:30:00+00,14206,1133,5680,9248,574,1486,2142,118,4981,0,39568,177,22625,20483,14803,15339
2022-03-15 14:00:00+00,14470,990,5602,9307,574,1432,2048,132,4293,64,38912,180,21824,19776,14174,15460
2022-03-15 14:30:00+00,14596,1406,5537,9367,574,1386,2102,147,3403,0,38518,193,20983,18881,13344,16002
2022-03-15 15:00:00+00,15175,1460,5526,9400,618,1354,2227,164,2639,50,38613,200,20410,18183,12657,16635
2022-03-15 15:30:00+00,16501,1472,5529,9020,677,1382,2252,160,1963,82,39038,212,19441,17189,11660,17973
2022-03-15 16:00:00+00,18266,1472,5593,8735,730,1352,2257,172,1326,154,40057,223,18641,16384,10791,19738
2022-03-15 16:30:00+00,19043,1473,5669,8715,769,1298,2259,287,776,636,40925,226,18188,15929,10260,20516
2022-03-15 17:00:00+00,18949,1478,5685,8676,903,1260,2269,382,344,1414,41360,224,17877,15608,9923,20427
2022-03-15 17:30:00+00,19162,1448,5677,8725,935,1313,2286,595,65,1798,42004,223,17688,15402,9725,20610
2022-03-15 18:00:00+00,19467,1444,5664,8679,941,1676,2291,743,0,1492,42397,227,17575,15284,9620,20911
2022-03-15 18:30:00+00,19340,1469,5654,8974,961,1738,2291,621,0,1506,42554,226,17880,15589,9935,20809
2022-03-15 19:00:00+00,19392,1469,5642,8973,962,1852,2292,311,0,782,41675,232,17869,15577,9935,20861
2022-03-15 19:30:00+00,18671,1473,5640,9229,954,1828,2290,176,0,346,40607,230,18113,15823,10183,20144
2022-03-15 20:00:00+00,18307,1450,5631,9548,778,1486,2218,155,0,16,39589,229,18175,15957,10326,19757
2022-03-15 20:30:00+00,17063,1246,5617,9815,773,1468,2006,153,0,16,38157,219,18211,16205,10588,18309
2022-03-15 21:00:00+00,15650,1110,5594,9842,726,1332,2101,149,0,0,36504,208,18263,16162,10568,16760
2022-03-15 21:30:00+00,13920,766,5547,9748,705,1298,2253,151,0,0,34388,192,18253,16000,10453,14686
2022-03-15 22:00:00+00,12954,315,5341,9659,627,1350,2244,154,0,0,32644,177,17871,15627,10286,13269
2022-03-15 22:30:00+00,12392,2,5227,9047,573,1292,1993,166,0,64,30756,169,16840,14847,9620,12394
2022-03-15 23:00:00+00,11887,0,5210,8668,578,1246,1678,151,0,0,29418,168,16134,14456,9246,11887
2022-03-15 23:30:00+00,11430,0,5089,8586,581,1321,1696,151,0,0,28854,165,15952,14256,9167,11430
2022-03-16 00:00:00+00,11164,0,4865,8275,397,1814,1679,152,0,0,28346,171,15216,13537,8672,11164
2022-03-16 00:30:00+00,11648,0,4862,7719,397,1860,1694,153,0,0,28333,178,14672,12978,8116,11648
2022-03-16 01:00:00+00,11593,0,4940,7282,396,1718,1693,153,0,0,27775,180,14311,12618,7678,11593
2022-03-16 01:30:00+00,11331,0,4985,6876,397,1704,1689,154,0,0,27136,180,13947,12258,7273,11331
2022-03-16 02:00:00+00,11366,0,4986,6410,397,1458,1688,153,0,0,26458,182,13481,11793,6807,11366
2022-03-16 02:30:00+00,11518,0,4983,6231,396,1458,1676,152,0,0,26414,184,13286,11610,6627,11518
2022-03-16 03:00:00+00,11577,0,4935,6002,397,1260,1716,154,0,0,26041,185,13050,11334,6399,11577
2022-03-16 03:30:00+00,11733,0,4866,5691,397,1260,1691,152,0,0,25790,189,12645,10954,6088,11734
2022-03-16 04:00:00+00,12325,1,4869,5499,396,1260,1733,152,0,0,26235,195,12497,10764,5895,12326
2022-03-16 04:30:00+00,12347,148,4890,5290,396,1260,1850,150,0,0,26331,200,12426,10576,5686,12495
2022-03-16 05:00:00+00,13205,354,4983,5228,517,1260,1793,151,0,0,27491,211,12521,10728,5745,13559
2022-03-16 05:30:00+00,13882,527,5168,5023,523,1267,1831,152,0,0,28373,220,12545,10714,5546,14409
2022-03-16 06:00:00+00,16217,863,5253,4951,542,1274,2083,150,0,0,31333,239,12829,10746,5493,17080
2022-03-16 06:30:00+00,18189,1099,5305,4709,560,1260,2196,191,46,56,33611,254,12816,10620,5315,19288
2022-03-16 07:00:00+00,18442,1091,5352,4557,581,2080,2162,164,207,0,34636,255,12859,10697,5345,19533
2022-03-16 07:30:00+00,19621,1098,5388,4366,585,2190,2293,173,445,14,36173,259,13077,10784,5396,20719
2022-03-16 08:00:00+00,19644,1244,5431,4287,586,3374,2288,161,669,134,37818,258,13261,10973,5542,20888
2022-03-16 08:30:00+00,19809,1451,5474,4316,593,3402,2292,163,802,10,38312,261,13477,11185,5711,21260
2022-03-16 09:00:00+00,20180,1475,5519,4155,582,3962,2292,192,903,322,39582,258,13451,11159,5640,21655
2022-03-16 09:30:00+00,20387,1474,5547,4247,581,3998,2292,201,910,16,39653,260,13577,11285,5738,21861
2022-03-16 10:00:00+00,20412,1471,5550,4147,583,3684,2290,162,1125,410,39834,258,13695,11405,5855,21883
2022-03-16 10:30:00+00,20372,1469,5552,4032,575,3668,2288,183,1229,492,39860,258,13676,11388,5836,21841
2022-03-16 11:00:00+00,20505,1472,5552,4141,594,3360,2291,172,1359,810,40256,255,13937,11646,6094,21977
2022-03-16 11:30:00+00,20529,1471,5552,4264,564,3358,2287,172,1374,360,39931,258,14041,11754,6202,22000
2022-03-16 12:00:00+00,20638,1467,5556,4604,563,3314,2268,188,1325,202,40125,257,14316,12048,6492,22105
2022-03-16 12:30:00+00,20626,1463,5564,4789,564,3302,2267,209,1240,136,40160,257,14424,12157,6593,22089
2022-03-16 13:00:00+00,20512,1470,5564,4884,545,3278,2266,172,1055,442,40188,256,14314,12048,6484,21982
2022-03-16 13:30:00+00,20569,1475,5576,4960,555,3240,2265,167,782,240,39829,259,14138,11873,6297,22044
2022-03-16 14:00:00+00,20439,1475,5576,5423,555,2776,2256,149,630,110,39389,259,14440,12184,6608,21914
2022-03-16 14:30:00+00,20275,1476,5540,5850,557,2782,2255,153,482,16,39386,258,14684,12429,6889,21751
2022-03-16 15:00:00+00,20567,1472,5458,5912,556,3050,2257,161,389,162,39984,258,14572,12315,6857,22039
2022-03-16 15:30:00+00,20748,1470,5410,6036,554,3066,2258,155,363,44,40104,259,14621,12363,6953,22218
2022-03-16 16:00:00+00,20793,1466,5403,6178,672,2900,2261,197,326,182,40378,257,14840,12579,7176,22259
2022-03-16 16:30:00+00,20834,1467,5411,6236,688,2924,2260,197,274,854,41145,253,14869,12609,7198,22301
2022-03-16 17:00:00+00,20727,1284,5474,6610,833,2966,2260,265,173,1402,41994,243,15350,13090,7616,22011
2022-03-16 17:30:00+00,20607,973,5571,7006,832,2988,2280,479,73,1438,42246,236,15762,13482,7910,21580
2022-03-16 18:00:00+00,20186,969,5600,6912,833,2994,2294,578,0,2024,42390,231,15639,13345,7745,21155
2022-03-16 18:30:00+00,20797,970,5609,6587,836,2996,2295,442,0,1916,42448,236,15327,13032,7423,21767
2022-03-16 19:00:00+00,20867,1102,5609,6469,839,3280,2260,312,0,954,41692,243,15177,12917,7308,21969
2022-03-16 19:30:00+00,19849,1090,5607,6714,835,3282,2189,243,0,528,40337,241,15345,13156,7549,20939
2022-03-16 20:00:00+00,19435,1017,5607,7258,769,3192,2147,206,0,54,39685,238,15781,13634,8027,20452
2022-03-16 20:30:00+00,17219,855,5606,8099,616,3190,2097,205,0,0,37887,222,16418,14321,8715,18074
2022-03-16 21:00:00+00,14762,858,5610,8456,516,3024,2106,179,0,366,35877,206,16688,14582,8972,15620
2022-03-16 21:30:00+00,13404,668,5615,8451,511,3026,2087,151,0,82,33995,197,16664,14577,8962,14072
2022-03-16 22:00:00+00,12040,321,5612,8484,473,3260,1970,156,0,86,32402,181,16539,14569,8957,12361
2022-03-16 22:30:00+00,10595,7,5613,8517,451,3272,1835,155,0,0,30445,163,16416,14581,8968,10602
2022-03-16 23:00:00+00,7883,0,5634,8605,449,3672,1629,151,0,0,28023,139,16317,14688,9054,7883
2022-03-16 23:30:00+00,6469,0,5658,8831,442,3770,1562,150,0,0,26882,124,16493,14931,9273,6469
2022-03-17 00:00:00+00,6110,0,5660,9258,331,3808,1694,149,0,0,27010,118,16943,15249,9589,6110
2022-03-17 00:30:00+00,6302,0,5660,9484,327,3900,1671,150,0,0,27494,120,17142,15471,9811,6302
2022-03-17 01:00:00+00,6323,0,5668,9488,325,4032,1552,149,0,0,27537,123,17033,15481,9813,6323
2022-03-17 01:30:00+00,5944,0,5674,9535,326,4160,1555,150,0,0,27344,120,17090,15535,9861,5944
2022-03-17 02:00:00+00,5835,0,5712,9562,325,4314,1586,152,0,0,27486,119,17185,15599,9887,5835
2022-03-17 02:30:00+00,5864,0,5739,9234,325,4316,1638,160,0,0,27276,121,16936,15298,9559,5864
2022-03-17 03:00:00+00,5592,0,5753,9285,323,4448,1679,150,0,0,27230,117,17040,15361,9608,5592
2022-03-17 03:30:00+00,5247,0,5756,9452,323,4452,1623,148,0,0,27001,113,17154,15531,9775,5247
2022-03-17 04:00:00+00,5654,0,5752,9314,320,4098,1654,151,0,0,26943,118,17040,15386,9634,5654
2022-03-17 04:30:00+00,5908,0,5755,9149,319,4080,1686,150,0,0,27047,122,16909,15223,9468,5908
2022-03-17 05:00:00+00,6449,169,5754,9034,319,3368,1920,159,0,0,27172,134,17027,15107,9353,6618
2022-03-17 05:30:00+00,7217,351,5760,9340,364,3364,2063,148,0,48,28655,144,17527,15464,9704,7568
2022-03-17 06:00:00+00,8431,507,5761,9634,464,3348,1844,152,0,44,30185,156,17703,15859,10098,8938
2022-03-17 06:30:00+00,9494,719,5762,9921,502,3366,1951,196,247,0,32157,166,18382,16431,10670,10213
2022-03-17 07:00:00+00,10428,962,5764,10222,540,3656,1966,248,1159,0,34946,171,19652,17685,11921,11390
2022-03-17 07:30:00+00,10931,1011,5767,10556,550,3660,1976,316,2412,0,37179,168,21261,19285,13518,11942
2022-03-17 08:00:00+00,11266,929,5766,10913,541,3836,1982,263,3586,0,39081,161,22787,20806,15040,12195
2022-03-17 08:30:00+00,11478,835,5763,11293,530,3834,1988,175,4715,0,40611,155,24289,22301,16538,12313
2022-03-17 09:00:00+00,11660,1258,5750,11689,531,2733,1993,169,5726,122,41631,160,25690,23697,17946,12918
2022-03-17 09:30:00+00,11740,1023,5736,12092,416,2691,1991,172,6459,0,42321,152,26694,24703,18967,12763
2022-03-17 10:00:00+00,11823,971,5736,12520,309,2522,1994,152,6988,0,43014,149,27547,25553,19817,12794
2022-03-17 10:30:00+00,11881,212,5740,12949,50,2536,2000,28,7287,0,42683,133,28026,26026,20286,12093
2022-03-17 11:00:00+00,12023,0,5751,13348,0,2925,2011,0,7483,0,43540,129,28593,26582,20831,12023
2022-03-17 11:30:00+00,12104,425,5757,13663,100,3247,2023,54,7263,0,44637,138,28806,26783,21026,12529
2022-03-17 12:00:00+00,12218,1275,5762,13890,301,3354,2037,163,7189,0,46188,154,29179,27142,21380,13493
2022-03-17 12:30:00+00,12225,696,5765,14028,303,3113,2049,149,7169,0,45497,140,29314,27265,21500,12921
2022-03-17 13:00:00+00,12326,687,5767,14118,327,2868,2064,151,6740,0,45048,140,29015,26951,21185,13013
2022-03-17 13:30:00+00,12396,689,5769,14188,323,2734,2079,153,6101,0,44432,142,28460,26381,20612,13085
2022-03-17 14:00:00+00,12589,773,5769,14247,321,1867,2097,161,5660,0,43484,145,28094,25996,20228,13362
2022-03-17 14:30:00+00,12910,1022,5771,14279,335,1874,2114,165,4725,0,43195,155,27224,25110,19339,13932
2022-03-17 15:00:00+00,13343,1301,5772,14265,333,1710,2127,156,3571,0,42578,165,26069,23942,18169,14644
2022-03-17 15:30:00+00,14042,1297,5774,14196,347,1777,2143,161,2665,0,42402,173,25125,22982,17208,15339
2022-03-17 16:00:00+00,14672,1299,5774,14050,403,1378,2159,147,2016,0,41899,177,24402,22244,16469,15971
2022-03-17 16:30:00+00,15348,1336,5776,13845,393,1321,2173,153,1379,200,41925,184,23566,21393,15617,16684
2022-03-17 17:00:00+00,15764,1352,5778,13327,444,1380,2184,167,680,1026,42103,188,22413,20229,14451,17116
2022-03-17 17:30:00+00,16039,1348,5781,12217,458,1340,2193,371,162,1530,41439,194,20811,18618,12837,17387
2022-03-17 18:00:00+00,16861,1350,5784,11609,630,1617,2290,632,1,1080,41854,205,20314,18024,12240,18211
2022-03-17 18:30:00+00,17060,1348,5776,10969,697,1676,2272,798,0,1810,42406,207,19714,17442,11666,18408
2022-03-17 19:00:00+00,16708,1279,5778,10560,693,2624,2282,664,0,574,41161,212,19313,17031,11253,17987
2022-03-17 19:30:00+00,16433,1352,5773,10324,692,2757,2274,253,0,696,40553,211,19063,16789,11016,17785
2022-03-17 20:00:00+00,16444,1344,5778,9956,584,2370,2260,222,0,412,39370,216,18578,16318,10540,17788
2022-03-17 20:30:00+00,15882,1317,5776,9875,539,2370,2264,169,0,0,38192,215,18454,16190,10414,17199
2022-03-17 21:00:00+00,14536,1334,5781,9784,450,2236,2274,163,0,0,36558,210,18289,16015,10234,15870
2022-03-17 21:30:00+00,13315,1217,5778,9178,469,2236,2137,165,0,0,34495,205,17562,15425,9647,14532
2022-03-17 22:00:00+00,12647,770,5777,8524,440,2196,2279,168,0,216,33017,195,17020,14741,8964,13417
2022-03-17 22:30:00+00,12214,306,5773,7942,438,2210,2173,163,0,138,31357,185,16326,14153,8380,12520
2022-03-17 23:00:00+00,11152,1,5768,7238,421,2184,2093,160,0,292,29309,172,15520,13427,7659,11153
2022-03-17 23:30:00+00,10469,0,5774,6678,400,2196,2265,148,0,212,28142,170,15117,12852,7078,10469
2022-03-18 00:00:00+00,10456,0,5778,6194,325,2728,2223,151,0,0,27855,172,14520,12297,6519,10456
2022-03-18 00:30:00+00,10920,0,5794,5593,411,2760,2267,158,0,408,28311,176,14065,11798,6004,10920
2022-03-18 01:00:00+00,10997,0,5797,4968,458,3298,2266,169,0,0,27953,180,13489,11223,5426,10997
2022-03-18 01:30:00+00,11259,0,5791,4293,448,3320,2267,154,0,0,27532,187,12799,10532,4741,11259
2022-03-18 02:00:00+00,11321,0,5800,4132,376,3218,2270,152,0,0,27269,190,12578,10308,4508,11321
2022-03-18 02:30:00+00,11466,0,5803,3776,305,3210,2127,155,0,0,26842,194,12011,9884,4081,11466
2022-03-18 03:00:00+00,11916,0,5806,3485,298,2736,2025,154,0,0,26420,201,11614,9589,3783,11916
2022-03-18 03:30:00+00,11948,0,5815,3299,291,2742,2030,151,0,0,26276,203,11435,9405,3590,11948
2022-03-18 04:00:00+00,12081,0,5821,3224,400,2382,2055,149,0,0,26112,204,11500,9445,3624,12081
2022-03-18 04:30:00+00,12322,0,5832,3232,402,2464,2055,150,0,0,26457,206,11521,9466,3634,12322
2022-03-18 05:00:00+00,12300,166,5834,3698,420,2218,2187,148,0,0,26971,211,12139,9952,4118,12466
2022-03-18 05:30:00+00,12580,386,5835,3912,442,2238,2271,149,0,40,27853,216,12460,10189,4354,12966
2022-03-18 06:00:00+00,13863,599,5837,4145,526,2458,2266,153,0,0,29847,225,12774,10508,4671,14462
2022-03-18 06:30:00+00,15198,839,5838,4169,545,2480,2280,211,277,232,32069,233,13109,10829,4991,16037
2022-03-18 07:00:00+00,15413,903,5839,4669,616,4422,2286,161,1029,84,35422,225,14439,12153,6314,16316
2022-03-18 07:30:00+00,15444,749,5838,5162,618,4490,2292,178,2007,206,36984,213,15917,13625,7787,16193
2022-03-18 08:00:00+00,15607,676,5836,5343,621,4446,2292,207,3039,216,38283,205,17131,14839,9003,16283
2022-03-18 08:30:00+00,15456,680,5839,5345,615,4316,2272,175,4059,0,38757,200,18130,15858,10019,16136
2022-03-18 09:00:00+00,15390,731,5837,5375,534,3926,2238,160,5089,0,39280,195,19073,16835,10998,16121
2022-03-18 09:30:00+00,14095,552,5834,5489,478,4262,2039,185,6111,0,39045,178,19951,17912,12078,14647
2022-03-18 10:00:00+00,13353,554,5835,5824,382,4264,1867,161,7094,0,39334,168,21002,19135,13300,13907
2022-03-18 10:30:00+00,12344,514,5831,6372,357,4262,1705,149,7817,0,39351,157,22082,20377,14546,12858
2022-03-18 11:00:00+00,11337,497,5826,6734,348,3930,1847,150,8157,0,38826,148,22912,21065,15239,11834
2022-03-18 11:30:00+00,11817,490,5822,6988,333,3262,1987,170,8283,52,39204,151,23413,21426,15604,12307
2022-03-18 12:00:00+00,11247,486,5828,7088,397,3858,1899,167,8339,0,39309,146,23551,21652,15824,11733
2022-03-18 12:30:00+00,10893,478,5829,7364,397,3972,1707,158,8157,0,38955,143,23454,21747,15918,11371
2022-03-18 13:00:00+00,10289,488,5819,7559,296,4032,1722,214,7811,0,38230,139,23207,21485,15666,10777
2022-03-18 13:30:00+00,9958,490,5821,7734,304,4068,1723,207,7151,0,37456,139,22733,21010,15189,10448
2022-03-18 14:00:00+00,9300,482,5826,7994,311,3846,1653,166,6813,0,36391,138,22597,20944,15118,9782
2022-03-18 14:30:00+00,9209,514,5831,8189,316,3750,1560,152,6221,0,35742,139,22117,20557,14726,9723
2022-03-18 15:00:00+00,10598,610,5832,8211,302,3208,1663,149,5272,0,35845,156,21280,19617,13785,11208
2022-03-18 15:30:00+00,11420,526,5832,8148,323,3250,1811,154,4313,0,35777,165,20427,18616,12784,11946
2022-03-18 16:00:00+00,12554,531,5832,8198,540,2334,1976,154,3310,44,35473,170,19856,17880,12048,13085
2022-03-18 16:30:00+00,13317,741,5829,8280,608,2352,2202,162,2271,50,35812,183,19190,16988,11159,14058
2022-03-18 17:00:00+00,13878,892,5823,8467,621,2772,2287,171,1119,278,36308,195,18317,16030,10207,14770
2022-03-18 17:30:00+00,14503,892,5816,8732,527,2878,2295,233,269,482,36627,202,17639,15344,9528,15395
2022-03-18 18:00:00+00,14638,878,5818,9085,626,3424,2295,264,4,682,37714,200,17828,15533,9715,15516
2022-03-18 18:30:00+00,14758,904,5812,9484,563,3502,2223,266,0,844,38356,199,18082,15859,10047,15662
2022-03-18 19:00:00+00,14590,904,5814,9837,645,3580,2291,212,0,454,38327,198,18587,16296,10482,15494
2022-03-18 19:30:00+00,13930,805,5815,10502,639,3466,2217,169,0,0,37543,191,19173,16956,11141,14735
2022-03-18 20:00:00+00,12667,692,5814,11067,527,3462,1836,166,0,0,36231,181,19244,17408,11594,13359
2022-03-18 20:30:00+00,11285,625,5814,11348,560,3466,1552,158,0,0,34808,169,19274,17722,11908,11910
2022-03-18 21:00:00+00,8982,525,5818,11893,484,4242,1445,150,0,0,33539,148,19640,18195,12377,9507
2022-03-18 21:30:00+00,7739,262,5819,12236,469,4200,1322,151,0,0,32198,130,19846,18524,12705,8001
2022-03-18 22:00:00+00,6837,230,5817,12379,350,3454,1308,150,0,0,30525,124,19854,18546,12729,7067
2022-03-18 22:30:00+00,5539,230,5815,12519,314,3462,1235,149,0,0,29263,112,19883,18648,12833,5769
2022-03-18 23:00:00+00,3845,228,5812,12430,297,3692,1150,152,0,0,27606,95,19689,18539,12727,4073
2022-03-18 23:30:00+00,3408,222,5814,12065,286,3778,1137,154,0,0,26864,92,19302,18165,12351,3630
2022-03-19 00:00:00+00,3437,0,5812,11773,271,4280,1145,162,0,0,26880,79,19001,17856,12044,3437
2022-03-19 00:30:00+00,3231,0,5819,11974,385,4290,1148,151,0,0,26998,76,19326,18178,12359,3231
2022-03-19 01:00:00+00,3065,0,5814,11936,384,3946,1156,157,0,0,26458,74,19290,18134,12320,3065
2022-03-19 01:30:00+00,2887,0,5815,11732,385,3928,1135,154,0,0,26036,73,19067,17932,12117,2887
2022-03-19 02:00:00+00,2969,0,5818,11468,368,3332,1148,160,0,0,25263,74,18802,17654,11836,2969
2022-03-19 02:30:00+00,2878,0,5812,11338,347,3326,1243,160,0,0,25104,73,18740,17497,11685,2878
2022-03-19 03:00:00+00,3065,0,5813,11292,359,2648,1276,164,0,0,24617,71,18740,17464,11651,3065
2022-03-19 03:30:00+00,3129,0,5816,11207,365,2646,1294,170,0,0,24627,72,18682,17388,11572,3129
2022-03-19 04:00:00+00,3222,0,5815,11063,251,2536,1305,175,0,0,24367,73,18434,17129,11314,3222
2022-03-19 04:30:00+00,3032,0,5822,11152,250,2530,1283,151,0,0,24220,70,18507,17224,11402,3032
2022-03-19 05:00:00+00,2831,0,5823,11270,250,3124,1198,148,0,0,24644,70,18541,17343,11520,2831
2022-03-19 05:30:00+00,2877,0,5825,11496,254,3126,1183,148,0,0,24909,70,18758,17575,11750,2877
2022-03-19 06:00:00+00,2836,0,5825,11496,379,3674,1142,154,0,0,25506,72,18842,17700,11875,2836
2022-03-19 06:30:00+00,3068,0,5824,11378,423,3710,1206,185,357,0,26151,75,19188,17982,12158,3068
2022-03-19 07:00:00+00,3507,0,5830,11378,471,4176,1277,162,1327,0,28128,77,20283,19006,13176,3507
2022-03-19 07:30:00+00,3607,0,5834,11489,473,4194,1261,159,2512,20,29549,74,21569,20308,14474,3607
2022-03-19 08:00:00+00,3748,0,5827,11753,523,4096,1066,189,3707,234,31143,72,22876,21810,15983,3748
2022-03-19 08:30:00+00,3521,0,5829,11836,538,4090,945,185,4850,344,32138,66,23998,23053,17224,3521
2022-03-19 09:00:00+00,3381,0,5830,12428,540,4076,925,165,5925,0,33270,62,25648,24723,18893,3381
2022-03-19 09:30:00+00,2833,0,5829,12828,453,4076,841,160,6883,0,33903,54,26834,25993,20164,2833
2022-03-19 10:00:00+00,2553,0,5829,13267,385,3684,811,150,7694,0,34373,49,27986,27175,21346,2553
2022-03-19 10:30:00+00,2494,0,5824,13214,362,3556,791,149,8348,0,34738,47,28539,27748,21924,2494
2022-03-19 11:00:00+00,2509,0,5818,13068,330,3346,793,151,8811,0,34826,46,28820,28027,22209,2509
2022-03-19 11:30:00+00,2354,0,5820,13453,314,3386,790,149,9100,0,35366,44,29477,28687,22867,2354
2022-03-19 12:00:00+00,2358,0,5818,13773,231,3142,795,150,9186,0,35453,42,29803,29008,23190,2358
2022-03-19 12:30:00+00,2160,0,5821,13945,185,3216,801,150,9093,0,35371,41,29845,29044,23223,2160
2022-03-19 13:00:00+00,2072,0,5820,14196,184,2804,801,157,8783,0,34817,40,29784,28983,23163,2072
2022-03-19 13:30:00+00,2093,0,5817,13991,185,2754,805,168,8288,0,34101,41,29086,28281,22464,2093
2022-03-19 14:00:00+00,2119,0,5821,14263,184,2608,807,160,7608,0,33570,44,28683,27876,22055,2119
2022-03-19 14:30:00+00,2442,0,5818,14601,184,2672,791,150,6775,0,33433,48,28169,27378,21560,2442
2022-03-19 15:00:00+00,2642,0,5817,14383,200,3112,803,161,5804,0,32922,52,27007,26204,20387,2642
2022-03-19 15:30:00+00,2877,0,5817,14739,204,3106,816,189,4726,0,32474,55,26302,25486,19669,2877
2022-03-19 16:00:00+00,3617,0,5822,15655,203,2466,814,198,3584,0,32359,55,26078,25264,19442,3617
2022-03-19 16:30:00+00,4921,0,5823,16155,292,2414,849,203,2390,36,33083,69,25509,24660,18837,4921
2022-03-19 17:00:00+00,5457,0,5821,16646,346,2840,819,187,1184,424,33724,77,24816,23997,18176,5457
2022-03-19 17:30:00+00,6272,0,5823,17241,387,2972,909,211,291,532,34638,86,24651,23742,17919,6272
2022-03-19 18:00:00+00,6507,0,5821,17451,385,3168,904,167,6,1108,35517,88,24567,23663,17842,6507
2022-03-19 18:30:00+00,7183,0,5815,17489,385,3224,936,211,0,1196,36439,94,24625,23689,17874,7183
2022-03-19 19:00:00+00,6934,0,5820,17619,386,3204,935,182,0,1122,36202,91,24760,23825,18005,6934
2022-03-19 19:30:00+00,6269,0,5818,17561,381,3168,886,158,0,1024,35265,85,24646,23760,17942,6269
2022-03-19 20:00:00+00,6428,0,5816,17574,293,3180,930,159,0,364,34744,89,24613,23683,17867,6428
2022-03-19 20:30:00+00,6038,0,5818,17508,278,3156,914,172,0,88,33972,86,24518,23604,17786,6038
2022-03-19 21:00:00+00,5199,0,5819,17423,278,3248,919,161,0,0,33047,80,24439,23520,17701,5199
2022-03-19 21:30:00+00,4078,0,5824,17130,278,3228,969,141,0,0,31648,69,24201,23232,17408,4078
2022-03-19 22:00:00+00,3467,0,5827,16822,258,2748,1100,140,0,0,30362,61,24007,22907,17080,3467
2022-03-19 22:30:00+00,3005,0,5821,16094,254,2776,1094,136,0,0,29180,58,23263,22169,16348,3005
2022-03-19 23:00:00+00,2976,0,5823,15479,254,2056,1071,147,0,0,27806,57,22627,21556,15733,2976
2022-03-19 23:30:00+00,2994,0,5821,14968,251,2006,1066,149,0,0,27255,57,22106,21040,15219,2994
2022-03-20 00:00:00+00,2882,0,5815,14682,238,2642,1067,148,0,0,27474,59,21802,20735,14920,2882
2022-03-20 00:30:00+00,3109,0,5817,14283,218,2762,1190,145,0,0,27524,64,21508,20318,14501,3109
2022-03-20 01:00:00+00,3111,0,5815,13928,216,2192,1206,136,0,0,26604,60,21165,19959,14144,3111
2022-03-20 01:30:00+00,3110,0,5822,13408,215,2126,1071,134,0,0,25886,60,20516,19445,13623,3110
2022-03-20 02:00:00+00,3341,0,5823,13036,216,2066,1108,132,0,0,25722,64,20183,19075,13252,3341
2022-03-20 02:30:00+00,3370,0,5826,12705,215,2038,1108,136,0,0,25398,65,19854,18746,12920,3370
2022-03-20 03:00:00+00,3485,0,5825,12406,215,2002,1171,137,0,0,25241,67,19617,18446,12621,3485
2022-03-20 03:30:00+00,3495,0,5827,12469,216,1944,1166,134,0,0,25251,66,19678,18512,12685,3495
2022-03-20 04:00:00+00,3468,0,5826,12455,215,1962,1161,136,0,0,25223,66,19657,18496,12670,3468
2022-03-20 04:30:00+00,3748,0,5822,11969,216,2000,1166,139,0,0,25060,72,19173,18007,12185,3748
2022-03-20 05:00:00+00,4004,0,5826,11842,220,2074,1244,138,0,0,25348,77,19132,17888,12062,4004
2022-03-20 05:30:00+00,4046,0,5829,12239,231,2054,1161,147,0,0,25707,75,19460,18299,12470,4046
2022-03-20 06:00:00+00,3937,0,5825,12574,232,1808,1085,183,18,0,25662,73,19734,18649,12824,3937
2022-03-20 06:30:00+00,4544,0,5825,12189,232,1648,1201,155,417,158,26369,78,19864,18663,12838,4544
2022-03-20 07:00:00+00,4820,0,5828,12299,248,1660,1204,152,1372,0,27583,84,20951,19747,13919,4820
2022-03-20 07:30:00+00,5267,0,5827,11966,250,1762,1218,159,2536,0,28985,87,21797,20579,14752,5267
2022-03-20 08:00:00+00,4354,0,5829,12062,293,3004,1289,149,3668,0,30648,77,23141,21852,16023,4354
2022-03-20 08:30:00+00,4382,0,5827,12099,310,3062,1294,137,4666,0,31777,74,24196,22902,17075,4382
2022-03-20 09:00:00+00,5169,0,5825,12054,295,2882,1344,147,5569,0,33285,80,25087,23743,17918,5169
2022-03-20 09:30:00+00,5536,0,5828,11712,300,2896,1335,153,6364,0,34124,82,25539,24204,18376,5536
2022-03-20 10:00:00+00,5469,0,5827,11882,307,2636,1235,132,6962,0,34450,80,26213,24978,19151,5469
2022-03-20 10:30:00+00,5002,0,5821,11958,314,2630,1230,136,7429,0,34520,74,26752,25522,19701,5002
2022-03-20 11:00:00+00,5035,0,5813,11769,289,2588,1220,136,7490,0,34340,75,26581,25361,19548,5035
2022-03-20 11:30:00+00,5227,0,5813,11764,281,2588,1226,133,7884,0,34916,76,26968,25742,19929,5227
2022-03-20 12:00:00+00,5571,0,5809,11638,266,2646,1278,143,7900,0,35251,79,26891,25613,19804,5571
2022-03-20 12:30:00+00,5860,0,5811,11432,268,2642,1297,134,7778,0,35222,82,26586,25289,19478,5860
2022-03-20 13:00:00+00,6100,0,5815,10928,276,2570,1377,135,7456,0,34657,86,25852,24475,18660,6100
2022-03-20 13:30:00+00,6611,0,5813,10302,277,2568,1365,137,7133,0,34206,93,24890,23525,17712,6611
2022-03-20 14:00:00+00,7338,0,5816,9517,277,2534,1500,138,6635,20,33775,102,23745,22245,16429,7338
2022-03-20 14:30:00+00,8185,0,5816,8961,272,2538,1553,152,5661,30,33168,115,22263,20710,14894,8185
2022-03-20 15:00:00+00,8980,27,5824,8231,272,2804,1551,140,4802,62,32693,126,20680,19129,13305,9007
2022-03-20 15:30:00+00,10340,196,5824,7686,291,2826,1563,144,3962,146,32978,146,19326,17763,11939,10536
2022-03-20 16:00:00+00,11908,472,5826,7000,331,3352,1620,166,2970,4,33649,170,17747,16127,10301,12380
2022-03-20 16:30:00+00,13664,681,5827,6332,538,3392,1665,247,1982,404,34732,191,16344,14679,8852,14345
2022-03-20 17:00:00+00,14858,859,5828,5719,705,3520,1684,438,1038,724,35373,207,14974,13290,7462,15717
2022-03-20 17:30:00+00,15658,899,5829,5134,764,3550,1804,654,301,1086,35679,218,13832,12028,6199,16557
2022-03-20 18:00:00+00,15893,900,5828,4831,771,3624,2045,733,10,1756,36391,218,13485,11440,5612,16793
2022-03-20 18:30:00+00,16486,899,5825,4651,703,3622,2205,765,0,1984,37140,220,13384,11179,5354,17385
2022-03-20 19:00:00+00,16210,890,5825,4697,723,4228,2224,722,0,1816,37335,220,13469,11245,5420,17100
2022-03-20 19:30:00+00,16349,851,5827,4811,611,4228,2240,499,0,1028,36444,224,13489,11249,5422,17200
2022-03-20 20:00:00+00,16560,814,5825,4763,523,3786,2252,410,0,556,35489,229,13363,11111,5286,17374
2022-03-20 20:30:00+00,16178,737,5824,4667,514,3704,2252,381,0,0,34257,230,13257,11005,5181,16915
2022-03-20 21:00:00+00,15945,836,5821,4623,508,3032,2251,282,0,150,33448,233,13203,10952,5131,16781
2022-03-20 21:30:00+00,15127,721,5822,4417,469,3028,2251,267,0,192,32294,227,12959,10708,4886,15848
2022-03-20 22:00:00+00,14183,836,5822,4278,437,2960,2215,261,0,44,31036,228,12752,10537,4715,15019
2022-03-20 22:30:00+00,12944,801,5823,4138,412,2964,2248,248,0,32,29610,221,12621,10373,4550,13745
2022-03-20 23:00:00+00,11732,331,5824,3989,385,3408,2129,244,0,0,28042,204,12327,10198,4374,12063
2022-03-20 23:30:00+00,11352,261,5821,3824,377,3420,2075,192,0,0,27322,200,12097,10022,4201,11613
2022-03-21 00:00:00+00,11213,277,5825,3535,260,3392,1992,115,0,0,26609,207,11612,9620,3795,11490
2022-03-21 00:30:00+00,11403,280,5820,3313,261,3392,2081,129,0,0,26679,210,11475,9394,3574,11683
2022-03-21 01:00:00+00,11420,257,5823,3019,234,3448,2106,132,0,0,26439,212,11182,9076,3253,11677
2022-03-21 01:30:00+00,11482,282,5820,2807,215,3448,2057,133,0,0,26244,215,10899,8842,3022,11764
2022-03-21 02:00:00+00,11042,235,5826,2674,213,3374,2134,131,0,0,25629,211,10847,8713,2887,11277
2022-03-21 02:30:00+00,10890,231,5828,2614,210,3372,2107,132,0,0,25384,211,10759,8652,2824,11121
2022-03-21 03:00:00+00,11133,230,5824,2514,209,3300,2080,131,0,0,25421,213,10627,8547,2723,11363
2022-03-21 03:30:00+00,11118,231,5823,2401,207,3321,2015,133,0,0,25249,215,10446,8431,2608,11349
2022-03-21 04:00:00+00,11393,294,5824,2409,207,3440,2000,133,0,0,25700,219,10440,8440,2616,11687
2022-03-21 04:30:00+00,11758,232,5830,2430,206,3424,2041,130,0,0,26051,220,10507,8466,2636,11990
2022-03-21 05:00:00+00,12442,282,5826,2449,286,2576,2069,137,0,0,26067,224,10630,8561,2735,12724
2022-03-21 05:30:00+00,13676,464,5829,2534,286,2582,2102,140,0,0,27613,236,10751,8649,2820,14140
2022-03-21 06:00:00+00,15069,810,5829,2590,354,2998,1989,160,27,50,29876,254,10789,8800,2971,15879
2022-03-21 06:30:00+00,16649,1085,5831,2543,389,2880,2120,330,380,14,32221,263,11263,9143,3312,17734
2022-03-21 07:00:00+00,17375,1017,5827,2419,521,3806,2151,435,1062,116,34729,253,11980,9829,4002,18392
2022-03-21 07:30:00+00,18424,1147,5832,2319,536,3858,2154,571,1899,286,37026,253,12740,10586,4754,19571
2022-03-21 08:00:00+00,18838,1246,5831,2182,530,4706,2155,275,2738,258,38759,247,13436,11281,5450,20084
2022-03-21 08:30:00+00,18762,1290,5833,2018,513,5122,2156,174,3565,0,39433,243,14085,11929,6096,20052
2022-03-21 09:00:00+00,18688,1334,5830,1995,372,5240,2172,186,4395,60,40272,239,14764,12592,6762,20022
2022-03-21 09:30:00+00,18149,1341,5850,1877,344,5254,2168,155,5209,0,40347,233,15448,13280,7430,19490
2022-03-21 10:00:00+00,18128,1344,5834,1821,317,4742,1956,135,5906,20,40203,232,15834,13878,8044,19472
2022-03-21 10:30:00+00,18148,1108,5827,1767,323,4702,1759,154,6390,0,40178,227,16066,14307,8480,19256
2022-03-21 11:00:00+00,17859,1034,5823,1691,228,4446,1923,171,6546,122,39843,224,16211,14288,8465,18893
2022-03-21 11:30:00+00,18107,847,5821,1673,231,4448,1817,153,6215,0,39312,225,15757,13940,8119,18954
2022-03-21 12:00:00+00,18112,821,5818,1709,240,4570,1842,147,6141,0,39400,224,15750,13908,8090,18933
2022-03-21 12:30:00+00,17600,854,5814,1785,242,4576,2192,147,6171,44,39425,221,16204,14012,8198,18454
2022-03-21 13:00:00+00,16917,988,5814,1755,258,4682,2229,148,5918,42,38751,221,15974,13745,7931,17905
2022-03-21 13:30:00+00,16527,1307,5818,1874,272,4652,2232,149,5312,0,38143,228,15508,13276,7458,17834
2022-03-21 14:00:00+00,17476,1317,5814,2037,270,3872,2231,149,4779,0,37945,236,15131,12900,7086,18793
2022-03-21 14:30:00+00,17577,1170,5820,2291,284,3854,2202,147,4247,0,37592,235,14844,12642,6822,18747
2022-03-21 15:00:00+00,17885,1175,5821,2593,413,3588,2083,150,3545,0,37253,239,14455,12372,6551,19060
2022-03-21 15:30:00+00,18374,1262,5826,2869,467,3660,2124,148,2733,0,37463,246,14019,11895,6069,19636
2022-03-21 16:00:00+00,19135,1351,5826,3053,565,3454,2228,168,2024,0,37804,253,13696,11468,5642,20486
2022-03-21 16:30:00+00,19446,1349,5827,3333,639,3546,2231,217,1407,368,38363,254,13437,11206,5379,20795
2022-03-21 17:00:00+00,19340,1349,5836,3490,819,3034,2228,230,774,1656,38756,245,13147,10919,5083,20689
2022-03-21 17:30:00+00,19628,1350,5846,3711,818,3114,2229,470,207,1858,39231,247,12811,10582,4736,20978
2022-03-21 18:00:00+00,19899,1347,5830,3977,863,3204,2230,649,8,1882,39889,248,12908,10678,4848,21246
2022-03-21 18:30:00+00,20048,1348,5833,4222,905,3324,2229,670,0,1922,40501,247,13189,10960,5127,21396
2022-03-21 19:00:00+00,19949,1353,5830,4542,853,4048,2229,534,0,814,40152,253,13454,11225,5395,21302
2022-03-21 19:30:00+00,19758,1350,5829,4730,804,3994,2226,333,0,38,39062,256,13589,11363,5534,21108
2022-03-21 20:00:00+00,19642,1351,5826,4846,609,4086,2223,181,0,56,38820,256,13504,11280,5454,20993
2022-03-21 20:30:00+00,18596,1345,5828,4828,446,4036,2229,163,0,14,37485,253,13331,11102,5274,19941
2022-03-21 21:00:00+00,16714,1291,5829,4818,413,4116,2208,145,0,0,35534,245,13268,11060,5231,18005
2022-03-21 21:30:00+00,15185,1041,5832,4902,407,4146,1916,148,0,0,33577,234,13057,11141,5309,16226
2022-03-21 22:00:00+00,14218,799,5832,5029,374,3940,1590,152,0,26,31960,225,12825,11235,5403,15017
2022-03-21 22:30:00+00,13167,428,5829,5157,360,3862,1438,162,0,4,30407,210,12784,11346,5517,13595
2022-03-21 23:00:00+00,12002,234,5832,5248,361,3846,1253,148,0,0,28924,197,12694,11441,5609,12236
2022-03-21 23:30:00+00,10990,245,5830,5078,361,4006,1264,149,0,0,27923,193,12533,11269,5439,11235
2022-03-22 00:00:00+00,10980,239,5834,4734,253,4116,1257,144,0,0,27557,195,12078,10821,4987,11219
2022-03-22 00:30:00+00,11922,229,5830,4488,248,3846,1258,146,0,0,27967,207,11824,10566,4736,12151
2022-03-22 01:00:00+00,11767,233,5830,4205,247,3450,1250,145,0,0,27127,211,11532,10282,4452,12000
2022-03-22 01:30:00+00,11422,231,5829,4060,248,3426,1249,144,0,0,26609,209,11386,10137,4308,11653
2022-03-22 02:00:00+00,11424,233,5829,3961,229,3308,1253,146,0,0,26383,210,11272,10019,4190,11657
2022-03-22 02:30:00+00,11343,239,5824,3868,225,3306,1258,146,0,0,26209,210,11175,9917,4093,11582
2022-03-22 03:00:00+00,11886,237,5827,3878,224,2694,1258,148,0,0,26152,211,11187,9929,4102,12123
2022-03-22 03:30:00+00,11775,240,5823,3788,224,2694,1261,149,0,0,25954,211,11096,9835,4012,12015
2022-03-22 04:00:00+00,12070,237,5827,3685,243,2320,1252,146,0,0,25780,215,11007,9755,3928,12307
2022-03-22 04:30:00+00,12200,295,5825,3570,244,2266,1251,147,0,0,25798,218,10890,9639,3814,12495
2022-03-22 05:00:00+00,12888,573,5826,3454,342,1800,1256,174,0,38,26351,228,10878,9622,3796,13461
2022-03-22 05:30:00+00,13522,869,5829,3400,357,1802,1273,272,0,104,27428,239,10859,9586,3757,14391
2022-03-22 06:00:00+00,14261,1231,5833,3399,499,2220,1509,303,29,20,29304,249,11269,9760,3927,15492
2022-03-22 06:30:00+00,14628,1515,5831,3732,623,2348,1589,424,401,640,31731,246,12176,10587,4756,16143
2022-03-22 07:00:00+00,14540,1586,5833,3867,586,4570,1596,269,1096,348,34291,241,12978,11382,5549,16126
2022-03-22 07:30:00+00,14957,1736,5833,3950,576,4652,1599,256,2019,300,35878,238,13977,12378,6545,16693
2022-03-22 08:00:00+00,15056,1793,5832,4074,522,4960,1448,179,2956,170,36990,233,14832,13384,7552,16849
2022-03-22 08:30:00+00,14980,1778,5836,4007,473,4822,1415,157,3931,0,37399,227,15662,14247,8411,16758
2022-03-22 09:00:00+00,15140,1753,5829,3871,375,4340,1418,163,4857,0,37746,225,16350,14932,9103,16893
2022-03-22 09:30:00+00,14588,1666,5832,4002,372,4260,1316,165,5964,0,38165,214,17486,16170,10338,16254
2022-03-22 10:00:00+00,14540,1759,5829,4148,343,3422,1341,209,6669,0,38260,214,18330,16989,11160,16299
2022-03-22 10:30:00+00,13619,1761,5819,4341,345,3422,1424,206,7404,0,38341,204,19333,17909,12090,15380
2022-03-22 11:00:00+00,12900,1451,5825,4618,347,3462,1441,166,7834,0,38044,191,20065,18624,12799,14351
2022-03-22 11:30:00+00,12285,1223,5823,4860,346,3462,1440,155,8113,20,37727,180,20582,19142,13319,13508
2022-03-22 12:00:00+00,11873,1222,5819,5146,330,3664,1440,151,8152,0,37797,176,20887,19447,13628,13095
2022-03-22 12:30:00+00,11564,1146,5814,5165,331,3684,1443,153,8044,0,37344,173,20797,19354,13540,12710
2022-03-22 13:00:00+00,12051,929,5817,5340,330,3238,1359,161,7700,0,36925,174,20546,19187,13370,12980
2022-03-22 13:30:00+00,11849,918,5821,5369,339,3200,1325,161,7224,0,36206,174,20078,18753,12932,12767
2022-03-22 14:00:00+00,12364,1119,5816,5338,341,2890,1342,174,6506,0,35890,186,19343,18001,12185,13483
2022-03-22 14:30:00+00,12701,1482,5821,5182,340,2804,1302,156,5678,0,35466,201,18323,17021,11200,14183
2022-03-22 15:00:00+00,14322,1789,5820,4987,366,2048,1309,162,4914,30,35747,219,17396,16087,10267,16111
2022-03-22 15:30:00+00,16302,1786,5821,4858,390,1112,1414,183,4087,124,36077,239,16570,15156,9335,18088
2022-03-22 16:00:00+00,18212,1800,5823,4685,457,1064,1432,164,3028,0,36665,252,15425,13993,8170,20012
2022-03-22 16:30:00+00,19855,1797,5821,4502,494,1144,1553,204,2031,256,37657,265,14401,12848,7027,21652
2022-03-22 17:00:00+00,20195,1795,5825,4505,712,1070,1627,329,1109,1150,38317,264,13778,12151,6326,21990
2022-03-22 17:30:00+00,20123,1796,5824,4590,741,1160,1627,422,361,1984,38628,263,13143,11516,5692,21919
2022-03-22 18:00:00+00,20150,1625,5825,4794,847,1048,1614,519,21,2238,38681,258,13101,11487,5662,21775
2022-03-22 18:30:00+00,20640,1750,5826,4963,834,1116,1605,579,0,2244,39557,261,13228,11623,5797,22390
2022-03-22 19:00:00+00,20298,1785,5826,5261,690,2352,1608,433,0,874,39127,269,13385,11777,5951,22083
2022-03-22 19:30:00+00,19825,1736,5828,5526,704,2362,1596,340,0,124,38041,270,13654,12058,6230,21561
2022-03-22 20:00:00+00,19631,1609,5824,5512,521,1966,1592,210,0,604,37469,264,13449,11857,6033,21240
2022-03-22 20:30:00+00,19255,1561,5822,5518,449,1942,1594,182,0,52,36375,266,13383,11789,5967,20816
2022-03-22 21:00:00+00,18584,1582,5821,5431,393,1574,1580,181,0,0,35146,268,13225,11645,5824,20166
2022-03-22 21:30:00+00,17487,1028,5824,5288,372,1652,1559,162,0,28,33400,254,13043,11484,5660,18515
2022-03-22 22:00:00+00,16021,624,5823,5104,360,1808,1559,167,0,96,31562,241,12846,11287,5464,16645
2022-03-22 22:30:00+00,14850,354,5824,4725,359,1754,1559,173,0,112,29710,231,12467,10908,5084,15204
2022-03-22 23:00:00+00,13359,318,5825,4398,360,1984,1559,155,0,34,27992,222,12142,10583,4758,13677
2022-03-22 23:30:00+00,12721,235,5824,4182,361,1912,1559,154,0,0,26948,217,11926,10367,4543,12956
2022-03-23 00:00:00+00,12273,232,5827,4001,327,2202,1558,155,0,0,26575,218,11713,10155,4328,12505
2022-03-23 00:30:00+00,12709,230,5827,3690,327,2206,1557,156,0,0,26702,223,11401,9844,4017,12939
2022-03-23 01:00:00+00,12906,231,5830,3465,320,2554,1412,153,0,0,26871,227,11027,9615,3785,13137
2022-03-23 01:30:00+00,12918,231,5829,3230,313,2558,1262,152,0,0,26493,229,10634,9372,3543,13149
2022-03-23 02:00:00+00,13248,233,5828,2911,292,2402,1263,156,0,0,26333,235,10294,9031,3203,13481
2022-03-23 02:30:00+00,13243,231,5808,2601,287,2400,1525,153,0,0,26248,237,10221,8696,2888,13474
2022-03-23 03:00:00+00,13478,271,5745,2426,286,2120,1560,160,0,0,26046,241,10017,8457,2712,13749
2022-03-23 03:30:00+00,13442,322,5751,2225,286,2120,1560,154,0,0,25860,244,9822,8262,2511,13764
2022-03-23 04:00:00+00,13424,242,5749,2136,285,2160,1561,156,0,0,25713,242,9731,8170,2421,13666
2022-03-23 04:30:00+00,13581,391,5750,2032,291,2070,1613,156,0,0,25884,248,9686,8073,2323,13972
2022-03-23 05:00:00+00,14961,797,5753,1952,396,898,1643,157,0,120,26677,262,9744,8101,2348,15758
2022-03-23 05:30:00+00,16044,917,5748,1918,437,978,1673,157,0,12,27884,271,9776,8103,2355,16961
2022-03-23 06:00:00+00,15638,977,5750,1881,569,1744,1717,196,54,88,28614,273,9971,8254,2504,16615
2022-03-23 06:30:00+00,16372,1194,5745,1828,591,1892,2001,336,505,352,30816,274,10670,8669,2924,17566
2022-03-23 07:00:00+00,16593,1501,5746,1781,591,3504,2250,229,1304,180,33679,270,11672,9422,3676,18094
2022-03-23 07:30:00+00,16741,1576,5745,1795,573,3484,2285,283,2092,432,35006,262,12490,10205,4460,18317
2022-03-23 08:00:00+00,16671,1631,5741,1808,442,4222,2251,208,3123,174,36271,253,13365,11114,5373,18302
2022-03-23 08:30:00+00,16464,1767,5749,1734,423,4158,2251,167,4137,0,36850,249,14294,12043,6294,18231
2022-03-23 09:00:00+00,16489,1797,5744,1534,372,3460,2286,173,5161,278,37294,246,15097,12811,7067,18286
2022-03-23 09:30:00+00,16238,1750,5754,1478,371,3436,2288,160,6152,30,37657,239,16043,13755,8001,17988
2022-03-23 10:00:00+00,15986,1782,5748,1489,364,2742,2287,165,6820,68,37451,238,16708,14421,8673,17768
2022-03-23 10:30:00+00,15479,1798,5755,1641,295,2740,2285,162,7544,0,37699,231,17520,15235,9480,17277
2022-03-23 11:00:00+00,15621,1783,5752,1830,242,2642,2272,158,7983,0,38283,228,18079,15807,10055,17404
2022-03-23 11:30:00+00,15236,1794,5761,1966,148,2642,2260,158,8230,0,38195,225,18365,16105,10344,17030
2022-03-23 12:00:00+00,14524,1798,5762,2121,144,2626,2219,156,8275,0,37625,221,18521,16302,10540,16322
2022-03-23 12:30:00+00,14139,1799,5749,2344,144,2660,2114,157,8080,0,37186,219,18431,16317,10568,15938
2022-03-23 13:00:00+00,14252,1749,5749,2562,144,2680,2237,154,7780,0,37307,219,18472,16235,10486,16001
2022-03-23 13:30:00+00,13939,1713,5747,2645,144,2682,2248,150,7336,0,36604,219,18120,15872,10125,15652
2022-03-23 14:00:00+00,14542,1614,5755,2637,146,2652,2249,152,6628,0,36375,224,17415,15166,9411,16156
2022-03-23 14:30:00+00,14958,1643,5765,2574,156,2652,2250,152,5799,0,35949,232,16544,14294,8529,16601
2022-03-23 15:00:00+00,15840,1784,5785,2476,302,2076,2254,152,4861,0,35530,243,15678,13424,7639,17624
2022-03-23 15:30:00+00,16954,1802,5792,2363,343,2048,2265,155,3885,0,35607,255,14648,12383,6591,18756
2022-03-23 16:00:00+00,18815,1798,5800,2198,412,2006,2287,176,2756,0,36248,272,13453,11166,5366,20613
2022-03-23 16:30:00+00,19324,1799,5798,1916,445,2006,2298,325,1848,124,35883,281,12305,10007,4209,21122
2022-03-23 17:00:00+00,19833,1802,5818,1690,724,1950,2300,346,1025,1196,36684,280,11557,9257,3439,21635
2022-03-23 17:30:00+00,20046,1800,5816,1563,848,1966,2302,522,338,1878,37079,280,10867,8565,2749,21846
2022-03-23 18:00:00+00,19999,1803,5819,1450,891,2558,2301,674,20,1972,37487,281,10481,8180,2361,21802
2022-03-23 18:30:00+00,20913,1798,5817,1325,887,2584,2299,788,0,1916,38327,286,10328,8029,2212,22711
2022-03-23 19:00:00+00,20919,1800,5817,1268,742,3596,2299,498,0,1582,38521,286,10126,7827,2010,22719
2022-03-23 19:30:00+00,20821,1800,5815,1186,741,3640,2299,412,0,948,37662,291,10041,7742,1927,22621
2022-03-23 20:00:00+00,20958,1802,5814,1128,700,2554,2298,327,0,300,35881,303,9940,7642,1828,22760
2022-03-23 20:30:00+00,20884,1692,5808,1068,436,2492,2295,193,0,98,34966,306,9607,7312,1504,22576
2022-03-23 21:00:00+00,20619,1358,5809,1054,370,2371,2298,159,0,72,34110,300,9531,7233,1424,21977
2022-03-23 21:30:00+00,19461,1234,5805,1073,343,2336,2297,164,0,0,32713,295,9518,7221,1416,20695
2022-03-23 22:00:00+00,17925,789,5808,1059,310,2570,2257,154,0,0,30872,282,9434,7177,1369,18714
2022-03-23 22:30:00+00,16808,392,5804,1056,307,2570,1989,169,0,0,29095,270,9156,7167,1363,17200
2022-03-23 23:00:00+00,15909,109,5808,1105,305,2408,1559,158,0,0,27361,261,8777,7218,1410,16018
2022-03-23 23:30:00+00,15066,0,5808,1198,299,2428,1509,153,0,0,26461,254,8814,7305,1497,15066
2022-03-24 00:00:00+00,14814,0,5814,1223,273,2713,1596,152,0,0,26584,251,8906,7310,1496,14814
2022-03-24 00:30:00+00,15193,0,5819,1270,254,2737,1601,171,0,0,27045,253,8944,7343,1524,15193
2022-03-24 01:00:00+00,15258,0,5822,1294,233,2702,1627,152,0,0,27088,252,8976,7349,1527,15258
2022-03-24 01:30:00+00,14909,0,5824,1269,232,2675,1566,152,0,0,26627,251,8891,7325,1501,14909
2022-03-24 02:00:00+00,15349,0,5826,1256,146,2192,1513,152,0,0,26434,255,8741,7228,1402,15349
2022-03-24 02:30:00+00,15095,0,5828,1320,140,2146,1526,150,0,0,26205,253,8814,7288,1460,15095
2022-03-24 03:00:00+00,15218,0,5824,1394,125,1670,1567,154,0,0,25952,252,8910,7343,1519,15218
2022-03-24 03:30:00+00,14977,0,5824,1446,125,1668,1596,151,0,0,25787,250,8991,7395,1571,14977
2022-03-24 04:00:00+00,15528,0,5827,1421,232,1110,1608,161,0,0,25887,253,9088,7480,1653,15528
2022-03-24 04:30:00+00,15390,108,5821,1427,231,1110,1618,158,0,0,25863,255,9097,7479,1658,15498
2022-03-24 05:00:00+00,15739,381,5820,1475,404,952,1597,141,0,84,26593,260,9296,7699,1879,16120
2022-03-24 05:30:00+00,16087,604,5822,1514,462,818,1597,151,0,208,27263,264,9395,7798,1976,16691
2022-03-24 06:00:00+00,16438,831,5821,1516,529,1450,1591,134,77,172,28559,270,9534,7943,2122,17269
2022-03-24 06:30:00+00,16916,1039,5822,1400,745,1586,1593,375,601,704,30781,267,10161,8568,2746,17955
2022-03-24 07:00:00+00,16732,1015,5821,1300,569,4202,1598,239,1479,484,33439,254,10767,9169,3348,17747
2022-03-24 07:30:00+00,16905,1382,5824,1221,693,4376,1621,257,2458,476,35213,254,11817,10196,4372,18287
2022-03-24 08:00:00+00,16937,1655,5823,1208,662,4718,1622,151,3467,228,36471,252,12782,11160,5337,18592
2022-03-24 08:30:00+00,16722,1757,5822,1101,589,4734,1623,120,4444,16,36928,249,13579,11956,6134,18479
2022-03-24 09:00:00+00,16778,1695,5821,965,369,4342,1609,123,5380,336,37418,244,14144,12535,6714,18473
2022-03-24 09:30:00+00,16387,1744,5821,1012,355,4326,1477,114,6251,0,37487,240,14916,13439,7618,18131
2022-03-24 10:00:00+00,16273,1802,5823,1028,310,3106,1545,113,6936,94,37030,242,15642,14097,8274,18075
2022-03-24 10:30:00+00,15832,1799,5823,1137,248,3038,1558,113,7525,0,37073,237,16291,14733,8910,17631
2022-03-24 11:00:00+00,15507,1801,5824,1249,525,2594,1587,112,7953,14,37166,231,17138,15551,9727,17308
2022-03-24 11:30:00+00,15390,1773,5823,1420,453,2594,1548,114,8114,0,37229,228,17358,15810,9987,17163
2022-03-24 12:00:00+00,15379,1748,5826,1371,277,2960,1444,120,8101,0,37226,229,17019,15575,9749,17127
2022-03-24 12:30:00+00,15480,1748,5739,1318,197,2976,1431,116,7967,0,36972,232,16652,15221,9482,17228
2022-03-24 13:00:00+00,15569,1750,5670,1260,160,2826,1430,113,7622,0,36400,236,16142,14712,9042,17319
2022-03-24 13:30:00+00,15479,1749,5648,1289,159,2828,1429,125,7124,0,35830,239,15649,14220,8572,17228
2022-03-24 14:00:00+00,15656,1749,5633,1260,158,2970,1427,116,6366,0,35335,244,14844,13417,7784,17405
2022-03-24 14:30:00+00,15844,1750,5624,1210,161,2980,1431,116,5482,0,34598,252,13908,12477,6853,17594
2022-03-24 15:00:00+00,16070,1749,5608,1188,202,3204,1438,115,4681,30,34285,256,13117,11679,6071,17819
2022-03-24 15:30:00+00,17405,1791,5595,1111,258,3200,1438,114,3750,138,34800,268,12152,10714,5119,19196
2022-03-24 16:00:00+00,18880,1784,5448,1084,463,2926,1438,142,2830,0,34995,282,11263,9825,4377,20664
2022-03-24 16:30:00+00,19587,1574,5247,1054,580,2952,1469,308,1919,588,35278,284,10269,8800,3553,21161
2022-03-24 17:00:00+00,19933,1475,5246,985,682,3816,1431,434,1071,1478,36551,278,9415,7984,2738,21408
2022-03-24 17:30:00+00,20306,1652,5249,949,683,3850,1486,445,386,1656,36662,286,8753,7267,2018,21958
2022-03-24 18:00:00+00,20783,1793,5252,926,752,3096,1455,619,35,1816,36527,294,8420,6965,1713,22576
2022-03-24 18:30:00+00,21078,1800,5249,953,753,3134,1442,832,0,1912,37153,295,8397,6955,1706,22878
2022-03-24 19:00:00+00,20804,1800,5250,915,753,4698,1441,608,0,1668,37937,289,8359,6918,1668,22604
2022-03-24 19:30:00+00,21025,1800,5250,853,753,4758,1441,511,0,626,37017,298,8297,6856,1606,22825
2022-03-24 20:00:00+00,21072,1798,5250,863,572,4372,1486,215,0,158,35786,305,8171,6685,1435,22870
2022-03-24 20:30:00+00,20432,1802,5246,893,441,4360,1487,134,0,174,34969,304,8067,6580,1334,22234
2022-03-24 21:00:00+00,20555,1666,5246,879,391,3024,1486,115,0,36,33398,314,8002,6516,1270,22221
2022-03-24 21:30:00+00,19602,1228,5246,899,313,2972,1484,114,0,0,31858,305,7942,6458,1212,20830
2022-03-24 22:00:00+00,17857,781,5242,888,282,3254,1484,119,0,0,29907,288,7896,6412,1170,18638
2022-03-24 22:30:00+00,16831,343,5241,868,355,3246,1279,118,0,0,28281,275,7743,6464,1223,17174
2022-03-24 23:00:00+00,16447,36,5245,843,323,2608,946,113,0,82,26643,271,7357,6411,1166,16483
2022-03-24 23:30:00+00,15785,0,5241,923,235,2596,951,109,0,0,25840,268,7350,6399,1158,15785
2022-03-25 00:00:00+00,15452,0,5157,1020,163,2752,953,111,0,0,25608,265,7293,6340,1183,15452
2022-03-25 00:30:00+00,15723,0,5031,1137,154,2832,955,110,0,0,25942,267,7277,6322,1291,15723
2022-03-25 01:00:00+00,15314,0,5015,1237,151,2824,888,110,0,0,25539,263,7291,6403,1388,15314
2022-03-25 01:30:00+00,15460,0,5020,1282,149,2808,924,109,0,0,25752,263,7375,6451,1431,15460
2022-03-25 02:00:00+00,15016,0,5019,1322,148,2816,846,109,0,0,25276,260,7335,6489,1470,15016
2022-03-25 02:30:00+00,14868,0,5018,1337,147,2820,853,108,0,0,25151,259,7355,6502,1484,14868
2022-03-25 03:00:00+00,15244,0,5023,1333,146,2034,956,109,0,0,24845,261,7458,6502,1479,15244
2022-03-25 03:30:00+00,15080,0,5022,1326,147,1958,956,110,0,0,24599,260,7451,6495,1473,15080
2022-03-25 04:00:00+00,15368,0,5026,1297,178,1536,957,109,0,0,24471,264,7458,6501,1475,15368
2022-03-25 04:30:00+00,15204,153,5024,1244,179,1612,954,108,0,0,24478,268,7401,6447,1423,15357
2022-03-25 05:00:00+00,15475,345,5024,1189,248,1318,956,109,0,0,24664,278,7417,6461,1437,15820
2022-03-25 05:30:00+00,15945,535,5022,1171,278,1460,957,120,0,0,25488,286,7428,6471,1449,16480
2022-03-25 06:00:00+00,15530,581,5019,1113,449,3702,957,152,86,0,27589,271,7624,6667,1648,16111
2022-03-25 06:30:00+00,16541,894,5019,1101,483,3778,962,394,623,0,29795,277,8188,7226,2207,17435
2022-03-25 07:00:00+00,17098,1291,5020,1106,493,4472,961,349,1468,254,32512,274,9048,8088,3068,18389
2022-03-25 07:30:00+00,17223,1442,5024,1069,474,4364,958,520,2476,312,33862,268,10001,9043,4019,18665
2022-03-25 08:00:00+00,17173,1649,5018,1018,466,4504,956,414,3560,460,35218,262,11018,10062,5044,18822
2022-03-25 08:30:00+00,17033,1770,5005,1012,443,4514,954,433,4448,208,35820,259,11862,10908,5903,18803
2022-03-25 09:00:00+00,16884,1797,4901,1074,300,4718,954,250,5478,72,36428,253,12707,11753,6852,18681
2022-03-25 09:30:00+00,16617,1796,4901,1045,280,4718,896,129,6317,0,36699,247,13439,12543,7642,18413
2022-03-25 10:00:00+00,16612,1798,4899,1107,223,3738,939,112,7163,48,36639,246,14331,13392,8493,18410
2022-03-25 10:30:00+00,16229,1723,4913,1220,216,3656,882,110,7784,0,36733,239,15015,14133,9220,17952
2022-03-25 11:00:00+00,16225,1773,5010,1226,244,2810,968,110,8228,0,36594,240,15676,14708,9698,17998
2022-03-25 11:30:00+00,15941,1647,5029,1391,247,2800,952,111,8435,0,36553,234,16054,15102,10073,17588
2022-03-25 12:00:00+00,15782,1648,5029,1535,198,2757,945,114,8381,0,36389,233,16088,15143,10114,17430
2022-03-25 12:30:00+00,15699,1553,4981,1649,192,2771,946,142,8152,0,36085,232,15920,14974,9993,17252
2022-03-25 13:00:00+00,15250,1565,4897,1693,195,2836,947,142,7843,0,35368,232,15575,14628,9731,16815
2022-03-25 13:30:00+00,14890,1720,4893,1780,184,2844,947,133,7395,0,34786,236,15199,14252,9359,16610
2022-03-25 14:00:00+00,14770,1681,4920,1831,176,3256,948,117,6764,0,34463,236,14639,13691,8771,16451
2022-03-25 14:30:00+00,14659,1729,5050,1847,181,3254,952,115,6018,0,33805,241,14048,13096,8046,16388
2022-03-25 15:00:00+00,15378,1782,5104,1833,195,2842,972,120,5176,0,33402,253,13280,12308,7204,17160
2022-03-25 15:30:00+00,16247,1743,5101,1844,217,2834,987,116,4240,0,33329,264,12389,11402,6301,17990
2022-03-25 16:00:00+00,17427,1734,5107,1815,373,2630,990,124,3224,36,33460,275,11509,10519,5412,19161
2022-03-25 16:30:00+00,18335,1662,5103,1793,488,2632,990,154,2211,556,33924,281,10585,9595,4492,19997
2022-03-25 17:00:00+00,18985,1603,5109,1701,588,3828,976,147,1271,856,35064,278,9645,8669,3560,20588
2022-03-25 17:30:00+00,19157,1767,5109,1636,533,3886,988,188,481,1074,34819,286,8747,7759,2650,20924
2022-03-25 18:00:00+00,18992,1783,5112,1659,555,4368,990,307,47,1250,35063,286,8363,7373,2261,20775
2022-03-25 18:30:00+00,19063,1750,5116,1768,547,4382,988,425,0,1860,35899,280,8419,7431,2315,20813
2022-03-25 19:00:00+00,19515,1798,5116,1841,555,4252,1011,474,0,1594,36156,285,8523,7512,2396,21313
2022-03-25 19:30:00+00,19562,1797,5119,1891,491,4248,1010,454,0,806,35378,291,8511,7501,2382,21359
2022-03-25 20:00:00+00,19351,1801,5116,1938,438,4190,1009,257,0,100,34200,297,8501,7492,2376,21152
2022-03-25 20:30:00+00,18643,1798,5113,2027,406,4170,1007,145,0,84,33393,295,8553,7546,2433,20441
2022-03-25 21:00:00+00,17896,1670,5113,2064,288,3590,1003,145,0,30,31799,295,8468,7465,2352,19566
2022-03-25 21:30:00+00,17255,1151,5020,2060,281,3562,1001,150,0,26,30506,284,8362,7360,2340,18406
2022-03-25 22:00:00+00,16636,692,4910,1935,232,3268,1002,145,0,24,28844,276,8079,7077,2167,17328
2022-03-25 22:30:00+00,15807,337,4899,1832,232,3316,1003,140,0,0,27566,265,7966,6963,2064,16144
2022-03-25 23:00:00+00,13750,1,4899,1754,223,4318,982,108,0,166,26201,238,7858,6876,1977,13751
2022-03-25 23:30:00+00,13067,0,4900,1676,215,4340,951,104,0,74,25328,235,7742,6792,1892,13067
2022-03-26 00:00:00+00,12763,0,4966,1602,167,4426,950,102,0,0,24976,230,7685,6735,1769,12763
2022-03-26 00:30:00+00,12709,0,5024,1518,166,4434,950,104,0,0,24905,230,7658,6708,1684,12709
2022-03-26 01:00:00+00,12463,0,5021,1434,152,4572,948,101,0,0,24691,228,7555,6607,1586,12463
2022-03-26 01:30:00+00,12006,0,5026,1373,150,4574,948,101,0,0,24178,226,7497,6549,1523,12006
2022-03-26 02:00:00+00,12277,0,5024,1327,150,4212,948,104,0,0,24042,225,7449,6501,1477,12277
2022-03-26 02:30:00+00,12155,0,4973,1384,149,4176,949,102,0,0,23888,224,7455,6506,1533,12155
2022-03-26 03:00:00+00,12529,0,4901,1365,148,4116,949,101,0,0,24109,231,7363,6414,1513,12529
2022-03-26 03:30:00+00,12447,0,4897,1359,151,4096,949,103,0,0,24002,231,7356,6407,1510,12447
2022-03-26 04:00:00+00,12351,0,4898,1431,182,3752,953,103,0,0,23670,235,7464,6511,1613,12351
2022-03-26 04:30:00+00,12274,0,4904,1479,184,3737,954,129,0,0,23661,234,7521,6567,1663,12274
2022-03-26 05:00:00+00,12108,0,5021,1443,259,3482,955,104,0,0,23372,234,7678,6723,1702,12108
2022-03-26 05:30:00+00,12046,0,5103,1410,351,3564,953,101,0,0,23528,233,7818,6864,1762,12046
2022-03-26 06:00:00+00,12109,142,5103,1383,489,4028,953,105,125,0,24437,228,8053,7100,1997,12251
2022-03-26 06:30:00+00,12259,376,5098,1459,490,4172,952,107,767,0,25680,230,8766,7814,2716,12635
2022-03-26 07:00:00+00,12324,582,5103,1429,490,4532,953,108,1729,0,27250,227,9704,8751,3648,12906
2022-03-26 07:30:00+00,12264,835,5100,1410,489,4432,951,125,2785,102,28493,223,10735,9784,4684,13099
2022-03-26 08:00:00+00,12276,1060,5104,1358,382,4728,949,150,3845,272,30124,219,11638,10689,5585,13336
2022-03-26 08:30:00+00,12212,1289,5111,1370,379,4734,951,152,4873,238,31309,216,12684,11733,6622,13501
2022-03-26 09:00:00+00,12225,1349,5106,1487,297,4578,951,138,5840,92,32063,213,13681,12730,7624,13574
2022-03-26 09:30:00+00,11919,1346,5111,1536,293,4574,947,117,6685,0,32528,206,14572,13625,8514,13265
2022-03-26 10:00:00+00,11215,1204,5111,1688,237,4618,941,111,7439,0,32564,193,15416,14475,9364,12419
2022-03-26 10:30:00+00,10463,1173,5113,1920,209,4604,948,104,8054,0,32588,183,16244,15296,10183,11636
2022-03-26 11:00:00+00,10363,1315,5114,2036,184,4180,947,102,8490,0,32731,184,16771,15824,10710,11678
2022-03-26 11:30:00+00,9951,1299,5110,2062,184,4152,948,104,8734,0,32544,180,17038,16090,10980,11250
2022-03-26 12:00:00+00,10118,1131,5095,2129,195,3998,947,102,8702,0,32417,177,17068,16121,11026,11249
2022-03-26 12:30:00+00,10063,937,4950,2155,197,4016,945,103,8540,0,31906,174,16787,15842,10892,11000
2022-03-26 13:00:00+00,9532,723,4898,2114,196,4704,839,106,8128,0,31240,165,16175,15336,10438,10255
2022-03-26 13:30:00+00,9512,699,4897,2061,201,4738,695,105,7669,0,30577,167,15523,14828,9931,10211
2022-03-26 14:00:00+00,9444,716,4893,2083,225,4738,808,110,7146,0,30163,170,15155,14347,9454,10160
2022-03-26 14:30:00+00,9554,706,4892,2227,225,4730,883,108,6300,0,29625,174,14527,13644,8752,10260
2022-03-26 15:00:00+00,10579,703,4883,2384,226,4532,748,110,5397,0,29562,187,13638,12890,8007,11282
2022-03-26 15:30:00+00,11630,716,4885,2464,234,4490,759,107,4408,0,29693,201,12750,11991,7106,12346
2022-03-26 16:00:00+00,13038,1032,4883,2673,307,3420,910,110,3361,0,29734,224,12134,11224,6341,14070
2022-03-26 16:30:00+00,14548,1344,4888,2830,342,3390,924,115,2344,0,30725,246,11328,10404,5516,15892
2022-03-26 17:00:00+00,15428,1327,4896,3020,541,4012,940,129,1407,0,31700,250,10804,9864,4968,16755
2022-03-26 17:30:00+00,16099,1329,4996,3181,506,4070,947,197,559,52,31936,257,10189,9242,4246,17428
2022-03-26 18:00:00+00,15728,1344,5021,3264,506,4752,824,268,60,682,32449,254,9675,8851,3830,17072
2022-03-26 18:30:00+00,16051,1346,5020,3305,589,4760,903,436,0,1090,33500,251,9817,8914,3894,17397
2022-03-26 19:00:00+00,16359,1216,5020,3422,549,4758,908,446,0,1042,33720,250,9899,8991,3971,17575
2022-03-26 19:30:00+00,16208,1144,5025,3466,440,4736,959,216,0,780,32974,250,9890,8931,3906,17352
2022-03-26 20:00:00+00,16506,1322,5024,3407,391,4174,966,128,0,200,32118,264,9788,8822,3798,17828
2022-03-26 20:30:00+00,15909,1172,5026,3661,277,4100,967,110,0,0,31222,259,9931,8964,3938,17081
2022-03-26 21:00:00+00,16098,923,5023,3734,236,2936,967,112,0,0,30029,262,9960,8993,3970,17021
2022-03-26 21:30:00+00,15641,505,5007,3649,226,2904,967,111,0,56,29066,251,9849,8882,3875,16146
2022-03-26 22:00:00+00,14955,220,4902,3479,222,2904,968,112,0,36,27798,243,9571,8603,3701,15175
2022-03-26 22:30:00+00,14017,2,4876,3213,211,2956,986,125,0,102,26488,234,9286,8300,3424,14019
2022-03-26 23:00:00+00,11757,0,4873,2844,178,4238,911,103,0,142,25046,213,8806,7895,3022,11757
2022-03-26 23:30:00+00,11386,0,4895,2760,178,4298,838,101,0,142,24598,210,8671,7833,2938,11386
2022-03-27 00:00:00+00,10884,0,5040,2730,162,4398,945,101,0,0,24260,207,8877,7932,2892,10884
2022-03-27 00:30:00+00,10981,0,5091,2458,162,4410,913,102,0,0,24117,210,8624,7711,2620,10981
2022-03-27 01:00:00+00,10866,0,5093,2282,44,3762,730,91,0,0,22868,215,8149,7419,2326,10866
2022-03-27 01:30:00+00,10709,0,5093,2236,84,3128,688,99,0,0,22037,216,8101,7413,2320,10709
2022-03-27 02:00:00+00,10640,0,5088,2221,112,4155,695,136,0,0,23047,212,8116,7421,2333,10640
2022-03-27 02:30:00+00,10604,0,5084,2080,114,4128,696,107,0,0,22812,213,7974,7278,2194,10604
2022-03-27 03:00:00+00,10712,0,5091,2040,113,3872,772,103,0,0,22703,215,8016,7244,2153,10712
2022-03-27 03:30:00+00,10544,0,5097,2112,111,3862,848,103,0,0,22677,213,8168,7320,2223,10544
2022-03-27 04:00:00+00,10757,0,5093,2156,111,3572,937,108,0,0,22734,215,8297,7360,2267,10757
2022-03-27 04:30:00+00,10709,0,5098,2171,111,3594,858,103,0,0,22644,215,8238,7380,2282,10709
2022-03-27 05:00:00+00,11097,0,5098,2097,183,3040,944,109,0,0,22568,221,8322,7378,2280,11097
2022-03-27 05:30:00+00,11268,127,5099,1948,197,3018,931,101,0,0,22689,227,8175,7244,2145,11395
2022-03-27 06:00:00+00,11612,529,5098,1858,166,3284,821,113,51,0,23532,245,7994,7173,2075,12141
2022-03-27 06:30:00+00,12053,822,5098,1860,167,3282,790,105,433,0,24610,252,8348,7558,2460,12875
2022-03-27 07:00:00+00,12130,1020,5092,1853,189,3682,782,117,1062,104,26031,240,8978,8196,3104,13150
2022-03-27 07:30:00+00,12417,1278,5077,1817,253,3580,932,126,1748,54,27282,243,9827,8895,3818,13695
2022-03-27 08:00:00+00,12426,1348,4929,1719,261,4344,947,111,2269,196,28550,240,10125,9178,4249,13774
2022-03-27 08:30:00+00,12796,1351,4893,1665,260,4358,948,127,2959,208,29565,237,10725,9777,4884,14147
2022-03-27 09:00:00+00,13037,1348,4896,1608,247,4312,949,115,3462,344,30318,234,11162,10213,5317,14385
2022-03-27 09:30:00+00,13266,1349,4895,1535,247,4316,951,129,4006,142,30836,233,11634,10683,5788,14615
2022-03-27 10:00:00+00,13414,1350,4903,1528,221,4486,951,109,4544,0,31506,232,12147,11196,6293,14764
2022-03-27 10:30:00+00,13250,1349,5042,1552,167,4490,897,105,5189,0,32041,226,12847,11950,6908,14599
2022-03-27 11:00:00+00,13187,1328,5098,1513,127,4386,820,101,5817,0,32377,221,13375,12555,7457,14515
2022-03-27 11:30:00+00,13008,1302,5099,1483,132,4382,799,106,6105,0,32416,218,13618,12819,7720,14310
2022-03-27 12:00:00+00,12740,1318,5103,1579,128,4102,787,105,6244,14,32120,217,13841,13054,7951,14058
2022-03-27 12:30:00+00,12597,899,5104,1628,150,4096,786,103,6202,0,31565,206,13870,13084,7980,13496
2022-03-27 13:00:00+00,12525,690,5100,1591,171,4020,795,103,6189,0,31184,201,13846,13051,7951,13215
2022-03-27 13:30:00+00,12183,689,5100,1576,174,4020,792,102,5903,0,30539,201,13545,12753,7653,12872
2022-03-27 14:00:00+00,12046,688,5098,1507,209,4664,799,107,5371,0,30489,202,12984,12185,7087,12734
2022-03-27 14:30:00+00,12567,689,5100,1420,217,4684,867,114,4897,12,30567,208,12501,11634,6534,13256
2022-03-27 15:00:00+00,13080,913,5096,1386,264,4550,947,121,4169,0,30526,222,11862,10915,5819,13993
2022-03-27 15:30:00+00,14369,962,5020,1379,319,4546,956,117,3493,0,31161,235,11167,10211,5191,15331
2022-03-27 16:00:00+00,16191,974,4904,1387,344,4300,966,115,2704,0,31885,252,10305,9339,4435,17165
2022-03-27 16:30:00+00,16863,1082,4896,1413,413,4300,965,116,1993,0,32041,262,9680,8715,3819,17945
2022-03-27 17:00:00+00,17649,1334,4897,1466,448,4308,962,141,1197,72,32474,276,8970,8008,3111,18983
2022-03-27 17:30:00+00,17655,1348,4898,1543,466,4304,967,183,498,514,32376,278,8372,7405,2507,19003
2022-03-27 18:00:00+00,17864,1348,4899,1646,467,4590,969,152,55,516,32506,280,8036,7067,2168,19212
2022-03-27 18:30:00+00,18661,1349,4903,1602,472,4600,971,170,0,178,32906,286,7948,6977,2074,20010
2022-03-27 19:00:00+00,18871,1348,4905,1429,445,4542,968,165,0,402,33075,286,7747,6779,1874,20219
2022-03-27 19:30:00+00,18489,1218,5011,1403,412,4530,969,130,0,240,32402,284,7795,6826,1815,19707
2022-03-27 20:00:00+00,18283,1092,5095,1328,334,3866,967,131,0,326,31422,282,7724,6757,1662,19375
2022-03-27 20:30:00+00,17619,968,5098,1208,278,3848,966,109,0,60,30154,281,7550,6584,1486,18587
2022-03-27 21:00:00+00,16862,631,5093,1176,283,3308,966,119,0,120,28558,274,7518,6552,1459,17493
2022-03-27 21:30:00+00,15440,338,5091,1169,280,3312,962,121,0,208,26921,260,7502,6540,1449,15778
2022-03-27 22:00:00+00,15633,6,5093,1109,261,2132,948,105,0,476,25763,262,7411,6463,1370,15639
2022-03-27 22:30:00+00,14939,0,5093,997,355,2140,950,101,0,0,24575,264,7395,6445,1352,14939
2022-03-27 23:00:00+00,14738,0,5081,945,212,2024,951,102,0,0,24053,264,7189,6238,1157,14738
2022-03-27 23:30:00+00,14880,0,4971,815,188,2038,949,102,0,0,23943,268,6923,5974,1003,14880
2022-03-28 00:00:00+00,14469,0,4882,795,156,2764,965,101,0,0,24132,266,6798,5833,951,14469
2022-03-28 00:30:00+00,14574,0,4877,743,235,2804,971,101,0,0,24305,266,6826,5855,978,14574
2022-03-28 01:00:00+00,14516,0,4878,677,162,3026,1011,103,0,0,24373,264,6728,5717,839,14516
2022-03-28 01:30:00+00,14336,0,4924,641,159,2982,1050,100,0,0,24192,262,6774,5724,800,14336
2022-03-28 02:00:00+00,14293,0,5057,645,171,2394,1175,100,0,0,23834,263,7048,5873,816,14293
2022-03-28 02:30:00+00,14290,0,5092,631,155,2330,1426,107,0,0,24031,261,7304,5878,786,14290
2022-03-28 03:00:00+00,14299,92,5092,621,149,1764,1648,100,0,0,23765,266,7510,5862,770,14391
2022-03-28 03:30:00+00,14206,249,5097,645,144,1588,1712,102,0,0,23743,269,7598,5886,789,14455
2022-03-28 04:00:00+00,14364,516,5095,637,177,918,1784,103,0,0,23594,275,7693,5909,814,14880
2022-03-28 04:30:00+00,14553,784,5101,623,193,868,1998,104,0,2,24226,281,7915,5917,816,15337
2022-03-28 05:00:00+00,15182,1044,5099,547,417,1114,2110,121,0,0,25634,290,8173,6063,964,16226
2022-03-28 05:30:00+00,15971,1281,5099,510,419,1076,2094,168,0,0,26618,299,8122,6028,929,17252
2022-03-28 06:00:00+00,17182,1399,5098,477,419,1992,2070,305,96,146,29185,299,8160,6090,992,18581
2022-03-28 06:30:00+00,18222,1549,5098,439,421,2102,1965,633,515,1026,31971,293,8438,6473,1375,19771
2022-03-28 07:00:00+00,19132,1492,5093,429,421,3232,1998,433,1139,910,34279,290,9080,7082,1989,20624
2022-03-28 07:30:00+00,19608,1677,5090,413,420,3312,2109,403,1841,284,35157,293,9873,7764,2674,21285
2022-03-28 08:00:00+00,19902,1795,5088,408,307,3420,2109,188,2624,182,36023,289,10536,8427,3339,21697
2022-03-28 08:30:00+00,20048,1757,5090,391,305,3432,2109,145,3412,0,36689,284,11307,9198,4108,21805
2022-03-28 09:00:00+00,20133,1773,5089,372,233,2884,2111,119,4134,0,36848,284,11939,9828,4739,21906
2022-03-28 09:30:00+00,20114,1657,5134,398,230,2836,2108,116,4909,14,37516,276,12779,10671,5537,21771
2022-03-28 10:00:00+00,20065,1563,5157,427,176,2626,2014,117,5455,0,37600,270,13229,11215,6058,21628
2022-03-28 10:30:00+00,19950,1507,5156,443,156,2634,1987,115,6000,0,37948,265,13742,11755,6599,21457
2022-03-28 11:00:00+00,19878,1621,5160,483,174,2486,1984,107,6501,22,38416,265,14302,12318,7158,21499
2022-03-28 11:30:00+00,19435,1794,5178,480,161,2498,1871,107,6840,0,38364,265,14530,12659,7481,21229
2022-03-28 12:00:00+00,19270,1780,5177,492,187,2674,1882,104,7085,0,38651,262,14823,12941,7764,21050
2022-03-28 12:30:00+00,19027,1518,5188,502,211,2674,1922,104,6977,0,38123,257,14800,12878,7690,20545
2022-03-28 13:00:00+00,19198,1142,5168,536,219,2576,1994,110,6552,0,37495,253,14469,12475,7307,20340
2022-03-28 13:30:00+00,19223,1213,5169,545,229,2574,1992,109,5790,20,36864,260,13725,11733,6564,20436
2022-03-28 14:00:00+00,19477,1349,5172,562,247,2554,1983,105,5010,0,36459,269,12974,10991,5819,20826
2022-03-28 14:30:00+00,19460,1602,5171,598,273,2556,1985,124,4491,0,36260,277,12518,10533,5362,21062
2022-03-28 15:00:00+00,19287,1939,5179,586,327,2814,2007,120,3744,0,36003,286,11843,9836,4657,21226
2022-03-28 15:30:00+00,19983,1962,5173,574,438,2848,2080,135,2984,84,36261,293,11249,9169,3996,21945
2022-03-28 16:00:00+00,20633,1957,5178,617,474,3022,2182,154,2223,196,36636,297,10674,8492,3314,22590
2022-03-28 16:30:00+00,20843,1956,5177,671,481,3032,2211,189,1450,878,36888,298,9990,7779,2602,22799
2022-03-28 17:00:00+00,21006,1956,5177,724,599,2822,2211,288,817,1050,36650,302,9528,7317,2140,22962
2022-03-28 17:30:00+00,21143,1957,5177,779,642,2816,2211,315,318,1052,36410,305,9127,6916,1739,23100
2022-03-28 18:00:00+00,21134,1857,5174,774,595,3232,2213,321,38,1298,36636,302,8794,6581,1407,22991
2022-03-28 18:30:00+00,21241,1960,5175,803,581,3260,2173,301,0,1342,36836,304,8732,6559,1384,23201
2022-03-28 19:00:00+00,21170,1895,5177,886,587,3764,2160,267,0,646,36552,304,8810,6650,1473,23065
2022-03-28 19:30:00+00,20930,1715,5178,1033,573,3780,2131,172,0,52,35564,304,8915,6784,1606,22645
2022-03-28 20:00:00+00,20691,1733,5178,1060,421,2626,2151,114,0,28,34002,312,8810,6659,1481,22424
2022-03-28 20:30:00+00,19565,1196,5179,1091,388,2528,2152,102,0,0,32201,299,8810,6658,1479,20761
2022-03-28 21:00:00+00,19307,676,5181,1095,305,2230,2140,102,0,0,31036,290,8721,6581,1400,19983
2022-03-28 21:30:00+00,18144,311,5180,1087,289,2230,2090,104,0,0,29435,279,8646,6556,1376,18455
2022-03-28 22:00:00+00,16042,236,5181,1026,236,2500,1956,104,0,70,27351,271,8399,6443,1262,16278
2022-03-28 22:30:00+00,14813,234,5180,1029,228,2498,1890,105,0,18,25995,266,8327,6437,1257,15047
2022-03-28 23:00:00+00,14269,235,5178,1005,181,2518,1832,104,0,0,25322,264,8196,6364,1186,14504
2022-03-28 23:30:00+00,14093,242,5175,998,181,2520,1842,108,0,0,25159,263,8196,6354,1179,14335
2022-03-29 00:00:00+00,13723,231,5178,1002,181,2738,1840,103,0,0,24996,260,8201,6361,1183,13954
2022-03-29 00:30:00+00,13896,238,5173,968,181,2810,1784,109,0,0,25159,262,8106,6322,1149,14134
2022-03-29 01:00:00+00,13906,237,5178,1029,181,2908,1734,105,0,0,25278,263,8122,6388,1210,14143
2022-03-29 01:30:00+00,13785,242,5174,1064,162,2792,1771,105,0,0,25095,261,8171,6400,1226,14027
2022-03-29 02:00:00+00,13788,235,5179,1116,127,2628,1947,101,0,0,25121,262,8369,6422,1243,14023
2022-03-29 02:30:00+00,13833,243,5174,1175,127,2556,1954,106,0,0,25168,261,8430,6476,1302,14076
2022-03-29 03:00:00+00,13899,241,5176,1080,130,2512,1861,104,0,0,25003,263,8247,6386,1210,14140
2022-03-29 03:30:00+00,13869,369,5172,957,145,2516,1872,102,0,0,25001,268,8146,6274,1102,14238
2022-03-29 04:00:00+00,14096,602,5178,992,177,1930,1884,103,0,0,24962,278,8231,6347,1169,14698
2022-03-29 04:30:00+00,14360,905,5182,1041,196,1790,1941,102,0,0,25518,285,8360,6419,1237,15265
2022-03-29 05:00:00+00,15075,1102,5178,1097,327,1436,2059,113,0,108,26494,287,8661,6602,1424,16177
2022-03-29 05:30:00+00,15947,1405,5179,1133,344,1286,2071,127,0,254,27746,294,8727,6656,1477,17352
2022-03-29 06:00:00+00,17243,1582,5182,1273,377,1324,2073,142,26,530,29752,298,8931,6858,1676,18825
2022-03-29 06:30:00+00,18382,1724,5184,1487,464,1278,2072,316,203,980,32090,295,9410,7338,2154,20106
2022-03-29 07:00:00+00,19398,1714,5185,1603,465,2048,2069,333,411,894,34120,291,9733,7664,2479,21112
2022-03-29 07:30:00+00,19984,1714,5179,1646,465,2184,2084,449,652,672,35028,292,10026,7942,2762,21698
2022-03-29 08:00:00+00,20389,1673,5190,1898,454,3510,2095,443,960,778,37390,284,10597,8502,3312,22062
2022-03-29 08:30:00+00,20652,1715,5196,1932,448,3546,2095,326,1158,380,37448,287,10829,8734,3538,22367
2022-03-29 09:00:00+00,20836,1831,5198,1737,394,3172,2092,226,1392,220,37098,294,10813,8721,3523,22667
2022-03-29 09:30:00+00,20889,1832,5220,1616,363,3156,2062,169,1956,276,37538,290,11217,9155,3935,22721
2022-03-29 10:00:00+00,20922,1948,5217,1601,303,3190,2059,196,2231,10,37677,293,11411,9352,4135,22870
2022-03-29 10:30:00+00,20908,1876,5210,1650,260,3224,2061,127,2427,0,37743,290,11608,9547,4337,22784
2022-03-29 11:00:00+00,20956,1958,5216,1876,266,4036,2062,165,2617,36,39188,283,12037,9975,4759,22914
2022-03-29 11:30:00+00,20786,1963,5225,2059,207,4016,2047,113,2589,30,39035,282,12127,10080,4855,22749
2022-03-29 12:00:00+00,21095,1962,5228,2151,275,2738,1965,334,2473,152,38373,290,12092,10127,4899,23057
2022-03-29 12:30:00+00,21113,1966,5218,1995,244,2738,1962,147,2630,10,38023,291,12049,10087,4869,23079
2022-03-29 13:00:00+00,21101,1962,5221,1846,276,2740,1974,115,2395,264,37894,292,11712,9738,4517,23063
2022-03-29 13:30:00+00,21056,1966,5218,1893,313,2740,2059,108,2151,22,37526,294,11634,9575,4357,23022
2022-03-29 14:00:00+00,20993,1964,5222,1888,310,2732,2061,110,1988,296,37564,293,11469,9408,4186,22957
2022-03-29 14:30:00+00,21094,1967,5227,1891,323,2732,2063,130,1917,472,37816,293,11421,9358,4131,23061
2022-03-29 15:00:00+00,20661,1965,5229,1980,379,3434,2061,135,1774,236,37854,289,11423,9362,4133,22626
2022-03-29 15:30:00+00,20894,1968,5225,2034,423,3512,2062,166,1314,306,37904,291,11058,8996,3771,22862
2022-03-29 16:00:00+00,20883,1968,5223,2175,501,3184,2063,171,1034,1116,38318,286,10996,8933,3710,22851
2022-03-29 16:30:00+00,20747,1965,5222,2359,515,3178,2061,303,717,1200,38267,286,10874,8813,3591,22712
2022-03-29 17:00:00+00,20678,1967,5218,2748,587,2572,2062,372,400,1754,38358,284,11015,8953,3735,22645
2022-03-29 17:30:00+00,20802,1966,5213,2763,606,2530,2058,394,151,1884,38367,286,10791,8733,3520,22768
2022-03-29 18:00:00+00,21058,1973,5217,2929,592,2332,2051,586,22,1472,38232,291,10811,8760,3543,23031
2022-03-29 18:30:00+00,21049,1972,5214,3309,602,2326,2023,594,0,710,37799,295,11148,9125,3911,23021
2022-03-29 19:00:00+00,20954,1969,5211,3408,591,2666,1978,323,0,840,37940,291,11188,9210,3999,22923
2022-03-29 19:30:00+00,20872,1967,5217,3429,486,2658,2012,220,0,58,36919,298,11144,9132,3915,22839
2022-03-29 20:00:00+00,20731,1789,5215,3244,306,2048,2056,187,0,120,35696,299,10821,8765,3550,22520
2022-03-29 20:30:00+00,19461,1290,5222,3560,289,2030,2057,127,0,0,34036,285,11128,9071,3849,20751
2022-03-29 21:00:00+00,17688,816,5223,3815,292,1984,2044,116,0,78,32056,266,11374,9330,4107,18504
2022-03-29 21:30:00+00,16252,502,5218,3588,290,1994,2019,122,0,40,30025,256,11115,9096,3878,16754
2022-03-29 22:00:00+00,13291,492,5223,3802,272,2556,1912,113,0,0,27661,237,11209,9297,4074,13783
2022-03-29 22:30:00+00,12820,499,5218,3907,271,2564,1908,115,0,0,27301,233,11304,9396,4178,13318
2022-03-29 23:00:00+00,12347,504,5215,3630,256,2405,1908,115,0,0,26380,234,11009,9101,3886,12851
2022-03-29 23:30:00+00,12398,496,5219,3532,255,2334,1987,115,0,0,26336,235,10993,9006,3787,12894
2022-03-30 00:00:00+00,12097,491,5224,3719,256,2558,2027,115,0,0,26487,231,11226,9199,3975,12588
2022-03-30 00:30:00+00,12188,498,5214,3760,256,2560,2037,123,0,0,26636,231,11267,9230,4016,12686
2022-03-30 01:00:00+00,11616,499,5225,3959,256,2976,2043,115,0,0,26689,223,11483,9440,4215,12115
2022-03-30 01:30:00+00,11168,500,5226,4132,255,2970,2057,116,0,0,26424,218,11670,9613,4387,11668
2022-03-30 02:00:00+00,11596,499,5225,3934,255,2414,2047,128,0,0,26098,223,11461,9414,4189,12095
2022-03-30 02:30:00+00,11511,499,5233,4153,253,2410,2049,114,0,0,26222,221,11688,9639,4406,12010
2022-03-30 03:00:00+00,11649,499,5226,4521,254,2138,2042,123,0,0,26452,218,12043,10001,4775,12148
2022-03-30 03:30:00+00,11612,501,5226,4501,254,2136,2025,117,0,0,26372,218,12006,9981,4755,12113
2022-03-30 04:00:00+00,11838,634,5226,4516,286,1696,2024,191,0,0,26411,223,12052,10028,4802,12472
2022-03-30 04:30:00+00,12112,906,5230,5157,298,1684,2022,342,0,0,27751,227,12707,10685,5455,13018
2022-03-30 05:00:00+00,12841,1140,5230,5792,384,1140,2023,263,0,0,28813,231,13429,11406,6176,13981
2022-03-30 05:30:00+00,13733,1393,5232,5955,401,1012,2024,117,0,100,29967,238,13612,11588,6356,15126
2022-03-30 06:00:00+00,15042,1589,5230,5995,531,990,2027,211,36,410,32061,245,13819,11792,6562,16631
2022-03-30 06:30:00+00,16195,1842,5228,6101,529,992,2012,420,215,574,34108,253,14084,12072,6845,18037
2022-03-30 07:00:00+00,17224,1966,5228,6593,510,2374,2027,384,449,208,36963,259,14807,12780,7552,19190
2022-03-30 07:30:00+00,17797,1974,5229,6935,522,2432,2022,266,846,392,38414,254,15554,13532,8303,19771
2022-03-30 08:00:00+00,18170,1980,5225,7043,502,2724,1995,335,1371,874,40218,248,16136,14141,8916,20150
2022-03-30 08:30:00+00,18387,1978,5219,7590,497,2728,1990,264,1782,110,40546,248,17079,15089,9869,20365
2022-03-30 09:00:00+00,18897,1937,5204,8216,648,2732,1994,763,2134,112,42637,245,18196,16202,10998,20834
2022-03-30 09:30:00+00,18589,1975,5187,8078,469,2732,1901,295,2366,0,41593,243,18002,16101,10913,20564
2022-03-30 10:00:00+00,18621,1834,5185,7525,398,2736,1909,160,2823,218,41409,241,17840,15931,10746,20455
2022-03-30 10:30:00+00,18612,1737,5187,7337,352,2736,1907,109,2978,18,40973,241,17760,15853,10667,20349
2022-03-30 11:00:00+00,18648,1841,5195,7643,245,2736,1908,109,2813,0,41138,242,17804,15896,10701,20489
2022-03-30 11:30:00+00,18583,1678,5200,7862,185,2736,1881,139,2923,0,41187,238,18051,16170,10970,20261
2022-03-30 12:00:00+00,18530,1412,5203,8211,178,2792,1787,114,3094,42,41362,230,18473,16686,11483,19942
2022-03-30 12:30:00+00,18366,1379,5204,8309,179,2922,1786,110,3040,0,41295,230,18518,16732,11528,19745
2022-03-30 13:00:00+00,18302,1417,5205,8196,179,2984,1787,115,3071,120,41375,230,18437,16650,11446,19719
2022-03-30 13:30:00+00,18207,1736,5205,7974,176,2928,1787,117,2871,0,41001,238,18013,16226,11021,19943
2022-03-30 14:00:00+00,18227,1853,5203,7780,191,2608,1785,186,2675,20,40528,243,17635,15850,10646,20080
2022-03-30 14:30:00+00,18364,1949,5205,7833,192,2744,1799,107,2326,4,40523,247,17355,15556,10351,20313
2022-03-30 15:00:00+00,18301,1982,5215,8170,229,2606,1876,155,1613,0,40147,251,17103,15227,10012,20283
2022-03-30 15:30:00+00,18519,1984,5214,8792,222,2606,1880,183,1322,84,40806,249,17430,15550,10336,20503
2022-03-30 16:00:00+00,18362,1717,5211,8993,273,2848,1949,247,1044,562,41206,240,17470,15521,10310,20079
2022-03-30 16:30:00+00,18359,1928,5213,8932,454,2852,1946,325,720,608,41337,245,17265,15319,10106,20287
2022-03-30 17:00:00+00,18354,1977,5211,8602,543,2716,1947,253,416,1330,41349,245,16719,14772,9561,20331
2022-03-30 17:30:00+00,18305,1981,5207,8734,565,2716,1949,269,165,1224,41115,246,16620,14671,9464,20286
2022-03-30 18:00:00+00,18542,1983,5207,8796,545,2524,1949,250,29,802,40627,251,16526,14577,9370,20525
2022-03-30 18:30:00+00,18377,1972,5213,9106,453,2522,1950,246,0,538,40377,251,16722,14772,9559,20349
2022-03-30 19:00:00+00,17964,1840,5210,9412,327,3048,1946,156,0,336,40239,246,16895,14949,9739,19804
2022-03-30 19:30:00+00,16567,1756,5214,9931,303,2878,1947,113,0,112,38821,238,17395,15448,10234,18323
2022-03-30 20:00:00+00,15876,1685,5210,10279,262,2538,1948,118,0,102,38018,232,17699,15751,10541,17561
2022-03-30 20:30:00+00,14018,1247,5212,10728,230,2530,1949,117,0,0,36032,213,18120,16170,10958,15265
2022-03-30 21:00:00+00,12885,836,5214,10999,199,2624,1950,105,0,0,34812,196,18362,16412,11198,13721
2022-03-30 21:30:00+00,10984,515,5211,11464,182,2622,1951,123,0,0,33052,175,18808,16857,11646,11499
2022-03-30 22:00:00+00,7866,342,5211,11381,181,2620,1939,107,0,0,29647,148,18712,16773,11562,8208
2022-03-30 22:30:00+00,6421,290,5215,11740,182,2618,1861,104,0,0,28431,132,18998,17137,11922,6711
2022-03-30 23:00:00+00,6174,360,5210,11847,183,2586,1858,111,0,0,28329,131,19098,17240,12030,6534
2022-03-30 23:30:00+00,5713,371,5208,11761,183,2604,1885,108,0,0,27833,128,19037,17152,11944,6084
2022-03-31 00:00:00+00,5026,235,5208,12221,184,3088,1579,108,0,0,27649,111,19192,17613,12405,5261
2022-03-31 00:30:00+00,5122,244,5208,11852,185,3106,1801,121,0,0,27638,114,19046,17245,12037,5366
2022-03-31 01:00:00+00,5038,234,5211,11587,166,3264,1936,109,0,0,27545,113,18900,16964,11753,5272
2022-03-31 01:30:00+00,4816,230,5212,11561,164,3264,1932,107,0,0,27286,111,18869,16937,11725,5046
2022-03-31 02:00:00+00,4724,234,5212,11858,163,3086,1909,109,0,0,27295,108,19142,17233,12021,4958
2022-03-31 02:30:00+00,4665,229,5220,12198,163,3076,1934,106,0,0,27591,106,19515,17581,12361,4894
2022-03-31 03:00:00+00,4635,382,5219,12503,163,2960,1899,105,0,0,27866,110,19784,17885,12666,5017
2022-03-31 03:30:00+00,4536,571,5219,12515,168,2906,1755,105,0,0,27775,114,19657,17902,12683,5107
2022-03-31 04:00:00+00,4729,705,5217,12376,211,2290,1863,115,0,0,27506,118,19667,17804,12587,5434
2022-03-31 04:30:00+00,4987,834,5214,11871,235,2298,1910,108,0,0,27456,126,19230,17320,12106,5821
2022-03-31 05:00:00+00,5706,1099,5219,12692,241,1144,1883,123,0,90,28197,132,20035,18152,12933,6805
2022-03-31 05:30:00+00,6600,1255,5218,12772,253,1252,1936,137,0,56,29478,146,20179,18243,13025,7855
2022-03-31 06:00:00+00,7913,1447,5219,12698,353,2650,1941,156,181,598,33156,160,20392,18451,13232,9360
2022-03-31 06:30:00+00,9068,1867,5224,12928,491,2734,1945,336,674,660,35927,173,21262,19317,14093,10935
2022-03-31 07:00:00+00,10115,1983,5223,13195,526,2786,1945,452,1411,502,38138,179,22300,20355,15132,12098
2022-03-31 07:30:00+00,10741,1983,5219,12939,503,2686,1945,225,1922,952,39115,178,22528,20583,15364,12724
2022-03-31 08:00:00+00,11244,1984,5223,13118,456,2486,1945,155,2852,1010,40474,175,23594,21649,16426,13228
2022-03-31 08:30:00+00,11573,1983,5223,13504,419,2466,1945,155,3248,394,40910,176,24339,22394,17171,13556
2022-03-31 09:00:00+00,11836,1983,5220,13950,390,2028,1943,137,4162,244,41893,172,25665,23722,18502,13819
2022-03-31 09:30:00+00,11965,1978,5216,14264,304,2022,1937,137,4952,0,42775,170,26673,24736,19520,13943
2022-03-31 10:00:00+00,12120,1744,5211,14478,159,1692,1975,110,5777,442,43708,160,27600,25625,20414,13864
2022-03-31 10:30:00+00,12298,1631,5216,14432,148,1682,1984,105,6326,54,43876,159,28106,26122,20906,13929
2022-03-31 11:00:00+00,12531,1474,5213,14292,117,1476,1990,139,7260,106,44598,152,28872,26882,21669,14005
2022-03-31 11:30:00+00,12647,1263,5208,14421,89,1480,1992,165,6914,56,44235,150,28624,26632,21424,13910
2022-03-31 12:00:00+00,12296,1224,5181,13739,74,1624,1990,144,7307,232,43811,146,28291,26301,21120,13520
2022-03-31 12:30:00+00,11378,1347,5172,14090,70,1652,1990,140,7363,28,43230,142,28685,26695,21523,12725
2022-03-31 13:00:00+00,10035,1097,5176,14729,85,2314,1985,111,6801,0,42333,132,28776,26791,21615,11132
2022-03-31 13:30:00+00,10251,929,5180,14471,88,2342,1988,110,6202,0,41561,133,27929,25941,20761,11180
2022-03-31 14:00:00+00,9871,763,5184,14194,138,2606,1986,108,5723,0,40573,132,27225,25239,20055,10634
2022-03-31 14:30:00+00,10097,765,5185,14535,155,2722,1989,112,5070,0,40630,135,26934,24945,19760,10862
2022-03-31 15:00:00+00,10919,828,5185,14636,207,2260,1991,124,4513,0,40663,140,26532,24541,19356,11747
2022-03-31 15:30:00+00,12153,748,5184,14550,229,2246,1991,134,4090,0,41325,147,26044,24053,18869,12901
2022-03-31 16:00:00+00,13323,802,5179,13877,286,2304,1989,133,2869,80,40842,162,24200,22211,17032,14125
2022-03-31 16:30:00+00,13504,1049,5193,14205,305,2302,1991,168,2205,192,41114,169,23899,21908,16715,14553
2022-03-31 17:00:00+00,14028,888,5218,13958,316,2494,1990,169,1581,890,41532,170,23063,21073,15855,14916
2022-03-31 17:30:00+00,14553,1292,5219,12970,326,2504,1980,172,669,1164,40849,187,21164,19184,13965,15845
2022-03-31 18:00:00+00,14094,1346,5219,12753,352,2674,2021,158,116,1032,39765,191,20461,18440,13221,15440
2022-03-31 18:30:00+00,14574,1447,5219,12363,353,2680,1993,150,0,1074,39853,198,19928,17935,12716,16021
2022-03-31 19:00:00+00,14498,1471,5219,11931,352,3400,2002,138,0,768,39779,199,19504,17502,12283,15969
2022-03-31 19:30:00+00,14173,1443,5224,11895,351,3346,2019,121,0,102,38674,199,19489,17470,12246,15616
2022-03-31 20:00:00+00,13886,1362,5225,12052,298,2534,2022,122,0,136,37637,198,19597,17575,12350,15248
2022-03-31 20:30:00+00,12373,1187,5224,11938,280,2466,2022,124,0,0,35614,187,19464,17442,12218,13560
2022-03-31 21:00:00+00,10980,669,5224,11546,200,2868,2022,125,0,152,33786,172,18992,16970,11746,11649
2022-03-31 21:30:00+00,9771,339,5225,11590,193,2762,2020,106,0,4,32010,155,19028,17008,11783,10110
2022-03-31 22:00:00+00,9073,230,5227,11969,152,2652,2023,111,0,0,31437,144,19371,17348,12121,9303
2022-03-31 22:30:00+00,8585,231,5219,11593,143,2652,2035,106,0,0,30564,142,18990,16955,11736,8816
2022-03-31 23:00:00+00,7702,237,5223,11786,104,2740,2032,103,0,0,29927,135,19145,17113,11890,7939
2022-03-31 23:30:00+00,7444,231,5226,11718,103,2738,2032,101,0,0,29593,133,19079,17047,11821,7675
2022-04-01 00:00:00+00,7516,239,5222,11612,103,2740,2033,106,0,0,29571,132,18970,16937,11715,7755
2022-04-01 00:30:00+00,7363,233,5224,11564,103,2796,1889,96,0,0,29268,131,18780,16891,11667,7596
2022-04-01 01:00:00+00,7446,236,5221,11494,103,2710,1739,94,0,0,29043,132,18557,16818,11597,7682
2022-04-01 01:30:00+00,7507,238,5218,11545,103,2706,1923,108,0,0,29348,132,18789,16866,11648,7745
2022-04-01 02:00:00+00,8136,251,5216,11461,103,2538,2034,115,0,0,29854,138,18814,16780,11564,8387
2022-04-01 02:30:00+00,8294,370,5213,11220,103,2538,2034,108,0,0,29880,143,18570,16536,11323,8664
2022-04-01 03:00:00+00,8550,407,5218,11107,103,2602,2033,103,0,0,30123,147,18461,16428,11210,8957
2022-04-01 03:30:00+00,8594,405,5217,11040,102,2602,2036,102,0,0,30098,147,18395,16359,11142,8999
2022-04-01 04:00:00+00,8855,633,5216,10933,100,2402,2038,109,0,0,30286,155,18287,16249,11033,9488
2022-04-01 04:30:00+00,9995,651,5219,10650,102,2396,1977,106,0,0,31096,166,17948,15971,10752,10646
2022-04-01 05:00:00+00,12307,956,5219,10291,151,2254,2014,91,0,0,33283,189,17675,15661,10442,13263
2022-04-01 05:30:00+00,13785,1313,5219,10053,153,2254,2037,139,5,0,34958,207,17467,15430,10211,15098
2022-04-01 06:00:00+00,15919,1421,5223,9848,238,2192,2025,182,271,138,37457,218,17605,15580,10357,17340
2022-04-01 06:30:00+00,16859,1483,5222,9581,262,2192,2015,452,1011,270,39347,220,18091,16076,10854,18342
2022-04-01 07:00:00+00,17473,1478,5224,9122,446,1394,2015,648,1812,1022,40634,219,18619,16604,11380,18951
2022-04-01 07:30:00+00,16790,1448,5224,9086,451,1388,2015,660,2877,700,40639,212,19653,17638,12414,18238
2022-04-01 08:00:00+00,16448,1285,5224,9080,319,2392,2016,608,3864,486,41722,204,20503,18487,13263,17733
2022-04-01 08:30:00+00,17100,1343,5221,8869,304,2416,2018,543,4995,512,43321,203,21407,19389,14168,18443
2022-04-01 09:00:00+00,17007,1324,5228,8750,215,2366,2024,431,5786,142,43273,202,22003,19979,14751,18331
2022-04-01 09:30:00+00,16841,1284,5228,8537,194,2360,2029,223,6319,18,43033,199,22307,20278,15050,18125
2022-04-01 10:00:00+00,16991,1308,5219,8168,143,1974,2023,219,6460,138,42643,202,22013,19990,14771,18299
2022-04-01 10:30:00+00,17188,1208,5220,8034,106,1966,2013,148,6565,0,42448,202,21938,19925,14705,18396
2022-04-01 11:00:00+00,17477,1412,5215,7797,86,2002,2015,128,6815,268,43215,205,21928,19913,14698,18889
2022-04-01 11:30:00+00,17505,1484,5218,7608,82,2000,2015,117,6807,24,42860,209,21730,19715,14497,18989
2022-04-01 12:00:00+00,17127,1479,5223,7420,82,2158,2013,109,6863,64,42538,207,21601,19588,14365,18606
2022-04-01 12:30:00+00,16624,1480,5222,7395,82,2160,2013,111,6368,52,41507,207,21080,19067,13845,18104
2022-04-01 13:00:00+00,16504,1471,5221,7484,88,2240,2012,124,5981,0,41125,208,20786,18774,13553,17975
2022-04-01 13:30:00+00,16054,1415,5223,7521,99,2240,2010,129,5775,72,40538,205,20628,18618,13395,17469
2022-04-01 14:00:00+00,15834,1232,5233,7530,103,2212,2013,136,5742,0,40035,202,20621,18608,13375,17066
2022-04-01 14:30:00+00,16098,1298,5237,7374,116,2212,2016,135,4697,0,39183,210,19440,17424,12187,17396
2022-04-01 15:00:00+00,16955,1451,5233,7187,140,2090,2014,149,4661,32,39912,218,19235,17221,11988,18406
2022-04-01 15:30:00+00,17459,1481,5236,7122,154,2092,2014,154,3700,0,39412,227,18226,16212,10976,18940
2022-04-01 16:00:00+00,18711,1477,5229,7198,246,2446,2015,152,3244,68,40786,232,17932,15916,10688,20188
2022-04-01 16:30:00+00,19336,1473,5229,6977,295,2450,2013,189,2401,220,40583,239,16915,14902,9673,20809
2022-04-01 17:00:00+00,19493,1482,5228,6740,416,2740,2013,217,1399,342,40070,246,15796,13783,8555,20975
2022-04-01 17:30:00+00,19701,1476,5229,6414,421,2880,2015,211,695,692,39734,251,14774,12759,7530,21177
2022-04-01 18:00:00+00,19685,1475,5225,6050,405,2884,2014,379,156,608,38881,257,13850,11836,6611,21160
2022-04-01 18:30:00+00,19794,1476,5224,5949,403,2924,2015,392,0,576,38753,260,13591,11576,6352,21270
2022-04-01 19:00:00+00,19752,1480,5223,5616,400,2910,2008,460,0,348,38196,263,13246,11238,6016,21232
2022-04-01 19:30:00+00,19710,1478,5223,5601,386,2792,2010,159,0,324,37683,263,13220,11210,5987,21188
2022-04-01 20:00:00+00,19271,1443,5230,5384,324,2850,2002,156,0,0,36660,265,12940,10938,5708,20714
2022-04-01 20:30:00+00,18687,1271,5230,4824,293,2770,1996,133,0,16,35220,264,12343,10347,5117,19958
2022-04-01 21:00:00+00,18475,854,5230,4613,206,2824,1982,137,0,84,34405,257,12031,10049,4819,19329
2022-04-01 21:30:00+00,17820,356,5235,4230,198,2886,1976,128,0,62,32891,248,11639,9663,4428,18176
2022-04-01 22:00:00+00,16676,247,5231,3844,161,2386,1968,138,0,140,30791,241,11204,9236,4005,16923
2022-04-01 22:30:00+00,15573,318,5235,3643,156,2242,1987,133,0,208,29495,237,11021,9034,3799,15891
2022-04-01 23:00:00+00,15310,267,5238,3446,139,2196,1988,131,0,0,28715,237,10811,8823,3585,15577
2022-04-01 23:30:00+00,14922,252,5239,3373,135,2196,1989,127,0,0,28233,236,10736,8747,3508,15174
2022-04-02 00:00:00+00,14461,255,5234,3317,120,2196,1989,131,0,0,27703,234,10660,8671,3437,14716
2022-04-02 00:30:00+00,15016,304,5234,2880,120,2252,1991,144,0,18,27959,243,10225,8234,3000,15320
2022-04-02 01:00:00+00,14975,294,5236,2889,120,2196,1994,132,0,0,27836,242,10239,8245,3009,15269
2022-04-02 01:30:00+00,14526,263,5235,2841,121,2196,1996,134,0,0,27312,239,10193,8197,2962,14789
2022-04-02 02:00:00+00,14321,234,5234,2769,121,2234,1982,134,0,0,27029,238,10106,8124,2890,14555
2022-04-02 02:30:00+00,14616,232,5233,2942,120,1978,1742,133,0,0,26996,238,10037,8295,3062,14848
2022-04-02 03:00:00+00,14743,267,5231,2888,121,2036,1395,143,0,0,26824,242,9635,8240,3009,15010
2022-04-02 03:30:00+00,14222,229,5232,2970,121,2318,1396,134,0,0,26622,239,9719,8323,3091,14451
2022-04-02 04:00:00+00,14732,283,5231,2707,138,2382,1397,132,0,0,27002,246,9473,8076,2845,15015
2022-04-02 04:30:00+00,14990,480,5232,2643,141,2398,1398,130,0,0,27412,253,9414,8016,2784,15470
2022-04-02 05:00:00+00,15951,795,5228,2569,154,2442,1398,137,0,0,28674,266,9349,7951,2723,16746
2022-04-02 05:30:00+00,16401,1082,5229,2514,159,2530,1398,136,22,12,29483,275,9322,7924,2695,17483
2022-04-02 06:00:00+00,16929,1387,5230,2476,217,2386,1397,133,368,0,30523,280,9688,8291,3061,18316
2022-04-02 06:30:00+00,17243,1486,5231,2406,219,2288,1399,263,1102,88,31725,276,10357,8958,3727,18729
2022-04-02 07:00:00+00,17193,1450,5231,2413,279,2256,1401,358,2008,0,32589,267,11332,9931,4700,18643
2022-04-02 07:30:00+00,17388,1489,5235,2394,304,2320,1401,394,2959,0,33884,260,12293,10892,5657,18877
2022-04-02 08:00:00+00,17243,1489,5230,2338,305,2826,1400,203,3934,0,34968,250,13207,11807,6577,18732
2022-04-02 08:30:00+00,17121,1451,5235,2268,305,2850,1401,122,4788,0,35541,243,13997,12596,7361,18572
2022-04-02 09:00:00+00,17137,1453,5233,2302,259,2418,1402,131,5508,22,35865,240,14704,13302,8069,18590
2022-04-02 09:30:00+00,17031,1488,5228,2204,240,2408,1401,178,5867,164,36209,238,14940,13539,8311,18519
2022-04-02 10:00:00+00,16953,1486,5231,2175,165,2824,1402,149,5964,16,36365,241,14937,13535,8304,18439
2022-04-02 10:30:00+00,16731,1408,5224,2271,164,2866,1402,118,5655,0,35839,240,14716,13314,8090,18139
2022-04-02 11:00:00+00,16938,1432,5224,2129,119,2700,1401,120,6101,234,36398,239,14974,13573,8349,18370
2022-04-02 11:30:00+00,16940,1401,5239,2218,119,2698,1401,116,5863,12,36007,240,14840,13439,8200,18341
2022-04-02 12:00:00+00,17079,1431,5231,2085,119,2696,1400,117,5313,66,35537,246,14148,12748,7517,18510
2022-04-02 12:30:00+00,17094,1432,5229,2127,119,2698,1399,117,5226,0,35441,247,14100,12701,7472,18526
2022-04-02 13:00:00+00,17194,1374,5226,2127,119,2756,1396,113,5146,40,35491,247,14014,12618,7392,18568
2022-04-02 13:30:00+00,17203,1223,5228,2135,119,2756,1397,113,5044,20,35238,245,13923,12526,7298,18426
2022-04-02 14:00:00+00,16984,886,5227,2052,123,2756,1400,116,5418,0,34962,235,14220,12820,7593,17870
2022-04-02 14:30:00+00,17126,745,5228,2176,137,2756,1401,120,4918,0,34607,235,13860,12459,7231,17871
2022-04-02 15:00:00+00,17616,835,5229,2165,163,2776,1400,119,4361,16,34680,243,13318,11918,6689,18451
2022-04-02 15:30:00+00,18226,1214,5238,2211,163,2776,1391,130,3829,0,35178,256,12832,11441,6203,19440
2022-04-02 16:00:00+00,18617,1185,5234,2350,191,2718,1398,125,2981,18,34817,262,12154,10756,5522,19802
2022-04-02 16:30:00+00,19493,1445,5236,2396,217,2716,1398,146,2198,38,35283,275,11445,10047,4811,20938
2022-04-02 17:00:00+00,19925,1488,5241,2458,354,2716,1508,371,1343,0,35404,283,10904,9396,4155,21413
2022-04-02 17:30:00+00,19843,1489,5237,2372,368,2716,1708,507,683,330,35253,285,10368,8660,3423,21332
2022-04-02 18:00:00+00,19890,1490,5237,2380,369,2746,1749,532,158,828,35379,285,9893,8144,2907,21380
2022-04-02 18:30:00+00,19864,1488,5239,2333,423,2776,1885,622,0,456,35086,289,9880,7995,2756,21352
2022-04-02 19:00:00+00,19806,1491,5231,2353,396,2852,2034,612,0,558,35333,287,10014,7980,2749,21297
2022-04-02 19:30:00+00,19839,1490,5227,2350,364,2858,2047,379,0,616,35170,287,9988,7941,2714,21329
2022-04-02 20:00:00+00,19883,1489,5228,2286,295,2452,2048,413,0,450,34544,289,9857,7809,2581,21372
2022-04-02 20:30:00+00,19573,1490,5231,2488,285,2468,2025,212,0,0,33772,290,10029,8004,2773,21063
2022-04-02 21:00:00+00,19020,1363,5228,2534,224,2690,2044,166,0,0,33269,287,10030,7986,2758,20383
2022-04-02 21:30:00+00,18137,856,5225,2426,223,2702,2049,175,0,16,31809,275,9923,7874,2649,18993
2022-04-02 22:00:00+00,15850,389,5229,2258,223,2708,2050,218,0,0,28925,255,9760,7710,2481,16239
2022-04-02 22:30:00+00,14825,228,5232,2116,222,2756,2049,206,0,0,27634,247,9619,7570,2338,15053
2022-04-02 23:00:00+00,14669,235,5229,1859,146,2752,2048,203,0,20,27161,250,9282,7234,2005,14904
2022-04-02 23:30:00+00,14438,239,5232,1786,137,2754,2047,191,0,0,26824,250,9202,7155,1923,14677
2022-04-03 00:00:00+00,14339,258,5228,1647,137,2698,2045,170,0,0,26522,255,9057,7012,1784,14597
2022-04-03 00:30:00+00,14438,426,5230,1747,137,2782,2044,172,0,0,26976,259,9158,7114,1884,14864
2022-04-03 01:00:00+00,14378,317,5232,1743,137,2714,2048,168,0,0,26737,257,9160,7112,1880,14695
2022-04-03 01:30:00+00,14206,228,5234,1898,137,2598,2050,165,0,0,26516,252,9319,7269,2035,14434
2022-04-03 02:00:00+00,13643,230,5235,2082,155,2294,2050,162,0,0,25851,246,9522,7472,2237,13873
2022-04-03 02:30:00+00,13350,234,5234,2340,155,2196,2050,167,0,0,25726,241,9779,7729,2495,13584
2022-04-03 03:00:00+00,13768,239,5234,2538,155,2108,2048,172,0,0,26262,240,9975,7927,2693,14007
2022-04-03 03:30:00+00,13635,234,5233,2878,154,2048,2048,166,0,0,26396,235,10313,8265,3032,13869
2022-04-03 04:00:00+00,13699,233,5234,3149,154,1670,2050,189,0,0,26378,235,10587,8537,3303,13932
2022-04-03 04:30:00+00,13475,230,5235,3458,160,1672,2051,162,0,0,26443,230,10904,8853,3618,13705
2022-04-03 05:00:00+00,13518,239,5233,3612,196,1928,2050,168,0,0,26944,228,11091,9041,3808,13757
2022-04-03 05:30:00+00,13695,361,5236,3732,192,1918,2046,164,25,30,27399,231,11231,9185,3949,14056
2022-04-03 06:00:00+00,14230,615,5235,3936,285,1773,2050,169,364,176,28833,234,11870,9820,4585,14845
2022-04-03 06:30:00+00,14601,876,5235,3987,295,1706,2049,202,1164,180,30295,235,12730,10681,5446,15477
2022-04-03 07:00:00+00,14744,988,5234,3848,324,1688,2049,223,2165,420,31683,226,13620,11571,6337,15732
2022-04-03 07:30:00+00,14972,987,5234,3622,324,1692,2048,208,3121,262,32470,223,14349,12301,7067,15959
2022-04-03 08:00:00+00,14663,982,5235,3636,324,1846,2049,204,4145,332,33416,217,15389,13340,8105,15645
2022-04-03 08:30:00+00,14566,980,5239,3798,322,1864,2050,166,5175,136,34296,210,16584,14534,9295,15546
2022-04-03 09:00:00+00,14925,983,5236,3882,200,2092,2048,164,5788,126,35444,210,17154,15106,9870,15908
2022-04-03 09:30:00+00,14590,983,5234,4087,182,2144,2042,157,6527,0,35946,204,18072,16030,10796,15573
2022-04-03 10:00:00+00,14140,934,5233,4354,181,2686,2048,116,6792,0,36484,200,18608,16560,11327,15074
2022-04-03 10:30:00+00,14030,719,5233,4894,181,2688,2047,114,6527,0,36433,193,18882,16835,11602,14749
2022-04-03 11:00:00+00,14362,571,5230,5334,152,2448,2049,135,6503,178,36962,189,19268,17219,11989,14933
2022-04-03 11:30:00+00,14528,679,5224,5674,146,2444,2049,124,5759,110,36737,195,18852,16803,11579,15207
2022-04-03 12:00:00+00,14570,589,5226,6024,120,2338,2046,117,5809,264,37103,190,19225,17179,11953,15159
2022-04-03 12:30:00+00,14213,619,5228,6421,121,2342,2045,115,5112,132,36348,191,18927,16882,11654,14832
2022-04-03 13:00:00+00,13865,499,5227,6987,121,2434,2045,111,4675,32,35996,187,19055,17010,11783,14364
2022-04-03 13:30:00+00,13690,458,5228,7191,121,2434,2045,102,4947,34,36250,182,19532,17487,12259,14148
2022-04-03 14:00:00+00,14240,566,5231,7302,141,2148,2043,102,4226,130,36129,189,18943,16900,11669,14806
2022-04-03 14:30:00+00,14189,620,5230,7618,144,2126,2050,105,3298,36,35416,194,18340,16290,11060,14809
2022-04-03 15:00:00+00,14411,868,5232,8010,186,1514,2051,164,2990,410,35836,195,18469,16418,11186,15279
2022-04-03 15:30:00+00,14457,945,5234,8337,191,1646,2048,352,2427,686,36323,198,18237,16189,10955,15402
2022-04-03 16:00:00+00,14405,988,5235,8638,294,1626,2048,459,2043,1340,37076,200,18258,16210,10975,15393
2022-04-03 16:30:00+00,14587,984,5239,8811,363,1678,2047,452,1576,1580,37317,201,18036,15989,10750,15571
2022-04-03 17:00:00+00,15056,983,5238,9120,450,1218,2047,556,1061,1482,37211,204,17916,15869,10631,16039
2022-04-03 17:30:00+00,15211,984,5241,9623,460,1218,2049,658,597,1344,37385,206,17970,15921,10680,16195
2022-04-03 18:00:00+00,15463,982,5238,10274,451,1146,2048,696,180,634,37112,210,18191,16143,10905,16445
2022-04-03 18:30:00+00,15287,969,5239,11394,409,1058,2049,690,1,498,37594,203,19092,17043,11804,16256
2022-04-03 19:00:00+00,15233,770,5235,12220,352,936,2047,524,0,240,37557,194,19854,17807,12572,16003
2022-04-03 19:30:00+00,14623,622,5233,12864,258,896,2049,247,0,0,36792,185,20404,18355,13122,15245
2022-04-03 20:00:00+00,13414,480,5227,12930,221,932,2048,245,0,0,35497,175,20426,18378,13151,13894
2022-04-03 20:30:00+00,11645,452,5227,13147,218,770,2048,193,0,32,33732,159,20640,18592,13365,12097
2022-04-03 21:00:00+00,9971,443,5230,13578,218,440,2048,176,0,0,32104,146,21074,19026,13796,10414
2022-04-03 21:30:00+00,8242,501,5234,14138,217,320,1904,173,0,0,30729,130,21493,19589,14355,8743
2022-04-03 22:00:00+00,5992,390,5234,14657,217,396,1743,163,0,0,28792,106,21851,20108,14874,6382
2022-04-03 22:30:00+00,4814,232,5231,14975,215,484,1643,153,0,0,27747,89,22064,20421,15190,5046
2022-04-03 23:00:00+00,3995,235,5230,15458,155,1040,1356,106,0,0,27575,86,22199,20843,15613,4230
2022-04-03 23:30:00+00,4031,234,5230,15545,145,936,1494,103,0,0,27718,85,22414,20920,15690,4265
2022-04-04 00:00:00+00,3649,326,5226,15723,127,1226,1518,104,0,0,27899,84,22594,21076,15850,3975
2022-04-04 00:30:00+00,3836,395,5228,15934,127,1330,1598,107,0,0,28555,89,22887,21289,16061,4231
2022-04-04 01:00:00+00,4009,460,5229,15966,127,1026,1606,112,0,0,28535,91,22928,21322,16093,4469
2022-04-04 01:30:00+00,3863,457,5230,16048,127,942,1715,104,0,0,28486,88,23120,21405,16175,4320
2022-04-04 02:00:00+00,3853,458,5231,16063,127,1116,1757,114,0,0,28719,89,23178,21421,16190,4311
2022-04-04 02:30:00+00,3840,456,5228,16113,127,1090,1757,107,0,0,28718,88,23225,21468,16240,4296
2022-04-04 03:00:00+00,3865,460,5230,16294,136,994,1763,112,0,0,28854,89,23423,21660,16430,4325
2022-04-04 03:30:00+00,3811,456,5228,16355,146,1006,1920,106,0,0,29028,89,23649,21729,16501,4267
2022-04-04 04:00:00+00,3864,453,5228,16207,146,904,2044,104,0,0,28950,88,23625,21581,16353,4317
2022-04-04 04:30:00+00,4533,445,5234,16282,146,904,1989,101,0,0,29634,94,23651,21662,16428,4978
2022-04-04 05:00:00+00,4969,455,5231,16602,246,1486,1830,107,0,0,30926,97,23909,22079,16848,5424
2022-04-04 05:30:00+00,6498,447,5233,16825,283,1514,2034,101,0,0,32935,110,24375,22341,17108,6945
2022-04-04 06:00:00+00,8687,452,5230,16951,350,1088,2046,139,38,230,35211,123,24615,22569,17339,9139
2022-04-04 06:30:00+00,9805,455,5228,17002,349,1026,2044,387,172,662,37130,130,24795,22751,17523,10260
2022-04-04 07:00:00+00,10331,570,5229,17312,349,1680,2037,558,413,558,39037,132,25340,23303,18074,10901
2022-04-04 07:30:00+00,10993,831,5229,17718,332,1762,2046,584,660,358,40513,140,25985,23939,18710,11824
2022-04-04 08:00:00+00,11287,954,5224,17766,304,2470,2046,411,992,258,41712,147,26332,24286,19062,12241
2022-04-04 08:30:00+00,11249,986,5227,17696,303,2492,2047,329,1189,368,41886,146,26462,24415,19188,12235
2022-04-04 09:00:00+00,11405,988,5227,17275,268,2730,2046,406,1380,234,41959,149,26196,24150,18923,12393
2022-04-04 09:30:00+00,11386,988,5227,17083,268,2734,2044,377,1705,88,41900,148,26327,24283,19056,12374
2022-04-04 10:00:00+00,11108,982,5231,17348,202,2740,2045,322,2056,0,42034,145,26882,24837,19606,12090
2022-04-04 10:30:00+00,10919,991,5227,17271,176,2740,2047,191,2313,0,41875,143,27034,24987,19760,11910
2022-04-04 11:00:00+00,11081,905,5229,17148,156,2810,2047,126,2470,50,42022,142,27050,25003,19774,11986
2022-04-04 11:30:00+00,10768,719,5228,17422,154,2758,2047,128,2558,0,41782,135,27409,25362,20134,11487
2022-04-04 12:00:00+00,10559,464,5222,17432,121,2788,2043,135,2576,164,41504,129,27394,25351,20129,11023
2022-04-04 12:30:00+00,10428,461,5226,17308,164,2752,2043,124,2639,6,41151,128,27380,25337,20111,10889
2022-04-04 13:00:00+00,10793,461,5225,17077,163,2504,2042,117,2419,40,40841,131,26926,24884,19659,11254
2022-04-04 13:30:00+00,10927,473,5224,16595,133,2546,2042,112,2198,0,40250,135,26192,24150,18926,11400
2022-04-04 14:00:00+00,10976,671,5227,16400,149,2084,2046,115,2440,14,40122,136,26262,24216,18989,11647
2022-04-04 14:30:00+00,11525,789,5225,15994,166,2182,2046,116,1885,16,39944,146,25316,23270,18044,12314
2022-04-04 15:00:00+00,12155,947,5225,15727,218,1750,2044,130,1646,0,39842,153,24860,22816,17591,13102
2022-04-04 15:30:00+00,12977,946,5224,15475,284,1804,2048,166,1403,0,40327,160,24434,22386,17162,13923
2022-04-04 16:00:00+00,13487,938,5227,14774,380,2632,2048,142,975,0,40603,170,23404,21356,16129,14425
2022-04-04 16:30:00+00,13589,937,5228,14518,425,2854,2048,168,660,0,40427,174,22879,20831,15603,14526
2022-04-04 17:00:00+00,13634,917,5225,14434,514,2774,2048,165,457,0,40168,175,22678,20630,15405,14551
2022-04-04 17:30:00+00,13872,743,5223,14245,481,2760,2041,248,216,0,39829,175,22206,20165,14942,14615
2022-04-04 18:00:00+00,13558,781,5228,14016,481,2842,2047,207,46,210,39416,175,21818,19771,14543,14339
2022-04-04 18:30:00+00,13299,947,5232,13731,486,2832,2048,198,0,232,39005,178,21497,19449,14217,14246
2022-04-04 19:00:00+00,13269,850,5230,13673,451,2718,2063,259,0,222,38735,176,21417,19354,14124,14119
2022-04-04 19:30:00+00,12806,624,5234,13580,426,2580,2074,183,0,0,37507,169,21314,19240,14006,13430
2022-04-04 20:00:00+00,11965,496,5233,13340,339,2304,2079,146,0,50,35952,161,20991,18912,13679,12461
2022-04-04 20:30:00+00,10593,406,5227,13134,324,2300,2081,138,0,0,34203,151,20766,18685,13458,10999
2022-04-04 21:00:00+00,9877,344,5228,12808,293,1468,2079,122,0,0,32219,147,20408,18329,13101,10221
2022-04-04 21:30:00+00,8505,237,5230,12544,259,1338,2027,135,0,0,30275,135,20060,18033,12803,8742
2022-04-04 22:00:00+00,5869,238,5228,12232,241,2470,1975,131,0,0,28384,112,19676,17701,12473,6107
2022-04-04 22:30:00+00,4692,234,5229,11987,244,2622,1978,126,0,0,27112,102,19438,17460,12231,4926
2022-04-04 23:00:00+00,3846,238,5231,11937,261,2890,1942,123,0,0,26468,96,19371,17429,12198,4084
2022-04-04 23:30:00+00,3497,230,5234,11953,261,3030,1878,113,0,0,26196,93,19326,17448,12214,3727
2022-04-05 00:00:00+00,3564,230,5228,12123,244,2982,1890,114,0,0,26375,95,19485,17595,12367,3794
2022-04-05 00:30:00+00,3970,240,5227,12041,242,2980,1779,121,0,0,26600,100,19289,17510,12283,4210
2022-04-05 01:00:00+00,3974,240,5228,12087,243,2838,1796,124,0,0,26530,99,19354,17558,12330,4214
2022-04-05 01:30:00+00,3888,241,5225,11809,243,2834,1917,124,0,0,26281,99,19194,17277,12052,4129
2022-04-05 02:00:00+00,3808,237,5230,11680,242,2578,2042,117,0,0,25934,95,19194,17152,11922,4045
2022-04-05 02:30:00+00,3688,238,5229,11712,252,2560,2071,117,0,0,25867,94,19264,17193,11964,3926
2022-04-05 03:00:00+00,3660,229,5232,12090,291,2504,2067,113,0,0,26186,91,19680,17613,12381,3889
2022-04-05 03:30:00+00,3744,229,5228,12312,282,2502,1950,113,0,0,26360,91,19772,17822,12594,3973
2022-04-05 04:00:00+00,4740,239,5221,11899,297,2324,1957,125,0,0,26802,104,19374,17417,12196,4979
2022-04-05 04:30:00+00,5594,324,5221,11648,279,2298,2038,126,0,0,27528,116,19186,17148,11927,5918
2022-04-05 05:00:00+00,8256,548,5224,11737,409,1792,2043,115,0,0,30124,142,19413,17370,12146,8804
2022-04-05 05:30:00+00,9813,839,5223,11834,424,1780,2049,112,5,0,32079,161,19535,17486,12263,10652
2022-04-05 06:00:00+00,12125,881,5224,11872,453,1842,2050,136,95,0,34678,175,19694,17644,12420,13006
2022-04-05 06:30:00+00,13330,977,5222,11851,453,1828,2049,159,331,458,36658,181,19906,17857,12635,14307
2022-04-05 07:00:00+00,13818,984,5223,12050,436,1728,2050,284,700,782,38055,179,20459,18409,13186,14802
2022-04-05 07:30:00+00,13584,980,5226,13008,441,1720,2047,259,1244,510,39019,172,21966,19919,14693,14564
2022-04-05 08:00:00+00,12775,974,5226,13935,439,1556,1970,216,1729,802,39622,160,23299,21329,16103,13749
2022-04-05 08:30:00+00,12433,910,5226,14266,440,1546,1868,183,2381,788,40041,153,24181,22313,17087,13343
2022-04-05 09:00:00+00,12262,862,5228,14526,442,1640,1813,183,2989,0,39945,152,24998,23185,17957,13124
2022-04-05 09:30:00+00,11683,779,5227,14811,443,1574,1836,165,3591,0,40109,143,25908,24072,18845,12462
2022-04-05 10:00:00+00,11204,874,5224,14865,386,1732,1893,174,3696,138,40186,141,26064,24171,18947,12078
2022-04-05 10:30:00+00,10951,800,5228,15154,380,1848,1805,215,3831,42,40254,138,26398,24593,19365,11751
2022-04-05 11:00:00+00,10823,590,5230,15109,367,2218,1909,185,3969,60,40460,135,26584,24675,19445,11413
2022-04-05 11:30:00+00,10705,460,5230,15039,358,2282,1972,139,3856,0,40041,133,26455,24483,19253,11165
2022-04-05 12:00:00+00,10184,464,5229,15024,321,2406,1974,124,3792,0,39518,132,26340,24366,19137,10648
2022-04-05 12:30:00+00,9679,462,5227,15097,354,2356,1999,112,4014,0,39300,127,26691,24692,19465,10141
2022-04-05 13:00:00+00,9605,462,5231,15194,359,2018,1874,121,4496,0,39360,120,27154,25280,20049,10067
2022-04-05 13:30:00+00,9443,466,5225,15082,359,2086,1833,173,4391,0,39058,120,26890,25057,19832,9909
2022-04-05 14:00:00+00,9624,462,5234,15188,365,1906,1796,113,3874,0,38562,125,26457,24661,19427,10086
2022-04-05 14:30:00+00,9754,539,5230,15468,384,2000,1743,116,3516,0,38750,128,26341,24598,19368,10293
2022-04-05 15:00:00+00,10559,698,5233,15520,394,1980,1762,116,2846,0,39108,140,25755,23993,18760,11257
2022-04-05 15:30:00+00,11032,733,5231,15670,390,1980,1861,141,2350,102,39490,145,25502,23641,18410,11765
2022-04-05 16:00:00+00,11482,955,5228,15713,442,1770,1999,157,1618,362,39726,154,25000,23001,17773,12437
2022-04-05 16:30:00+00,11643,982,5231,15655,476,1742,1960,171,1300,658,39818,156,24622,22662,17431,12625
2022-04-05 17:00:00+00,12249,983,5230,15448,515,1330,1908,167,790,1072,39692,156,23891,21983,16753,13232
2022-04-05 17:30:00+00,12338,986,5228,15107,499,1332,2001,192,400,1314,39397,159,23235,21234,16006,13324
2022-04-05 18:00:00+00,12795,982,5229,14705,491,1620,1976,325,97,1214,39434,166,22498,20522,15293,13777
2022-04-05 18:30:00+00,12871,982,5230,14696,455,1622,1982,470,1,850,39159,169,22364,20382,15152,13853
2022-04-05 19:00:00+00,12916,983,5229,14772,444,2002,1977,238,0,588,39149,170,22422,20445,15216,13899
2022-04-05 19:30:00+00,12501,962,5233,14953,441,1942,1848,150,0,110,38140,167,22475,20627,15394,13463
2022-04-05 20:00:00+00,11299,957,5228,15008,400,2308,1467,120,0,38,36825,164,22103,20636,15408,12256
2022-04-05 20:30:00+00,8810,956,5226,15207,385,2210,1531,134,0,22,34481,146,22349,20818,15592,9766
2022-04-05 21:00:00+00,7205,739,5226,15113,357,2636,1397,119,0,8,32800,131,22093,20696,15470,7944
2022-04-05 21:30:00+00,5962,492,5223,15138,377,2526,1178,113,0,0,31009,113,21916,20738,15515,6454
2022-04-05 22:00:00+00,4767,497,5224,15030,380,1720,1182,113,0,0,28913,100,21816,20634,15410,5264
2022-04-05 22:30:00+00,3929,497,5228,15014,384,1804,1275,114,0,0,28245,93,21901,20626,15398,4426
2022-04-05 23:00:00+00,3871,465,5228,14865,384,1422,1345,116,0,0,27696,91,21822,20477,15249,4336
2022-04-05 23:30:00+00,3740,410,5231,15101,383,1436,1300,114,0,0,27715,87,22015,20715,15484,4150
2022-04-06 00:00:00+00,3530,480,5231,15271,360,1682,1222,113,0,0,27889,87,22084,20862,15631,4010
2022-04-06 00:30:00+00,3605,498,5226,15218,359,1712,1258,132,0,0,28008,89,22061,20803,15577,4103
2022-04-06 01:00:00+00,2986,388,5224,15046,361,2198,1247,131,0,0,27581,81,21878,20631,15407,3374
2022-04-06 01:30:00+00,2951,318,5229,14906,360,2204,1213,114,0,0,27295,79,21708,20495,15266,3269
2022-04-06 02:00:00+00,2779,229,5228,14901,347,2314,1215,111,0,0,27124,75,21691,20476,15248,3008
2022-04-06 02:30:00+00,2740,230,5232,14944,347,2314,1251,116,0,0,27174,75,21774,20523,15291,2970
2022-04-06 03:00:00+00,2782,232,5224,14705,368,2146,1262,121,0,0,26840,75,21559,20297,15073,3014
2022-04-06 03:30:00+00,2774,258,5229,14961,383,2146,1216,111,0,0,27078,74,21789,20573,15344,3032
2022-04-06 04:00:00+00,2718,261,5227,15015,387,1778,1300,116,0,0,26802,70,21929,20629,15402,2979
2022-04-06 04:30:00+00,2998,264,5226,15162,381,1840,1362,120,0,0,27353,73,22131,20769,15543,3262
2022-04-06 05:00:00+00,4208,392,5224,15429,432,2438,1481,123,0,52,29779,90,22566,21085,15861,4600
2022-04-06 05:30:00+00,5631,603,5221,15551,433,2424,1780,116,19,0,31778,108,23004,21224,16003,6234
2022-04-06 06:00:00+00,8160,756,5224,15634,457,2094,1812,118,191,0,34446,128,23318,21506,16282,8916
2022-04-06 06:30:00+00,9131,948,5219,15735,460,2092,1821,142,555,100,36203,138,23790,21969,16750,10079
2022-04-06 07:00:00+00,9743,970,5225,16174,509,2512,1746,174,939,88,38080,141,24593,22847,17622,10713
2022-04-06 07:30:00+00,9800,843,5224,16321,559,2522,1645,179,1296,206,38595,137,25045,23400,18176,10643
2022-04-06 08:00:00+00,9845,822,5220,16432,558,2842,1657,138,1774,8,39296,137,25641,23984,18764,10667
2022-04-06 08:30:00+00,9729,820,5222,16649,518,2808,1568,120,2139,52,39625,134,26096,24528,19306,10549
2022-04-06 09:00:00+00,9440,843,5221,16611,477,2896,1496,114,2450,38,39586,133,26255,24759,19538,10283
2022-04-06 09:30:00+00,9111,881,5225,16790,475,2902,1315,119,2899,36,39753,129,26704,25389,20164,9992
2022-04-06 10:00:00+00,8777,881,5242,16757,431,3084,1293,136,3388,88,40077,126,27111,25818,20576,9658
2022-04-06 10:30:00+00,8444,948,5234,16770,422,3084,1365,122,3564,74,40027,125,27355,25990,20756,9392
2022-04-06 11:00:00+00,8641,985,5228,16739,414,3084,1338,127,3967,40,40563,126,27686,26348,21120,9626
2022-04-06 11:30:00+00,8505,987,5235,16816,424,3084,1171,118,4243,14,40597,124,27889,26718,21483,9492
2022-04-06 12:00:00+00,7826,950,5234,16828,398,3082,1171,162,4241,32,39924,119,27872,26701,21467,8776
2022-04-06 12:30:00+00,7120,939,5231,16663,408,3082,1190,120,4392,84,39229,113,27884,26694,21463,8059
2022-04-06 13:00:00+00,6476,986,5228,16603,415,2954,1192,127,4520,68,38569,110,27958,26766,21538,7462
2022-04-06 13:30:00+00,6149,953,5230,16566,426,2954,1207,119,5529,142,39275,103,28958,27751,22521,7102
2022-04-06 14:00:00+00,6267,723,5228,16146,465,2530,1307,129,5190,210,38195,98,28336,27029,21801,6990
2022-04-06 14:30:00+00,7249,580,5231,16094,463,2518,1307,113,4479,172,38206,104,27574,26267,21036,7829
2022-04-06 15:00:00+00,8000,589,5233,16180,547,2236,1372,125,3873,180,38335,109,27205,25833,20600,8589
2022-04-06 15:30:00+00,8903,736,5234,16055,555,2218,1548,153,3241,274,38917,121,26633,25085,19851,9639
2022-04-06 16:00:00+00,9629,754,5233,15562,597,2566,1790,145,2266,440,38982,132,25448,23658,18425,10383
2022-04-06 16:30:00+00,10585,697,5239,15428,612,2566,1840,166,1539,472,39144,140,24658,22818,17579,11282
2022-04-06 17:00:00+00,10753,832,5231,15410,632,2224,1928,224,991,1034,39259,142,24192,22264,17033,11585
2022-04-06 17:30:00+00,10768,941,5236,15252,645,2250,2057,218,395,1130,38892,147,23585,21528,16292,11709
2022-04-06 18:00:00+00,10788,985,5233,14413,644,2616,2027,196,124,1462,38488,153,22441,20414,15181,11773
2022-04-06 18:30:00+00,10783,986,5233,13787,644,2662,2055,188,2,1732,38072,155,21721,19666,14433,11769
2022-04-06 19:00:00+00,10740,976,5233,13699,625,3102,2047,165,0,1282,37869,159,21604,19557,14324,11716
2022-04-06 19:30:00+00,9918,860,5229,14273,609,3102,1862,168,0,940,36961,151,21973,20111,14882,10778
2022-04-06 20:00:00+00,8831,791,5229,14801,539,3072,1736,164,0,672,35835,141,22305,20569,15340,9622
2022-04-06 20:30:00+00,7389,691,5229,15233,519,3110,1652,167,0,118,34108,129,22633,20981,15752,8080
2022-04-06 21:00:00+00,5757,505,5231,15922,462,3144,1274,113,0,0,32408,109,22889,21615,16384,6262
2022-04-06 21:30:00+00,4249,250,5222,16196,452,2966,1227,122,0,0,30684,86,23097,21870,16648,4499
2022-04-06 22:00:00+00,4241,362,5217,15980,426,2305,1128,128,0,18,29805,86,22751,21623,16406,4603
2022-04-06 22:30:00+00,3561,375,5219,15775,404,1858,998,118,0,0,28308,76,22396,21398,16179,3936
2022-04-06 23:00:00+00,3608,346,5224,15639,384,1862,924,103,0,0,28090,76,22171,21247,16023,3954
2022-04-06 23:30:00+00,3703,312,5219,15403,384,1848,927,108,0,0,27904,76,21933,21006,15787,4015
2022-04-07 00:00:00+00,3614,319,5216,15328,385,1792,985,109,0,0,27748,76,21914,20929,15713,3933
2022-04-07 00:30:00+00,4010,402,5217,15243,385,1754,1160,110,0,0,28281,83,22005,20845,15628,4412
2022-04-07 01:00:00+00,4120,397,5215,15292,366,1356,1165,112,0,0,28023,85,22038,20873,15658,4517
2022-04-07 01:30:00+00,4057,394,5220,15347,366,1312,1166,112,0,0,27974,85,22099,20933,15713,4451
2022-04-07 02:00:00+00,3957,395,5216,15293,366,1316,1168,116,0,0,27827,84,22043,20875,15659,4352
2022-04-07 02:30:00+00,3767,391,5223,15594,365,1302,1137,111,0,0,27890,81,22319,21182,15959,4158
2022-04-07 03:00:00+00,4006,417,5216,15734,366,1220,1168,117,0,0,28244,84,22484,21316,16100,4423
2022-04-07 03:30:00+00,3649,417,5225,16116,366,1220,1167,113,0,0,28273,79,22874,21707,16482,4066
2022-04-07 04:00:00+00,3921,478,5223,16268,362,1086,1169,117,0,0,28624,83,23022,21853,16630,4399
2022-04-07 04:30:00+00,4409,488,5222,16360,358,1184,1169,116,0,0,29306,88,23109,21940,16718,4897
2022-04-07 05:00:00+00,4478,385,5223,16423,378,2580,1169,116,0,0,30752,88,23193,22024,16801,4863
2022-04-07 05:30:00+00,5781,599,5220,16468,390,2690,1175,125,59,0,32507,106,23312,22137,16917,6380
2022-04-07 06:00:00+00,7411,897,5221,16779,497,2946,1292,147,474,32,35696,125,24263,22971,17750,8308
2022-04-07 06:30:00+00,8093,987,5219,16958,481,2934,1319,186,1188,168,37533,128,25165,23846,18627,9080
2022-04-07 07:00:00+00,8344,989,5219,17279,475,2642,1319,179,1893,130,38469,125,26185,24866,19647,9333
2022-04-07 07:30:00+00,8187,990,5220,17368,479,2682,1225,179,2708,262,39300,121,27000,25775,20555,9177
2022-04-07 08:00:00+00,8078,989,5222,17646,464,3064,1211,168,2855,268,39964,121,27398,26186,20964,9067
2022-04-07 08:30:00+00,7947,986,5223,17844,468,2974,1294,208,3535,62,40541,117,28364,27070,21847,8933
2022-04-07 09:00:00+00,7793,985,5221,18086,423,2912,1223,108,4404,70,41225,112,29357,28134,22913,8778
2022-04-07 09:30:00+00,7522,987,5221,18180,421,2798,1157,104,5008,0,41398,108,29987,28830,23609,8509
2022-04-07 10:00:00+00,7131,984,5229,18232,412,2694,1022,110,5320,0,41134,103,30215,29193,23964,8115
2022-04-07 10:30:00+00,6827,988,5227,18172,411,2694,1081,119,5697,60,41276,100,30588,29507,24280,7815
2022-04-07 11:00:00+00,6479,988,5229,18380,401,2692,1246,111,6312,144,41982,96,31568,30322,25093,7467
2022-04-07 11:30:00+00,6361,988,5229,18461,411,2694,1063,115,6183,14,41519,95,31347,30284,25055,7349
2022-04-07 12:00:00+00,6030,883,5224,18593,394,2742,864,130,6116,14,40990,91,31191,30327,25103,6913
2022-04-07 12:30:00+00,5712,803,5227,18443,398,2740,885,121,6504,22,40855,86,31457,30572,25345,6515
2022-04-07 13:00:00+00,5109,693,5221,18311,418,2740,833,120,5856,226,39527,80,30639,29806,24585,5802
2022-04-07 13:30:00+00,5169,730,5226,18073,418,2742,820,117,5398,0,38693,83,29935,29115,23889,5899
2022-04-07 14:00:00+00,4243,670,5215,17717,382,3314,885,145,5193,124,37888,75,29392,28507,23292,4913
2022-04-07 14:30:00+00,5143,749,5220,17482,395,3364,829,124,4978,12,38296,85,28904,28075,22855,5892
2022-04-07 15:00:00+00,6579,770,5217,17092,446,3406,839,119,4440,32,38940,98,28034,27196,21978,7349
2022-04-07 15:30:00+00,7466,846,5215,16970,437,3412,957,146,3510,0,38959,109,27089,26132,20917,8312
2022-04-07 16:00:00+00,8759,1174,5218,16375,540,2402,1214,156,2708,346,38892,126,26055,24841,19623,9933
2022-04-07 16:30:00+00,9115,1398,5218,16207,542,2414,1234,184,2154,422,38888,135,25355,24121,18903,10513
2022-04-07 17:00:00+00,9309,1485,5223,15732,543,3522,1183,163,1418,560,39138,138,24099,22916,17693,10794
2022-04-07 17:30:00+00,9439,1472,5231,15828,542,3578,1169,214,781,476,38730,141,23551,22382,17151,10911
2022-04-07 18:00:00+00,9764,1489,5225,14982,543,4138,1192,189,228,632,38382,149,22170,20978,15753,11253
2022-04-07 18:30:00+00,9820,1486,5230,14404,532,4148,1179,158,8,1048,38013,150,21353,20174,14944,11306
2022-04-07 19:00:00+00,10028,1484,5230,13925,523,4380,1177,235,0,662,37644,156,20855,19678,14448,11512
2022-04-07 19:30:00+00,10134,1482,5231,13073,516,4352,1171,388,0,1020,37367,159,19991,18820,13589,11616
2022-04-07 20:00:00+00,10178,1455,5233,12414,459,3316,1206,539,0,698,35498,170,19312,18106,12873,11633
2022-04-07 20:30:00+00,9717,1241,5234,12294,463,3222,1147,477,0,238,34033,165,19138,17991,12757,10958
2022-04-07 21:00:00+00,9662,1005,5231,12317,409,2606,1131,163,0,78,32602,161,19088,17957,12726,10667
2022-04-07 21:30:00+00,8941,575,5231,12184,397,2606,801,129,0,0,30864,147,18613,17812,12581,9516
2022-04-07 22:00:00+00,8012,523,5230,12165,370,2738,455,115,0,0,29608,139,18220,17765,12535,8535
2022-04-07 22:30:00+00,7491,230,5223,12118,380,2742,465,112,0,0,28761,126,18186,17721,12498,7721
2022-04-07 23:00:00+00,7841,12,5225,11804,370,2742,459,106,0,0,28559,125,17858,17399,12174,7853
2022-04-07 23:30:00+00,7956,0,5224,11447,368,2740,454,102,0,0,28291,127,17493,17039,11815,7956
2022-04-08 00:00:00+00,8084,0,5227,11046,331,2672,471,103,0,0,27934,136,17075,16604,11377,8084
2022-04-08 00:30:00+00,8480,0,5225,10613,327,2668,554,113,0,0,27980,141,16719,16165,10940,8480
2022-04-08 01:00:00+00,8314,0,5227,10348,305,2552,542,112,0,0,27400,141,16422,15880,10653,8314
2022-04-08 01:30:00+00,8426,0,5226,10032,305,2592,594,113,0,0,27288,144,16157,15563,10337,8426
2022-04-08 02:00:00+00,8376,0,5222,9653,304,2804,578,112,0,0,27049,143,15757,15179,9957,8376
2022-04-08 02:30:00+00,8456,0,5222,9174,315,2832,659,114,0,0,26772,146,15370,14711,9489,8456
2022-04-08 03:00:00+00,8643,0,5226,8710,315,2176,622,119,0,0,25811,146,14873,14251,9025,8643
2022-04-08 03:30:00+00,9071,102,5222,8118,314,2158,605,118,0,0,25708,157,14259,13654,8432,9173
2022-04-08 04:00:00+00,10667,357,5226,7773,351,1236,825,126,0,0,26561,183,14175,13350,8124,11024
2022-04-08 04:30:00+00,12185,487,5226,7266,366,1210,1050,120,0,0,27910,201,13908,12858,7632,12672
2022-04-08 05:00:00+00,14996,842,5227,6645,392,1034,1128,146,0,50,30460,231,13392,12264,7037,15838
2022-04-08 05:30:00+00,16165,1137,5230,6159,470,1152,1280,164,79,174,32010,245,13218,11938,6708,17302
2022-04-08 06:00:00+00,16733,1294,5224,5750,585,1066,1370,251,465,588,33326,243,13394,12024,6800,18027
2022-04-08 06:30:00+00,17212,1486,5224,5419,577,1008,1385,519,1061,1440,35331,241,13666,12281,7057,18698
2022-04-08 07:00:00+00,17125,1490,5225,5245,577,2214,1425,411,1657,1602,36971,233,14129,12704,7479,18615
2022-04-08 07:30:00+00,17427,1484,5224,5239,599,2248,1424,470,2228,1466,37809,232,14714,13290,8066,18911
2022-04-08 08:00:00+00,17573,1482,5228,4897,597,2830,1423,537,3114,1138,38819,233,15259,13836,8608,19055
2022-04-08 08:30:00+00,17733,1480,5230,4941,583,3250,1423,467,4021,578,39706,230,16198,14775,9545,19213
2022-04-08 09:00:00+00,17667,1483,5232,5147,582,2794,1425,414,4785,482,40011,224,17171,15746,10514,19150
2022-04-08 09:30:00+00,17210,1481,5235,5490,580,2516,1415,202,5587,132,39848,219,18307,16892,11657,18691
2022-04-08 10:00:00+00,17282,1487,5229,5525,537,2158,1399,144,6257,408,40426,214,18947,17548,12319,18769
2022-04-08 10:30:00+00,17219,1487,5233,5769,519,1634,1398,159,6773,260,40451,213,19692,18294,13061,18706
2022-04-08 11:00:00+00,16645,1487,5238,5990,486,1208,1401,118,6796,96,39465,209,19911,18510,13272,18132
2022-04-08 11:30:00+00,15621,1489,5240,6696,399,1200,1399,112,6888,112,39156,200,20622,19223,13983,17110
2022-04-08 12:00:00+00,14554,1354,5239,7071,379,1244,1397,120,6959,120,38437,193,21045,19648,14409,15908
2022-04-08 12:30:00+00,13916,1022,5244,7570,382,1216,1392,113,6884,30,37769,181,21472,20080,14836,14938
2022-04-08 13:00:00+00,13309,803,5237,7924,352,1501,1389,114,6689,0,37318,171,21591,20202,14965,14112
2022-04-08 13:30:00+00,13067,697,5237,8200,373,1318,1236,114,6119,12,36373,167,21165,19929,14692,13764
2022-04-08 14:00:00+00,13132,618,5238,8387,403,694,1414,103,5380,42,35411,168,20822,19408,14170,13750
2022-04-08 14:30:00+00,13090,489,5235,8997,411,694,1442,109,4865,28,35360,165,20950,19508,14273,13579
2022-04-08 15:00:00+00,13398,540,5234,9690,458,728,1449,100,4031,0,35628,169,20862,19413,14179,13938
2022-04-08 15:30:00+00,13652,751,5230,10168,461,764,1400,109,3608,132,36275,174,20867,19467,14237,14403
2022-04-08 16:00:00+00,14007,969,5228,10682,559,830,1396,135,2721,166,36693,183,20586,19190,13962,14976
2022-04-08 16:30:00+00,14228,989,5229,11169,561,1004,1455,171,1894,208,36908,187,20308,18853,13624,15217
2022-04-08 17:00:00+00,14617,969,5228,11080,577,1074,1457,318,1410,118,36848,193,19752,18295,13067,15586
2022-04-08 17:30:00+00,14856,988,5230,10985,577,1024,1456,312,724,122,36274,198,18972,17516,12286,15844
2022-04-08 18:00:00+00,14578,989,5226,10424,577,2030,1455,296,235,284,36094,199,17917,16462,11236,15567
2022-04-08 18:30:00+00,14807,986,5228,10411,575,1954,1455,157,14,76,35663,202,17683,16228,11000,15793
2022-04-08 19:00:00+00,14733,988,5230,10002,508,2460,1447,145,0,188,35701,205,17187,15740,10510,15721
2022-04-08 19:30:00+00,14656,988,5232,9647,501,2490,1435,128,0,82,35159,208,16815,15380,10148,15644
2022-04-08 20:00:00+00,14178,985,5230,9688,484,2270,1435,149,0,122,34541,204,16837,15402,10172,15163
2022-04-08 20:30:00+00,12629,985,5232,10127,459,2262,1411,120,0,0,33225,194,17229,15818,10586,13614
2022-04-08 21:00:00+00,11842,865,5229,10212,321,2432,1408,109,0,0,32418,188,17170,15762,10533,12707
2022-04-08 21:30:00+00,10785,403,5227,10471,318,2444,1179,133,0,120,31080,169,17195,16016,10789,11188
2022-04-08 22:00:00+00,8666,234,5228,10391,318,2790,861,124,0,100,28712,150,16798,15937,10709,8900
2022-04-08 22:30:00+00,7515,229,5228,10352,313,2804,897,112,0,0,27450,140,16790,15893,10665,7744
2022-04-08 23:00:00+00,7161,238,5225,10237,298,2742,874,122,0,0,26897,138,16634,15760,10535,7399
2022-04-08 23:30:00+00,6834,238,5226,10038,278,2742,856,119,0,0,26331,136,16398,15542,10316,7072
2022-04-09 00:00:00+00,6899,237,5221,9685,209,2842,849,127,0,0,26069,134,15964,15115,9894,7136
2022-04-09 00:30:00+00,7155,231,5229,9710,189,2858,840,110,0,0,26322,137,15968,15128,9899,7386
2022-04-09 01:00:00+00,7251,230,5232,9681,188,3114,832,110,0,0,26638,137,15933,15101,9869,7481
2022-04-09 01:30:00+00,6895,231,5229,9992,189,3132,839,111,0,0,26618,132,16249,15410,10181,7126
2022-04-09 02:00:00+00,6225,233,5225,10344,189,3186,838,114,0,0,26354,123,16596,15758,10534,6458
2022-04-09 02:30:00+00,6100,233,5227,10490,188,3168,825,112,0,0,26342,121,16730,15904,10678,6333
2022-04-09 03:00:00+00,5967,236,5224,10832,188,2714,833,114,0,0,26108,119,17077,16244,11020,6203
2022-04-09 03:30:00+00,5970,233,5228,10606,188,2706,831,112,0,0,25874,120,16853,16022,10794,6203
2022-04-09 04:00:00+00,7106,246,5227,10259,207,2452,860,130,0,0,26487,132,16553,15693,10466,7352
2022-04-09 04:30:00+00,7371,347,5230,9859,218,2444,960,123,0,0,26552,140,16267,15307,10077,7718
2022-04-09 05:00:00+00,8066,493,5230,9768,283,2420,1082,113,0,74,27529,150,16363,15281,10051,8559
2022-04-09 05:30:00+00,8909,667,5230,9371,325,2422,1096,121,141,268,28550,162,16163,15067,9837,9576
2022-04-09 06:00:00+00,9521,895,5229,8675,432,2492,1276,324,762,360,29966,173,16374,15098,9869,10416
2022-04-09 06:30:00+00,9526,987,5228,8474,549,2508,1325,587,1763,148,31095,172,17339,16014,10786,10513
2022-04-09 07:00:00+00,9590,991,5225,8583,559,2742,1317,669,2776,148,32600,168,18460,17143,11918,10581
2022-04-09 07:30:00+00,9612,985,5225,8208,555,2742,1317,709,3798,504,33655,163,19103,17786,12561,10597
2022-04-09 08:00:00+00,9583,989,5222,8212,542,2742,1254,666,4851,112,34173,160,20081,18827,13605,10572
2022-04-09 08:30:00+00,9357,918,5224,8601,493,2742,1109,209,5794,0,34447,150,21221,20112,14888,10275
2022-04-09 09:00:00+00,9452,981,5228,8397,429,2742,1215,126,6557,434,35561,148,21826,20611,15383,10433
2022-04-09 09:30:00+00,9525,925,5234,8372,318,2742,1215,196,7212,96,35835,146,22351,21136,15902,10450
2022-04-09 10:00:00+00,8467,767,5232,8755,277,2742,1270,195,7621,94,35420,132,23155,21885,16653,9234
2022-04-09 10:30:00+00,7750,876,5229,8663,276,2827,1349,202,7827,300,35299,128,23344,21995,16766,8626
2022-04-09 11:00:00+00,7554,824,5235,8526,281,2942,1094,273,8039,306,35074,125,23175,22081,16846,8378
2022-04-09 11:30:00+00,7327,720,5235,8605,288,2984,1071,301,7942,54,34527,122,23141,22070,16835,8047
2022-04-09 12:00:00+00,7389,516,5241,8937,215,3198,1024,110,7617,0,34247,117,23034,22010,16769,7905
2022-04-09 12:30:00+00,7115,481,5239,9040,215,3204,903,122,7418,0,33737,114,22815,21912,16673,7596
2022-04-09 13:00:00+00,7173,460,5242,8848,215,3442,936,143,6775,0,33234,116,22016,21080,15838,7633
2022-04-09 13:30:00+00,7259,471,5239,8543,214,3460,1064,146,6693,0,33089,119,21753,20689,15450,7730
2022-04-09 14:00:00+00,7249,470,5237,8299,250,3852,1077,121,6150,0,32705,120,21013,19936,14699,7719
2022-04-09 14:30:00+00,7404,521,5237,8221,252,3856,1162,123,4865,0,31641,128,19737,18575,13338,7925
2022-04-09 15:00:00+00,8694,681,5235,8070,285,3486,1318,120,3959,0,31848,148,18867,17549,12314,9375
2022-04-09 15:30:00+00,9892,878,5231,7704,296,3444,1238,160,3959,130,32932,163,18428,17190,11959,10770
2022-04-09 16:00:00+00,12381,1036,5228,7057,360,2962,1247,194,3092,136,33693,192,16984,15737,10509,13417
2022-04-09 16:30:00+00,13822,1185,5230,6472,394,2952,1257,223,2294,198,34027,211,15647,14390,9160,15007
2022-04-09 17:00:00+00,15686,1404,5228,6043,478,2586,1409,164,1722,260,34980,231,14880,13471,8243,17090
2022-04-09 17:30:00+00,16714,1482,5228,5102,493,2658,1449,212,949,362,34649,248,13221,11772,6544,18196
2022-04-09 18:00:00+00,16644,1481,5230,4366,500,2978,1449,209,300,562,33719,253,11845,10396,5166,18125
2022-04-09 18:30:00+00,16706,1471,5228,3798,498,3082,1450,228,24,776,33261,257,10998,9548,4320,18177
2022-04-09 19:00:00+00,16636,1483,5225,3191,472,3370,1362,352,0,890,32981,261,10250,8888,3663,18119
2022-04-09 19:30:00+00,16851,1469,5229,2900,457,3388,1417,347,0,618,32676,266,10003,8586,3357,18320
2022-04-09 20:00:00+00,17031,1476,5228,2692,424,2482,1444,375,0,250,31402,276,9788,8344,3116,18507
2022-04-09 20:30:00+00,16596,1366,5228,2528,425,2462,1445,385,0,262,30697,273,9626,8181,2953,17962
2022-04-09 21:00:00+00,16873,994,5226,2418,366,1942,1439,231,0,128,29617,273,9449,8010,2784,17867
2022-04-09 21:30:00+00,16602,596,5226,2140,365,1996,1434,208,0,52,28619,267,9165,7731,2505,17198
2022-04-09 22:00:00+00,15324,250,5226,1898,332,2292,1436,202,0,118,27078,252,8892,7456,2230,15574
2022-04-09 22:30:00+00,14419,113,5228,1979,293,2282,1444,240,0,18,26016,243,8944,7500,2272,14532
2022-04-09 23:00:00+00,14123,0,5223,1993,196,2478,1442,246,0,64,25765,239,8854,7412,2189,14123
2022-04-09 23:30:00+00,13371,0,5221,1999,195,2532,1441,389,0,116,25264,235,8856,7415,2194,13371
2022-04-10 00:00:00+00,12434,0,5214,2237,161,2656,1437,226,0,0,24365,229,9049,7612,2398,12434
2022-04-10 00:30:00+00,12450,0,5219,2519,160,2824,1422,204,0,0,24798,228,9320,7898,2679,12450
2022-04-10 01:00:00+00,12175,0,5226,2659,151,2802,1423,169,0,0,24605,226,9459,8036,2810,12175
2022-04-10 01:30:00+00,12157,0,5228,2647,150,2796,1279,153,0,0,24410,227,9304,8025,2797,12157
2022-04-10 02:00:00+00,12738,0,5228,2422,150,2630,1187,167,0,0,24522,233,8987,7800,2572,12738
2022-04-10 02:30:00+00,12866,0,5228,2272,150,2630,1236,152,0,0,24534,235,8886,7650,2422,12866
2022-04-10 03:00:00+00,12877,0,5230,2089,149,2532,1306,157,0,72,24412,235,8774,7468,2238,12877
2022-04-10 03:30:00+00,12889,0,5232,2057,150,2534,1296,150,0,0,24308,237,8735,7439,2207,12889
2022-04-10 04:00:00+00,12468,0,5233,1930,169,2498,1184,166,0,0,23648,237,8516,7332,2099,12468
2022-04-10 04:30:00+00,12610,0,5234,1826,185,2500,1266,172,0,20,23813,238,8511,7245,2011,12610
2022-04-10 05:00:00+00,12274,0,5235,1707,248,3012,1419,154,0,44,24093,231,8609,7190,1955,12274
2022-04-10 05:30:00+00,12533,0,5234,1617,291,3088,1423,152,213,108,24659,230,8778,7355,2121,12533
2022-04-10 06:00:00+00,12282,0,5234,1594,398,4132,1428,157,881,64,26170,219,9535,8107,2873,12282
2022-04-10 06:30:00+00,12599,0,5238,1566,417,4164,1431,154,1739,0,27308,215,10391,8960,3722,12599
2022-04-10 07:00:00+00,12615,0,5237,1488,506,4702,1425,151,2745,0,28869,205,11401,9976,4739,12615
2022-04-10 07:30:00+00,12749,0,5234,1477,506,4722,1186,154,3726,0,29754,200,12129,10943,5709,12749
2022-04-10 08:00:00+00,12579,0,5233,1533,497,4884,1199,151,4685,0,30761,191,13147,11948,6715,12579
2022-04-10 08:30:00+00,12116,0,5235,1683,487,4944,1151,151,5626,0,31393,182,14182,13031,7796,12116
2022-04-10 09:00:00+00,11973,0,5232,1849,346,4820,1004,152,6418,0,31794,175,14849,13845,8613,11973
2022-04-10 09:30:00+00,11267,0,5235,2117,319,4814,960,152,7031,0,31895,166,15662,14702,9467,11267
2022-04-10 10:00:00+00,10984,0,5231,2175,267,4826,882,169,7597,20,32151,161,16152,15270,10039,10984
2022-04-10 10:30:00+00,11096,0,5226,2141,249,4830,908,208,7922,0,32580,161,16446,15538,10312,11096
2022-04-10 11:00:00+00,11311,0,5230,2218,192,5106,864,150,8013,0,33084,162,16517,15653,10423,11311
2022-04-10 11:30:00+00,11163,0,5225,2207,180,5078,881,152,8004,0,32890,161,16497,15616,10391,11163
2022-04-10 12:00:00+00,10950,0,5229,2221,165,5140,875,149,7945,0,32674,160,16435,15560,10331,10950
2022-04-10 12:30:00+00,10959,0,5232,2185,158,5140,939,143,7538,0,32294,162,16052,15113,9881,10959
2022-04-10 13:00:00+00,11030,64,5232,2155,150,5140,972,154,6937,0,31834,168,15446,14474,9242,11094
2022-04-10 13:30:00+00,11037,281,5231,2094,150,5140,899,168,6223,0,31223,177,14597,13698,8467,11318
2022-04-10 14:00:00+00,11547,557,5231,2026,169,5140,1117,157,5512,0,31456,191,14055,12938,7707,12104
2022-04-10 14:30:00+00,11976,770,5229,2016,169,5140,1142,178,4766,0,31386,204,13322,12180,6951,12746
2022-04-10 15:00:00+00,13130,993,5232,2067,333,5160,1123,168,3819,66,32091,220,12574,11451,6219,14123
2022-04-10 15:30:00+00,14257,1248,5231,2116,260,5160,1254,151,3098,78,32853,236,11959,10705,5474,15505
2022-04-10 16:00:00+00,15304,1464,5225,2158,365,4998,1424,172,2452,54,33616,248,11624,10200,4975,16768
2022-04-10 16:30:00+00,16035,1486,5225,2191,392,4988,1432,166,1645,0,33560,257,10885,9453,4228,17521
2022-04-10 17:00:00+00,16228,1485,5226,2377,508,4640,1442,428,1004,38,33376,260,10557,9115,3889,17713
2022-04-10 17:30:00+00,16303,1482,5223,2574,524,4598,1473,470,538,0,33185,262,10332,8859,3636,17785
2022-04-10 18:00:00+00,16237,1478,5223,2818,668,3718,1490,443,177,334,32586,260,10376,8886,3663,17715
2022-04-10 18:30:00+00,16084,1478,5224,3118,685,3704,1507,357,8,0,32165,261,10542,9035,3811,17562
2022-04-10 19:00:00+00,15839,1481,5226,3417,691,3658,1529,278,0,174,32293,257,10863,9334,4108,17320
2022-04-10 19:30:00+00,15391,1481,5225,3812,689,3588,1487,193,0,0,31866,254,11213,9726,4501,16872
2022-04-10 20:00:00+00,14953,1481,5224,4365,617,1798,1526,152,0,188,30304,257,11732,10206,4982,16434
2022-04-10 20:30:00+00,14185,1372,5227,4916,420,1722,1519,188,0,0,29549,251,12082,10563,5336,15557
2022-04-10 21:00:00+00,13351,1023,5226,5274,422,1300,1198,461,0,44,28299,237,12120,10922,5696,14374
2022-04-10 21:30:00+00,12160,735,5223,5584,405,1352,1273,216,0,84,27032,218,12485,11212,5989,12895
2022-04-10 22:00:00+00,10984,251,5226,5861,358,4434,1155,167,0,316,28752,186,12600,11445,6219,11235
2022-04-10 22:30:00+00,9888,29,5229,6080,337,4646,998,173,0,0,27380,173,12644,11646,6417,9917
2022-04-10 23:00:00+00,9042,0,5230,6270,276,3930,972,155,0,60,25934,166,12748,11776,6546,9042
2022-04-10 23:30:00+00,8476,0,5231,6636,276,3908,966,150,0,0,25643,159,13109,12143,6912,8476
2022-04-11 00:00:00+00,8331,0,5228,6645,261,3872,981,156,0,0,25473,160,13115,12134,6906,8331
2022-04-11 00:30:00+00,8292,0,5223,6718,260,3874,1080,161,0,0,25608,159,13281,12201,6978,8292
2022-04-11 01:00:00+00,8096,0,5220,6804,260,3714,1165,164,0,0,25424,149,13449,12284,7064,8096
2022-04-11 01:30:00+00,7773,0,5223,6853,260,3692,1213,155,0,0,25168,146,13549,12336,7113,7773
2022-04-11 02:00:00+00,7570,0,5225,6951,260,3376,1231,154,0,0,24767,148,13667,12436,7211,7570
2022-04-11 02:30:00+00,7408,0,5224,7159,259,3344,1231,153,0,0,24778,146,13873,12642,7418,7408
2022-04-11 03:00:00+00,7266,0,5224,7296,259,2144,1395,155,0,0,23739,148,14174,12779,7555,7266
2022-04-11 03:30:00+00,7029,0,5226,7499,260,2110,1399,151,0,0,23674,144,14384,12985,7759,7029
2022-04-11 04:00:00+00,8147,1,5226,7565,308,1310,1627,188,0,350,24722,151,14726,13099,7873,8148
2022-04-11 04:30:00+00,8981,151,5230,7728,341,1310,1681,187,0,66,25675,164,14980,13299,8069,9132
2022-04-11 05:00:00+00,9777,366,5232,8381,446,1096,1784,283,0,590,27955,167,15843,14059,8827,10143
2022-04-11 05:30:00+00,10024,616,5262,9154,497,1096,1974,332,144,660,29759,170,17031,15057,9795,10640
2022-04-11 06:00:00+00,10172,636,5263,9558,479,2284,2077,316,648,950,32383,169,18025,15948,10685,10808
2022-04-11 06:30:00+00,10632,879,5264,10025,483,2430,2157,250,1464,846,34430,172,19393,17236,11972,11511
2022-04-11 07:00:00+00,10736,902,5262,10600,514,2532,2034,168,2233,344,35325,168,20643,18609,13347,11638
2022-04-11 07:30:00+00,10700,904,5258,11337,532,2542,1702,153,2723,58,35909,163,21552,19850,14592,11604
2022-04-11 08:00:00+00,10622,762,5265,12009,512,2916,1529,173,3357,0,37145,155,22672,21143,15878,11384
2022-04-11 08:30:00+00,10220,511,5262,12844,422,2772,1207,188,4352,0,37778,139,24087,22880,17618,10731
2022-04-11 09:00:00+00,9199,462,5278,13469,313,2756,1128,151,5167,0,37923,126,25355,24227,18949,9661
2022-04-11 09:30:00+00,7947,461,5280,13832,294,2742,1092,143,5614,0,37405,114,26112,25020,19740,8408
2022-04-11 10:00:00+00,5779,467,5283,14203,265,3776,1068,146,6561,0,37548,93,27380,26312,21029,6246
2022-04-11 10:30:00+00,4978,466,5290,14484,250,3904,974,145,7122,0,37613,84,28120,27146,21856,5444
2022-04-11 11:00:00+00,4722,287,5293,15306,219,3782,970,154,7025,0,37758,76,28813,27843,22550,5009
2022-04-11 11:30:00+00,4124,232,5300,15999,183,3740,973,153,7065,0,37769,68,29520,28547,23247,4356
2022-04-11 12:00:00+00,4431,179,5308,16452,180,3268,972,156,7138,0,38084,69,30050,29078,23770,4610
2022-04-11 12:30:00+00,4590,90,5341,16690,179,3210,967,159,6518,0,37744,69,29696,28728,23388,4680
2022-04-11 13:00:00+00,5054,0,5343,16849,148,2880,949,153,6620,0,37996,71,29909,28960,23617,5054
2022-04-11 13:30:00+00,4782,0,5348,17326,140,2826,980,153,5739,0,37294,69,29533,28553,23205,4782
2022-04-11 14:00:00+00,4878,0,5356,17564,155,2508,988,157,5256,0,36862,66,29319,28331,22975,4878
2022-04-11 14:30:00+00,5485,0,5349,17158,169,2546,1043,162,4389,0,36301,74,28108,27065,21716,5485
2022-04-11 15:00:00+00,6045,0,5351,17104,266,2458,1103,159,3251,0,35737,80,27075,25972,20621,6045
2022-04-11 15:30:00+00,7215,0,5360,16724,289,2598,1042,187,2319,0,35734,94,25734,24692,19332,7215
2022-04-11 16:00:00+00,8732,0,5364,16376,345,2058,1278,183,1657,490,36483,109,25020,23742,18378,8732
2022-04-11 16:30:00+00,9608,0,5364,16157,299,2112,1570,187,1211,430,36938,119,24601,23031,17667,9608
2022-04-11 17:00:00+00,10323,0,5385,16087,304,2042,1561,275,655,878,37510,128,23992,22431,17046,10323
2022-04-11 17:30:00+00,10635,0,5456,15789,271,2042,1550,210,372,834,37159,132,23438,21888,16432,10635
2022-04-11 18:00:00+00,10412,0,5477,15668,239,2048,1566,190,152,666,36418,133,23102,21536,16059,10412
2022-04-11 18:30:00+00,10534,0,5475,15423,240,1972,1576,184,8,588,36000,135,22722,21146,15671,10534
2022-04-11 19:00:00+00,10551,0,5471,15218,252,2139,1574,172,0,480,35857,136,22515,20941,15470,10551
2022-04-11 19:30:00+00,10294,0,5479,14919,250,1985,1576,157,0,316,34976,135,22224,20648,15169,10294
2022-04-11 20:00:00+00,9848,0,5476,14919,240,2024,1562,170,0,306,34545,131,22197,20635,15159,9848
2022-04-11 20:30:00+00,9084,0,5482,14767,237,1922,1407,146,0,0,33045,126,21893,20486,15004,9084
2022-04-11 21:00:00+00,8601,0,5480,14744,245,1272,1179,142,0,2,31665,116,21648,20469,14989,8601
2022-04-11 21:30:00+00,7599,0,5491,14518,247,1270,990,147,0,0,30262,107,21246,20256,14765,7599
2022-04-11 22:00:00+00,5803,0,5492,14041,205,1984,977,154,0,0,28656,95,20715,19738,14246,5803
2022-04-11 22:30:00+00,5165,0,5491,13570,194,2032,852,147,0,0,27451,90,20107,19255,13764,5165
2022-04-11 23:00:00+00,5045,0,5487,12996,179,1510,649,147,0,0,26013,90,19311,18662,13175,5045
2022-04-11 23:30:00+00,5391,0,5490,12647,178,1502,602,142,0,0,25952,95,18917,18315,12825,5391
2022-04-12 00:00:00+00,5084,0,5485,12176,128,1860,569,143,0,0,25445,95,18358,17789,12304,5084
2022-04-12 00:30:00+00,5028,0,5481,12053,126,1864,605,166,0,0,25323,95,18265,17660,12179,5028
2022-04-12 01:00:00+00,4519,0,5483,11967,126,2468,577,152,0,0,25292,88,18153,17576,12093,4519
2022-04-12 01:30:00+00,4442,0,5471,11679,126,2512,578,152,0,0,24960,88,17854,17276,11805,4442
2022-04-12 02:00:00+00,4628,0,5477,11012,127,2602,580,160,0,0,24586,92,17196,16616,11139,4628
2022-04-12 02:30:00+00,4788,0,5478,10602,128,2604,586,152,0,0,24338,96,16794,16208,10730,4788
2022-04-12 03:00:00+00,5352,0,5475,10171,143,2006,619,166,0,0,23932,104,16408,15789,10314,5352
2022-04-12 03:30:00+00,5687,0,5480,9948,147,1972,589,154,0,0,23977,109,16164,15575,10095,5687
2022-04-12 04:00:00+00,6685,92,5474,9773,184,1724,607,165,0,0,24704,125,16038,15431,9957,6777
2022-04-12 04:30:00+00,7935,232,5475,9236,188,1758,590,161,0,54,25629,146,15489,14899,9424,8167
2022-04-12 05:00:00+00,11187,505,5477,8835,263,1006,816,207,0,396,28692,181,15391,14575,9098,11692
2022-04-12 05:30:00+00,12794,792,5479,8791,305,934,1059,316,94,0,30564,200,15728,14669,9190,13586
2022-04-12 06:00:00+00,13580,975,5476,8755,338,1376,1190,201,382,54,32327,206,16141,14951,9475,14555
2022-04-12 06:30:00+00,15018,986,5476,8934,367,1412,930,302,814,56,34295,212,16521,15591,10115,16004
2022-04-12 07:00:00+00,15417,988,5472,9170,372,2516,852,206,1105,38,36136,212,16971,16119,10647,16405
2022-04-12 07:30:00+00,15810,987,5478,9181,399,2546,897,222,1599,0,37119,211,17554,16657,11179,16797
2022-04-12 08:00:00+00,15906,810,5472,8921,380,2954,866,196,1608,0,37113,207,17247,16381,10909,16716
2022-04-12 08:30:00+00,15815,663,5472,8930,396,2978,913,159,2214,0,37540,200,17925,17012,11540,16478
2022-04-12 09:00:00+00,15489,523,5471,9364,379,2828,911,152,2538,0,37656,193,18664,17752,12282,16012
2022-04-12 09:30:00+00,15332,506,5454,9290,330,2836,913,164,2634,0,37459,192,18621,17708,12254,15838
2022-04-12 10:00:00+00,15389,656,5454,9329,248,2742,912,163,2924,84,37901,194,18867,17955,12501,16045
2022-04-12 10:30:00+00,15199,732,5461,9271,236,2742,910,171,3517,0,38239,192,19395,18485,13024,15931
2022-04-12 11:00:00+00,15220,536,5463,9315,185,2800,910,173,3804,0,38406,187,19677,18767,13304,15756
2022-04-12 11:30:00+00,14717,470,5464,9745,189,2802,911,156,4008,0,38462,179,20317,19406,13942,15187
2022-04-12 12:00:00+00,13967,465,5521,9717,198,3052,910,157,4023,0,38010,174,20369,19459,13938,14432
2022-04-12 12:30:00+00,13600,462,5557,9414,200,3060,1056,173,4206,0,37728,172,20433,19377,13820,14062
2022-04-12 13:00:00+00,14088,466,5551,8964,178,2784,1416,206,3729,96,37478,179,19838,18422,12871,14554
2022-04-12 13:30:00+00,14847,464,5549,8348,163,2742,1549,178,3144,30,37014,190,18753,17204,11655,15311
2022-04-12 14:00:00+00,15356,486,5548,8279,175,2694,1555,158,2951,42,37244,194,18508,16953,11405,15842
2022-04-12 14:30:00+00,15795,665,5551,8229,181,2668,1555,157,2375,0,37176,203,17891,16336,10785,16460
2022-04-12 15:00:00+00,16023,812,5549,8102,243,2458,1557,209,1634,72,36659,205,17085,15528,9979,16835
2022-04-12 15:30:00+00,16683,850,5556,8337,259,2480,1555,179,1215,0,37114,210,16922,15367,9811,17533
2022-04-12 16:00:00+00,17616,959,5549,8522,339,1718,1555,185,1030,160,37633,216,16995,15440,9891,18575
2022-04-12 16:30:00+00,18034,985,5546,8499,418,1706,1555,186,776,204,37909,220,16794,15239,9693,19019
2022-04-12 17:00:00+00,18259,979,5544,8192,480,1760,1554,264,586,500,38118,221,16356,14802,9258,19238
2022-04-12 17:30:00+00,18413,982,5542,7962,437,1760,1555,316,322,366,37655,226,15818,14263,8721,19395
2022-04-12 18:00:00+00,18591,978,5542,7328,483,1816,1553,450,123,626,37490,230,15029,13476,7934,19569
2022-04-12 18:30:00+00,18653,979,5542,6477,613,1820,1561,379,6,792,36822,234,14199,12638,7096,19632
2022-04-12 19:00:00+00,18792,981,5547,6086,670,1586,1562,479,0,772,36475,239,13865,12303,6756,19773
2022-04-12 19:30:00+00,18637,981,5545,6088,620,1572,1571,389,0,338,35741,242,13824,12253,6708,19618
2022-04-12 20:00:00+00,18386,944,5548,6240,562,1300,1574,370,0,382,35306,240,13924,12350,6802,19330
2022-04-12 20:30:00+00,17723,788,5547,6229,409,1298,1572,204,0,84,33854,237,13757,12185,6638,18511
2022-04-12 21:00:00+00,16430,463,5548,6551,344,1152,1573,160,0,100,32321,222,14016,12443,6895,16893
2022-04-12 21:30:00+00,15120,171,5555,6373,310,1150,1572,155,0,114,30520,209,13810,12238,6683,15291
2022-04-12 22:00:00+00,13855,0,5557,6423,291,1374,1571,168,0,86,29325,196,13842,12271,6714,13855
2022-04-12 22:30:00+00,12843,0,5556,6276,280,1372,1571,159,0,20,28077,191,13683,12112,6556,12843
2022-04-12 23:00:00+00,12739,0,5559,6625,207,1084,1495,151,0,0,27860,189,13886,12391,6832,12739
2022-04-12 23:30:00+00,12082,0,5568,6809,201,1080,1324,165,0,0,27229,184,13902,12578,7010,12082
2022-04-13 00:00:00+00,11755,0,5584,6511,182,1188,1319,162,0,0,26701,183,13596,12277,6693,11755
2022-04-13 00:30:00+00,12074,0,5646,6606,181,1188,1321,159,0,0,27175,185,13754,12433,6787,12074
2022-04-13 01:00:00+00,11668,0,5681,6862,165,1268,1325,154,0,0,27123,179,14033,12708,7027,11668
2022-04-13 01:30:00+00,11082,0,5688,7038,164,1270,1315,153,0,0,26710,173,14205,12890,7202,11082
2022-04-13 02:00:00+00,10535,0,5736,7093,164,1316,1215,156,0,0,26215,173,14208,12993,7257,10535
2022-04-13 02:30:00+00,10509,0,5744,6803,164,1338,1137,174,0,0,25869,175,13848,12711,6967,10509
2022-04-13 03:00:00+00,10952,0,5801,6612,164,1079,1278,155,0,0,26041,178,13855,12577,6776,10952
2022-04-13 03:30:00+00,10977,1,5828,6302,167,930,1317,171,0,0,25693,181,13614,12297,6469,10978
2022-04-13 04:00:00+00,11874,126,5826,6059,182,694,1311,155,0,0,26227,191,13378,12067,6241,12000
2022-04-13 04:30:00+00,12672,297,5822,5665,191,776,1449,163,0,42,27077,204,13127,11678,5856,12969
2022-04-13 05:00:00+00,13643,499,5835,5480,291,924,1549,154,0,0,28375,218,13155,11606,5771,14142
2022-04-13 05:30:00+00,14924,699,5833,5353,337,874,1554,183,108,140,30005,229,13185,11631,5798,15623
2022-04-13 06:00:00+00,15925,670,5840,5194,372,736,1503,341,350,0,30931,233,13259,11756,5916,16595
2022-04-13 06:30:00+00,16470,653,5841,5437,380,694,1493,481,721,254,32424,229,13872,12379,6538,17123
2022-04-13 07:00:00+00,17033,747,5832,5565,417,1420,1564,375,1243,292,34488,228,14621,13057,7225,17780
2022-04-13 07:30:00+00,17350,947,5834,5740,411,1456,1568,398,1787,322,35813,228,15340,13772,7938,18297
2022-04-13 08:00:00+00,17309,985,5847,5983,392,1866,1569,367,2438,422,37178,225,16229,14660,8813,18294
2022-04-13 08:30:00+00,17269,982,5872,6154,375,1868,1568,485,2970,74,37617,223,16939,15371,9499,18251
2022-04-13 09:00:00+00,17181,982,5907,6438,359,1932,1569,374,3142,210,38094,219,17415,15846,9939,18163
2022-04-13 09:30:00+00,17084,921,5917,6429,353,1932,1560,220,3395,348,38159,215,17654,16094,10177,18005
2022-04-13 10:00:00+00,17078,802,5924,6640,416,1488,1555,157,3842,226,38128,206,18377,16822,10898,17880
2022-04-13 10:30:00+00,17034,789,5922,6949,292,1486,1543,154,4313,0,38482,203,19019,17476,11554,17823
2022-04-13 11:00:00+00,17290,827,5919,7045,190,1258,1540,163,4222,148,38602,206,18916,17376,11457,18117
2022-04-13 11:30:00+00,17525,700,5928,6766,182,1248,1544,207,4553,104,38757,205,18973,17429,11501,18225
2022-04-13 12:00:00+00,17612,684,5954,6617,178,966,1543,179,4958,0,38691,203,19250,17707,11753,18296
2022-04-13 12:30:00+00,17275,629,5994,6536,181,966,1544,156,5238,0,38519,199,19493,17949,11955,17904
2022-04-13 13:00:00+00,17477,707,6030,6559,179,694,1544,158,5222,246,38816,201,19534,17990,11960,18184
2022-04-13 13:30:00+00,17458,642,6035,6698,186,801,1541,154,4659,0,38174,203,19119,17578,11543,18100
2022-04-13 14:00:00+00,17421,491,6034,6709,185,908,1541,163,4625,0,38077,201,19094,17553,11519,17912
2022-04-13 14:30:00+00,18052,530,6066,6391,210,900,1539,154,3764,0,37606,211,17970,16431,10365,18582
2022-04-13 15:00:00+00,18504,601,6072,6020,271,694,1538,219,3464,2,37385,217,17365,15827,9755,19105
2022-04-13 15:30:00+00,18878,940,6106,5792,303,694,1532,177,3060,122,37604,228,16793,15261,9155,19818
2022-04-13 16:00:00+00,19437,984,6123,5707,375,694,1484,179,2232,190,37405,236,15921,14437,8314,20421
2022-04-13 16:30:00+00,19315,985,6127,5868,419,694,1471,323,1577,416,37195,237,15462,13991,7864,20300
2022-04-13 17:00:00+00,19143,987,6125,5593,506,694,1471,482,1195,908,37104,237,14890,13419,7294,20130
2022-04-13 17:30:00+00,19388,986,6131,5238,534,694,1471,506,788,820,36556,243,14162,12691,6560,20374
2022-04-13 18:00:00+00,19558,987,6129,5152,687,694,1472,546,321,1456,37002,243,13761,12289,6160,20545
2022-04-13 18:30:00+00,19787,985,6126,5322,663,694,1471,558,33,1120,36759,247,13615,12144,6018,20772
2022-04-13 19:00:00+00,19877,988,6122,5194,628,694,1465,521,0,946,36436,250,13410,11944,5822,20865
2022-04-13 19:30:00+00,19880,986,6126,4627,592,694,1463,496,0,1218,36082,252,12808,11345,5219,20866
2022-04-13 20:00:00+00,19840,989,6126,4347,515,848,1463,335,0,350,34813,260,12451,10988,4862,20829
2022-04-13 20:30:00+00,19530,889,6125,3505,439,858,1465,240,0,0,33051,266,11534,10069,3944,20419
2022-04-13 21:00:00+00,18990,432,6122,3321,267,1096,1508,212,0,76,32024,255,11218,9710,3588,19422
2022-04-13 21:30:00+00,18264,146,6127,3137,250,1098,1559,174,0,0,30755,248,11073,9514,3387,18410
2022-04-13 22:00:00+00,16906,0,6127,2892,218,694,1560,171,0,196,28764,240,10797,9237,3110,16906
2022-04-13 22:30:00+00,16221,0,6127,2612,208,694,1455,165,0,0,27482,241,10402,8947,2820,16221
2022-04-13 23:00:00+00,16316,0,6136,2498,128,810,1317,157,0,58,27420,244,10079,8762,2626,16316
2022-04-13 23:30:00+00,16155,0,6135,2317,127,750,1314,163,0,72,27033,244,9893,8579,2444,16155
2022-04-14 00:00:00+00,16156,0,6140,2194,120,862,1312,159,0,0,26943,247,9766,8454,2314,16156
2022-04-14 00:30:00+00,16489,0,6142,2132,119,922,1310,156,0,0,27270,250,9703,8393,2251,16489
2022-04-14 01:00:00+00,15885,0,6145,2238,103,590,1310,153,0,0,26424,249,9796,8486,2341,15885
2022-04-14 01:30:00+00,15269,0,6151,2226,102,590,1309,153,0,0,25800,246,9788,8479,2328,15269
2022-04-14 02:00:00+00,15378,0,6152,2034,102,506,1308,155,0,0,25635,249,9596,8288,2136,15378
2022-04-14 02:30:00+00,15645,0,6150,1744,102,510,1313,164,0,0,25628,253,9310,7996,1846,15645
2022-04-14 03:00:00+00,16117,0,6159,1565,102,914,1437,165,0,0,26459,253,9263,7826,1667,16117
2022-04-14 03:30:00+00,16213,0,6156,1398,113,944,1567,162,0,0,26553,254,9234,7667,1511,16213
2022-04-14 04:00:00+00,16426,123,6156,1333,225,1072,1561,160,0,0,27056,259,9275,7714,1558,16549
2022-04-14 04:30:00+00,17273,308,6166,1321,233,1096,1510,149,0,0,28056,268,9230,7720,1554,17581
2022-04-14 05:00:00+00,18302,452,6163,1290,334,1096,1497,151,7,0,29292,275,9291,7794,1631,18754
2022-04-14 05:30:00+00,19322,779,6173,1165,373,1088,1490,276,198,80,30944,284,9399,7909,1736,20101
2022-04-14 06:00:00+00,19239,743,6167,1078,390,1046,1492,176,588,134,31053,279,9715,8223,2056,19982
2022-04-14 06:30:00+00,20039,893,6169,1004,392,1046,1502,231,1219,162,32657,280,10286,8784,2615,20932
2022-04-14 07:00:00+00,20128,758,6168,1003,378,2124,1500,185,1646,12,33902,273,10695,9195,3027,20886
2022-04-14 07:30:00+00,20345,763,6171,982,391,2114,1501,155,2387,16,34824,268,11432,9930,3760,21108
2022-04-14 08:00:00+00,19719,564,6168,969,392,3244,1512,147,2997,0,35712,257,12038,10526,4358,20283
2022-04-14 08:30:00+00,19258,464,6204,1029,380,3170,1509,141,3752,0,35907,247,12874,11365,5161,19722
2022-04-14 09:00:00+00,19259,475,6200,1091,252,2608,1508,142,4300,0,35835,246,13351,11843,5643,19734
2022-04-14 09:30:00+00,18726,474,6225,1225,228,2614,1467,147,4724,0,35830,240,13869,12402,6177,19200
2022-04-14 10:00:00+00,18647,467,6219,1335,191,3050,1509,146,5122,0,36686,238,14376,12867,6648,19114
2022-04-14 10:30:00+00,18185,460,6225,1387,180,3054,1510,146,5435,0,36582,234,14737,13227,7002,18645
2022-04-14 11:00:00+00,18358,467,6226,1469,180,3008,1512,151,5641,0,37012,233,15028,13516,7290,18825
2022-04-14 11:30:00+00,18410,484,6231,1535,180,2960,1513,168,5564,0,37045,234,15023,13510,7279,18894
2022-04-14 12:00:00+00,19052,509,6233,1599,158,2070,1515,166,4952,0,36254,241,14457,12942,6709,19561
2022-04-14 12:30:00+00,18845,485,6241,1666,140,1914,1494,160,4749,0,35694,240,14290,12796,6555,19330
2022-04-14 13:00:00+00,18998,470,6249,1750,155,1752,1490,173,4468,0,35505,245,14112,12622,6373,19468
2022-04-14 13:30:00+00,18819,468,6251,1841,157,1742,1487,160,4127,0,35052,246,13863,12376,6125,19287
2022-04-14 14:00:00+00,19099,490,6251,1867,173,1044,1491,158,3981,0,34554,246,13763,12272,6021,19589
2022-04-14 14:30:00+00,19075,688,6254,1912,179,1068,1486,170,3682,0,34514,252,13513,12027,5773,19763
2022-04-14 15:00:00+00,18450,533,6256,2036,243,1194,1534,187,3181,10,33624,244,13250,11716,5460,18983
2022-04-14 15:30:00+00,18866,712,6269,2141,286,1232,1548,200,2606,0,33860,252,12850,11302,5033,19578
2022-04-14 16:00:00+00,19160,846,6266,2209,400,1372,1552,186,2133,244,34368,256,12560,11008,4742,20006
2022-04-14 16:30:00+00,19203,907,6265,2272,407,1374,1553,194,1666,378,34219,259,12163,10610,4345,20110
2022-04-14 17:00:00+00,19280,829,6261,2192,502,1206,1554,341,1233,1300,34698,254,11742,10188,3927,20109
2022-04-14 17:30:00+00,19320,789,6257,2156,508,1206,1552,395,788,1670,34641,255,11261,9709,3452,20109
2022-04-14 18:00:00+00,19343,830,6258,2180,507,1166,1559,421,347,1220,33831,263,10851,9292,3034,20173
2022-04-14 18:30:00+00,19339,840,6253,2204,504,1174,1567,399,50,1178,33508,265,10578,9011,2758,20179
2022-04-14 19:00:00+00,19417,832,6253,2112,471,1150,1567,343,0,1208,33353,267,10403,8836,2583,20249
2022-04-14 19:30:00+00,19318,777,6254,2025,470,1150,1543,318,0,1436,33291,264,10292,8749,2495,20095
2022-04-14 20:00:00+00,19539,826,6265,1921,367,1230,1569,341,0,922,32980,272,10122,8553,2288,20365
2022-04-14 20:30:00+00,19398,821,6262,1856,338,1228,1474,260,0,148,31785,280,9930,8456,2194,20219
2022-04-14 21:00:00+00,19184,604,6259,1843,234,1190,1373,174,0,112,30973,277,9709,8336,2077,19788
2022-04-14 21:30:00+00,18259,417,6267,1970,226,1194,1283,151,0,0,29767,269,9746,8463,2196,18676
2022-04-14 22:00:00+00,17265,276,6278,2075,193,935,1315,158,0,0,28495,261,9861,8546,2268,17541
2022-04-14 22:30:00+00,16264,0,6278,2184,190,730,1573,152,0,0,27371,246,10225,8652,2374,16264
2022-04-14 23:00:00+00,15929,0,6276,2297,145,314,1493,152,0,0,26606,248,10211,8718,2442,15929
2022-04-14 23:30:00+00,15642,0,6280,2324,143,228,1302,153,0,0,26072,247,10049,8747,2467,15642
2022-04-15 00:00:00+00,15414,0,6279,2371,144,210,1249,152,0,0,25819,246,10043,8794,2515,15414
2022-04-15 00:30:00+00,15276,0,6287,2411,144,292,1381,162,0,0,25953,245,10223,8842,2555,15276
2022-04-15 01:00:00+00,15013,0,6292,2332,106,172,1427,161,0,0,25503,244,10157,8730,2438,15013
2022-04-15 01:30:00+00,14935,0,6293,2306,104,152,1210,162,0,0,25162,244,9913,8703,2410,14935
2022-04-15 02:00:00+00,14883,0,6293,2337,104,248,1139,159,0,0,25163,245,9873,8734,2441,14883
2022-04-15 02:30:00+00,14946,0,6290,2366,104,170,1091,163,0,0,25130,245,9851,8760,2470,14946
2022-04-15 03:00:00+00,15032,0,6288,2451,104,160,1011,170,0,0,25216,245,9854,8843,2555,15032
2022-04-15 03:30:00+00,15005,0,6294,2515,108,130,1040,155,0,0,25247,243,9957,8917,2623,15005
2022-04-15 04:00:00+00,14306,0,6306,2564,205,400,1337,156,0,0,25274,235,10412,9075,2769,14306
2022-04-15 04:30:00+00,14407,0,6307,2537,245,498,1476,159,0,0,25629,234,10565,9089,2782,14407
2022-04-15 05:00:00+00,14477,0,6311,2533,349,860,1525,230,15,0,26300,230,10733,9208,2897,14477
2022-04-15 05:30:00+00,14978,0,6308,2625,362,972,1526,356,236,0,27363,231,11057,9531,3223,14978
2022-04-15 06:00:00+00,14797,0,6307,2554,386,836,1528,242,777,244,27671,222,11552,10024,3717,14797
2022-04-15 06:30:00+00,14992,0,6305,2570,373,746,1383,434,1512,482,28797,216,12143,10760,4455,14992
2022-04-15 07:00:00+00,15225,0,6303,2521,368,836,1414,384,2316,594,29961,210,12922,11508,5205,15225
2022-04-15 07:30:00+00,15100,0,6304,2620,387,856,1517,443,3153,468,30848,204,13981,12464,6160,15100
2022-04-15 08:00:00+00,14820,0,6306,2857,387,1370,1356,283,3997,244,31620,194,14903,13547,7241,14820
2022-04-15 08:30:00+00,14619,0,6303,3110,373,1376,1351,288,4730,0,32150,189,15867,14516,8213,14619
2022-04-15 09:00:00+00,15094,0,6312,3295,232,1000,1521,281,5513,168,33416,187,16873,15352,9040,15094
2022-04-15 09:30:00+00,14698,0,6315,3445,218,982,1527,196,6270,0,33651,180,17775,16248,9933,14698
2022-04-15 10:00:00+00,14156,0,6314,3721,178,1334,1529,155,6708,10,34105,173,18450,16921,10607,14156
2022-04-15 10:30:00+00,13803,0,6310,4005,182,1314,1526,161,6917,0,34218,168,18940,17414,11104,13803
2022-04-15 11:00:00+00,13521,0,6309,4255,141,874,1528,169,7227,200,34224,164,19460,17932,11623,13521
2022-04-15 11:30:00+00,13366,0,6315,4674,141,842,1527,161,7015,0,34041,164,19672,18145,11830,13366
2022-04-15 12:00:00+00,13209,0,6316,5044,141,232,1523,165,7132,0,33762,162,20156,18633,12317,13209
2022-04-15 12:30:00+00,13026,0,6325,5327,141,216,1523,155,6924,0,33637,160,20240,18717,12392,13026
2022-04-15 13:00:00+00,13358,0,6323,5762,142,108,1522,157,6702,0,34074,161,20451,18929,12606,13358
2022-04-15 13:30:00+00,13467,0,6324,6016,142,106,1500,162,6231,0,33948,163,20213,18713,12389,13467
2022-04-15 14:00:00+00,13133,0,6332,6184,133,0,1311,157,5799,0,33049,163,19759,18448,12116,13133
2022-04-15 14:30:00+00,12944,0,6331,6368,133,0,1220,170,5311,0,32477,163,19363,18143,11812,12944
2022-04-15 15:00:00+00,13418,0,6337,6427,207,0,1221,168,4603,0,32381,169,18795,17574,11237,13418
2022-04-15 15:30:00+00,14142,0,6338,6540,218,0,1485,261,3831,0,32815,178,18412,16927,10589,14142
2022-04-15 16:00:00+00,14647,0,6341,6660,303,206,1526,253,3230,6,33172,182,18060,16534,10193,14647
2022-04-15 16:30:00+00,15014,0,6338,6824,326,254,1528,341,2465,6,33096,187,17481,15953,9615,15014
2022-04-15 17:00:00+00,15065,0,6336,6817,445,654,1528,421,1701,346,33313,188,16827,15299,8963,15065
2022-04-15 17:30:00+00,15172,0,6341,6701,453,694,1529,500,1016,754,33160,190,16040,14511,8170,15172
2022-04-15 18:00:00+00,15135,0,6336,6751,451,906,1529,526,380,434,32448,195,15447,13918,7582,15135
2022-04-15 18:30:00+00,14985,0,6341,6851,451,920,1543,413,54,502,32060,194,15240,13697,7356,14985
2022-04-15 19:00:00+00,14228,0,6336,7196,452,758,1553,473,0,270,31266,190,15537,13984,7648,14228
2022-04-15 19:30:00+00,14051,0,6332,7340,451,752,1551,479,0,362,31318,188,15674,14123,7791,14051
2022-04-15 20:00:00+00,14212,0,6331,7368,356,482,1553,484,0,194,30980,192,15608,14055,7724,14212
2022-04-15 20:30:00+00,13576,0,6337,7206,325,426,1524,444,0,6,29844,190,15392,13868,7531,13576
2022-04-15 21:00:00+00,13890,0,6336,6970,225,58,1533,446,0,0,29458,197,15064,13531,7195,13890
2022-04-15 21:30:00+00,12646,0,6332,6846,219,10,1487,477,0,72,28089,189,14884,13397,7065,12646
2022-04-15 22:00:00+00,9160,0,6344,6942,207,420,1443,345,0,0,24861,157,14936,13493,7149,9160
2022-04-15 22:30:00+00,7409,0,6337,6884,206,522,1557,360,0,58,23333,139,14984,13427,7090,7409
2022-04-15 23:00:00+00,6612,0,6335,6672,181,738,1559,302,0,62,22461,130,14747,13188,6853,6612
2022-04-15 23:30:00+00,6374,0,6341,6539,180,746,1516,247,0,48,21991,127,14576,13060,6719,6374
2022-04-16 00:00:00+00,6604,0,6340,6370,179,988,1475,174,0,0,22130,131,14364,12889,6549,6604
2022-04-16 00:30:00+00,6910,0,6340,6240,179,1090,1568,190,0,0,22517,137,14327,12759,6419,6910
2022-04-16 01:00:00+00,6404,0,6351,6026,142,1314,1604,157,0,0,21998,132,14123,12519,6168,6404
2022-04-16 01:30:00+00,6215,0,6352,5939,141,1350,1599,154,0,0,21750,131,14031,12432,6080,6215
2022-04-16 02:00:00+00,5395,0,6356,5928,141,1938,1490,158,0,0,21406,121,13915,12425,6069,5395
2022-04-16 02:30:00+00,5357,0,6355,5738,141,1984,1370,158,0,0,21103,122,13604,12234,5879,5357
2022-04-16 03:00:00+00,5781,0,6348,5565,141,1794,1043,160,0,0,20832,129,13097,12054,5706,5781
2022-04-16 03:30:00+00,5555,0,6349,5533,156,1790,1171,164,0,0,20718,126,13209,12038,5689,5555
2022-04-16 04:00:00+00,5735,0,6352,5452,254,1564,1356,188,0,0,20901,129,13414,12058,5706,5735
2022-04-16 04:30:00+00,6068,0,6355,5212,279,1578,1500,206,0,14,21212,135,13346,11846,5491,6068
2022-04-16 05:00:00+00,5812,0,6357,5039,368,2080,1544,259,16,114,21589,131,13324,11780,5423,5812
2022-04-16 05:30:00+00,6056,0,6371,5141,377,2094,1540,343,248,0,22170,133,13677,12137,5766,6056
2022-04-16 06:00:00+00,6441,0,6367,5172,394,2578,1503,312,698,414,23879,130,14134,12631,6264,6441
2022-04-16 06:30:00+00,6665,0,6367,5147,395,2588,1463,361,1428,612,25026,128,14800,13337,6970,6665
2022-04-16 07:00:00+00,6572,0,6365,5250,414,3582,1473,337,2226,446,26665,131,15728,14255,7890,6572
2022-04-16 07:30:00+00,6441,0,6369,5420,409,3644,1437,337,3078,540,27675,125,16713,15276,8907,6441
2022-04-16 08:00:00+00,6256,0,6364,5795,372,4086,1432,203,4065,82,28655,117,18028,16596,10232,6256
2022-04-16 08:30:00+00,5714,0,6373,6165,353,4116,1530,162,5042,0,29455,106,19463,17933,11560,5714
2022-04-16 09:00:00+00,5588,0,6374,6432,247,3996,1510,160,5982,0,30289,102,20545,19035,12661,5588
2022-04-16 09:30:00+00,4841,0,6368,6829,216,3900,1417,155,6880,0,30606,89,21710,20293,13925,4841
2022-04-16 10:00:00+00,3998,0,6369,7098,169,4178,1281,157,7708,0,30958,78,22625,21344,14975,3998
2022-04-16 10:30:00+00,3746,0,6362,7193,168,4086,1142,156,8252,0,31105,72,23117,21975,15613,3746
2022-04-16 11:00:00+00,3925,0,6363,7422,141,3976,1080,155,8655,0,31717,71,23661,22581,16218,3925
2022-04-16 11:30:00+00,3663,0,6362,7829,141,3874,1149,154,8692,0,31864,66,24173,23024,16662,3663
2022-04-16 12:00:00+00,3546,0,6350,7944,141,3820,1226,159,8643,0,31829,65,24304,23078,16728,3546
2022-04-16 12:30:00+00,3558,0,6354,7882,140,3814,1256,160,8355,0,31519,66,23987,22731,16377,3558
2022-04-16 13:00:00+00,4121,0,6358,7815,140,3092,1388,170,7909,0,30993,72,23610,22222,15864,4121
2022-04-16 13:30:00+00,4186,0,6360,7918,140,3062,1498,162,7511,0,30836,73,23426,21928,15568,4186
2022-04-16 14:00:00+00,4164,0,6354,8093,140,2834,1509,174,7075,0,30343,74,23171,21662,15308,4164
2022-04-16 14:30:00+00,4468,0,6355,8158,138,2904,1512,164,6349,0,30048,80,22512,21000,14645,4468
2022-04-16 15:00:00+00,5465,0,6361,8111,183,1678,1512,183,5452,0,28945,93,21619,20107,13746,5465
2022-04-16 15:30:00+00,6929,0,6365,8096,190,1640,1520,164,4707,0,29611,111,20878,19358,12993,6929
2022-04-16 16:00:00+00,10463,0,6380,8158,244,402,1515,160,3720,90,31132,146,20017,18502,12122,10463
2022-04-16 16:30:00+00,11630,0,6378,8278,294,402,1505,188,2847,404,31926,157,19302,17797,11419,11630
2022-04-16 17:00:00+00,11871,0,6379,8415,400,402,1646,196,1964,620,31894,160,18804,17158,10779,11871
2022-04-16 17:30:00+00,11988,0,6376,8415,436,402,1844,230,1147,798,31636,164,18218,16374,9998,11988
2022-04-16 18:00:00+00,11953,0,6374,8299,436,402,2144,194,442,1052,31296,166,17695,15551,9177,11953
2022-04-16 18:30:00+00,11821,0,6370,8353,436,402,2186,206,73,892,30739,168,17418,15232,8862,11821
2022-04-16 19:00:00+00,11594,0,6375,8434,435,402,2177,253,0,894,30564,167,17421,15244,8869,11594
2022-04-16 19:30:00+00,11167,0,6373,8648,424,402,2160,269,0,868,30310,162,17605,15445,9072,11167
2022-04-16 20:00:00+00,10754,0,6373,8723,333,402,2155,273,0,866,29880,159,17584,15429,9056,10754
2022-04-16 20:30:00+00,10013,0,6368,8494,310,402,2156,243,0,340,28326,158,17328,15172,8804,10013
2022-04-16 21:00:00+00,9216,0,6380,8367,262,404,2161,242,0,310,27343,152,17170,15009,8629,9216
2022-04-16 21:30:00+00,8082,0,6375,8218,259,404,2162,192,0,196,25888,142,17014,14852,8477,8082
2022-04-16 22:00:00+00,6996,0,6371,8197,244,1012,1988,155,0,8,24972,132,16800,14812,8441,6996
2022-04-16 22:30:00+00,6032,0,6370,8215,219,1066,2120,199,0,2,24222,122,16924,14804,8434,6032
2022-04-16 23:00:00+00,5329,0,6368,8374,177,1524,1561,156,0,0,23489,111,16480,14919,8551,5329
2022-04-16 23:30:00+00,4917,0,6368,8507,177,1396,1329,156,0,0,22850,103,16381,15052,8684,4917
2022-04-17 00:00:00+00,4926,0,6371,8201,157,1762,1333,159,0,0,22909,101,16062,14729,8358,4926
2022-04-17 00:30:00+00,5024,0,6378,7836,158,1830,1331,155,0,0,22713,105,15703,14372,7994,5024
2022-04-17 01:00:00+00,4951,0,6379,7339,142,1160,1601,169,0,0,21741,109,15461,13860,7481,4951
2022-04-17 01:30:00+00,4744,0,6390,6994,143,1136,1855,158,0,0,21420,108,15382,13527,7137,4744
2022-04-17 02:00:00+00,4653,0,6393,6817,143,1282,1996,162,0,0,21446,108,15349,13353,6960,4653
2022-04-17 02:30:00+00,4597,0,6396,6508,143,1242,2061,161,0,0,21109,109,15108,13047,6651,4597
2022-04-17 03:00:00+00,4556,0,6394,6373,143,1388,2096,155,0,0,21105,108,15006,12910,6516,4556
2022-04-17 03:30:00+00,4409,0,6401,6329,169,1384,2155,152,0,0,20999,106,15054,12899,6498,4409
2022-04-17 04:00:00+00,4317,0,6393,6044,283,1556,1966,157,0,0,20716,107,14686,12720,6327,4317
2022-04-17 04:30:00+00,4491,0,6392,5632,300,1654,2070,163,0,0,20702,114,14394,12324,5932,4491
2022-04-17 05:00:00+00,4683,0,6398,5246,377,1808,2169,156,34,0,20871,115,14224,12055,5657,4683
2022-04-17 05:30:00+00,4949,0,6397,5085,389,1836,2186,163,344,0,21349,117,14401,12215,5818,4949
2022-04-17 06:00:00+00,4720,0,6398,5036,389,2912,2177,155,876,0,22663,110,14876,12699,6301,4720
2022-04-17 06:30:00+00,4914,0,6399,4958,388,2986,2186,164,1648,100,23743,109,15579,13393,6994,4914
2022-04-17 07:00:00+00,4879,0,6398,4810,363,3886,2116,169,2571,178,25370,105,16258,14142,7744,4879
2022-04-17 07:30:00+00,4915,0,6401,4975,363,3910,2096,156,3452,24,26292,101,17287,15191,8790,4915
2022-04-17 08:00:00+00,4935,0,6396,5181,329,4034,2106,161,4349,192,27683,97,18361,16255,9859,4935
2022-04-17 08:30:00+00,4571,0,6403,5173,411,4040,2157,186,5201,200,28342,90,19345,17188,10785,4571
2022-04-17 09:00:00+00,4315,0,6403,5122,356,4040,2140,224,5972,144,28716,86,19993,17853,11450,4315
2022-04-17 09:30:00+00,4022,0,6407,5453,341,4040,2129,230,6727,10,29359,80,21057,18928,12521,4022
2022-04-17 10:00:00+00,3963,0,6399,5861,319,4040,2155,197,7243,0,30177,77,21977,19822,13423,3963
2022-04-17 10:30:00+00,3799,0,6398,6205,319,4040,2154,190,7772,0,30877,73,22848,20694,14296,3799
2022-04-17 11:00:00+00,3781,0,6397,6726,299,4040,2150,178,8055,0,31626,71,23627,21477,15080,3781
2022-04-17 11:30:00+00,3730,0,6399,7331,235,4040,1922,155,7940,0,31752,69,23827,21905,15506,3730
2022-04-17 12:00:00+00,3328,0,6400,8286,224,3764,1596,155,7783,0,31536,60,24289,22693,16293,3328
2022-04-17 12:30:00+00,2653,0,6399,9018,177,3750,1586,153,7621,0,31357,52,24801,23215,16816,2653
2022-04-17 13:00:00+00,3216,0,6401,10285,175,2178,1701,154,7305,0,31415,56,25867,24166,17765,3216
2022-04-17 13:30:00+00,2696,0,6398,11003,153,2110,1495,154,6828,0,30837,49,25877,24382,17984,2696
2022-04-17 14:00:00+00,2152,0,6413,11432,152,3038,1256,145,6119,0,30707,46,25372,24116,17703,2152
2022-04-17 14:30:00+00,2241,0,6419,12089,159,3038,1281,155,5417,0,30799,47,25365,24084,17665,2241
2022-04-17 15:00:00+00,2572,0,6420,12471,188,2470,1575,158,4587,0,30441,47,25241,23666,17246,2572
2022-04-17 15:30:00+00,3027,0,6418,12743,188,2456,1891,161,3834,0,30718,54,25074,23183,16765,3027
2022-04-17 16:00:00+00,4278,0,6417,12664,259,1384,2070,166,3079,0,30317,70,24489,22419,16002,4278
2022-04-17 16:30:00+00,5093,0,6416,12046,280,1354,2068,179,2334,28,29798,82,23144,21076,14660,5093
2022-04-17 17:00:00+00,5733,0,6429,11435,352,784,2073,207,1540,568,29121,92,21829,19756,13327,5733
2022-04-17 17:30:00+00,5894,0,6424,11041,348,770,2074,180,869,1132,28732,95,20756,18682,12258,5894
2022-04-17 18:00:00+00,6424,0,6426,10944,408,562,2070,191,358,1296,28679,100,20206,18136,11710,6424
2022-04-17 18:30:00+00,6406,0,6421,11011,417,566,2074,277,67,1172,28411,102,19990,17916,11495,6406
2022-04-17 19:00:00+00,7221,0,6425,10843,415,524,2074,178,0,906,28586,112,19757,17683,11258,7221
2022-04-17 19:30:00+00,7372,0,6418,10806,436,458,2071,262,0,828,28651,114,19731,17660,11242,7372
2022-04-17 20:00:00+00,6902,0,6415,10830,409,692,2084,259,0,136,27727,111,19738,17654,11239,6902
2022-04-17 20:30:00+00,6236,0,6416,10916,333,684,1945,170,0,60,26760,104,19610,17665,11249,6236
2022-04-17 21:00:00+00,6234,0,6421,11134,228,558,1799,215,0,168,26757,104,19582,17783,11362,6234
2022-04-17 21:30:00+00,5802,0,6419,10900,223,510,1580,183,0,186,25803,99,19122,17542,11123,5802
2022-04-17 22:00:00+00,5232,0,6421,10570,210,542,1481,164,0,108,24728,93,18682,17201,10780,5232
2022-04-17 22:30:00+00,4757,0,6422,10573,200,552,1511,151,0,0,24166,88,18706,17195,10773,4757
2022-04-17 23:00:00+00,4371,0,6422,10617,120,656,1525,151,0,0,23862,84,18684,17159,10737,4371
2022-04-17 23:30:00+00,4209,0,6416,10444,120,662,1402,162,0,0,23415,82,18382,16980,10564,4209
2022-04-18 00:00:00+00,4187,0,6418,9660,100,836,1383,157,0,0,22741,84,17561,16178,9760,4187
2022-04-18 00:30:00+00,4732,0,6414,9223,98,860,1570,160,0,0,23057,93,17305,15735,9321,4732
2022-04-18 01:00:00+00,4722,0,6413,8872,84,748,1816,153,0,0,22808,95,17185,15369,8956,4722
2022-04-18 01:30:00+00,4619,0,6410,8447,84,748,1875,165,0,0,22348,96,16816,14941,8531,4619
2022-04-18 02:00:00+00,4773,0,6406,7781,84,908,1603,163,0,0,21718,102,15874,14271,7865,4773
2022-04-18 02:30:00+00,5190,0,6410,7188,84,932,1693,165,0,0,21662,110,15375,13682,7272,5190
2022-04-18 03:00:00+00,4905,0,6411,6488,130,1496,1790,158,0,0,21378,106,14819,13029,6618,4905
2022-04-18 03:30:00+00,4962,0,6416,6209,137,1550,1822,152,0,0,21248,108,14584,12762,6346,4962
2022-04-18 04:00:00+00,5125,0,6413,5670,173,1968,1837,164,0,0,21350,110,14093,12256,5843,5125
2022-04-18 04:30:00+00,5575,0,6410,5212,233,1994,1875,159,0,0,21458,118,13730,11855,5445,5575
2022-04-18 05:00:00+00,5616,0,6420,5012,394,2270,1921,150,51,0,21834,118,13798,11877,5457,5616
2022-04-18 05:30:00+00,5782,0,6414,5005,397,2358,2020,153,420,0,22549,119,14256,12236,5822,5782
2022-04-18 06:00:00+00,5948,0,6413,4820,397,3547,1714,300,939,124,24202,123,14283,12569,6156,5948
2022-04-18 06:30:00+00,6600,0,6411,4319,399,3623,1638,333,1498,480,25301,128,14265,12627,6216,6600
2022-04-18 07:00:00+00,7048,0,6414,4013,417,3816,2070,335,2271,464,26848,132,15185,13115,6701,7048
2022-04-18 07:30:00+00,7508,0,6412,4047,418,3816,2107,227,2989,394,27918,132,15973,13866,7454,7508
2022-04-18 08:00:00+00,7630,0,6410,3927,401,4000,2117,271,3654,132,28542,133,16509,14392,7982,7630
2022-04-18 08:30:00+00,7412,0,6414,4050,401,3998,2121,317,4249,272,29234,128,17235,15114,8700,7412
2022-04-18 09:00:00+00,7485,0,6413,4093,351,3998,2114,270,5081,258,30063,125,18052,15938,9525,7485
2022-04-18 09:30:00+00,7166,0,6417,4210,273,3998,2116,224,5731,0,30135,120,18747,16631,10214,7166
2022-04-18 10:00:00+00,7365,0,6414,3992,183,3998,2124,260,6091,0,30427,122,18804,16680,10266,7365
2022-04-18 10:30:00+00,7892,0,6414,3926,157,3996,2129,181,6324,0,31019,125,18950,16821,10407,7892
2022-04-18 11:00:00+00,8139,0,6417,4081,141,3992,2111,156,6944,0,31981,124,19694,17583,11166,8139
2022-04-18 11:30:00+00,7988,0,6341,4357,143,3992,2119,155,7113,0,32208,122,20073,17954,11613,7988
2022-04-18 12:00:00+00,8340,0,6264,4493,143,3998,2133,152,7086,0,32610,124,20120,17987,11722,8340
2022-04-18 12:30:00+00,8183,0,6185,4576,124,3998,2145,158,6867,0,32236,124,19897,17752,11567,8183
2022-04-18 13:00:00+00,8063,0,6105,4714,108,4000,2131,160,6801,0,32082,123,19859,17728,11623,8063
2022-04-18 13:30:00+00,7960,0,6025,4775,108,3998,2126,154,6725,0,31871,122,19759,17633,11608,7960
2022-04-18 14:00:00+00,7740,0,5944,4950,108,3998,2120,153,6317,0,31330,122,19439,17319,11375,7740
2022-04-18 14:30:00+00,7858,0,5865,5125,108,3998,2096,155,5223,0,30428,127,18417,16321,10456,7858
2022-04-18 15:00:00+00,9068,0,5785,5383,177,3018,2084,169,4410,0,30094,142,17839,15755,9970,9068
2022-04-18 15:30:00+00,10200,0,5707,5439,182,3030,2129,171,3658,0,30516,155,17115,14986,9279,10200
2022-04-18 16:00:00+00,13760,0,5627,5381,251,244,2147,550,2990,42,30992,192,16396,14249,8622,13760
2022-04-18 16:30:00+00,15267,0,5548,5109,281,398,2145,600,2430,572,32349,205,15512,13367,7820,15267
2022-04-18 17:00:00+00,16411,0,5469,4839,384,584,2144,640,1726,990,33187,213,14562,12418,6949,16411
2022-04-18 17:30:00+00,17125,0,5389,4600,400,558,2154,640,1139,1092,33097,221,13682,11528,6139,17125
2022-04-18 18:00:00+00,17251,0,5310,4363,402,900,2132,509,587,1218,32672,224,12794,10662,5352,17251
2022-04-18 18:30:00+00,17612,0,5230,4082,401,782,2137,409,126,1334,32114,229,11977,9840,4609,17612
2022-04-18 19:00:00+00,17517,0,5150,4051,401,666,2154,397,0,1140,31476,231,11756,9602,4452,17517
2022-04-18 19:30:00+00,17301,0,5068,4425,383,640,2169,421,0,954,31361,230,12045,9876,4808,17301
2022-04-18 20:00:00+00,16773,0,4985,4445,341,486,2169,450,0,592,30241,232,11940,9771,4786,16773
2022-04-18 20:30:00+00,15833,0,4908,4384,321,442,2165,413,0,168,28633,232,11777,9612,4705,15833
2022-04-18 21:00:00+00,15566,0,4826,4309,242,30,2168,382,0,406,27929,233,11545,9377,4551,15566
2022-04-18 21:30:00+00,15243,0,4745,4245,229,0,2164,281,0,52,26959,236,11383,9219,4474,15243
2022-04-18 22:00:00+00,14896,0,4662,4071,214,0,2167,273,0,134,26418,235,11115,8948,4285,14896
2022-04-18 22:30:00+00,14116,0,4581,4048,189,0,2167,205,0,0,25306,233,10985,8818,4237,14116
2022-04-18 23:00:00+00,14761,0,4584,3961,139,0,2165,185,0,0,25795,238,10849,8684,4100,14761
2022-04-18 23:30:00+00,14725,0,4580,3797,139,84,2150,165,0,0,25640,240,10666,8516,3936,14725
2022-04-19 00:00:00+00,14678,0,4583,3763,139,26,2143,168,0,0,25500,239,10628,8485,3902,14678
2022-04-19 00:30:00+00,14862,0,4577,3586,137,84,2147,161,0,0,25554,243,10447,8300,3723,14862
2022-04-19 01:00:00+00,14765,0,4583,3493,100,60,2145,160,0,0,25306,243,10321,8176,3593,14765
2022-04-19 01:30:00+00,14760,0,4573,3347,100,14,2152,161,0,0,25107,244,10172,8020,3447,14760
2022-04-19 02:00:00+00,14570,0,4579,3236,100,14,2151,175,0,0,24825,244,10066,7915,3336,14570
2022-04-19 02:30:00+00,14776,0,4576,3122,134,14,2155,175,0,0,24952,246,9987,7832,3256,14776
2022-04-19 03:00:00+00,15132,0,4578,3095,281,14,2149,171,0,0,25420,247,10103,7954,3376,15132
2022-04-19 03:30:00+00,15246,0,4583,3065,184,100,2155,155,0,0,25488,249,9987,7832,3249,15246
2022-04-19 04:00:00+00,15039,0,4582,2882,193,246,2154,162,0,0,25258,251,9811,7657,3075,15039
2022-04-19 04:30:00+00,15599,0,4587,2810,242,382,2155,185,0,6,25966,256,9794,7639,3052,15599
2022-04-19 05:00:00+00,16229,0,4583,2740,439,532,2154,386,36,14,27113,255,9952,7798,3215,16229
2022-04-19 05:30:00+00,17025,15,4582,2642,441,456,2149,462,328,682,28782,250,10142,7993,3411,17040
2022-04-19 06:00:00+00,17177,38,4579,2426,458,680,2144,581,935,1162,30180,240,10542,8398,3819,17215
2022-04-19 06:30:00+00,17961,134,4586,2162,459,746,2145,715,1719,1390,32017,240,11071,8926,4340,18095
2022-04-19 07:00:00+00,19339,230,4581,2076,451,1262,2158,556,2565,770,33988,246,11831,9673,5092,19569
2022-04-19 07:30:00+00,19254,238,4579,1933,414,1276,2191,545,3332,664,34426,243,12449,10258,5679,19492
2022-04-19 08:00:00+00,18767,264,4577,1845,361,2130,2222,504,4208,112,34990,242,13213,10991,6414,19031
2022-04-19 08:30:00+00,18595,313,4579,1871,347,2130,2269,484,4873,0,35461,238,13939,11670,7091,18908
2022-04-19 09:00:00+00,18379,446,4582,1854,281,2036,2264,340,5519,0,35701,238,14500,12236,7654,18825
2022-04-19 09:30:00+00,18050,458,4580,1845,264,2002,2238,282,5774,0,35493,236,14701,12463,7883,18508
2022-04-19 10:00:00+00,18308,459,4580,1803,186,1954,2315,200,6159,20,35984,235,15043,12728,8148,18767
2022-04-19 10:30:00+00,18381,468,4582,1735,168,1954,2598,198,6393,18,36495,233,15476,12878,8296,18849
2022-04-19 11:00:00+00,18670,460,4584,1772,138,2002,2617,188,6717,18,37166,232,15828,13211,8627,19130
2022-04-19 11:30:00+00,18523,459,4578,1798,134,2004,2618,161,6142,0,36417,235,15270,12652,8074,18982
2022-04-19 12:00:00+00,18373,458,4579,1781,134,2002,2613,174,5456,0,35570,239,14563,11950,7371,18831
2022-04-19 12:30:00+00,18361,462,4580,1906,135,2004,2607,161,5366,0,35582,239,14594,11987,7407,18823
2022-04-19 13:00:00+00,18424,453,4578,2106,119,2004,2582,176,4755,0,35197,242,14140,11558,6980,18877
2022-04-19 13:30:00+00,18467,302,4576,2268,118,2002,2583,179,4826,0,35321,238,14371,11788,7212,18769
2022-04-19 14:00:00+00,18362,229,4577,2459,119,1626,2584,172,4259,0,34387,238,13998,11414,6837,18591
2022-04-19 14:30:00+00,18495,1,4575,2683,124,1636,2582,227,3594,116,34033,236,13558,10976,6401,18496
2022-04-19 15:00:00+00,18543,0,4586,2942,191,1596,2600,259,3063,2,33782,234,13382,10782,6196,18543
2022-04-19 15:30:00+00,18783,0,4585,3255,204,1662,2643,468,2386,4,33990,237,13073,10430,5845,18783
2022-04-19 16:00:00+00,18962,0,4587,3475,318,1738,2694,482,2062,20,34338,238,13136,10442,5855,18962
2022-04-19 16:30:00+00,18966,0,4585,3730,338,1774,2703,497,1802,294,34689,235,13158,10455,5870,18966
2022-04-19 17:00:00+00,19343,0,4587,3828,514,1568,2653,503,1231,644,34871,238,12813,10160,5573,19343
2022-04-19 17:30:00+00,19584,0,4585,3732,499,1522,2594,483,790,592,34381,243,12200,9606,5021,19584
2022-04-19 18:00:00+00,19815,0,4585,3706,492,1740,2618,519,334,632,34441,248,11735,9117,4532,19815
2022-04-19 18:30:00+00,19820,0,4581,3687,500,1660,2645,465,92,550,34000,250,11505,8860,4279,19820
2022-04-19 19:00:00+00,19745,0,4585,3626,455,976,2722,427,0,344,32880,253,11388,8666,4081,19745
2022-04-19 19:30:00+00,19665,0,4579,3530,430,944,2732,419,0,342,32641,254,11271,8539,3960,19665
2022-04-19 20:00:00+00,19127,0,4579,3468,312,1100,2732,429,0,678,32425,252,11091,8359,3780,19127
2022-04-19 20:30:00+00,18502,0,4574,3479,296,1060,2730,248,0,360,31249,252,11079,8349,3775,18502
2022-04-19 21:00:00+00,18937,0,4579,3637,215,48,2734,242,0,54,30446,259,11165,8431,3852,18937
2022-04-19 21:30:00+00,17637,0,4581,3794,200,40,2641,249,0,0,29142,252,11216,8576,3994,17637
2022-04-19 22:00:00+00,16548,0,4576,3729,184,0,2524,197,0,96,27854,247,11013,8489,3913,16548
2022-04-19 22:30:00+00,15529,0,4579,3801,181,0,2509,152,0,12,26763,242,11070,8561,3982,15529
2022-04-19 23:00:00+00,15211,0,4582,4015,140,0,2513,154,0,12,26627,238,11250,8737,4155,15211
2022-04-19 23:30:00+00,14797,0,4586,4122,140,0,2516,157,0,0,26318,235,11364,8848,4262,14797
2022-04-20 00:00:00+00,14935,0,4579,4329,140,0,2516,156,0,0,26655,234,11564,9048,4469,14935
2022-04-20 00:30:00+00,15135,0,4578,4371,140,0,2510,152,0,0,26886,235,11599,9089,4511,15135
2022-04-20 01:00:00+00,14907,0,4580,4271,121,0,2513,164,0,0,26556,234,11485,8972,4392,14907
2022-04-20 01:30:00+00,14871,0,4576,4120,121,0,2512,164,0,0,26364,236,11329,8817,4241,14871
2022-04-20 02:00:00+00,15531,0,4575,3935,101,0,2519,159,0,0,26820,241,11130,8611,4036,15531
2022-04-20 02:30:00+00,15709,0,4572,3786,101,0,2530,178,0,0,26876,244,10989,8459,3887,15709
2022-04-20 03:00:00+00,15913,0,4569,3588,101,0,2533,166,0,0,26870,247,10791,8258,3689,15913
2022-04-20 03:30:00+00,15960,0,4581,3473,101,0,2533,152,0,0,26800,248,10688,8155,3574,15960
2022-04-20 04:00:00+00,15936,0,4581,3628,161,0,2541,153,0,0,27000,246,10911,8370,3789,15936
2022-04-20 04:30:00+00,16376,0,4585,3676,210,12,2473,155,0,0,27487,247,10944,8471,3886,16376
2022-04-20 05:00:00+00,17066,0,4583,3701,343,184,2326,222,52,120,28597,247,11005,8679,4096,17066
2022-04-20 05:30:00+00,17755,0,4582,3708,354,238,2399,432,378,762,30608,242,11420,9022,4440,17755
2022-04-20 06:00:00+00,18405,0,4584,3820,442,612,2491,360,839,812,32365,237,12176,9685,5101,18405
2022-04-20 06:30:00+00,18623,0,4582,3923,514,652,2699,442,1453,1078,33966,230,13171,10472,5890,18623
2022-04-20 07:00:00+00,18191,0,4588,4021,457,1674,2815,272,2395,422,34835,224,14276,11461,6873,18191
2022-04-20 07:30:00+00,17567,0,4585,4115,436,1754,2824,255,3297,388,35221,215,15257,12433,7848,17567
2022-04-20 08:00:00+00,18049,0,4584,4139,327,1878,2679,189,4228,170,36243,214,15957,13278,8694,18049
2022-04-20 08:30:00+00,17507,0,4590,4277,308,1848,2487,162,5372,0,36551,205,17034,14547,9957,17507
2022-04-20 09:00:00+00,17508,0,4592,4401,240,996,2470,194,6432,0,36833,200,18135,15665,11073,17508
2022-04-20 09:30:00+00,16909,0,4581,4486,233,914,2270,185,7215,0,36793,193,18785,16515,11934,16909
2022-04-20 10:00:00+00,16446,0,4576,4602,212,1372,2004,175,8073,0,37460,187,19467,17463,12887,16446
2022-04-20 10:30:00+00,15937,0,4584,4711,187,1372,1987,201,8695,0,37674,181,20164,18177,13593,15937
2022-04-20 11:00:00+00,15903,0,4577,4924,139,1282,2059,199,9026,0,38109,180,20725,18666,14089,15903
2022-04-20 11:30:00+00,15713,0,4584,5043,139,1282,2057,175,9042,0,38035,178,20865,18808,14224,15713
2022-04-20 12:00:00+00,15415,0,4576,5142,141,1552,1866,179,8833,0,37704,177,20558,18692,14116,15415
2022-04-20 12:30:00+00,15150,0,4575,5321,141,1554,1920,160,8754,0,37575,175,20711,18791,14216,15150
2022-04-20 13:00:00+00,14923,0,4570,5347,126,1104,2380,173,8473,0,37096,173,20896,18516,13946,14923
2022-04-20 13:30:00+00,14910,0,4575,5351,126,1122,2461,155,7761,0,36461,176,20274,17813,13238,14910
2022-04-20 14:00:00+00,15514,0,4575,5796,127,96,2447,164,7051,0,35770,181,19996,17549,12974,15514
2022-04-20 14:30:00+00,15367,0,4571,6213,136,122,2454,166,6424,0,35453,181,19798,17344,12773,15367
2022-04-20 15:00:00+00,15159,0,4572,6377,215,262,2450,199,5541,0,34775,182,19155,16705,12133,15159
2022-04-20 15:30:00+00,16347,0,4578,6463,239,388,2442,193,4746,6,35402,193,18468,16026,11448,16347
2022-04-20 16:00:00+00,17684,0,4577,6524,309,680,2459,209,3674,82,36198,203,17543,15084,10507,17684
2022-04-20 16:30:00+00,17882,0,4584,6643,329,740,2598,339,2750,282,36147,207,16904,14306,9722,17882
2022-04-20 17:00:00+00,17841,0,4583,6795,430,748,2774,646,1991,310,36118,210,16573,13799,9216,17841
2022-04-20 17:30:00+00,17850,0,4580,6928,442,750,2576,667,1194,824,35811,211,15720,13144,8564,17850
2022-04-20 18:00:00+00,17893,0,4580,7182,431,862,2452,584,561,874,35419,215,15206,12754,8174,17893
2022-04-20 18:30:00+00,18151,0,4582,7523,428,778,2447,421,138,564,35032,217,15118,12671,8089,18151
2022-04-20 19:00:00+00,18248,0,4580,7697,426,836,2465,386,1,580,35219,218,15169,12704,8124,18248
2022-04-20 19:30:00+00,18310,0,4577,7876,402,734,2482,339,0,428,35148,217,15337,12855,8278,18310
2022-04-20 20:00:00+00,18400,0,4580,8237,293,430,2607,352,0,366,35265,219,15717,13110,8530,18400
2022-04-20 20:30:00+00,18100,0,4577,8419,244,292,2444,192,0,50,34318,219,15684,13240,8663,18100
2022-04-20 21:00:00+00,16806,0,4579,8575,188,166,2389,156,0,0,32859,214,15731,13342,8763,16806
2022-04-20 21:30:00+00,15278,0,4574,8730,174,176,2207,170,0,0,31309,205,15685,13478,8904,15278
2022-04-20 22:00:00+00,13744,0,4572,8725,174,98,2165,164,0,60,29702,194,15636,13471,8899,13744
2022-04-20 22:30:00+00,12981,0,4573,8657,167,0,2116,153,0,0,28647,189,15513,13397,8824,12981
2022-04-20 23:00:00+00,12872,0,4566,8385,124,60,2265,169,0,0,28441,191,15340,13075,8509,12872
2022-04-20 23:30:00+00,12834,0,4572,8098,125,56,2341,170,0,0,28196,192,15136,12795,8223,12834
2022-04-21 00:00:00+00,13275,0,4571,7790,107,54,2398,159,0,0,28354,197,14866,12468,7897,13275
2022-04-21 00:30:00+00,13333,0,4570,7484,105,192,2318,162,0,0,28164,201,14477,12159,7589,13333
2022-04-21 01:00:00+00,13225,0,4574,7400,86,198,2206,150,0,0,27840,202,14266,12060,7486,13225
2022-04-21 01:30:00+00,12989,0,4568,7467,87,152,1956,155,0,0,27374,200,14078,12122,7554,12989
2022-04-21 02:00:00+00,12767,0,4567,7269,87,278,1940,157,0,0,27065,201,13863,11923,7356,12767
2022-04-21 02:30:00+00,12962,0,4568,6960,87,286,1934,157,0,0,26954,205,13549,11615,7047,12962
2022-04-21 03:00:00+00,13201,0,4568,6666,87,376,1979,154,0,0,27031,209,13300,11321,6753,13201
2022-04-21 03:30:00+00,13396,0,4573,6435,94,364,1928,152,0,0,26942,212,13030,11102,6529,13396
2022-04-21 04:00:00+00,12801,0,4575,6356,162,402,2098,152,0,0,26546,208,13191,11093,6518,12801
2022-04-21 04:30:00+00,12889,0,4575,6297,203,430,1985,158,0,0,26537,209,13060,11075,6500,12889
2022-04-21 05:00:00+00,14618,0,4578,6193,310,806,1857,165,79,84,28690,217,13017,11160,6582,14618
2022-04-21 05:30:00+00,15731,0,4581,5927,345,864,2402,371,524,90,30835,220,13779,11377,6796,15731
2022-04-21 06:00:00+00,15923,0,4576,5707,498,1072,2612,745,1181,1076,33390,210,14574,11962,7386,15923
2022-04-21 06:30:00+00,16022,0,4576,5591,556,1000,2691,1030,1964,1780,35210,201,15378,12687,8111,16022
2022-04-21 07:00:00+00,15926,0,4580,5548,512,866,2687,907,2877,944,34847,200,16204,13517,8937,15926
2022-04-21 07:30:00+00,15816,0,4581,5616,463,724,2762,795,3820,574,35151,194,17242,14480,9899,15816
2022-04-21 08:00:00+00,15403,0,4579,5813,437,832,2718,399,4784,548,35513,185,18331,15613,11034,15403
2022-04-21 08:30:00+00,15186,0,4583,5892,428,824,2791,258,5815,112,35889,180,19509,16718,12135,15186
2022-04-21 09:00:00+00,15069,0,4579,6128,289,710,2755,164,6778,100,36572,174,20529,17774,13195,15069
2022-04-21 09:30:00+00,14339,0,4582,6658,280,664,2604,165,7579,0,36871,164,21703,19099,14517,14339
2022-04-21 10:00:00+00,13064,0,4583,7227,211,968,2450,145,8240,0,36887,155,22711,20261,15678,13064
2022-04-21 10:30:00+00,11914,0,4581,7782,199,1159,2401,143,8739,0,36919,145,23702,21301,16720,11914
2022-04-21 11:00:00+00,11434,0,4577,8328,139,1505,2361,145,9026,0,37515,140,24431,22070,17493,11434
2022-04-21 11:30:00+00,10902,0,4578,8709,138,1463,2201,147,9241,0,37379,135,24867,22666,18088,10902
2022-04-21 12:00:00+00,10600,0,4573,8736,138,1582,2089,150,9120,0,36989,134,24656,22567,17994,10600
2022-04-21 12:30:00+00,10318,0,4579,8904,138,1524,2227,142,8947,0,36780,131,24795,22568,17989,10318
2022-04-21 13:00:00+00,10126,0,4574,9121,122,1383,2155,146,8585,0,36212,130,24557,22402,17828,10126
2022-04-21 13:30:00+00,10331,0,4569,9258,122,1248,1934,144,7947,0,35553,133,23830,21896,17327,10331
2022-04-21 14:00:00+00,11012,0,4567,9269,123,509,2021,157,7342,0,35000,136,23322,21301,16734,11012
2022-04-21 14:30:00+00,11481,0,4578,9433,126,570,2201,155,6515,0,35059,143,22853,20652,16074,11481
2022-04-21 15:00:00+00,12712,0,4576,9792,181,548,2266,183,5711,0,35969,153,22526,20260,15684,12712
2022-04-21 15:30:00+00,13633,0,4580,10083,192,523,2219,186,4849,0,36265,162,21923,19704,15124,13633
2022-04-21 16:00:00+00,14676,0,4577,10320,272,812,2286,241,3973,192,37349,168,21428,19142,14565,14676
2022-04-21 16:30:00+00,15447,0,4584,10611,294,880,2300,220,3121,64,37521,176,20910,18610,14026,15447
2022-04-21 17:00:00+00,15528,0,4584,11101,344,1023,2358,253,2307,378,37876,174,20694,18336,13752,15528
2022-04-21 17:30:00+00,15632,0,4588,11452,346,947,2359,304,1462,366,37456,177,20207,17848,13260,15632
2022-04-21 18:00:00+00,15488,0,4588,11617,339,1036,2359,550,714,366,37057,180,19617,17258,12670,15488
2022-04-21 18:30:00+00,15423,0,4589,11526,337,945,2347,557,174,430,36328,182,18973,16626,12037,15423
2022-04-21 19:00:00+00,15826,0,4586,11380,338,773,2367,520,2,524,36316,185,18673,16306,11720,15826
2022-04-21 19:30:00+00,16117,0,4585,11441,335,707,2372,500,0,272,36328,187,18733,16361,11776,16117
2022-04-21 20:00:00+00,15709,0,4587,11161,247,347,2292,217,0,198,34759,189,18287,15995,11408,15709
2022-04-21 20:30:00+00,14939,0,4592,11091,245,452,2202,155,0,44,33720,187,18130,15928,11336,14939
2022-04-21 21:00:00+00,13661,0,4597,11407,205,364,1726,156,0,0,32116,181,17935,16209,11612,13661
2022-04-21 21:30:00+00,12778,0,4590,11283,185,402,1324,162,0,158,30882,176,17382,16058,11468,12778
2022-04-21 22:00:00+00,11048,0,4594,11139,185,504,1108,151,0,0,28729,163,17026,15918,11324,11048
2022-04-21 22:30:00+00,10030,0,4595,11048,185,380,766,167,0,0,27171,154,16594,15828,11233,10030
2022-04-21 23:00:00+00,10033,0,4594,10906,100,50,510,160,0,34,26387,155,16110,15600,11006,10033
2022-04-21 23:30:00+00,9731,0,4593,10707,100,16,523,173,0,28,25871,153,15923,15400,10807,9731
2022-04-22 00:00:00+00,10284,0,4602,10698,100,16,506,154,0,0,26360,158,15906,15400,10798,10284
2022-04-22 00:30:00+00,10174,0,4606,11065,100,16,505,155,0,0,26621,155,16276,15771,11165,10174
2022-04-22 01:00:00+00,9885,0,4600,11378,84,16,505,154,0,0,26622,151,16567,16062,11462,9885
2022-04-22 01:30:00+00,9456,0,4603,12069,84,16,504,150,0,0,26882,143,17260,16756,12153,9456
2022-04-22 02:00:00+00,9135,0,4596,12281,84,16,511,156,0,0,26778,139,17472,16961,12365,9135
2022-04-22 02:30:00+00,8848,0,4593,12126,84,16,507,151,0,0,26325,137,17310,16803,12210,8848
2022-04-22 03:00:00+00,8586,0,4600,12163,84,26,509,154,0,0,26122,134,17356,16847,12247,8586
2022-04-22 03:30:00+00,8233,0,4603,12246,85,16,505,154,0,0,25842,130,17439,16934,12331,8233
2022-04-22 04:00:00+00,8151,0,4601,12339,117,56,511,155,0,0,25930,129,17568,17057,12456,8151
2022-04-22 04:30:00+00,8116,0,4619,12638,160,28,508,155,0,0,26225,127,17925,17417,12798,8116
2022-04-22 05:00:00+00,8530,0,4622,12437,316,54,522,170,22,0,26674,130,17919,17397,12775,8530
2022-04-22 05:30:00+00,9108,0,4630,12532,341,102,520,171,220,0,27624,134,18243,17723,13093,9108
2022-04-22 06:00:00+00,10109,0,4658,12625,445,476,522,195,621,192,29843,138,18871,18349,13691,10109
2022-04-22 06:30:00+00,11001,0,4687,12565,421,528,309,317,1080,1012,31920,140,19062,18753,14066,11001
2022-04-22 07:00:00+00,11735,0,4720,12378,439,1472,230,220,1679,852,33726,143,19446,19216,14496,11735
2022-04-22 07:30:00+00,11978,0,4746,12291,433,1502,433,191,2277,536,34387,143,20180,19747,15001,11978
2022-04-22 08:00:00+00,12063,0,4771,12342,371,2062,689,176,2808,306,35589,144,20981,20292,15521,12063
2022-04-22 08:30:00+00,12020,0,4806,12392,371,2078,823,161,3417,0,36069,142,21809,20986,16180,12020
2022-04-22 09:00:00+00,11922,0,4841,12453,299,1996,823,155,4015,0,36504,142,22431,21608,16767,11922
2022-04-22 09:30:00+00,11714,0,4864,12560,275,1982,822,160,4891,0,37268,137,23412,22590,17726,11714
2022-04-22 10:00:00+00,11474,0,4913,12802,175,2040,821,157,5154,18,37554,134,23865,23044,18131,11474
2022-04-22 10:30:00+00,11175,0,4937,13118,154,2038,823,155,5686,0,38086,129,24718,23895,18958,11175
2022-04-22 11:00:00+00,10917,0,4944,13274,137,1882,823,160,6060,12,38209,126,25238,24415,19471,10917
2022-04-22 11:30:00+00,10751,0,4942,13162,135,1880,824,155,6256,0,38105,124,25319,24495,19553,10751
2022-04-22 12:00:00+00,10654,0,4946,13399,135,1742,680,153,6164,0,37873,123,25324,24644,19698,10654
2022-04-22 12:30:00+00,9823,0,4945,13676,129,1744,528,201,6175,0,37221,117,25453,24925,19980,9823
2022-04-22 13:00:00+00,9051,0,4938,14153,130,1660,478,193,6071,0,36674,110,25770,25292,20354,9051
2022-04-22 13:30:00+00,8460,0,4942,14514,125,1662,478,153,6085,0,36419,104,26144,25666,20724,8460
2022-04-22 14:00:00+00,8145,0,4933,14658,119,1662,481,164,5579,0,35741,101,25770,25289,20356,8145
2022-04-22 14:30:00+00,8747,0,4938,14809,124,1546,481,152,4869,0,35666,106,25221,24740,19802,8747
2022-04-22 15:00:00+00,9900,0,4935,15120,149,386,482,156,4359,12,35499,114,25045,24563,19628,9900
2022-04-22 15:30:00+00,10718,0,4928,15352,163,370,483,159,3683,34,35890,121,24609,24126,19198,10718
2022-04-22 16:00:00+00,12079,0,4942,15067,253,106,558,192,3064,124,36385,134,23884,23326,18384,12079
2022-04-22 16:30:00+00,12450,0,4981,14793,304,136,806,184,2380,0,36034,141,23264,22458,17477,12450
2022-04-22 17:00:00+00,12518,0,5000,14657,404,442,750,229,1744,220,35964,142,22555,21805,16805,12518
2022-04-22 17:30:00+00,12651,0,5037,14561,404,494,504,333,1122,322,35428,146,21628,21124,16087,12651
2022-04-22 18:00:00+00,12822,0,5069,14216,388,972,485,245,581,342,35120,149,20739,20254,15185,12822
2022-04-22 18:30:00+00,12902,0,5096,13947,393,998,491,181,143,434,34585,151,20070,19579,14483,12902
2022-04-22 19:00:00+00,12868,0,5126,13643,371,1174,497,175,2,338,34194,153,19639,19142,14016,12868
2022-04-22 19:30:00+00,12581,0,5113,13487,353,1126,495,170,0,312,33637,152,19448,18953,13840,12581
2022-04-22 20:00:00+00,12405,0,5076,13560,256,282,491,164,0,644,32878,152,19383,18892,13816,12405
2022-04-22 20:30:00+00,11747,0,5076,13744,243,222,490,166,0,356,32044,148,19553,19063,13987,11747
2022-04-22 21:00:00+00,11062,0,5057,13783,204,98,491,158,0,316,31169,143,19535,19044,13987,11062
2022-04-22 21:30:00+00,9721,0,4974,14116,199,84,489,152,0,0,29735,133,19778,19289,14315,9721
2022-04-22 22:00:00+00,6315,0,4889,14033,165,1252,496,155,0,0,27305,97,19583,19087,14198,6315
2022-04-22 22:30:00+00,4722,0,4829,13911,157,1394,505,161,0,0,25679,81,19402,18897,14068,4722
2022-04-22 23:00:00+00,4284,0,4828,13661,116,1168,507,174,0,144,24882,79,19112,18605,13777,4284
2022-04-22 23:30:00+00,3968,0,4825,13604,115,1212,491,165,0,62,24442,76,19035,18544,13719,3968
2022-04-23 00:00:00+00,3821,0,4875,13573,99,1360,485,145,0,0,24358,74,19032,18547,13672,3821
2022-04-23 00:30:00+00,3794,0,4942,13254,99,1354,500,156,0,0,24099,75,18795,18295,13353,3794
2022-04-23 01:00:00+00,3859,0,4953,12987,99,1264,496,155,0,0,23813,76,18535,18039,13086,3859
2022-04-23 01:30:00+00,3943,0,4956,12946,99,1280,485,142,0,0,23851,77,18486,18001,13045,3943
2022-04-23 02:00:00+00,3802,0,4924,12967,99,948,488,150,0,0,23378,76,18478,17990,13066,3802
2022-04-23 02:30:00+00,3979,0,4839,12584,99,940,496,145,0,0,23082,80,18018,17522,12683,3979
2022-04-23 03:00:00+00,4006,0,4832,12530,99,1220,503,148,0,0,23338,81,17964,17461,12629,4006
2022-04-23 03:30:00+00,4288,0,4838,12427,99,1224,511,154,0,0,23541,85,17875,17364,12526,4288
2022-04-23 04:00:00+00,4585,0,4843,12739,131,830,506,151,0,0,23785,88,18219,17713,12870,4585
2022-04-23 04:30:00+00,4064,0,4913,12893,125,828,488,145,0,0,23456,80,18419,17931,13018,4064
2022-04-23 05:00:00+00,3703,0,5005,13284,220,1234,503,140,41,0,24130,70,19053,18550,13545,3703
2022-04-23 05:30:00+00,3610,0,5070,13477,232,1212,504,147,240,0,24492,66,19523,19019,13949,3610
2022-04-23 06:00:00+00,3724,0,5071,13669,256,2112,514,152,584,0,26082,68,20094,19580,14509,3724
2022-04-23 06:30:00+00,4101,0,5068,13738,359,2234,519,168,1001,18,27206,71,20685,20166,15098,4101
2022-04-23 07:00:00+00,3477,0,5076,13870,366,3270,503,159,1432,0,28153,64,21247,20744,15668,3477
2022-04-23 07:30:00+00,3358,0,5068,14088,311,3426,511,194,1968,0,28924,62,21946,21435,16367,3358
2022-04-23 08:00:00+00,3560,0,5068,14265,298,3696,508,167,2568,136,30266,61,22707,22199,17131,3560
2022-04-23 08:30:00+00,3427,0,5069,14482,295,3706,507,172,3173,0,30831,59,23526,23019,17950,3427
2022-04-23 09:00:00+00,3685,0,5069,14797,281,2928,513,163,3629,8,31073,61,24289,23776,18707,3685
2022-04-23 09:30:00+00,3320,0,5035,15199,276,2874,503,157,4086,0,31450,55,25099,24596,19561,3320
2022-04-23 10:00:00+00,3290,0,5017,15438,164,2656,518,174,4517,324,32098,54,25654,25136,20119,3290
2022-04-23 10:30:00+00,2967,0,5021,15496,155,2638,506,155,4840,290,32068,50,26018,25512,20491,2967
2022-04-23 11:00:00+00,3495,0,5016,15632,136,2246,597,170,5182,42,32516,56,26563,25966,20950,3495
2022-04-23 11:30:00+00,3170,0,5018,15685,135,2192,538,152,5523,0,32413,52,26899,26361,21343,3170
2022-04-23 12:00:00+00,2860,0,5018,15844,116,2110,502,153,5533,0,32136,48,27013,26511,21493,2860
2022-04-23 12:30:00+00,2388,0,5020,15835,115,2094,496,153,5991,0,32092,43,27457,26961,21941,2388
2022-04-23 13:00:00+00,2499,0,5014,15534,115,2040,506,153,6073,0,31934,44,27242,26736,21722,2499
2022-04-23 13:30:00+00,2488,0,5017,15312,115,2038,499,144,5869,0,31482,45,26812,26313,21296,2488
2022-04-23 14:00:00+00,2556,0,5013,15614,116,1764,517,171,5443,0,31194,44,26703,26186,21173,2556
2022-04-23 14:30:00+00,2557,0,5014,15900,116,1766,501,153,5010,0,31017,44,26541,26040,21026,2557
2022-04-23 15:00:00+00,2580,0,4974,15643,131,2254,506,156,4461,0,30705,48,25715,25209,20235,2580
2022-04-23 15:30:00+00,2937,0,4911,15871,132,2390,528,195,3816,0,30780,55,25258,24730,19819,2937
2022-04-23 16:00:00+00,3562,0,4853,15686,285,2080,512,167,3058,136,30339,60,24394,23882,19029,3562
2022-04-23 16:30:00+00,4897,0,4849,15521,314,2088,508,164,2482,0,30823,76,23674,23166,18317,4897
2022-04-23 17:00:00+00,5594,0,4845,15257,426,2120,525,187,1877,78,30909,84,22930,22405,17560,5594
2022-04-23 17:30:00+00,5820,0,4926,14926,438,2146,504,195,1174,586,30715,87,21968,21464,16538,5820
2022-04-23 18:00:00+00,6120,0,4957,14510,454,2114,508,235,610,590,30098,90,21039,20531,15574,6120
2022-04-23 18:30:00+00,6256,0,4976,14156,454,2128,522,256,187,630,29565,93,20295,19773,14797,6256
2022-04-23 19:00:00+00,6306,0,5018,13904,403,2542,552,273,11,416,29425,93,19888,19336,14318,6306
2022-04-23 19:30:00+00,6130,0,5047,13577,396,2578,532,332,0,644,29236,92,19552,19020,13973,6130
2022-04-23 20:00:00+00,6076,0,5079,13423,324,2554,522,333,0,628,28939,95,19348,18826,13747,6076
2022-04-23 20:30:00+00,5732,0,5106,13408,309,2554,517,218,0,430,28274,92,19340,18823,13717,5732
2022-04-23 21:00:00+00,5350,0,5093,13062,224,2252,507,238,0,548,27274,91,18886,18379,13286,5350
2022-04-23 21:30:00+00,4952,0,5050,13069,217,2258,519,167,0,116,26348,88,18855,18336,13286,4952
2022-04-23 22:00:00+00,4177,0,5071,12835,200,2358,565,159,0,34,25399,78,18671,18106,13035,4177
2022-04-23 22:30:00+00,3325,0,5101,12872,200,2360,509,153,0,0,24520,67,18682,18173,13072,3325
2022-04-23 23:00:00+00,3121,0,5161,12710,150,1882,503,150,0,0,23677,62,18524,18021,12860,3121
2022-04-23 23:30:00+00,3121,0,5268,12249,143,1858,505,152,0,0,23296,63,18165,17660,12392,3121
2022-04-24 00:00:00+00,3370,0,5379,11955,131,1642,521,169,0,0,23167,66,17986,17465,12086,3370
2022-04-24 00:30:00+00,3857,0,5437,11521,115,1630,520,169,0,0,23249,74,17593,17073,11636,3857
2022-04-24 01:00:00+00,3966,0,5454,11207,99,1728,515,171,0,0,23140,79,17275,16760,11306,3966
2022-04-24 01:30:00+00,3522,0,5462,11230,99,1724,500,150,0,0,22687,72,17291,16791,11329,3522
2022-04-24 02:00:00+00,3412,0,5462,11260,99,1852,508,154,0,0,22747,73,17329,16821,11359,3412
2022-04-24 02:30:00+00,3342,0,5466,11364,99,1836,500,151,0,0,22758,72,17429,16929,11463,3342
2022-04-24 03:00:00+00,3388,0,5487,11583,99,1228,502,150,0,0,22437,69,17671,17169,11682,3388
2022-04-24 03:30:00+00,3398,0,5518,11405,99,1206,502,150,0,0,22278,70,17524,17022,11504,3398
2022-04-24 04:00:00+00,3403,0,5540,11621,114,1510,496,150,0,0,22834,69,17771,17275,11735,3403
2022-04-24 04:30:00+00,3360,0,5577,11628,117,1504,496,151,0,0,22833,69,17818,17322,11745,3360
2022-04-24 05:00:00+00,3659,0,5597,11599,228,1280,513,166,79,0,23121,76,18016,17503,11906,3659
2022-04-24 05:30:00+00,3910,0,5631,11667,241,1304,496,159,402,0,23810,78,18437,17941,12310,3910
2022-04-24 06:00:00+00,3424,0,5640,11728,319,2194,488,171,847,0,24811,71,19022,18534,12894,3424
2022-04-24 06:30:00+00,3370,0,5652,11614,274,2272,476,147,1418,0,25223,69,19434,18958,13306,3370
2022-04-24 07:00:00+00,3449,0,5658,11575,280,2558,472,145,2186,0,26323,68,20171,19699,14041,3449
2022-04-24 07:30:00+00,3396,0,5667,11554,282,2590,468,144,3028,0,27129,65,20999,20531,14864,3396
2022-04-24 08:00:00+00,3069,0,5655,12122,297,2648,469,152,4021,0,28433,58,22564,22095,16440,3069
2022-04-24 08:30:00+00,2981,0,5572,12348,287,2656,467,153,4997,0,29461,55,23671,23204,17632,2981
2022-04-24 09:00:00+00,2812,0,5486,12630,249,2716,471,152,5906,0,30422,51,24742,24271,18785,2812
2022-04-24 09:30:00+00,2709,0,5458,12711,252,2714,468,152,6831,0,31295,48,25720,25252,19794,2709
2022-04-24 10:00:00+00,2958,0,5453,12688,162,2692,468,163,7367,0,31951,51,26138,25670,20217,2958
2022-04-24 10:30:00+00,2731,0,5457,12476,153,2688,468,164,7805,0,31942,48,26359,25891,20434,2731
2022-04-24 11:00:00+00,2699,0,5454,12710,135,2748,468,166,7870,0,32250,47,26637,26169,20715,2699
2022-04-24 11:30:00+00,2840,0,5454,12443,134,2764,476,171,7718,0,32000,49,26225,25749,20295,2840
2022-04-24 12:00:00+00,3026,0,5469,12272,117,2734,548,157,7509,0,31832,52,25915,25367,19898,3026
2022-04-24 12:30:00+00,3171,0,5542,12092,117,2736,483,162,7284,0,31587,54,25518,25035,19493,3171
2022-04-24 13:00:00+00,3772,0,5575,11646,117,2544,618,157,6797,0,31226,62,24753,24135,18560,3772
2022-04-24 13:30:00+00,4107,0,5578,11187,119,2554,691,158,6129,0,30523,68,23704,23013,17435,4107
2022-04-24 14:00:00+00,4975,0,5524,10563,132,2634,761,172,5766,0,30527,80,22746,21985,16461,4975
2022-04-24 14:30:00+00,5534,0,5458,10052,134,2638,750,168,5187,66,29987,88,21581,20831,15373,5534
2022-04-24 15:00:00+00,6201,0,5464,9820,148,3042,619,154,4728,140,30316,96,20779,20160,14696,6201
2022-04-24 15:30:00+00,6995,0,5464,9868,148,3070,703,166,4061,134,30609,106,20244,19541,14077,6995
2022-04-24 16:00:00+00,7887,0,5504,9708,457,3062,506,323,3456,208,31111,116,19631,19125,13621,7887
2022-04-24 16:30:00+00,9413,0,5585,9466,472,3030,473,341,2877,138,31795,132,18873,18400,12815,9413
2022-04-24 17:00:00+00,11235,0,5657,9398,506,2002,475,363,2143,230,32009,150,18179,17704,12047,11235
2022-04-24 17:30:00+00,11947,0,5672,9377,486,1938,473,294,1457,284,31928,159,17465,16992,11320,11947
2022-04-24 18:00:00+00,12517,0,5679,9449,489,1414,468,335,785,542,31678,166,16870,16402,10723,12517
2022-04-24 18:30:00+00,12382,0,5674,9492,481,1408,485,416,244,530,31112,168,16376,15891,10217,12382
2022-04-24 19:00:00+00,12370,0,5682,9503,489,1760,469,231,12,580,31096,166,16155,15686,10004,12370
2022-04-24 19:30:00+00,12339,0,5676,9613,436,1774,472,159,0,586,31055,165,16197,15725,10049,12339
2022-04-24 20:00:00+00,12622,0,5675,9486,359,1538,487,192,0,468,30827,169,16007,15520,9845,12622
2022-04-24 20:30:00+00,12083,0,5680,9331,337,1526,476,158,0,2,29593,169,15824,15348,9668,12083
2022-04-24 21:00:00+00,12709,0,5664,9025,227,590,478,226,0,172,29091,177,15394,14916,9252,12709
2022-04-24 21:30:00+00,12326,0,5584,8598,210,544,476,167,0,0,27905,179,14868,14392,8808,12326
2022-04-24 22:00:00+00,11809,0,5489,8033,188,174,493,173,0,114,26473,180,14203,13710,8221,11809
2022-04-24 22:30:00+00,11273,0,5465,7373,186,168,526,159,0,224,25374,179,13550,13024,7559,11273
2022-04-24 23:00:00+00,11132,0,5464,6780,116,12,502,160,0,0,24166,186,12862,12360,6896,11132
2022-04-24 23:30:00+00,11106,0,5462,6225,114,0,508,160,0,52,23627,190,12309,11801,6339,11106
2022-04-25 00:00:00+00,10853,0,5491,5816,98,267,468,187,0,0,23180,191,11873,11405,5914,10853
2022-04-25 00:30:00+00,10913,0,5563,5436,98,280,491,201,0,0,22982,194,11588,11097,5534,10913
2022-04-25 01:00:00+00,10736,0,5577,5442,98,188,496,196,0,0,22733,192,11613,11117,5540,10736
2022-04-25 01:30:00+00,10927,0,5579,5088,98,190,509,234,0,0,22625,197,11274,10765,5186,10927
2022-04-25 02:00:00+00,11011,0,5550,4926,98,168,547,220,0,0,22520,201,11121,10574,5024,11011
2022-04-25 02:30:00+00,11059,0,5474,4522,98,166,585,253,0,0,22157,206,10679,10094,4620,11059
2022-04-25 03:00:00+00,11423,0,5476,4461,247,357,669,243,0,0,22876,207,10853,10184,4708,11423
2022-04-25 03:30:00+00,11613,11,5472,4278,297,411,670,239,0,0,22991,210,10716,10046,4574,11624
2022-04-25 04:00:00+00,12571,37,5470,4309,346,668,1038,268,0,598,25305,207,11163,10125,4655,12608
2022-04-25 04:30:00+00,13605,133,5469,4276,374,664,1428,240,0,24,26213,219,11547,10119,4650,13738
2022-04-25 05:00:00+00,14525,284,5496,4214,535,794,1605,352,89,428,28322,224,11939,10334,4838,14809
2022-04-25 05:30:00+00,15922,433,5609,4210,549,844,1761,416,457,560,30761,230,12586,10825,5216,16355
2022-04-25 06:00:00+00,16993,500,5676,4197,533,722,1941,548,923,338,32371,234,13270,11329,5653,17493
2022-04-25 06:30:00+00,17298,498,5678,4232,390,694,2050,752,1583,910,34085,228,13933,11883,6205,17796
2022-04-25 07:00:00+00,17241,499,5679,4255,325,1282,2087,663,2129,308,34468,228,14475,12388,6709,17740
2022-04-25 07:30:00+00,17223,497,5681,4316,321,1322,2127,624,2857,236,35204,223,15302,13175,7494,17720
2022-04-25 08:00:00+00,17291,498,5674,4312,305,1280,2128,620,3697,646,36451,216,16116,13988,8314,17789
2022-04-25 08:30:00+00,17386,499,5678,4301,306,1278,2153,502,4128,514,36745,215,16566,14413,8735,17885
2022-04-25 09:00:00+00,17554,499,5671,4264,224,1166,2417,486,4346,662,37289,215,16922,14505,8834,18053
2022-04-25 09:30:00+00,17371,500,5673,4173,210,1150,2586,508,4922,506,37599,212,17564,14978,9305,17871
2022-04-25 10:00:00+00,17355,501,5685,4161,141,974,2621,469,5058,370,37335,212,17666,15045,9360,17856
2022-04-25 10:30:00+00,17328,501,5669,4218,141,954,2659,395,5793,242,37900,208,18480,15821,10152,17829
2022-04-25 11:00:00+00,17056,434,5587,4217,140,862,2649,368,6053,174,37540,204,18646,15997,10410,17490
2022-04-25 11:30:00+00,16983,367,5492,4304,139,846,2610,414,5740,0,36895,206,18285,15675,10183,17350
2022-04-25 12:00:00+00,16720,233,5457,4417,121,462,2515,282,5826,0,36033,202,18336,15821,10364,16953
2022-04-25 12:30:00+00,16765,229,5463,4561,121,447,2511,252,5732,170,36251,201,18388,15877,10414,16994
2022-04-25 13:00:00+00,17090,237,5463,4542,121,179,2645,251,5253,16,35796,205,18024,15379,9916,17327
2022-04-25 13:30:00+00,17127,231,5522,4405,121,178,2639,212,5002,0,35437,207,17689,15050,9528,17358
2022-04-25 14:00:00+00,16876,230,5622,4449,138,184,2619,216,4326,0,34660,209,17154,14535,8913,17106
2022-04-25 14:30:00+00,16965,228,5669,4454,141,196,2680,224,3885,56,34498,211,16829,14149,8480,17193
2022-04-25 15:00:00+00,16519,230,5679,4619,171,1198,2745,201,3294,0,34656,209,16508,13763,8084,16749
2022-04-25 15:30:00+00,16887,230,5680,4744,215,1280,2654,348,3264,316,35618,208,16557,13903,8223,17117
2022-04-25 16:00:00+00,16878,231,5676,4871,316,1830,2409,425,2853,514,36003,208,16125,13716,8040,17109
2022-04-25 16:30:00+00,17031,231,5681,4903,483,1862,2360,506,2256,1016,36329,209,15683,13323,7642,17262
2022-04-25 17:00:00+00,17738,231,5674,4822,535,1368,2359,528,1776,1144,36175,213,15166,12807,7133,17969
2022-04-25 17:30:00+00,17891,230,5672,4634,509,1370,2473,476,1259,1138,35652,218,14547,12074,6402,18121
2022-04-25 18:00:00+00,18564,233,5673,4445,518,1031,2737,581,696,1254,35732,226,14069,11332,5659,18797
2022-04-25 18:30:00+00,18596,240,5676,4225,521,959,2744,679,194,1196,35031,232,13360,10616,4940,18836
2022-04-25 19:00:00+00,18589,229,5680,4182,501,1024,2657,545,10,1078,34495,234,13030,10373,4693,18818
2022-04-25 19:30:00+00,18621,251,5718,4339,477,1010,2569,483,0,1096,34564,233,13103,10534,4816,18872
2022-04-25 20:00:00+00,18627,285,5762,4478,437,978,2569,475,0,682,34293,238,13246,10677,4915,18912
2022-04-25 20:30:00+00,18450,234,5758,4516,406,958,2410,244,0,18,32994,241,13090,10680,4922,18684
2022-04-25 21:00:00+00,18558,228,5761,4454,230,649,2497,197,0,334,32908,242,12942,10445,4684,18786
2022-04-25 21:30:00+00,18253,0,5760,4438,197,517,2103,163,0,0,31431,240,12498,10395,4635,18253
2022-04-25 22:00:00+00,17880,0,5761,4324,173,26,1872,163,0,104,30303,242,12130,10258,4497,17880
2022-04-25 22:30:00+00,17993,0,5760,4055,162,0,1587,156,0,0,29713,247,11564,9977,4217,17993
2022-04-25 23:00:00+00,17913,0,5760,3961,127,0,1541,156,0,0,29458,247,11389,9848,4088,17913
2022-04-25 23:30:00+00,16969,0,5762,3884,106,0,1537,156,0,0,28414,243,11289,9752,3990,16969
2022-04-26 00:00:00+00,16975,0,5763,3810,103,0,1547,151,0,0,28349,244,11223,9676,3913,16975
2022-04-26 00:30:00+00,17811,0,5761,3626,87,0,1589,163,0,0,29037,250,11063,9474,3713,17811
2022-04-26 01:00:00+00,18073,0,5765,3414,84,0,1575,165,0,0,29076,253,10838,9263,3498,18073
2022-04-26 01:30:00+00,18072,0,5760,3439,84,0,1554,154,0,0,29063,253,10837,9283,3523,18072
2022-04-26 02:00:00+00,17945,0,5759,3343,84,0,1552,159,0,0,28842,253,10738,9186,3427,17945
2022-04-26 02:30:00+00,17924,0,5760,3270,84,0,1575,152,0,0,28765,254,10689,9114,3354,17924
2022-04-26 03:00:00+00,17940,0,5764,3236,84,0,1663,162,0,0,28849,254,10747,9084,3320,17940
2022-04-26 03:30:00+00,18029,0,5764,3411,84,0,1606,159,0,0,29053,253,10865,9259,3495,18029
2022-04-26 04:00:00+00,17613,0,5769,3673,98,0,1539,151,0,0,28843,249,11079,9540,3771,17613
2022-04-26 04:30:00+00,18140,0,5766,3738,100,0,1575,163,0,0,29482,251,11179,9604,3838,18140
2022-04-26 05:00:00+00,18720,15,5764,3717,195,0,1630,206,129,0,30376,252,11435,9805,4041,18735
2022-04-26 05:30:00+00,19027,203,5764,3864,257,100,2239,366,568,202,32590,249,12692,10453,4689,19230
2022-04-26 06:00:00+00,19217,317,5758,3643,378,464,2618,636,1191,834,35056,240,13588,10970,5212,19534
2022-04-26 06:30:00+00,19802,361,5760,3300,411,448,2666,882,1932,714,36276,243,14069,11403,5643,20163
2022-04-26 07:00:00+00,19598,241,5766,3113,410,826,2751,803,2748,64,36320,238,14788,12037,6271,19839
2022-04-26 07:30:00+00,19421,235,5758,2922,409,886,2793,615,3802,32,36873,232,15684,12891,7133,19656
2022-04-26 08:00:00+00,19389,240,5759,2787,383,1134,2747,395,4863,52,37749,229,16539,13792,8033,19629
2022-04-26 08:30:00+00,18857,231,5767,2876,325,1104,2773,315,5833,0,38081,221,17574,14801,9034,19088
2022-04-26 09:00:00+00,18680,230,5759,2958,232,280,2779,234,6894,0,38046,213,18622,15843,10084,18910
2022-04-26 09:30:00+00,18344,234,5756,3063,196,224,2620,182,7642,0,38261,208,19277,16657,10901,18578
2022-04-26 10:00:00+00,18793,236,5754,2862,156,0,2499,180,8077,64,38621,208,19348,16849,11095,19029
2022-04-26 10:30:00+00,18815,235,5758,2785,155,0,2267,173,8203,0,38391,208,19168,16901,11143,19050
2022-04-26 11:00:00+00,19034,242,5753,2698,139,0,2109,169,7859,140,38143,212,18558,16449,10696,19276
2022-04-26 11:30:00+00,19073,242,5761,2849,141,0,2070,179,7453,0,37768,214,18274,16204,10443,19315
2022-04-26 12:00:00+00,19395,240,5759,2730,141,0,2075,195,6759,32,37326,221,17464,15389,9630,19635
2022-04-26 12:30:00+00,19460,239,5759,2521,138,0,2191,201,6300,38,36847,225,16909,14718,8959,19699
2022-04-26 13:00:00+00,19529,236,5760,2534,131,0,2268,204,5504,110,36276,229,16197,13929,8169,19765
2022-04-26 13:30:00+00,19450,228,5760,2615,158,0,2332,295,5029,0,35867,232,15894,13562,7802,19678
2022-04-26 14:00:00+00,19199,231,5758,2885,140,0,2313,200,4517,0,35243,232,15613,13300,7542,19430
2022-04-26 14:30:00+00,19182,230,5756,3207,143,34,2322,325,4228,334,35761,229,15656,13334,7578,19412
2022-04-26 15:00:00+00,18975,229,5756,3264,156,884,2115,341,3761,0,35481,233,15052,12937,7181,19204
2022-04-26 15:30:00+00,19291,231,5758,3170,160,998,2432,540,3077,218,35875,238,14597,12165,6407,19522
2022-04-26 16:00:00+00,19614,230,5763,3219,362,884,2455,628,2633,732,36520,234,14432,11977,6214,19844
2022-04-26 16:30:00+00,19633,229,5761,3305,390,878,2538,660,2071,850,36315,237,14065,11527,5766,19862
2022-04-26 17:00:00+00,19631,230,5760,3396,466,694,2552,714,1693,1122,36258,235,13866,11314,5554,19861
2022-04-26 17:30:00+00,19894,229,5755,3410,480,716,2474,679,1075,1392,36104,239,13194,10720,4965,20123
2022-04-26 18:00:00+00,19767,230,5754,3391,488,816,2509,682,568,1186,35391,244,12710,10201,4447,19997
2022-04-26 18:30:00+00,19785,230,5760,3335,438,740,2749,684,168,1020,34909,248,12450,9701,3941,20015
2022-04-26 19:00:00+00,19786,233,5752,3353,391,708,2772,693,13,1090,34791,249,12281,9509,3757,20019
2022-04-26 19:30:00+00,19499,230,5762,3795,387,672,2776,639,0,842,34602,245,12720,9944,4182,19729
2022-04-26 20:00:00+00,19899,231,5765,4171,460,472,2777,665,0,650,35090,247,13173,10396,4631,20130
2022-04-26 20:30:00+00,19376,253,5769,4189,355,410,2777,533,0,90,33752,248,13090,10313,4544,19629
2022-04-26 21:00:00+00,18907,145,5766,4323,220,34,2619,323,0,34,32371,247,12928,10309,4543,19052
2022-04-26 21:30:00+00,18668,0,5773,4226,218,0,1995,211,0,12,31103,246,12212,10217,4444,18668
2022-04-26 22:00:00+00,17999,0,5779,3955,167,0,1773,184,0,0,29857,247,11674,9901,4122,17999
2022-04-26 22:30:00+00,17708,0,5785,3806,155,0,2192,169,0,0,29815,245,11938,9746,3961,17708
2022-04-26 23:00:00+00,17568,0,5787,3625,137,0,2231,153,0,0,29501,245,11780,9549,3762,17568
2022-04-26 23:30:00+00,17209,0,5792,3539,136,0,2103,159,0,0,28938,245,11570,9467,3675,17209
2022-04-27 00:00:00+00,17027,0,5794,3518,136,0,1969,159,0,0,28603,244,11417,9448,3654,17027
2022-04-27 00:30:00+00,17474,0,5791,3320,136,0,1667,180,0,0,28568,250,10914,9247,3456,17474
2022-04-27 01:00:00+00,17679,0,5797,2973,117,0,1794,168,0,0,28528,253,10681,8887,3090,17679
2022-04-27 01:30:00+00,17540,0,5798,2593,117,0,2062,156,0,0,28266,255,10570,8508,2710,17540
2022-04-27 02:00:00+00,17331,0,5798,2496,117,0,2162,159,0,0,28063,254,10573,8411,2613,17331
2022-04-27 02:30:00+00,17302,0,5795,2553,117,0,2048,152,0,0,27967,254,10513,8465,2670,17302
2022-04-27 03:00:00+00,17661,0,5798,2623,117,0,1630,153,0,0,27982,257,10168,8538,2740,17661
2022-04-27 03:30:00+00,17849,0,5801,2640,117,0,1591,154,0,0,28152,258,10149,8558,2757,17849
2022-04-27 04:00:00+00,17904,0,5804,2526,117,0,1699,151,0,0,28201,259,10146,8447,2643,17904
2022-04-27 04:30:00+00,17890,0,5807,2500,116,24,1799,153,0,0,28289,259,10222,8423,2616,17890
2022-04-27 05:00:00+00,18489,0,5806,2518,231,174,2208,159,66,0,29651,259,10829,8621,2815,18489
2022-04-27 05:30:00+00,19581,0,5807,2493,280,292,2437,312,330,152,31684,260,11347,8910,3103,19581
2022-04-27 06:00:00+00,19482,0,5808,2450,412,494,2452,537,714,912,33261,247,11836,9384,3576,19482
2022-04-27 06:30:00+00,19759,0,5806,2502,430,400,2531,773,1188,1314,34703,241,12457,9926,4120,19759
2022-04-27 07:00:00+00,19718,0,5806,2549,399,840,2785,635,1715,572,35019,241,13254,10469,4663,19718
2022-04-27 07:30:00+00,19745,0,5801,2509,401,884,2806,553,2218,646,35563,237,13735,10929,5128,19745
2022-04-27 08:00:00+00,19579,0,5802,2518,449,1668,2803,601,2622,508,36550,236,14194,11391,5589,19579
2022-04-27 08:30:00+00,19558,0,5802,2506,466,1698,2751,562,2896,226,36465,236,14421,11670,5868,19558
2022-04-27 09:00:00+00,19371,0,5800,2409,286,2375,2654,251,3087,412,36645,233,14236,11582,5782,19371
2022-04-27 09:30:00+00,19315,0,5801,2520,293,2411,2803,320,3256,494,37213,230,14673,11870,6069,19315
2022-04-27 10:00:00+00,19136,0,5802,2514,285,2172,2800,394,3481,382,36965,227,14882,12082,6280,19136
2022-04-27 10:30:00+00,19118,0,5802,2504,295,2181,2774,446,3686,148,36954,227,15061,12287,6485,19118
2022-04-27 11:00:00+00,19234,0,5808,2490,210,2983,2759,265,3877,18,37645,227,15144,12385,6577,19234
2022-04-27 11:30:00+00,19218,0,5809,2437,157,2995,2803,154,4207,0,37780,225,15413,12610,6801,19218
2022-04-27 12:00:00+00,19209,0,5803,2528,147,2351,2797,156,4560,82,37633,226,15835,13038,7235,19209
2022-04-27 12:30:00+00,18854,0,5812,2629,146,2307,2795,155,4604,0,37301,224,15986,13191,7379,18854
2022-04-27 13:00:00+00,18950,0,5808,2774,130,1373,2792,233,4506,36,36601,226,16010,13218,7410,18950
2022-04-27 13:30:00+00,18627,0,5808,2985,131,1354,2709,181,4287,0,36082,225,15920,13211,7403,18627
2022-04-27 14:00:00+00,18605,0,5805,3227,142,1345,2583,159,4017,0,35883,226,15774,13191,7386,18605
2022-04-27 14:30:00+00,18992,0,5808,3257,142,1362,2644,165,3708,0,36078,230,15559,12915,7107,18992
2022-04-27 15:00:00+00,19555,0,5776,3433,162,1466,2790,163,3205,0,36550,231,15366,12576,6800,19555
2022-04-27 15:30:00+00,19546,0,5774,3556,244,1516,2799,615,2797,0,36847,233,15170,12371,6597,19546
2022-04-27 16:00:00+00,19723,0,5803,3663,310,1370,2803,665,2462,170,36969,233,15041,12238,6435,19723
2022-04-27 16:30:00+00,19687,0,5808,3710,322,1354,2805,648,2020,810,37164,231,14665,11860,6052,19687
2022-04-27 17:00:00+00,19759,0,5812,3625,449,1076,2806,723,1446,1394,37090,229,14138,11332,5520,19759
2022-04-27 17:30:00+00,19809,0,5813,3667,447,1052,2804,858,886,1164,36500,234,13617,10813,5000,19809
2022-04-27 18:00:00+00,19744,0,5811,3637,447,873,2810,784,459,1484,36049,234,13164,10354,4543,19744
2022-04-27 18:30:00+00,19738,0,5807,3511,448,694,2811,788,158,1302,35257,237,12735,9924,4117,19738
2022-04-27 19:00:00+00,19768,0,5810,3598,437,694,2813,750,14,902,34786,240,12672,9859,4049,19768
2022-04-27 19:30:00+00,19696,0,5807,3722,423,694,2805,727,0,732,34606,240,12757,9952,4145,19696
2022-04-27 20:00:00+00,19393,0,5808,3958,301,848,2731,660,0,388,34087,242,12798,10067,4259,19393
2022-04-27 20:30:00+00,18804,0,5802,3851,285,848,2579,534,0,40,32743,243,12517,9938,4136,18804
2022-04-27 21:00:00+00,19413,0,5810,3877,172,694,2611,316,0,130,33023,244,12470,9859,4049,19413
2022-04-27 21:30:00+00,18475,0,5810,3876,158,656,2114,167,0,0,31256,243,11958,9844,4034,18475
2022-04-27 22:00:00+00,17715,0,5805,3721,157,282,2343,155,0,0,30178,242,12026,9683,3878,17715
2022-04-27 22:30:00+00,17700,0,5806,3543,154,206,2306,151,0,0,29866,244,11809,9503,3697,17700
2022-04-27 23:00:00+00,17833,0,5812,3425,118,0,2384,154,0,0,29726,248,11739,9355,3543,17833
2022-04-27 23:30:00+00,17706,0,5808,3357,117,0,2337,164,0,0,29489,248,11619,9282,3474,17706
2022-04-28 00:00:00+00,17486,0,5792,3338,117,0,2275,172,0,0,29180,247,11522,9247,3455,17486
2022-04-28 00:30:00+00,17369,0,5805,3217,116,0,2457,176,0,0,29140,247,11595,9138,3333,17369
2022-04-28 01:00:00+00,17091,0,5804,3243,101,0,2453,159,0,0,28851,245,11601,9148,3344,17091
2022-04-28 01:30:00+00,16688,0,5810,3217,101,0,2412,164,0,0,28392,244,11540,9128,3318,16688
2022-04-28 02:00:00+00,16416,0,5802,3068,101,0,2463,159,0,0,28009,243,11434,8971,3169,16416
2022-04-28 02:30:00+00,16185,0,5801,2873,101,0,2478,163,0,0,27601,244,11253,8775,2974,16185
2022-04-28 03:00:00+00,15966,0,5799,2624,101,0,2473,159,0,0,27122,245,10997,8524,2725,15966
2022-04-28 03:30:00+00,15655,0,5801,2394,103,0,2468,158,0,0,26578,245,10766,8298,2497,15655
2022-04-28 04:00:00+00,15619,0,5808,2221,118,0,2486,153,0,0,26405,246,10633,8147,2339,15619
2022-04-28 04:30:00+00,15635,0,5806,1948,121,92,2539,158,3,0,26302,249,10417,7878,2072,15635
2022-04-28 05:00:00+00,16104,53,5810,1788,213,426,2130,198,100,0,26822,254,10041,7911,2101,16157
2022-04-28 05:30:00+00,16737,231,5806,1717,278,426,2031,477,355,52,28110,259,10187,8156,2350,16968
2022-04-28 06:00:00+00,17790,435,5806,1758,416,830,2006,737,739,658,31175,255,10725,8719,2913,18225
2022-04-28 06:30:00+00,18686,500,5806,1705,420,897,1877,949,1203,1188,33231,254,11011,9134,3328,19186
2022-04-28 07:00:00+00,19459,500,5809,1616,416,2044,2146,864,1568,1028,35451,254,11555,9409,3600,19959
2022-04-28 07:30:00+00,19796,500,5814,1662,433,2086,2553,892,1941,476,36153,254,12402,9850,4036,20296
2022-04-28 08:00:00+00,19953,499,5805,1704,416,2924,2265,489,2352,400,36807,252,12542,10277,4472,20452
2022-04-28 08:30:00+00,19970,501,5807,1718,388,2938,2092,437,2565,372,36788,251,12570,10478,4671,20471
2022-04-28 09:00:00+00,19924,498,5804,1598,293,2732,2092,685,2874,340,36840,252,12661,10569,4765,20422
2022-04-28 09:30:00+00,19765,498,5806,1573,250,2732,2083,646,3218,256,36828,250,12930,10847,5041,20263
2022-04-28 10:00:00+00,19616,498,5799,1637,208,2722,2085,382,3677,282,36905,246,13406,11321,5522,20114
2022-04-28 10:30:00+00,19436,499,5806,1628,227,2722,2113,421,4063,34,36949,244,13837,11724,5918,19935
2022-04-28 11:00:00+00,19794,500,5801,1501,228,2850,2056,344,4344,180,37598,242,13930,11874,6073,20294
2022-04-28 11:30:00+00,19741,498,5807,1451,228,2860,2150,323,4595,4,37657,241,14231,12081,6274,20239
2022-04-28 12:00:00+00,19781,442,5805,1523,203,1886,2351,278,4754,126,37149,240,14636,12285,6480,20223
2022-04-28 12:30:00+00,19627,418,5810,1506,135,1860,2536,200,4842,0,36934,239,14829,12293,6483,20045
2022-04-28 13:00:00+00,19827,360,5805,1567,111,1716,2278,166,4509,76,36415,242,14270,11992,6187,20187
2022-04-28 13:30:00+00,19770,234,5813,1721,111,1710,2346,158,4125,0,35988,241,14116,11770,5957,20004
2022-04-28 14:00:00+00,19734,236,5811,1775,117,1128,2640,156,3987,32,35616,239,14330,11690,5879,19970
2022-04-28 14:30:00+00,19849,333,5812,1856,124,1158,2654,215,3826,30,35857,242,14272,11618,5806,20182
2022-04-28 15:00:00+00,19648,469,5804,1814,144,1966,2433,272,3192,116,35858,247,13387,10954,5150,20117
2022-04-28 15:30:00+00,20095,498,5806,1823,139,1982,2571,536,2720,70,36240,253,13059,10488,4682,20593
2022-04-28 16:00:00+00,20476,496,5803,1800,249,1588,2736,834,2423,352,36757,256,13011,10275,4472,20972
2022-04-28 16:30:00+00,20487,477,5799,1812,272,1578,2790,904,1899,566,36584,257,12572,9782,3983,20964
2022-04-28 17:00:00+00,20599,498,5804,1915,361,808,2827,1022,1268,932,36034,256,12175,9348,3544,21097
2022-04-28 17:30:00+00,20602,500,5800,1856,364,794,2831,1044,889,1034,35714,259,11740,8909,3109,21102
2022-04-28 18:00:00+00,20516,487,5808,1834,415,694,2754,1165,529,1170,35372,261,11340,8586,2778,21003
2022-04-28 18:30:00+00,20446,448,5801,1774,403,694,2600,1159,209,1250,34784,263,10787,8187,2386,20894
2022-04-28 19:00:00+00,20342,477,5805,1671,388,886,2777,1119,18,1220,34703,265,10659,7882,2077,20819
2022-04-28 19:30:00+00,20297,497,5804,1661,404,866,2826,1093,0,1080,34528,267,10695,7869,2065,20794
2022-04-28 20:00:00+00,20054,497,5808,1713,395,694,2796,1060,0,634,33651,268,10712,7916,2108,20551
2022-04-28 20:30:00+00,19834,461,5809,1781,314,694,2675,512,0,612,32692,267,10579,7904,2095,20295
2022-04-28 21:00:00+00,19862,490,5807,1768,248,694,2770,279,0,450,32368,269,10593,7823,2016,20352
2022-04-28 21:30:00+00,19577,395,5803,1804,248,682,2609,182,0,62,31362,270,10464,7855,2052,19972
2022-04-28 22:00:00+00,19707,203,5808,1800,245,328,2215,147,0,190,30643,270,10068,7853,2045,19910
2022-04-28 22:30:00+00,19509,0,5799,1678,238,250,2158,138,0,0,29770,269,9873,7715,1916,19509
2022-04-28 23:00:00+00,19654,0,5804,1592,150,16,2182,116,0,0,29514,273,9728,7546,1742,19654
2022-04-28 23:30:00+00,19570,0,5799,1475,132,76,2189,119,0,0,29360,274,9595,7406,1607,19570
2022-04-29 00:00:00+00,19539,0,5785,1428,118,132,2176,114,0,0,29292,275,9507,7331,1546,19539
2022-04-29 00:30:00+00,19594,0,5759,1316,118,228,2131,124,0,0,29270,277,9324,7193,1434,19594
2022-04-29 01:00:00+00,19515,0,5774,1246,118,272,2128,112,0,0,29165,278,9266,7138,1364,19515
2022-04-29 01:30:00+00,19318,0,5791,1284,118,196,2170,113,0,0,28990,276,9363,7193,1402,19318
2022-04-29 02:00:00+00,19291,0,5805,1378,118,222,2170,112,0,0,29096,275,9471,7301,1496,19291
2022-04-29 02:30:00+00,19455,0,5805,1417,118,202,2105,111,0,0,29214,275,9445,7340,1535,19455
2022-04-29 03:00:00+00,19384,0,5803,1551,118,208,2077,110,0,0,29251,274,9549,7472,1669,19384
2022-04-29 03:30:00+00,19360,0,5801,1506,118,228,1966,115,0,0,29094,275,9391,7425,1624,19360
2022-04-29 04:00:00+00,19299,1,5798,1492,122,100,2034,115,0,0,28961,274,9446,7412,1614,19300
2022-04-29 04:30:00+00,18977,190,5803,1686,140,212,1967,164,3,0,29142,276,9599,7632,1829,19167
2022-04-29 05:00:00+00,19058,232,5807,1697,215,270,2048,229,137,22,29716,275,9904,7856,2049,19290
2022-04-29 05:30:00+00,19642,236,5803,1721,246,220,1877,467,541,666,31420,268,10188,8311,2508,19878
2022-04-29 06:00:00+00,20209,246,5806,1649,330,234,2066,730,1219,666,33155,262,11070,9004,3198,20455
2022-04-29 06:30:00+00,20319,299,5808,1601,339,186,2146,965,1924,1224,34812,254,11818,9672,3864,20618
2022-04-29 07:00:00+00,19998,248,5802,1448,319,1172,2001,870,2651,548,35057,251,12221,10220,4418,20246
2022-04-29 07:30:00+00,20400,335,5807,1457,336,1246,2024,751,3380,296,36033,251,13004,10980,5173,20735
2022-04-29 08:00:00+00,20449,386,5806,1499,322,1357,2122,706,3957,266,36869,248,13706,11584,5778,20835
2022-04-29 08:30:00+00,20352,350,5809,1459,304,1337,2114,637,4454,4,36820,246,14140,12026,6217,20702
2022-04-29 09:00:00+00,20377,330,5807,1590,230,1057,2109,605,4944,20,37068,243,14680,12571,6764,20707
2022-04-29 09:30:00+00,20330,238,5804,1767,217,1009,2119,338,5298,134,37254,237,15205,13086,7282,20568
2022-04-29 10:00:00+00,20328,232,5809,1896,180,895,2108,224,5815,0,37487,235,15808,13700,7891,20560
2022-04-29 10:30:00+00,20121,236,5804,1932,181,891,2109,202,6260,0,37736,231,16286,14177,8373,20357
2022-04-29 11:00:00+00,19842,234,5804,1999,162,859,2114,143,6627,0,37783,227,16706,14592,8788,20076
2022-04-29 11:30:00+00,19387,232,5797,2021,145,860,2110,117,6685,0,37354,224,16758,14648,8851,19619
2022-04-29 12:00:00+00,19948,150,5802,2120,143,146,1951,118,6805,0,37183,223,16821,14870,9068,20098
2022-04-29 12:30:00+00,19670,75,5798,2199,143,144,1720,122,6913,202,36986,218,16773,15053,9255,19745
2022-04-29 13:00:00+00,19997,0,5806,2212,128,0,1745,293,6687,10,36878,222,16578,14833,9027,19997
2022-04-29 13:30:00+00,19945,0,5801,2291,127,0,1729,155,6265,0,36313,223,16213,14484,8683,19945
2022-04-29 14:00:00+00,20148,0,5805,2341,144,0,1679,135,5980,0,36232,226,15949,14270,8465,20148
2022-04-29 14:30:00+00,20367,0,5803,2281,149,0,1620,148,5525,4,35897,230,15378,13758,7955,20367
2022-04-29 15:00:00+00,20633,0,5813,2178,208,198,1507,168,4872,8,35585,235,14578,13071,7258,20633
2022-04-29 15:30:00+00,20927,0,5810,2079,224,280,1812,284,4180,0,35596,240,14105,12293,6483,20927
2022-04-29 16:00:00+00,20900,0,5803,2099,281,648,1990,534,3569,256,36080,239,13742,11752,5949,20900
2022-04-29 16:30:00+00,21041,0,5803,2065,306,694,1956,741,2721,648,35975,243,12851,10895,5092,21041
2022-04-29 17:00:00+00,21155,0,5797,2050,436,694,1944,894,2036,1150,36156,245,12263,10319,4522,21155
2022-04-29 17:30:00+00,21255,0,5794,2118,448,694,1959,806,1360,1530,35964,247,11679,9720,3926,21255
2022-04-29 18:00:00+00,21205,0,5797,2153,363,694,1945,793,785,1216,34951,253,11043,9098,3301,21205
2022-04-29 18:30:00+00,21125,0,5799,2290,361,694,1879,728,263,1108,34247,257,10592,8713,2914,21125
2022-04-29 19:00:00+00,21216,0,5794,2405,361,694,1881,700,30,950,34031,259,10471,8590,2796,21216
2022-04-29 19:30:00+00,21238,0,5802,2573,359,694,1866,688,0,928,34148,258,10600,8734,2932,21238
2022-04-29 20:00:00+00,20766,0,5793,2702,300,694,1859,477,0,52,32643,263,10654,8795,3002,20766
2022-04-29 20:30:00+00,20354,0,5795,2556,266,658,1804,354,0,28,31815,263,10421,8617,2822,20354
2022-04-29 21:00:00+00,20248,0,5794,2462,158,314,1950,213,0,40,31179,266,10364,8414,2620,20248
2022-04-29 21:30:00+00,19358,0,5798,2394,160,248,1714,129,0,0,29801,265,10066,8352,2554,19358
2022-04-29 22:00:00+00,19243,0,5796,2311,139,90,1769,198,0,86,29632,267,10015,8246,2450,19243
2022-04-29 22:30:00+00,18636,0,5799,2273,134,170,1626,123,0,0,28761,266,9832,8206,2407,18636
2022-04-29 23:00:00+00,18746,0,5798,2185,122,170,1645,115,0,0,28781,267,9750,8105,2307,18746
2022-04-29 23:30:00+00,18854,0,5801,2191,122,220,1841,110,0,0,29139,267,9955,8114,2313,18854
2022-04-30 00:00:00+00,19179,0,5799,2245,122,220,2056,119,0,0,29740,267,10222,8166,2367,19179
2022-04-30 00:30:00+00,19184,0,5803,2169,103,296,2100,124,0,0,29779,268,10175,8075,2272,19184
2022-04-30 01:00:00+00,18930,0,5803,2108,103,374,2097,113,0,0,29528,268,10111,8014,2211,18930
2022-04-30 01:30:00+00,18974,0,5804,2088,103,232,2102,123,0,0,29426,268,10097,7995,2191,18974
2022-04-30 02:00:00+00,18809,0,5812,2173,103,212,2027,113,0,0,29249,266,10115,8088,2276,18809
2022-04-30 02:30:00+00,18789,0,5803,2246,104,140,1679,118,0,0,28879,267,9832,8153,2350,18789
2022-04-30 03:00:00+00,18715,0,5808,2311,103,288,1401,112,0,0,28738,268,9623,8222,2414,18715
2022-04-30 03:30:00+00,18472,0,5807,2418,103,282,1411,111,0,0,28604,266,9739,8328,2521,18472
2022-04-30 04:00:00+00,18453,0,5803,2470,138,256,1504,113,0,0,28737,265,9915,8411,2608,18453
2022-04-30 04:30:00+00,17637,0,5805,2568,141,314,1464,113,12,0,28054,260,9990,8526,2721,17637
2022-04-30 05:00:00+00,18517,0,5801,2517,182,252,1317,113,277,0,28976,262,10094,8777,2976,18517
2022-04-30 05:30:00+00,19287,0,5802,2470,218,370,1266,123,870,0,30406,262,10626,9360,3558,19287
2022-04-30 06:00:00+00,19561,0,5805,2389,283,328,1267,226,1626,0,31485,257,11370,10103,4298,19561
2022-04-30 06:30:00+00,19543,0,5803,2216,303,226,1320,325,2531,86,32353,249,12173,10853,5050,19543
2022-04-30 07:00:00+00,19416,0,5807,1958,337,68,1348,211,3435,336,32916,240,12885,11537,5730,19416
2022-04-30 07:30:00+00,19363,0,5807,1922,337,14,1347,208,4376,434,33808,232,13789,12442,6635,19363
2022-04-30 08:00:00+00,19370,0,5805,2096,337,0,1349,193,5269,476,34895,225,14856,13507,7702,19370
2022-04-30 08:30:00+00,19355,0,5806,2223,329,0,1343,170,6204,0,35430,222,15905,14562,8756,19355
2022-04-30 09:00:00+00,19165,0,5803,2305,270,0,1296,135,7102,18,36094,216,16776,15480,9677,19165
2022-04-30 09:30:00+00,18610,0,5803,2486,255,0,1108,114,7838,0,36214,207,17490,16382,10579,18610
2022-04-30 10:00:00+00,18233,0,5798,2688,196,0,805,124,8428,0,36272,202,17915,17110,11312,18233
2022-04-30 10:30:00+00,17848,0,5797,2801,192,0,810,127,8786,0,36361,197,18386,17576,11779,17848
2022-04-30 11:00:00+00,17689,0,5795,2809,141,0,809,125,8817,0,36185,196,18371,17562,11767,17689
2022-04-30 11:30:00+00,17478,0,5799,3020,140,0,787,115,8670,0,36009,195,18416,17629,11830,17478
2022-04-30 12:00:00+00,17059,0,5796,3266,140,0,804,121,8222,0,35408,194,18228,17424,11628,17059
2022-04-30 12:30:00+00,16725,0,5795,3528,140,0,789,116,7958,0,35051,192,18210,17421,11626,16725
2022-04-30 13:00:00+00,16460,0,5798,3834,127,0,779,114,7360,0,34472,192,17898,17120,11322,16460
2022-04-30 13:30:00+00,16189,0,5799,4081,124,66,788,114,6833,0,33994,192,17625,16837,11038,16189
2022-04-30 14:00:00+00,16413,0,5800,4106,124,136,784,120,6282,0,33765,197,17096,16312,10512,16413
2022-04-30 14:30:00+00,16739,0,5798,4267,128,218,783,123,5391,0,33447,204,16367,15584,9786,16739
2022-04-30 15:00:00+00,17321,0,5803,4352,216,326,804,143,4357,0,33322,213,15532,14728,8925,17321
2022-04-30 15:30:00+00,18759,0,5804,4229,220,402,811,147,3409,30,33811,228,14473,13662,7858,18759
2022-04-30 16:00:00+00,19008,0,5802,4243,293,402,970,140,2588,158,33604,233,13896,12926,7124,19008
2022-04-30 16:30:00+00,19133,0,5809,4344,298,402,1443,220,2129,102,33880,235,14023,12580,6771,19133
2022-04-30 17:00:00+00,19043,0,5807,4338,327,402,1612,303,1479,576,33887,235,13563,11951,6144,19043
2022-04-30 17:30:00+00,19017,0,5806,4371,341,402,1823,339,887,918,33904,236,13228,11405,5599,19017
2022-04-30 18:00:00+00,19046,0,5805,4619,355,402,1908,522,509,596,33762,239,13196,11288,5483,19046
2022-04-30 18:30:00+00,18956,0,5806,4893,349,402,1914,515,178,404,33417,241,13140,11226,5420,18956
2022-04-30 19:00:00+00,19233,0,5804,5031,349,402,1921,453,14,764,33971,239,13119,11198,5394,19233
2022-04-30 19:30:00+00,19217,0,5801,5197,350,402,2035,424,0,468,33894,240,13383,11348,5547,19217
2022-04-30 20:00:00+00,19240,0,5808,5462,313,402,2036,344,0,62,33667,241,13619,11583,5775,19240
2022-04-30 20:30:00+00,18727,0,5820,5614,268,402,1905,168,0,4,32908,238,13607,11702,5882,18727
2022-04-30 21:00:00+00,18595,0,5827,5435,200,402,1637,122,0,0,32218,240,13099,11462,5635,18595
2022-04-30 21:30:00+00,17973,0,5883,5493,199,402,1235,113,0,0,31298,238,12810,11575,5692,17973
2022-04-30 22:00:00+00,16559,0,5922,5580,182,402,1244,119,0,0,30008,230,12928,11684,5762,16559
2022-04-30 22:30:00+00,15855,0,5928,5355,179,342,1240,115,0,0,29014,227,12702,11462,5534,15855
2022-04-30 23:00:00+00,15778,0,5928,4936,157,398,1236,114,0,0,28547,231,12257,11021,5093,15778
2022-04-30 23:30:00+00,15834,0,5942,4792,154,384,1224,111,0,0,28441,232,12112,10888,4946,15834
2022-05-01 00:00:00+00,15741,0,5937,4650,140,402,1243,125,0,0,28238,233,11970,10727,4790,15741
2022-05-01 00:30:00+00,15919,0,5970,4443,140,402,1255,142,0,0,28271,235,11808,10553,4583,15919
2022-05-01 01:00:00+00,16060,0,6007,4178,126,402,1226,118,0,0,28117,238,11537,10311,4304,16060
2022-05-01 01:30:00+00,15821,0,6009,4039,121,402,1215,114,0,0,27721,238,11384,10169,4160,15821
2022-05-01 02:00:00+00,15669,0,5995,3848,119,394,1225,117,0,0,27367,239,11187,9962,3967,15669
2022-05-01 02:30:00+00,15664,0,5995,3551,118,388,1224,117,0,0,27057,241,10888,9664,3669,15664
2022-05-01 03:00:00+00,15662,0,6003,3356,121,376,1220,114,0,0,26852,243,10700,9480,3477,15662
2022-05-01 03:30:00+00,15634,0,6003,3210,125,274,1215,112,0,0,26573,243,10553,9338,3335,15634
2022-05-01 04:00:00+00,15745,0,6006,3154,155,220,1218,111,0,0,26609,244,10533,9315,3309,15745
2022-05-01 04:30:00+00,15476,0,6003,3106,156,342,1223,110,7,0,26423,244,10495,9272,3269,15476
2022-05-01 05:00:00+00,15876,0,5994,3030,210,262,1234,118,95,0,26819,245,10563,9329,3335,15876
2022-05-01 05:30:00+00,15938,0,5995,2928,219,346,1250,117,292,0,27085,245,10684,9434,3439,15938
2022-05-01 06:00:00+00,16420,0,5994,2891,231,270,1252,117,554,0,27729,244,10922,9670,3676,16420
2022-05-01 06:30:00+00,17185,0,5998,2829,235,350,1307,131,883,0,28918,246,11252,9945,3947,17185
2022-05-01 07:00:00+00,18148,0,5996,2750,299,274,1376,145,1244,74,30306,247,11665,10289,4293,18148
2022-05-01 07:30:00+00,18625,0,5996,2790,307,354,1545,187,1742,36,31582,245,12380,10835,4839,18625
2022-05-01 08:00:00+00,18619,0,5998,2881,307,280,1736,201,2322,146,32490,239,13244,11508,5510,18619
2022-05-01 08:30:00+00,18724,0,5997,2881,308,364,1883,178,2606,150,33091,238,13675,11792,5795,18724
2022-05-01 09:00:00+00,18484,0,6005,2614,296,272,1850,224,2891,102,32738,236,13656,11806,5801,18484
2022-05-01 09:30:00+00,18710,0,6000,2528,264,150,1902,175,3065,30,32824,236,13759,11857,5857,18710
2022-05-01 10:00:00+00,17645,0,5997,2529,182,590,1847,153,3237,62,32242,229,13792,11945,5948,17645
2022-05-01 10:30:00+00,17816,0,5998,2651,181,580,1904,121,3517,0,32768,226,14251,12347,6349,17816
2022-05-01 11:00:00+00,17984,0,6035,2766,145,460,1955,123,3156,0,32624,231,14057,12102,6067,17984
2022-05-01 11:30:00+00,18310,0,6048,2831,144,464,1718,131,3388,0,33034,231,14129,12411,6363,18310
2022-05-01 12:00:00+00,17438,0,6051,2580,143,454,1763,119,3078,228,31854,227,13615,11852,5801,17438
2022-05-01 12:30:00+00,17352,0,6053,2480,144,508,1783,116,2748,0,31184,231,13208,11425,5372,17352
2022-05-01 13:00:00+00,17529,0,6050,2411,129,278,1779,123,2589,0,30888,232,12958,11179,5129,17529
2022-05-01 13:30:00+00,17680,0,6057,2326,127,268,1705,121,2304,0,30588,236,12519,10814,4757,17680
2022-05-01 14:00:00+00,18413,0,6058,2085,126,68,1760,126,2182,0,30818,244,12211,10451,4393,18413
2022-05-01 14:30:00+00,18522,0,6059,1833,127,132,1860,135,2084,156,30908,246,11963,10103,4044,18522
2022-05-01 15:00:00+00,18911,0,6068,1719,196,190,1986,200,1835,0,31105,250,11804,9818,3750,18911
2022-05-01 15:30:00+00,19089,0,6065,1709,239,296,2007,223,1650,140,31418,252,11670,9663,3598,19089
2022-05-01 16:00:00+00,19018,0,6068,1566,291,238,2109,288,1318,462,31358,251,11352,9243,3175,19018
2022-05-01 16:30:00+00,19194,0,6067,1325,291,328,2118,334,988,742,31387,255,10789,8671,2604,19194
2022-05-01 17:00:00+00,19537,0,6068,1224,318,430,2119,516,677,1414,32303,256,10406,8287,2219,19537
2022-05-01 17:30:00+00,19579,0,6080,1070,330,422,2119,552,392,1616,32160,258,9991,7872,1792,19579
2022-05-01 18:00:00+00,19623,0,6080,989,330,586,2039,588,183,1840,32258,259,9621,7582,1502,19623
2022-05-01 18:30:00+00,19630,0,6078,964,329,528,2052,728,53,1342,31704,263,9476,7424,1346,19630
2022-05-01 19:00:00+00,19680,0,6080,918,330,298,2179,910,3,1544,31942,263,9510,7331,1251,19680
2022-05-01 19:30:00+00,19701,0,6080,858,314,214,2177,850,0,1400,31594,265,9429,7252,1172,19701
2022-05-01 20:00:00+00,19277,0,6083,851,285,104,2109,560,0,1328,30597,262,9328,7219,1136,19277
2022-05-01 20:30:00+00,19081,0,6079,856,279,78,1990,435,0,1080,29878,264,9204,7214,1135,19081
2022-05-01 21:00:00+00,19261,0,6085,890,251,14,2143,233,0,1204,30081,263,9369,7226,1141,19261
2022-05-01 21:30:00+00,19012,0,6075,1176,250,0,2144,231,0,206,29094,269,9645,7501,1426,19012
2022-05-01 22:00:00+00,18652,0,6070,1418,195,0,2027,226,0,356,28944,265,9710,7683,1613,18652
2022-05-01 22:30:00+00,18247,0,6084,1548,190,74,1696,187,0,4,28030,267,9518,7822,1738,18247
2022-05-01 23:00:00+00,18211,0,6076,1503,149,86,1511,176,0,0,27712,269,9239,7728,1652,18211
2022-05-01 23:30:00+00,17919,0,6079,1458,148,38,1605,193,0,0,27440,267,9290,7685,1606,17919
2022-05-02 00:00:00+00,18033,0,6077,1514,132,140,1361,123,0,0,27380,269,9084,7723,1646,18033
2022-05-02 00:30:00+00,17927,0,6080,1512,133,150,1254,133,0,0,27189,269,8979,7725,1645,17927
2022-05-02 01:00:00+00,18058,0,6076,1435,119,132,1271,141,0,0,27232,271,8901,7630,1554,18058
2022-05-02 01:30:00+00,18074,0,6082,1355,117,144,1254,132,0,0,27158,272,8808,7554,1472,18074
2022-05-02 02:00:00+00,18030,0,6104,1323,117,202,1249,117,0,0,27142,272,8793,7544,1440,18030
2022-05-02 02:30:00+00,17997,0,6139,1232,117,54,1265,124,0,0,26928,271,8753,7488,1349,17997
2022-05-02 03:00:00+00,17999,0,6142,1196,116,44,1265,117,0,0,26879,272,8719,7454,1312,17999
2022-05-02 03:30:00+00,18006,0,6144,1194,121,16,1253,114,0,0,26848,271,8712,7459,1315,18006
2022-05-02 04:00:00+00,18130,0,6146,1185,152,114,1273,121,0,0,27121,272,8756,7483,1337,18130
2022-05-02 04:30:00+00,18165,0,6143,1051,159,168,1298,136,2,0,27122,274,8653,7355,1212,18165
2022-05-02 05:00:00+00,18470,0,6146,960,221,300,1514,137,59,0,27807,275,8900,7386,1240,18470
2022-05-02 05:30:00+00,18851,0,6138,906,243,304,1788,174,243,0,28647,273,9318,7530,1392,18851
2022-05-02 06:00:00+00,19323,0,6140,866,257,252,1993,151,487,0,29469,272,9743,7750,1610,19323
2022-05-02 06:30:00+00,19573,0,6134,838,249,198,2029,241,751,0,30013,271,10001,7972,1838,19573
2022-05-02 07:00:00+00,19821,0,6136,831,322,74,2027,329,1090,214,30844,265,10406,8379,2243,19821
2022-05-02 07:30:00+00,19784,0,6138,859,370,140,2026,478,1570,260,31625,261,10963,8937,2799,19784
2022-05-02 08:00:00+00,19500,0,6137,887,354,38,2026,363,2283,322,31910,252,11687,9661,3524,19500
2022-05-02 08:30:00+00,19969,0,6147,891,399,0,2025,219,2549,304,32503,252,12011,9986,3839,19969
2022-05-02 09:00:00+00,19836,0,6139,951,298,98,1916,286,2894,492,32910,248,12198,10282,4143,19836
2022-05-02 09:30:00+00,19958,0,6151,1178,316,104,1981,276,3165,148,33277,248,12791,10810,4659,19958
2022-05-02 10:00:00+00,19837,0,6142,1210,216,366,2032,322,3474,146,33745,247,13074,11042,4900,19837
2022-05-02 10:30:00+00,19685,0,6173,1291,180,380,2031,313,3863,146,34062,243,13538,11507,5334,19685
2022-05-02 11:00:00+00,19531,0,6210,1236,143,874,2034,238,3975,114,34355,241,13598,11564,5354,19531
2022-05-02 11:30:00+00,19596,0,6237,1209,143,860,2026,283,3916,54,34324,243,13531,11505,5268,19596
2022-05-02 12:00:00+00,19554,0,6239,1202,142,226,2023,322,3610,258,33576,243,13216,11193,4954,19554
2022-05-02 12:30:00+00,19705,0,6232,1195,141,204,2024,254,3376,162,33293,245,12968,10944,4712,19705
2022-05-02 13:00:00+00,19550,0,6237,1258,129,336,2022,227,3291,238,33288,245,12937,10915,4678,19550
2022-05-02 13:30:00+00,19612,0,6233,1292,123,340,2023,216,2784,154,32777,250,12455,10432,4199,19612
2022-05-02 14:00:00+00,19713,0,6267,1322,122,0,2022,274,2121,28,31870,254,11854,9832,3566,19713
2022-05-02 14:30:00+00,19599,0,6304,1393,130,34,2023,603,1865,24,31975,255,11715,9692,3388,19599
2022-05-02 15:00:00+00,19566,0,6317,1480,198,512,2025,798,1598,174,32668,253,11618,9593,3276,19566
2022-05-02 15:30:00+00,19602,0,6352,1556,209,570,2033,909,1360,766,33357,249,11510,9477,3125,19602
2022-05-02 16:00:00+00,19573,0,6352,1536,267,1224,2132,923,1180,1138,34325,248,11467,9335,2983,19573
2022-05-02 16:30:00+00,19623,0,6343,1523,337,1306,2180,920,907,1414,34553,248,11290,9110,2767,19623
2022-05-02 17:00:00+00,19672,0,6346,1578,432,1020,2181,967,596,1912,34704,244,11133,8952,2606,19672
2022-05-02 17:30:00+00,19662,0,6345,1801,505,1076,2176,961,374,1530,34430,247,11201,9025,2680,19662
2022-05-02 18:00:00+00,19586,0,6346,1968,501,904,2179,1042,195,1506,34227,246,11189,9010,2664,19586
2022-05-02 18:30:00+00,19461,0,6340,2016,485,806,2178,949,66,1394,33695,246,11085,8907,2567,19461
2022-05-02 19:00:00+00,19283,0,6340,2140,323,800,2184,866,5,1234,33175,247,10992,8808,2468,19283
2022-05-02 19:30:00+00,19036,0,6340,2306,316,722,2184,703,0,1158,32765,245,11146,8962,2622,19036
2022-05-02 20:00:00+00,19250,0,6340,2508,302,280,2185,703,0,810,32378,250,11335,9150,2810,19250
2022-05-02 20:30:00+00,18846,0,6338,2633,290,206,2129,599,0,150,31191,252,11390,9261,2923,18846
2022-05-02 21:00:00+00,18723,0,6341,2573,270,0,2159,439,0,146,30651,253,11343,9184,2843,18723
2022-05-02 21:30:00+00,18161,0,6344,2558,257,0,2140,203,0,78,29741,251,11299,9159,2815,18161
2022-05-02 22:00:00+00,18347,0,6340,2514,211,0,1661,198,0,0,29271,256,10726,9065,2725,18347
2022-05-02 22:30:00+00,18018,0,6347,2383,210,0,1213,193,0,0,28364,257,10153,8940,2593,18018
2022-05-02 23:00:00+00,17889,0,6371,2353,173,0,1228,189,0,0,28203,257,10125,8897,2526,17889
2022-05-02 23:30:00+00,17848,0,6369,2195,152,0,1226,194,0,0,27984,259,9942,8716,2347,17848
2022-05-03 00:00:00+00,17918,0,6374,2216,135,88,1293,187,0,0,28211,259,10018,8725,2351,17918
2022-05-03 00:30:00+00,17935,0,6376,2140,135,138,1340,187,0,0,28251,260,9991,8651,2275,17935
2022-05-03 01:00:00+00,17940,0,6375,1961,117,120,1319,185,0,0,28017,262,9772,8453,2078,17940
2022-05-03 01:30:00+00,17971,0,6383,1854,117,96,1297,181,0,0,27899,263,9651,8354,1971,17971
2022-05-03 02:00:00+00,17813,0,6379,1760,117,138,1252,190,0,0,27649,264,9508,8256,1877,17813
2022-05-03 02:30:00+00,17897,0,6381,1759,119,96,1225,160,0,0,27637,264,9484,8259,1878,17897
2022-05-03 03:00:00+00,17898,0,6380,1731,119,152,1248,163,0,0,27691,264,9478,8230,1850,17898
2022-05-03 03:30:00+00,17811,0,6401,1674,119,148,1582,156,0,0,27891,263,9776,8194,1793,17811
2022-05-03 04:00:00+00,17844,0,6399,1573,152,102,2115,164,0,0,28349,260,10239,8124,1725,17844
2022-05-03 04:30:00+00,17992,0,6421,1587,157,220,2130,182,0,0,28689,261,10295,8165,1744,17992
2022-05-03 05:00:00+00,18093,0,6421,1546,243,126,2120,184,37,0,28770,261,10367,8247,1826,18093
2022-05-03 05:30:00+00,18713,0,6424,1543,284,192,2126,443,159,392,30276,259,10536,8410,1986,18713
2022-05-03 06:00:00+00,18569,0,6416,1518,321,154,2131,806,328,1126,31369,250,10714,8583,2167,18569
2022-05-03 06:30:00+00,19278,0,6421,1524,322,160,2115,1018,504,1658,33000,247,10886,8771,2350,19278
2022-05-03 07:00:00+00,19185,0,6417,1526,315,1798,2127,897,750,654,33670,247,11136,9008,2592,19185
2022-05-03 07:30:00+00,19483,0,6419,1570,317,1966,2131,862,1056,648,34452,246,11493,9362,2943,19483
2022-05-03 08:00:00+00,19355,0,6421,1544,317,2810,2132,647,1398,568,35192,245,11812,9680,3259,19355
2022-05-03 08:30:00+00,19365,0,6429,1548,363,2802,2080,613,1812,494,35506,243,12232,10152,3723,19365
2022-05-03 09:00:00+00,19318,0,6437,1568,336,2840,2055,544,2442,396,35936,239,12838,10783,4346,19318
2022-05-03 09:30:00+00,19387,0,6424,1532,293,2832,2112,474,3074,124,36252,237,13435,11323,4899,19387
2022-05-03 10:00:00+00,19205,0,6434,1505,166,3274,2068,415,3492,0,36559,233,13665,11597,5163,19205
2022-05-03 10:30:00+00,18765,0,6429,1517,234,3320,1983,300,3969,186,36703,226,14132,12149,5720,18765
2022-05-03 11:00:00+00,18702,0,6430,1507,216,3628,1868,347,4403,220,37321,223,14424,12556,6126,18702
2022-05-03 11:30:00+00,18532,0,6424,1505,216,3636,1805,230,4533,110,36991,222,14483,12678,6254,18532
2022-05-03 12:00:00+00,18961,0,6420,1505,187,2786,1768,229,4404,110,36370,227,14284,12516,6096,18961
2022-05-03 12:30:00+00,18819,0,6430,1502,134,2726,1788,214,4213,110,35936,228,14067,12279,5849,18819
2022-05-03 13:00:00+00,19179,0,6431,1463,120,1964,2080,213,4060,110,35621,233,14154,12074,5643,19179
2022-05-03 13:30:00+00,19089,1,6434,1424,134,1936,2132,217,3774,110,35251,234,13898,11766,5332,19090
2022-05-03 14:00:00+00,19307,1,6425,1381,152,920,2133,320,3465,198,34302,239,13556,11423,4998,19308
2022-05-03 14:30:00+00,19331,11,6430,1381,162,944,2133,461,2960,298,34111,242,13066,10933,4503,19342
2022-05-03 15:00:00+00,19248,32,6430,1381,223,2126,2132,734,2687,62,35055,240,12853,10721,4291,19280
2022-05-03 15:30:00+00,19606,109,6433,1387,225,2208,2134,866,2503,318,35789,242,12682,10548,4115,19715
2022-05-03 16:00:00+00,19589,225,6437,1425,323,2056,2128,977,2177,450,35787,245,12490,10362,3925,19814
2022-05-03 16:30:00+00,19386,230,6439,1416,324,2066,2133,949,1605,900,35448,245,11917,9784,3345,19616
2022-05-03 17:00:00+00,19454,230,6443,1424,350,1466,2035,965,1288,1592,35247,248,11540,9505,3062,19684
2022-05-03 17:30:00+00,19554,230,6440,1397,352,1426,1992,1033,888,1658,34970,251,11069,9077,2637,19784
2022-05-03 18:00:00+00,19996,230,6440,1426,377,782,2129,1095,455,1674,34604,255,10827,8698,2258,20226
2022-05-03 18:30:00+00,19654,229,6441,1439,431,870,2132,966,165,1638,33965,256,10608,8476,2035,19883
2022-05-03 19:00:00+00,19692,230,6435,1489,435,1178,2134,916,25,1084,33618,261,10518,8384,1949,19922
2022-05-03 19:30:00+00,19545,229,6433,1551,434,1092,2132,912,0,988,33316,261,10550,8418,1985,19774
2022-05-03 20:00:00+00,19596,228,6437,1554,413,592,2131,875,0,842,32668,263,10535,8404,1967,19824
2022-05-03 20:30:00+00,19039,230,6435,1569,359,484,2090,715,0,152,31073,267,10453,8363,1928,19269
2022-05-03 21:00:00+00,19114,324,6440,1550,328,392,2097,523,0,164,30932,272,10415,8318,1878,19438
2022-05-03 21:30:00+00,18307,232,6438,1593,237,402,2103,314,0,0,29626,269,10371,8268,1830,18539
2022-05-03 22:00:00+00,17435,234,6443,1698,186,402,2102,222,0,0,28722,264,10429,8327,1884,17669
2022-05-03 22:30:00+00,16558,184,6441,1953,172,402,2046,182,0,0,27938,257,10612,8566,2125,16742
2022-05-03 23:00:00+00,17122,92,6436,2039,137,388,1932,169,0,0,28315,258,10544,8612,2176,17214
2022-05-03 23:30:00+00,17172,0,6443,2179,120,298,1894,158,0,0,28264,254,10636,8742,2299,17172
2022-05-04 00:00:00+00,17693,0,6410,2363,119,386,1861,174,0,0,29006,256,10753,8892,2482,17693
2022-05-04 00:30:00+00,17759,0,6404,2675,119,402,1777,192,0,0,29328,254,10975,9198,2794,17759
2022-05-04 01:00:00+00,17266,0,6410,2910,119,330,1650,160,0,0,28845,250,11089,9439,3029,17266
2022-05-04 01:30:00+00,16362,0,6398,3130,119,262,1474,186,0,0,27931,243,11121,9647,3249,16362
2022-05-04 02:00:00+00,16425,0,6431,3148,119,388,1620,162,0,0,28293,244,11318,9698,3267,16425
2022-05-04 02:30:00+00,16807,0,6430,3173,119,364,2018,158,0,0,29069,244,11740,9722,3292,16807
2022-05-04 03:00:00+00,16732,0,6425,3255,119,274,2021,172,0,0,28998,242,11820,9799,3374,16732
2022-05-04 03:30:00+00,16747,0,6426,3333,120,222,2099,170,0,0,29117,241,11978,9879,3453,16747
2022-05-04 04:00:00+00,17354,0,6430,3270,139,142,2091,163,0,0,29589,243,11930,9839,3409,17354
2022-05-04 04:30:00+00,17763,7,6425,3358,142,274,2093,166,2,0,30230,246,12020,9927,3502,17770
2022-05-04 05:00:00+00,18215,170,6428,3370,155,390,1962,179,73,0,30942,252,11988,10026,3598,18385
2022-05-04 05:30:00+00,19287,230,6434,3415,189,402,2073,371,285,0,32686,256,12396,10323,3889,19517
2022-05-04 06:00:00+00,19183,227,6432,3578,270,402,2098,823,587,238,33838,250,12965,10867,4435,19410
2022-05-04 06:30:00+00,19301,230,6434,3856,283,386,2104,1076,1042,886,35598,241,13719,11615,5181,19531
2022-05-04 07:00:00+00,18740,229,6431,4261,284,404,2105,812,1437,162,34865,237,14518,12413,5982,18969
2022-05-04 07:30:00+00,18477,229,6431,4530,282,310,2071,743,2049,340,35462,229,15363,13292,6861,18706
2022-05-04 08:00:00+00,19045,230,6433,4635,239,584,2094,584,2738,256,36838,228,16139,14045,7612,19275
2022-05-04 08:30:00+00,18862,232,6426,4927,238,612,1944,548,3051,292,37132,224,16586,14642,8216,19094
2022-05-04 09:00:00+00,19241,232,6427,5209,219,386,1999,391,3228,26,37358,222,17082,15083,8656,19473
2022-05-04 09:30:00+00,18819,233,6428,5628,230,380,2088,270,3447,66,37589,216,17821,15733,9305,19052
2022-05-04 10:00:00+00,18389,231,6424,6245,232,146,2075,221,4195,56,38214,205,19171,17096,10672,18620
2022-05-04 10:30:00+00,18238,229,6424,6658,233,144,2027,202,4703,0,38858,200,20045,18018,11594,18467
2022-05-04 11:00:00+00,18483,229,6429,6820,207,162,1750,182,4765,6,39033,201,19971,18221,11792,18712
2022-05-04 11:30:00+00,18688,229,6430,6941,138,164,1709,189,4462,0,38950,203,19680,17971,11541,18917
2022-05-04 12:00:00+00,19197,286,6428,7159,124,0,2059,181,4514,0,39948,204,20284,18225,11797,19483
2022-05-04 12:30:00+00,18911,236,6421,7494,122,0,2043,174,4764,0,40165,198,20844,18801,12380,19147
2022-05-04 13:00:00+00,19283,242,6421,7848,120,0,1912,180,5158,0,41164,197,21459,19547,13126,19525
2022-05-04 13:30:00+00,19339,230,6426,8306,120,0,1851,171,5122,0,41565,195,21825,19974,13548,19569
2022-05-04 14:00:00+00,18832,233,6420,8718,119,0,1696,177,4122,0,40317,196,21075,19379,12959,19065
2022-05-04 14:30:00+00,19292,243,6416,8733,124,0,1668,194,3362,0,40032,202,20303,18635,12219,19535
2022-05-04 15:00:00+00,19530,236,6421,8643,227,0,1985,186,3631,0,40859,201,20907,18922,12501,19766
2022-05-04 15:30:00+00,19796,248,6415,8420,234,0,2087,291,3362,10,40863,205,20518,18431,12016,20044
2022-05-04 16:00:00+00,20044,234,6430,8039,271,0,2101,649,2901,54,40723,211,19742,17641,11211,20278
2022-05-04 16:30:00+00,19967,299,6431,7774,270,0,2103,689,2377,290,40200,215,18955,16852,10421,20266
2022-05-04 17:00:00+00,19539,237,6436,7372,284,0,2104,648,1750,884,39254,214,17946,15842,9406,19776
2022-05-04 17:30:00+00,19635,235,6437,6984,284,0,2104,672,1249,1030,38630,219,17058,14954,8517,19870
2022-05-04 18:00:00+00,20007,229,6439,6517,289,52,2100,721,795,1266,38415,225,16140,14040,7601,20236
2022-05-04 18:30:00+00,19955,230,6436,6299,279,2,1908,497,328,1604,37538,227,15250,13342,6906,20185
2022-05-04 19:00:00+00,20114,191,6435,5708,269,46,1875,424,54,1482,36598,232,14341,12466,6031,20305
2022-05-04 19:30:00+00,20214,96,6433,5336,265,58,2050,437,0,1394,36282,234,14084,12034,5601,20310
2022-05-04 20:00:00+00,19680,0,6449,4850,255,126,1832,377,0,1372,34941,232,13386,11554,5105,19680
2022-05-04 20:30:00+00,19569,0,6432,4666,254,122,1577,391,0,956,33967,237,12929,11352,4920,19569
2022-05-04 21:00:00+00,19652,0,6435,4227,230,0,1691,354,0,198,32787,246,12583,10892,4457,19652
2022-05-04 21:30:00+00,18929,0,6430,3968,223,0,1460,249,0,50,31309,246,12081,10621,4191,18929
2022-05-04 22:00:00+00,17879,0,6438,3944,159,0,1917,176,0,0,30513,240,12458,10541,4103,17879
2022-05-04 22:30:00+00,17060,0,6436,3927,156,0,1892,160,0,0,29631,236,12411,10519,4083,17060
2022-05-04 23:00:00+00,17224,0,6432,4071,137,74,1796,168,0,0,29902,237,12436,10640,4208,17224
2022-05-04 23:30:00+00,17206,0,6429,4108,137,46,1597,164,0,0,29687,237,12271,10674,4245,17206
2022-05-05 00:00:00+00,16912,0,6425,4028,117,176,1609,172,0,0,29440,237,12180,10570,4146,16912
2022-05-05 00:30:00+00,17062,0,6425,3723,116,328,1613,175,0,0,29442,242,11877,10264,3839,17062
2022-05-05 01:00:00+00,17043,0,6433,3428,116,402,1745,164,0,0,29331,244,11722,9977,3544,17043
2022-05-05 01:30:00+00,16820,0,6432,3343,116,344,1751,158,0,0,28964,243,11642,9891,3459,16820
2022-05-05 02:00:00+00,16903,0,6436,3216,116,392,1623,159,0,0,28845,246,11391,9768,3332,16903
2022-05-05 02:30:00+00,16980,0,6426,3111,116,350,1582,171,0,0,28736,247,11235,9653,3227,16980
2022-05-05 03:00:00+00,17089,0,6429,3071,116,342,1565,161,0,0,28773,248,11181,9616,3187,17089
2022-05-05 03:30:00+00,17202,0,6430,3067,120,342,1635,159,0,0,28955,248,11252,9617,3187,17202
2022-05-05 04:00:00+00,17485,0,6424,3114,151,404,1572,159,0,0,29309,249,11261,9689,3265,17485
2022-05-05 04:30:00+00,17752,0,6429,3136,151,404,1800,168,26,0,29866,249,11542,9742,3313,17752
2022-05-05 05:00:00+00,18164,0,6433,3246,168,404,2079,520,260,0,31274,249,12186,10107,3674,18164
2022-05-05 05:30:00+00,19118,177,6428,3265,181,394,2070,591,720,192,33136,251,12664,10594,4166,19295
2022-05-05 06:00:00+00,19597,222,6433,3384,307,310,2069,592,1256,750,34920,244,13449,11380,4947,19819
2022-05-05 06:30:00+00,19516,237,6430,3434,348,360,2084,1095,1944,1220,36668,237,14240,12156,5726,19753
2022-05-05 07:00:00+00,19505,344,6432,3280,305,398,2103,1116,2613,826,36922,236,14733,12630,6198,19849
2022-05-05 07:30:00+00,19490,347,6426,3260,296,316,2104,817,3302,664,37022,232,15388,13284,6858,19837
2022-05-05 08:00:00+00,19478,346,6427,3212,257,214,2104,471,4072,574,37155,229,16072,13968,7541,19824
2022-05-05 08:30:00+00,19448,279,6435,3186,256,190,2103,416,4915,288,37516,224,16895,14792,8357,19727
2022-05-05 09:00:00+00,18992,231,6436,3338,235,34,1990,342,5751,186,37535,215,17750,15760,9324,19223
2022-05-05 09:30:00+00,19040,239,6433,3457,237,14,1827,317,6499,0,38063,211,18453,16626,10193,19279
2022-05-05 10:00:00+00,19319,237,6438,3625,239,0,1763,297,7226,0,39144,208,19291,17528,11090,19556
2022-05-05 10:30:00+00,19414,242,6435,3735,198,0,1742,234,7533,0,39533,206,19643,17901,11466,19656
2022-05-05 11:00:00+00,19394,348,6430,3866,141,0,1944,234,7566,232,40155,206,19947,18003,11573,19742
2022-05-05 11:30:00+00,18945,341,6434,3969,140,0,1951,212,7584,46,39622,204,20078,18127,11693,19286
2022-05-05 12:00:00+00,18870,250,6429,4074,127,88,1885,206,7605,0,39534,202,20120,18235,11806,19120
2022-05-05 12:30:00+00,18817,73,6435,4046,136,178,2002,180,7236,90,39193,201,19855,17853,11418,18890
2022-05-05 13:00:00+00,18810,58,6430,4156,141,268,2106,174,6722,0,38865,203,19555,17449,11019,18868
2022-05-05 13:30:00+00,19013,44,6426,4160,147,170,2065,173,6192,0,38389,206,18990,16925,10499,19057
2022-05-05 14:00:00+00,18781,29,6429,4266,137,276,2097,180,5533,0,37728,208,18462,16365,9936,18810
2022-05-05 14:30:00+00,19029,15,6428,4302,135,392,2102,284,5053,0,37740,213,18020,15918,9490,19044
2022-05-05 15:00:00+00,19401,0,6434,4257,198,404,2104,221,4628,0,37647,216,17621,15517,9083,19401
2022-05-05 15:30:00+00,19629,0,6423,4260,215,404,2104,497,3861,0,37393,223,16863,14759,8336,19629
2022-05-05 16:00:00+00,19700,0,6431,4262,290,444,2105,610,3309,460,37611,223,16397,14292,7861,19700
2022-05-05 16:30:00+00,19649,0,6427,4288,304,551,2105,619,2706,832,37481,224,15830,13725,7298,19649
2022-05-05 17:00:00+00,19211,0,6399,4276,339,828,2105,783,2269,1214,37424,221,15388,13283,6884,19211
2022-05-05 17:30:00+00,19118,0,6377,4490,325,850,2104,810,1498,1452,37024,223,14794,12690,6313,19118
2022-05-05 18:00:00+00,19009,0,6380,4403,338,690,2104,849,914,1842,36529,225,14139,12035,5655,19009
2022-05-05 18:30:00+00,19025,0,6379,4192,344,660,2102,825,414,1760,35701,230,13431,11329,4950,19025
2022-05-05 19:00:00+00,19066,0,6375,4235,264,424,2104,881,81,1624,35054,236,13059,10955,4580,19066
2022-05-05 19:30:00+00,19005,0,6373,4170,258,404,2080,832,0,1644,34766,237,12881,10801,4428,19005
2022-05-05 20:00:00+00,19262,0,6374,4216,256,404,2091,833,0,1268,34704,241,12937,10846,4472,19262
2022-05-05 20:30:00+00,18996,0,6378,4523,258,404,2087,780,0,336,33762,244,13246,11159,4781,18996
2022-05-05 21:00:00+00,18759,0,6371,4822,218,404,2064,595,0,500,33733,238,13475,11411,5040,18759
2022-05-05 21:30:00+00,18286,0,6379,5314,209,334,1686,215,0,0,32423,236,13588,11902,5523,18286
2022-05-05 22:00:00+00,17526,0,6369,5475,174,366,856,227,0,16,31009,234,12874,12018,5649,17526
2022-05-05 22:30:00+00,16636,0,6377,5526,175,402,485,213,0,0,29814,230,12563,12078,5701,16636
2022-05-05 23:00:00+00,15916,0,6372,5768,150,364,488,214,0,0,29272,224,12778,12290,5918,15916
2022-05-05 23:30:00+00,15724,0,6377,6016,150,356,481,203,0,0,29307,221,13024,12543,6166,15724
2022-05-06 00:00:00+00,14972,0,6364,6663,150,338,483,210,0,0,29180,212,13660,13177,6813,14972
2022-05-06 00:30:00+00,14917,0,6362,6978,148,402,495,220,0,0,29522,210,13983,13488,7126,14917
2022-05-06 01:00:00+00,15078,0,6366,6998,102,402,483,204,0,0,29633,211,13949,13466,7100,15078
2022-05-06 01:30:00+00,14474,0,6372,7174,104,402,481,202,0,0,29209,206,14131,13650,7278,14474
2022-05-06 02:00:00+00,14115,0,6365,6886,115,402,490,156,0,0,28529,205,13856,13366,7001,14115
2022-05-06 02:30:00+00,14021,0,6366,6766,115,402,492,157,0,0,28319,205,13739,13247,6881,14021
2022-05-06 03:00:00+00,13843,0,6369,6875,115,402,492,165,0,0,28261,203,13851,13359,6990,13843
2022-05-06 03:30:00+00,13969,0,6370,6952,116,392,488,167,0,0,28454,204,13926,13438,7068,13969
2022-05-06 04:00:00+00,14260,0,6375,7064,106,402,705,155,0,0,29067,204,14250,13545,7170,14260
2022-05-06 04:30:00+00,14354,0,6375,7284,111,370,890,156,62,0,29602,202,14722,13832,7457,14354
2022-05-06 05:00:00+00,15148,0,6380,7437,174,268,1039,155,328,0,30929,203,15358,14319,7939,15148
2022-05-06 05:30:00+00,16091,0,6368,7451,186,378,1070,181,733,0,32458,206,15808,14738,8370,16091
2022-05-06 06:00:00+00,17580,0,6376,7276,284,402,1327,204,1360,10,34819,211,16623,15296,8920,17580
2022-05-06 06:30:00+00,18022,0,6375,7154,320,386,1792,464,2070,104,36687,208,17711,15919,9544,18022
2022-05-06 07:00:00+00,17780,0,6386,7336,375,270,2078,419,2863,194,37701,199,19038,16960,10574,17780
2022-05-06 07:30:00+00,17716,0,6379,7245,374,116,2110,323,3665,86,38014,194,19773,17663,11284,17716
2022-05-06 08:00:00+00,17807,0,6299,7313,356,84,2114,244,4351,240,38808,190,20433,18319,12020,17807
2022-05-06 08:30:00+00,17766,0,6274,7310,348,0,1998,184,5009,74,38963,187,20939,18941,12667,17766
2022-05-06 09:00:00+00,17477,0,6277,7276,302,0,1759,133,5439,118,38781,184,21053,19294,13017,17477
2022-05-06 09:30:00+00,17500,0,6279,7123,303,0,1430,126,6080,396,39237,181,21215,19785,13506,17500
2022-05-06 10:00:00+00,17504,0,6284,7180,248,0,1396,121,6304,170,39207,181,21412,20016,13732,17504
2022-05-06 10:30:00+00,17350,0,6284,7210,235,0,1393,128,6611,314,39525,178,21733,20340,14056,17350
2022-05-06 11:00:00+00,17239,0,6280,7393,191,0,1396,145,6925,316,39885,176,22185,20789,14509,17239
2022-05-06 11:30:00+00,17181,0,6288,7751,206,0,1376,121,6602,158,39683,176,22223,20847,14559,17181
2022-05-06 12:00:00+00,16916,0,6287,8411,172,0,1399,122,6528,18,39853,172,22797,21398,15111,16916
2022-05-06 12:30:00+00,16745,0,6283,8523,170,0,1412,124,6051,6,39314,173,22439,21027,14744,16745
2022-05-06 13:00:00+00,16811,0,6284,8460,170,0,1415,117,5766,0,39023,175,22095,20680,14396,16811
2022-05-06 13:30:00+00,17218,0,6278,8208,168,0,1404,117,5063,8,38464,182,21121,19717,13439,17218
2022-05-06 14:00:00+00,17521,0,6278,8181,167,0,1374,118,4328,0,37967,187,20328,18954,12676,17521
2022-05-06 14:30:00+00,17749,0,6276,7814,154,0,1406,259,3467,276,37401,194,19117,17711,11435,17749
2022-05-06 15:00:00+00,18036,0,6280,7576,234,0,1405,521,2864,374,37290,199,18359,16954,10674,18036
2022-05-06 15:30:00+00,18360,0,6279,7414,250,0,1837,562,2278,710,37690,203,18058,16221,9942,18360
2022-05-06 16:00:00+00,19064,0,6277,6843,328,0,2117,598,1659,1162,38048,210,17224,15107,8830,19064
2022-05-06 16:30:00+00,19254,0,6276,6310,345,0,2126,593,1279,1356,37539,215,16336,14210,7934,19254
2022-05-06 17:00:00+00,19666,0,6282,5963,395,0,2124,604,978,1262,37274,221,15742,13618,7336,19666
2022-05-06 17:30:00+00,20131,0,6281,5571,360,56,2126,613,655,1228,37021,229,14993,12867,6586,20131
2022-05-06 18:00:00+00,20165,0,6292,5135,336,0,2117,645,378,1516,36584,232,14258,12141,5849,20165
2022-05-06 18:30:00+00,20088,0,6283,4735,390,0,2036,639,163,1642,35976,235,13607,11571,5288,20088
2022-05-06 19:00:00+00,20094,0,6307,4093,391,0,2090,573,26,1780,35354,238,12907,10817,4510,20094
2022-05-06 19:30:00+00,19982,0,6287,3983,376,0,2032,594,0,1590,34844,241,12678,10646,4359,19982
2022-05-06 20:00:00+00,20037,0,6289,3847,304,0,2088,629,0,1070,34264,246,12528,10440,4151,20037
2022-05-06 20:30:00+00,19282,0,6287,3810,298,0,2056,572,0,950,33255,243,12451,10395,4108,19282
2022-05-06 21:00:00+00,19087,0,6283,3635,222,0,1820,650,0,944,32641,244,11960,10140,3857,19087
2022-05-06 21:30:00+00,18957,0,6282,3357,216,0,1482,505,0,522,31321,250,11337,9855,3573,18957
2022-05-06 22:00:00+00,18556,0,6280,3227,160,0,825,225,0,414,29687,253,10492,9667,3387,18556
2022-05-06 22:30:00+00,18620,0,6272,3012,160,0,496,175,0,210,28945,258,9940,9444,3172,18620
2022-05-06 23:00:00+00,18607,0,5610,2826,160,0,499,145,0,0,27847,267,9095,8596,2986,18607
2022-05-06 23:30:00+00,18449,0,5578,2561,157,0,496,138,0,0,27379,269,8792,8296,2718,18449
2022-05-07 00:00:00+00,18586,0,5575,2367,156,0,492,137,0,0,27313,272,8590,8098,2523,18586
2022-05-07 00:30:00+00,18763,0,5571,2255,154,0,501,189,0,0,27433,274,8481,7980,2409,18763
2022-05-07 01:00:00+00,18489,0,5301,2169,137,0,483,417,0,0,26996,277,8090,7607,2306,18489
2022-05-07 01:30:00+00,18351,0,5282,2005,137,0,490,459,0,0,26724,278,7914,7424,2142,18351
2022-05-07 02:00:00+00,18481,0,5291,1856,136,0,474,447,0,0,26685,280,7757,7283,1992,18481
2022-05-07 02:30:00+00,18361,0,5284,1860,148,0,482,443,0,0,26578,279,7774,7292,2008,18361
2022-05-07 03:00:00+00,17496,0,5292,1878,147,0,476,339,0,0,25628,275,7793,7317,2025,17496
2022-05-07 03:30:00+00,17613,0,5299,1844,147,0,474,321,0,0,25698,276,7764,7290,1990,17613
2022-05-07 04:00:00+00,18502,0,5306,1785,148,0,481,253,0,0,26475,280,7720,7239,1933,18502
2022-05-07 04:30:00+00,18586,0,5296,1777,150,0,481,146,16,0,26452,281,7720,7239,1943,18586
2022-05-07 05:00:00+00,18079,0,5301,1644,174,0,470,204,183,0,26055,278,7772,7302,2001,18079
2022-05-07 05:30:00+00,18091,0,5295,1464,181,0,481,268,515,0,26295,276,7936,7455,2160,18091
2022-05-07 06:00:00+00,17844,0,5302,1394,285,82,469,271,1008,0,26655,270,8458,7989,2687,17844
2022-05-07 06:30:00+00,18048,0,5297,1368,349,42,382,579,1661,112,27838,264,9057,8675,3378,18048
2022-05-07 07:00:00+00,18187,0,5297,1217,434,0,169,561,2436,472,28773,256,9553,9384,4087,18187
2022-05-07 07:30:00+00,18501,0,5300,1109,445,0,167,565,3159,614,29860,251,10180,10013,4713,18501
2022-05-07 08:00:00+00,18479,0,5299,1087,446,0,168,553,4022,124,30178,248,11022,10854,5555,18479
2022-05-07 08:30:00+00,18293,0,5291,1157,422,0,168,522,4504,280,30637,241,11542,11374,6083,18293
2022-05-07 09:00:00+00,18260,0,5290,1290,369,64,168,420,5184,82,31127,236,12301,12133,6843,18260
2022-05-07 09:30:00+00,17871,0,5289,1367,369,68,169,362,5822,224,31541,227,13016,12847,7558,17871
2022-05-07 10:00:00+00,17946,0,5291,1339,361,0,171,329,6028,40,31505,228,13190,13019,7728,17946
2022-05-07 10:30:00+00,17926,0,5297,1327,363,0,168,318,6450,0,31849,225,13605,13437,8140,17926
2022-05-07 11:00:00+00,17978,0,5293,1268,297,186,180,303,6214,0,31719,229,13252,13072,7779,17978
2022-05-07 11:30:00+00,17808,0,5295,1379,271,192,188,268,6249,0,31650,227,13382,13194,7899,17808
2022-05-07 12:00:00+00,18435,0,5299,1567,195,232,190,218,5705,0,31841,234,12956,12766,7467,18435
2022-05-07 12:30:00+00,18006,0,5308,1679,175,232,191,205,5791,0,31587,230,13144,12953,7645,18006
2022-05-07 13:00:00+00,18640,0,5297,1904,159,0,185,190,5955,0,32330,230,13500,13315,8018,18640
2022-05-07 13:30:00+00,18333,0,5294,2137,153,0,184,165,5547,0,31813,229,13315,13131,7837,18333
2022-05-07 14:00:00+00,18637,0,5287,2427,179,0,186,166,5083,0,31965,232,13162,12976,7689,18637
2022-05-07 14:30:00+00,18407,0,5290,2763,216,0,186,258,4906,0,32026,230,13361,13175,7885,18407
2022-05-07 15:00:00+00,18604,0,5300,2828,271,0,361,280,4335,0,31979,233,13095,12734,7434,18604
2022-05-07 15:30:00+00,18857,0,5294,2931,271,0,656,388,3735,16,32148,237,12887,12231,6937,18857
2022-05-07 16:00:00+00,19343,0,5291,2995,315,0,826,568,3280,580,33198,238,12707,11881,6590,19343
2022-05-07 16:30:00+00,19582,0,5289,2952,336,0,831,609,2423,824,32846,244,11831,11000,5711,19582
2022-05-07 17:00:00+00,19413,0,5288,2980,421,0,833,603,1760,1456,32754,243,11282,10449,5161,19413
2022-05-07 17:30:00+00,19217,0,5288,3054,424,30,831,668,1267,1702,32481,244,10864,10033,4745,19217
2022-05-07 18:00:00+00,19312,0,5287,2907,411,202,831,689,719,1748,32106,249,10155,9324,4037,19312
2022-05-07 18:30:00+00,19567,0,5293,2866,410,180,832,747,313,1524,31732,255,9714,8882,3589,19567
2022-05-07 19:00:00+00,19043,0,5290,2827,409,184,832,749,57,1528,30919,257,9415,8583,3293,19043
2022-05-07 19:30:00+00,18968,0,5289,2906,410,82,828,704,0,1584,30771,255,9433,8605,3316,18968
2022-05-07 20:00:00+00,18926,0,5288,2943,351,124,823,742,0,1498,30695,256,9405,8582,3294,18926
2022-05-07 20:30:00+00,18769,0,5290,3183,343,64,816,679,0,1048,30192,257,9632,8816,3526,18769
2022-05-07 21:00:00+00,18131,0,5288,3530,309,202,770,461,0,464,29155,256,9897,9127,3839,18131
2022-05-07 21:30:00+00,17903,0,5298,3594,307,340,533,376,0,102,28453,260,9732,9199,3901,17903
2022-05-07 22:00:00+00,16561,0,5289,3688,264,386,475,276,0,10,26949,254,9716,9241,3952,16561
2022-05-07 22:30:00+00,15465,0,5286,3807,264,308,471,263,0,84,25948,246,9828,9357,4071,15465
2022-05-07 23:00:00+00,15028,0,5286,4066,232,98,474,191,0,0,25375,240,10058,9584,4298,15028
2022-05-07 23:30:00+00,14701,0,5290,4081,243,29,475,186,0,54,25059,236,10089,9614,4324,14701
2022-05-08 00:00:00+00,14809,0,5286,4219,224,156,474,145,0,0,25313,237,10203,9729,4443,14809
2022-05-08 00:30:00+00,14862,0,5289,4104,223,184,473,134,0,0,25269,239,10089,9616,4327,14862
2022-05-08 01:00:00+00,14888,0,5272,3961,224,298,492,169,0,0,25304,242,9949,9457,4185,14888
2022-05-08 01:30:00+00,14977,0,5283,3897,223,304,474,150,0,0,25308,244,9877,9403,4120,14977
2022-05-08 02:00:00+00,14976,0,5283,3851,223,348,478,140,0,0,25299,244,9835,9357,4074,14976
2022-05-08 02:30:00+00,14870,0,5292,3830,207,326,481,138,0,0,25144,244,9810,9329,4037,14870
2022-05-08 03:00:00+00,14792,0,5291,3794,206,346,488,132,0,0,25049,244,9779,9291,4000,14792
2022-05-08 03:30:00+00,14520,0,5293,3791,207,358,493,138,0,0,24800,242,9784,9291,3998,14520
2022-05-08 04:00:00+00,13912,0,5295,3933,243,308,488,231,0,0,24410,236,9959,9471,4176,13912
2022-05-08 04:30:00+00,13369,0,5291,4214,223,368,488,271,46,0,24270,230,10262,9774,4483,13369
2022-05-08 05:00:00+00,13495,0,5304,4433,224,352,494,295,290,0,24887,226,10745,10251,4947,13495
2022-05-08 05:30:00+00,13651,0,5300,4459,228,346,485,309,718,0,25496,224,11190,10705,5405,13651
2022-05-08 06:00:00+00,13564,0,5295,4416,309,214,390,215,1253,0,25656,217,11663,11273,5978,13564
2022-05-08 06:30:00+00,13849,0,5288,4348,317,244,187,335,1862,68,26498,216,12002,11815,6527,13849
2022-05-08 07:00:00+00,14065,0,5292,4281,327,44,187,321,2584,322,27423,208,12671,12484,7192,14065
2022-05-08 07:30:00+00,14204,0,5293,4213,346,14,186,418,3466,464,28604,202,13504,13318,8025,14204
2022-05-08 08:00:00+00,13609,0,5296,4199,324,1052,182,305,4459,0,29426,193,14460,14278,8982,13609
2022-05-08 08:30:00+00,13342,0,5295,4233,309,1128,180,258,5442,122,30309,184,15459,15279,9984,13342
2022-05-08 09:00:00+00,13014,0,5298,4389,308,1782,184,229,6377,0,31581,178,16556,16372,11074,13014
2022-05-08 09:30:00+00,12411,0,5295,4620,305,1802,184,142,7192,0,31951,167,17596,17412,12117,12411
2022-05-08 10:00:00+00,12284,0,5292,4923,293,1902,175,142,7844,0,32855,161,18527,18352,13060,12284
2022-05-08 10:30:00+00,12140,0,5298,4984,287,1904,173,135,8433,0,33354,157,19175,19002,13704,12140
2022-05-08 11:00:00+00,11476,0,5296,5152,245,2034,173,134,8755,0,33266,150,19622,19448,14152,11476
2022-05-08 11:30:00+00,11277,0,5297,5286,246,2034,174,137,8687,0,33138,148,19690,19516,14219,11277
2022-05-08 12:00:00+00,10215,0,5297,5417,244,1992,174,134,8650,0,32123,140,19782,19608,14311,10215
2022-05-08 12:30:00+00,9834,0,5298,5761,243,1992,172,135,8391,0,31826,136,19865,19693,14395,9834
2022-05-08 13:00:00+00,9654,0,5296,6022,244,1724,167,138,8022,0,31267,136,19751,19584,14288,9654
2022-05-08 13:30:00+00,9104,0,5302,6353,240,1720,166,137,7462,0,30484,132,19523,19357,14055,9104
2022-05-08 14:00:00+00,11580,0,5312,6456,238,670,166,137,6744,0,31304,154,18916,18750,13438,11580
2022-05-08 14:30:00+00,11798,0,5298,6715,241,732,168,144,6034,0,31130,159,18456,18288,12990,11798
2022-05-08 15:00:00+00,13854,0,5291,6832,276,456,168,167,5266,0,32310,178,17833,17665,12374,13854
2022-05-08 15:30:00+00,15403,0,5294,6907,264,560,169,170,4622,0,33389,192,17256,17087,11793,15403
2022-05-08 16:00:00+00,16360,0,5291,6933,310,520,169,327,3689,148,33747,202,16392,16223,10932,16360
2022-05-08 16:30:00+00,17106,0,5296,6818,319,604,172,512,3005,308,34140,211,15610,15438,10142,17106
2022-05-08 17:00:00+00,16802,0,5294,6776,342,740,170,613,2223,362,33322,215,14805,14635,9341,16802
2022-05-08 17:30:00+00,17037,0,5290,6580,340,750,168,600,1505,696,32966,221,13883,13715,8425,17037
2022-05-08 18:00:00+00,17115,0,5287,6402,344,874,168,666,975,956,32787,225,13176,13008,7721,17115
2022-05-08 18:30:00+00,17137,0,5289,6178,344,792,169,669,438,1042,32058,229,12418,12249,6960,17137
2022-05-08 19:00:00+00,16914,0,5290,6017,359,756,172,672,83,990,31253,231,11921,11749,6459,16914
2022-05-08 19:30:00+00,17007,0,5296,6044,357,634,205,667,0,1084,31294,230,11902,11697,6401,17007
2022-05-08 20:00:00+00,17065,0,5297,6195,293,634,243,661,0,876,31264,232,12028,11785,6488,17065
2022-05-08 20:30:00+00,16492,0,5297,6479,324,536,267,501,0,614,30510,227,12367,12100,6803,16492
2022-05-08 21:00:00+00,16700,0,5293,6700,325,370,289,435,0,472,30584,226,12607,12318,7025,16700
2022-05-08 21:30:00+00,15579,0,5292,6810,324,252,439,325,0,214,29235,219,12865,12426,7134,15579
2022-05-08 22:00:00+00,14296,0,5293,7073,316,242,567,299,0,0,28086,210,13249,12682,7389,14296
2022-05-08 22:30:00+00,13135,0,5285,7244,279,268,585,188,0,0,26984,201,13393,12808,7523,13135
2022-05-08 23:00:00+00,13078,0,5291,7298,211,340,599,136,0,0,26953,201,13399,12800,7509,13078
2022-05-08 23:30:00+00,12582,0,5288,7355,189,370,632,149,0,0,26565,198,13464,12832,7544,12582
2022-05-09 00:00:00+00,12612,0,5295,7327,157,474,624,127,0,0,26616,199,13403,12779,7484,12612
2022-05-09 00:30:00+00,12888,0,5289,7194,158,564,631,124,0,0,26848,203,13272,12641,7352,12888
2022-05-09 01:00:00+00,13267,0,5295,7112,158,484,631,129,0,0,27076,206,13196,12565,7270,13267
2022-05-09 01:30:00+00,13189,0,5292,7004,157,488,618,119,0,0,26867,206,13071,12453,7161,13189
2022-05-09 02:00:00+00,12885,0,5288,7096,159,612,635,121,0,0,26796,204,13178,12543,7255,12885
2022-05-09 02:30:00+00,12476,0,5291,7253,159,608,644,120,0,0,26551,200,13347,12703,7412,12476
2022-05-09 03:00:00+00,12309,0,5289,7466,158,656,656,121,0,0,26655,198,13569,12913,7624,12309
2022-05-09 03:30:00+00,12362,0,5292,7477,159,674,726,122,0,0,26812,198,13654,12928,7636,12362
2022-05-09 04:00:00+00,12161,0,5300,7683,158,636,749,120,0,0,26807,194,13890,13141,7841,12161
2022-05-09 04:30:00+00,12904,0,5295,7576,142,716,783,128,104,0,27648,201,13900,13117,7822,12904
2022-05-09 05:00:00+00,14274,0,5298,7654,245,786,988,179,507,0,29931,206,14692,13704,8406,14274
2022-05-09 05:30:00+00,15155,0,5295,8092,250,880,1351,404,1040,0,32467,205,16028,14677,9382,15155
2022-05-09 06:00:00+00,15685,0,5298,8546,271,754,1863,619,1667,0,34703,200,17645,15782,10484,15685
2022-05-09 06:30:00+00,16102,0,5297,8811,307,840,2065,558,2416,0,36396,198,18896,16831,11534,16102
2022-05-09 07:00:00+00,15880,0,5297,9015,271,716,2058,604,3210,0,37051,190,19851,17793,12496,15880
2022-05-09 07:30:00+00,15514,0,5296,9224,275,572,1992,602,4011,0,37486,181,20798,18806,13510,15514
2022-05-09 08:00:00+00,15090,0,5290,9526,276,452,1978,566,4653,0,37831,173,21723,19745,14455,15090
2022-05-09 08:30:00+00,14497,0,5311,9916,275,280,2094,343,5314,0,38030,163,22910,20816,15505,14497
2022-05-09 09:00:00+00,14511,0,5298,10019,244,146,2093,236,5914,0,38461,159,23568,21475,16177,14511
2022-05-09 09:30:00+00,14009,0,5299,10187,244,136,2094,298,6107,0,38374,154,23931,21837,16538,14009
2022-05-09 10:00:00+00,14282,0,5298,10138,234,250,2092,218,6495,0,39007,155,24257,22165,16867,14282
2022-05-09 10:30:00+00,14044,0,5293,10470,230,302,2093,181,6890,0,39503,151,24976,22883,17590,14044
2022-05-09 11:00:00+00,13539,0,5301,10604,215,320,2087,149,6793,0,39008,148,25000,22913,17612,13539
2022-05-09 11:30:00+00,13463,0,5296,10573,213,230,2133,104,6544,0,38556,148,24759,22626,17330,13463
2022-05-09 12:00:00+00,13372,0,5303,11158,212,206,2141,107,6148,0,38647,146,24962,22821,17518,13372
2022-05-09 12:30:00+00,13137,0,5318,11850,212,110,2141,104,6271,0,39143,141,25792,23651,18333,13137
2022-05-09 13:00:00+00,12694,0,5297,12679,217,0,2141,107,5733,0,38868,136,26067,23926,18629,12694
2022-05-09 13:30:00+00,12243,0,5298,13404,217,48,2146,104,5165,0,38625,133,26230,24084,18786,12243
2022-05-09 14:00:00+00,12014,0,5295,14180,216,62,2140,102,4687,0,38696,131,26518,24378,19084,12014
2022-05-09 14:30:00+00,12054,0,5295,15049,221,118,2147,104,4169,0,39157,130,26881,24734,19439,12054
2022-05-09 15:00:00+00,12544,0,5287,15404,260,92,2137,141,3310,0,39175,135,26398,24261,18974,12544
2022-05-09 15:30:00+00,13022,0,5294,15934,268,62,2138,133,2657,0,39508,138,26291,24153,18859,13022
2022-05-09 16:00:00+00,13687,0,5292,16036,280,216,2132,138,2109,0,39890,145,25849,23717,18425,13687
2022-05-09 16:30:00+00,13918,0,5285,16241,283,286,2137,161,1555,0,39866,149,25501,23364,18079,13918
2022-05-09 17:00:00+00,13885,0,5291,16050,295,184,2146,176,1213,200,39440,149,24995,22849,17558,13885
2022-05-09 17:30:00+00,13909,0,5291,15981,274,250,2137,364,757,0,38963,153,24440,22303,17012,13909
2022-05-09 18:00:00+00,13711,0,5292,15959,278,202,2135,472,436,96,38581,153,24100,21965,16673,13711
2022-05-09 18:30:00+00,13289,0,5286,16150,278,30,2150,239,196,170,37788,148,24060,21910,16624,13289
2022-05-09 19:00:00+00,13045,0,5287,16206,288,0,2139,154,41,130,37290,146,23961,21822,16535,13045
2022-05-09 19:30:00+00,12690,0,5292,16258,282,0,2136,148,0,32,36838,144,23968,21832,16540,12690
2022-05-09 20:00:00+00,12273,0,5291,16228,268,0,1993,133,0,0,36186,141,23780,21787,16496,12273
2022-05-09 20:30:00+00,11630,0,5300,16173,292,0,1454,99,0,0,34948,137,23219,21765,16465,11630
2022-05-09 21:00:00+00,10949,0,5296,16039,312,0,1025,99,0,0,33720,132,22672,21647,16351,10949
2022-05-09 21:30:00+00,9690,0,5303,15879,327,0,646,105,0,0,31950,123,22155,21509,16206,9690
2022-05-09 22:00:00+00,8296,0,5302,15661,314,0,511,109,0,0,30193,111,21788,21277,15975,8296
2022-05-09 22:30:00+00,7285,0,5298,15265,333,72,512,129,0,0,28894,104,21408,20896,15598,7285
2022-05-09 23:00:00+00,6560,0,5306,14964,280,144,512,100,0,0,27866,98,21062,20550,15244,6560
2022-05-09 23:30:00+00,6453,0,5301,14844,241,290,513,112,0,0,27754,100,20899,20386,15085,6453
2022-05-10 00:00:00+00,6040,0,5297,14690,226,448,510,113,0,0,27324,98,20723,20213,14916,6040
2022-05-10 00:30:00+00,6182,0,5303,14452,222,536,509,111,0,0,27315,102,20486,19977,14674,6182
2022-05-10 01:00:00+00,6429,0,5297,14154,222,582,506,117,0,0,27307,106,20179,19673,14376,6429
2022-05-10 01:30:00+00,6360,0,5300,13889,220,506,512,116,0,0,26903,105,19921,19409,14109,6360
2022-05-10 02:00:00+00,6300,0,5300,13621,220,432,512,104,0,0,26489,105,19653,19141,13841,6300
2022-05-10 02:30:00+00,5918,0,5302,13763,217,458,512,100,0,0,26270,100,19794,19282,13980,5918
2022-05-10 03:00:00+00,5720,0,5296,13900,211,496,514,103,0,0,26240,98,19921,19407,14111,5720
2022-05-10 03:30:00+00,5939,0,5301,13733,211,482,514,109,0,0,26289,101,19759,19245,13944,5939
2022-05-10 04:00:00+00,6206,0,5297,13518,212,446,515,107,0,0,26301,104,19542,19027,13730,6206
2022-05-10 04:30:00+00,6625,0,5306,13218,212,696,512,111,9,0,26689,113,19257,18745,13439,6625
2022-05-10 05:00:00+00,7393,0,5299,13151,250,656,659,121,99,4,27632,120,19458,18799,13500,7393
2022-05-10 05:30:00+00,9522,0,5300,13666,253,580,1018,130,391,44,30904,135,20628,19610,14310,9522
2022-05-10 06:00:00+00,10792,0,5301,14393,379,308,1154,129,884,200,33540,136,22111,20957,15656,10792
2022-05-10 06:30:00+00,11290,0,5299,14994,327,230,1160,168,1367,540,35375,134,23147,21987,16688,11290
2022-05-10 07:00:00+00,11255,0,5296,15330,337,38,1162,163,1716,642,35939,129,23841,22679,17383,11255
2022-05-10 07:30:00+00,11048,0,5300,15553,318,0,1295,149,2038,540,36241,126,24504,23209,17909,11048
2022-05-10 08:00:00+00,10854,0,5294,15745,290,0,1425,204,2287,630,36729,123,25041,23616,18322,10854
2022-05-10 08:30:00+00,10459,0,5297,15964,299,0,1202,235,3142,328,36926,117,25904,24702,19405,10459
2022-05-10 09:00:00+00,9735,0,5291,16170,295,126,1124,244,3627,252,36864,111,26507,25383,20092,9735
2022-05-10 09:30:00+00,9506,0,5268,16379,257,96,1113,146,4036,230,37031,107,27053,25940,20672,9506
2022-05-10 10:00:00+00,9165,0,5253,16314,244,0,1123,131,4672,316,37218,102,27606,26483,21230,9165
2022-05-10 10:30:00+00,8912,0,5251,16055,234,0,1118,203,5717,628,38118,97,28375,27257,22006,8912
2022-05-10 11:00:00+00,8880,0,5250,16351,237,0,1112,253,6348,0,38431,97,29298,28186,22936,8880
2022-05-10 11:30:00+00,8315,0,5251,16230,234,0,1122,251,7058,72,38533,90,29895,28773,23522,8315
2022-05-10 12:00:00+00,7740,0,5258,16291,247,0,1122,115,6733,0,37506,86,29651,28529,23271,7740
2022-05-10 12:30:00+00,6955,0,5253,16192,241,0,1121,100,7241,0,37103,78,30048,28927,23674,6955
2022-05-10 13:00:00+00,7237,0,5252,15948,218,0,1212,114,7093,0,37074,82,29723,28511,23259,7237
2022-05-10 13:30:00+00,7088,0,5266,15937,219,0,1204,101,7136,0,36951,80,29762,28558,23292,7088
2022-05-10 14:00:00+00,7193,0,5267,15960,236,0,1301,104,6836,0,36897,82,29600,28299,23032,7193
2022-05-10 14:30:00+00,8160,0,5261,15390,248,34,1420,116,6115,0,36744,94,28434,27014,21753,8160
2022-05-10 15:00:00+00,9420,0,5254,15055,245,128,1430,154,5667,0,37353,107,27651,26221,20967,9420
2022-05-10 15:30:00+00,10921,0,5247,14619,244,232,1394,145,5009,10,37821,122,26513,25119,19872,10921
2022-05-10 16:00:00+00,12336,0,5242,14267,258,144,1497,173,4178,54,38149,135,25442,23945,18703,12336
2022-05-10 16:30:00+00,13226,0,5248,14504,272,252,1497,154,3153,0,38306,145,24674,23177,17929,13226
2022-05-10 17:00:00+00,13203,0,5247,14567,284,234,1503,172,2199,332,37741,147,23800,22297,17050,13203
2022-05-10 17:30:00+00,13218,0,5289,14323,279,268,1504,183,1431,674,37169,150,22826,21322,16033,13218
2022-05-10 18:00:00+00,13529,0,5290,13980,265,418,1499,200,941,728,36850,156,21975,20476,15186,13529
2022-05-10 18:30:00+00,13596,0,5284,13169,250,452,1406,236,405,916,35714,163,20514,19108,13824,13596
2022-05-10 19:00:00+00,14070,0,5289,12492,230,382,1455,357,100,826,35201,171,19566,18111,12822,14070
2022-05-10 19:30:00+00,14016,0,5283,12337,222,282,1457,303,1,698,34599,171,19300,17843,12560,14016
2022-05-10 20:00:00+00,13918,0,5288,12525,219,218,1441,246,0,584,34439,169,19473,18032,12744,13918
2022-05-10 20:30:00+00,13460,0,5292,13243,256,112,1281,142,0,72,33858,164,20072,18791,13499,13460
2022-05-10 21:00:00+00,12047,0,5294,13918,233,226,1111,116,0,0,32945,152,20556,19445,14151,12047
2022-05-10 21:30:00+00,10743,0,5303,14119,219,272,867,101,0,0,31624,142,20508,19641,14338,10743
2022-05-10 22:00:00+00,9954,0,5297,13493,191,434,520,112,0,0,30001,141,19501,18981,13684,9954
2022-05-10 22:30:00+00,8648,0,5301,13421,188,622,523,109,0,0,28812,131,19433,18910,13609,8648
2022-05-10 23:00:00+00,7665,0,5302,13560,181,588,513,110,0,0,27919,121,19556,19043,13741,7665
2022-05-10 23:30:00+00,7318,0,5300,13287,182,462,524,126,0,0,27199,118,19293,18769,13469,7318
2022-05-11 00:00:00+00,7112,0,5305,13329,149,482,506,103,0,0,26986,115,19289,18783,13478,7112
2022-05-11 00:30:00+00,6989,0,5303,13795,151,500,509,101,0,0,27348,112,19758,19249,13946,6989
2022-05-11 01:00:00+00,6843,0,5305,13943,137,442,512,104,0,0,27286,110,19897,19385,14080,6843
2022-05-11 01:30:00+00,6671,0,5307,13870,138,398,517,104,0,0,27005,108,19832,19315,14008,6671
2022-05-11 02:00:00+00,6877,0,5300,13667,154,247,523,107,0,0,26875,109,19644,19121,13821,6877
2022-05-11 02:30:00+00,6750,0,5308,13968,170,129,512,101,0,0,26938,104,19958,19446,14138,6750
2022-05-11 03:00:00+00,6240,0,5298,14353,176,54,513,101,0,0,26735,96,20340,19827,14529,6240
2022-05-11 03:30:00+00,6087,0,5300,14429,196,82,516,104,0,0,26714,95,20441,19925,14625,6087
2022-05-11 04:00:00+00,6099,0,5295,14458,198,0,566,109,0,0,26725,94,20517,19951,14656,6099
2022-05-11 04:30:00+00,6438,0,5296,14563,219,0,603,112,14,0,27245,97,20695,20092,14796,6438
2022-05-11 05:00:00+00,8048,0,5299,14323,232,0,843,127,109,284,29265,113,20806,19963,14664,8048
2022-05-11 05:30:00+00,9793,0,5295,14112,285,0,1294,137,338,140,31394,129,21324,20030,14735,9793
2022-05-11 06:00:00+00,11020,0,5295,14051,481,0,1522,195,643,102,33309,138,21992,20470,15175,11020
2022-05-11 06:30:00+00,11962,0,5290,13869,443,0,1980,224,889,400,35057,143,22471,20491,15201,11962
2022-05-11 07:00:00+00,12069,0,5293,13499,422,0,1982,376,1156,810,35607,143,22352,20370,15077,12069
2022-05-11 07:30:00+00,12148,0,5294,13302,417,0,1979,520,1491,1086,36237,143,22483,20504,15210,12148
2022-05-11 08:00:00+00,12507,0,5293,13478,413,0,2174,585,1818,250,36518,147,23176,21002,15709,12507
2022-05-11 08:30:00+00,12426,0,5289,13135,419,0,2177,564,1933,482,36425,146,22953,20776,15487,12426
2022-05-11 09:00:00+00,11855,0,5292,13443,353,1126,2065,514,2118,126,36892,143,23271,21206,15914,11855
2022-05-11 09:30:00+00,11810,0,5290,14117,327,1254,2109,213,2231,68,37419,139,24074,21965,16675,11810
2022-05-11 10:00:00+00,11680,0,5288,13947,322,1988,1751,104,2370,0,37450,138,23678,21927,16639,11680
2022-05-11 10:30:00+00,11894,0,5291,13916,308,2002,1596,102,2434,0,37543,139,23545,21949,16658,11894
2022-05-11 11:00:00+00,12077,0,5291,13673,296,2002,1570,104,2567,18,37598,141,23397,21827,16536,12077
2022-05-11 11:30:00+00,11960,0,5289,13490,293,2002,1448,101,3172,40,37795,139,23692,22244,16955,11960
2022-05-11 12:00:00+00,11646,0,5290,13118,286,2016,1452,104,3690,56,37658,136,23836,22384,17094,11646
2022-05-11 12:30:00+00,10819,0,5296,13353,286,2056,1445,101,4560,0,37916,127,24940,23495,18199,10819
2022-05-11 13:00:00+00,10193,0,5280,13693,287,2002,1440,101,4831,0,37827,120,25531,24091,18811,10193
2022-05-11 13:30:00+00,9526,0,5275,13569,287,1978,1452,107,4799,0,36993,115,25382,23930,18655,9526
2022-05-11 14:00:00+00,9207,0,5277,13423,272,1290,1451,125,4294,20,35359,113,24717,23266,17989,9207
2022-05-11 14:30:00+00,10074,0,5275,12985,288,1374,1442,115,4336,0,35889,122,24326,22884,17609,10074
2022-05-11 15:00:00+00,12359,0,5272,12615,334,322,1441,157,4584,278,37362,140,24246,22805,17533,12359
2022-05-11 15:30:00+00,13529,0,5273,12161,344,268,1655,157,4291,192,37870,151,23724,22069,16796,13529
2022-05-11 16:00:00+00,15083,0,5273,11309,381,272,2006,162,3642,120,38248,166,22611,20605,15332,15083
2022-05-11 16:30:00+00,15583,0,5269,10683,397,364,2177,155,3011,58,37697,175,21537,19360,14091,15583
2022-05-11 17:00:00+00,16027,0,5267,10262,413,372,2178,163,2518,178,37378,182,20638,18460,13193,16027
2022-05-11 17:30:00+00,16591,0,5275,10230,434,366,2180,213,1867,310,37466,188,19986,17806,12531,16591
2022-05-11 18:00:00+00,16323,0,5267,10080,451,304,2180,267,1228,1304,37404,185,19206,17026,11759,16323
2022-05-11 18:30:00+00,16207,0,5270,9597,431,290,2181,237,615,1488,36316,189,18094,15913,10643,16207
2022-05-11 19:00:00+00,16450,0,5270,9208,386,74,2181,228,152,1454,35403,193,17197,15016,9746,16450
2022-05-11 19:30:00+00,16431,0,5265,9103,356,0,2181,184,4,1352,34876,195,16909,14728,9463,16431
2022-05-11 20:00:00+00,16147,0,5268,9376,357,0,2180,157,0,1304,34789,192,17181,15001,9733,16147
2022-05-11 20:30:00+00,15875,0,5264,9625,352,0,2157,210,0,874,34357,192,17398,15241,9977,15875
2022-05-11 21:00:00+00,15129,0,5267,9673,270,0,1867,167,0,492,32865,190,17077,15210,9943,15129
2022-05-11 21:30:00+00,14506,0,5265,9620,269,0,1532,143,0,172,31507,189,16686,15154,9889,14506
2022-05-11 22:00:00+00,13081,0,5270,9804,240,0,1399,155,0,176,30125,178,16713,15314,10044,13081
2022-05-11 22:30:00+00,11618,0,5273,9742,235,90,1028,141,0,118,28245,169,16278,15250,9977,11618
2022-05-11 23:00:00+00,11107,0,5272,9835,226,16,891,116,0,46,27509,165,16224,15333,10061,11107
2022-05-11 23:30:00+00,10606,0,5282,10294,221,8,878,104,0,0,27394,158,16676,15798,10516,10606
2022-05-12 00:00:00+00,10482,0,5272,9930,196,0,845,138,0,0,26863,159,16243,15398,10126,10482
2022-05-12 00:30:00+00,10644,0,5272,9525,195,0,887,131,0,0,26654,163,15879,14992,9720,10644
2022-05-12 01:00:00+00,10680,0,5271,9402,194,0,887,129,0,0,26563,164,15754,14867,9596,10680
2022-05-12 01:30:00+00,10707,0,5268,9223,194,0,889,134,0,0,26415,165,15574,14685,9417,10707
2022-05-12 02:00:00+00,10691,0,5276,8799,193,0,891,117,0,0,25967,168,15159,14268,8992,10691
2022-05-12 02:30:00+00,10725,0,5277,8650,193,0,892,105,0,0,25842,169,15012,14120,8843,10725
2022-05-12 03:00:00+00,10952,0,5277,8506,192,0,893,109,0,0,25929,172,14868,13975,8698,10952
2022-05-12 03:30:00+00,11082,0,5275,8452,191,0,893,104,0,0,25997,173,14811,13918,8643,11082
2022-05-12 04:00:00+00,11273,0,5271,8410,192,0,1022,120,0,0,26288,175,14895,13873,8602,11273
2022-05-12 04:30:00+00,11735,0,5277,8376,201,0,1348,112,120,0,27169,177,15322,13974,8697,11735
2022-05-12 05:00:00+00,13298,0,5274,7993,257,0,1844,117,519,86,29388,187,15887,14043,8769,13298
2022-05-12 05:30:00+00,14602,0,5275,7364,278,0,2124,149,1087,378,31257,194,16128,14004,8729,14602
2022-05-12 06:00:00+00,15174,0,5276,7198,397,0,2141,238,1750,846,33020,191,16762,14621,9345,15174
2022-05-12 06:30:00+00,15317,0,5273,7330,397,0,2135,525,2508,1332,34817,185,17643,15508,10235,15317
2022-05-12 07:00:00+00,15438,0,5271,7644,398,100,2136,557,3200,1344,36088,181,18649,16513,11242,15438
2022-05-12 07:30:00+00,15334,0,5271,7782,397,104,2140,468,3968,918,36382,178,19558,17418,12147,15334
2022-05-12 08:00:00+00,15178,0,5268,8241,399,260,2135,435,4724,418,37058,174,20767,18632,13364,15178
2022-05-12 08:30:00+00,15038,0,5265,8316,396,214,2136,328,5197,374,37264,170,21310,19174,13909,15038
2022-05-12 09:00:00+00,14954,0,5263,8393,311,14,2135,230,5540,460,37300,167,21642,19507,14244,14954
2022-05-12 09:30:00+00,14377,0,5263,8881,305,14,2173,325,5829,268,37435,161,22451,20278,15015,14377
2022-05-12 10:00:00+00,13490,0,5264,9558,287,0,2179,303,6326,362,37769,150,23614,21435,16171,13490
2022-05-12 10:30:00+00,13343,0,5265,9948,279,0,2178,271,6403,324,38011,147,24073,21895,16630,13343
2022-05-12 11:00:00+00,13017,0,5264,10711,228,166,2177,120,5982,162,37827,145,24362,22185,16921,13017
2022-05-12 11:30:00+00,12713,0,5264,10812,229,224,2181,135,6331,102,37991,142,24817,22636,17372,12713
2022-05-12 12:00:00+00,12201,0,5266,10943,227,362,2144,107,6387,28,37665,139,24967,22823,17557,12201
2022-05-12 12:30:00+00,11490,0,5263,11211,228,308,2171,104,5896,0,36671,135,24769,22598,17335,11490
2022-05-12 13:00:00+00,11511,0,5253,10992,228,336,2169,112,6306,86,36993,135,24948,22779,17526,11511
2022-05-12 13:30:00+00,11648,0,5250,10879,227,358,2171,104,5764,44,36445,138,24291,22120,16870,11648
2022-05-12 14:00:00+00,11857,0,5259,11383,230,390,2170,101,5366,0,36756,140,24408,22238,16979,11857
2022-05-12 14:30:00+00,11685,0,5254,12316,242,426,2166,113,4635,0,36837,138,24613,22447,17193,11685
2022-05-12 15:00:00+00,12693,0,5254,12799,266,372,2120,134,4240,0,37878,144,24679,22559,17305,12693
2022-05-12 15:30:00+00,12974,0,5265,13308,294,564,2129,140,3500,0,38174,148,24496,22367,17102,12974
2022-05-12 16:00:00+00,14106,0,5257,13448,394,484,2161,151,2796,34,38831,157,24056,21895,16638,14106
2022-05-12 16:30:00+00,14440,0,5259,13467,420,526,2174,148,2264,12,38710,161,23584,21410,16151,14440
2022-05-12 17:00:00+00,14604,0,5257,13619,426,636,2174,246,1664,288,38914,164,23140,20966,15709,14604
2022-05-12 17:30:00+00,14947,0,5256,13612,431,666,2176,237,1099,0,38424,170,22574,20398,15142,14947
2022-05-12 18:00:00+00,14889,0,5257,13470,415,796,2179,249,625,38,37918,173,21946,19767,14510,14889
2022-05-12 18:30:00+00,14163,0,5257,13689,445,712,2178,274,281,368,37367,167,21850,19672,14415,14163
2022-05-12 19:00:00+00,13739,0,5257,13548,489,696,2180,168,43,528,36648,165,21517,19337,14080,13739
2022-05-12 19:30:00+00,14120,0,5255,13459,360,606,2173,122,0,376,36471,168,21247,19074,13819,14120
2022-05-12 20:00:00+00,14343,0,5249,12902,333,410,2146,122,0,366,35871,171,20630,18484,13235,14343
2022-05-12 20:30:00+00,13511,0,5255,13159,329,232,2103,127,0,0,34716,165,20846,18743,13488,13511
2022-05-12 21:00:00+00,11902,0,5253,13475,290,450,1730,130,0,0,33230,155,20748,19018,13765,11902
2022-05-12 21:30:00+00,10487,0,5254,14118,283,338,911,158,0,0,31549,141,20566,19655,14401,10487
2022-05-12 22:00:00+00,8770,0,5253,14528,312,444,438,201,0,44,29990,126,20531,20093,14840,8770
2022-05-12 22:30:00+00,6977,0,5261,15191,299,626,443,135,0,0,28932,108,21194,20751,15490,6977
2022-05-12 23:00:00+00,6465,0,5257,15193,275,634,445,160,0,0,28429,103,21170,20725,15468,6465
2022-05-12 23:30:00+00,6286,0,5264,15043,269,672,439,153,0,0,28126,103,21015,20576,15312,6286
2022-05-13 00:00:00+00,6050,0,5265,14889,258,676,434,111,0,0,27683,100,20846,20412,15147,6050
2022-05-13 00:30:00+00,5990,0,5265,14811,254,752,426,106,0,0,27604,101,20756,20330,15065,5990
2022-05-13 01:00:00+00,5815,0,5264,14708,236,864,434,109,0,0,27430,101,20642,20208,14944,5815
2022-05-13 01:30:00+00,5296,0,5264,15002,236,850,431,121,0,0,27200,94,20933,20502,15238,5296
2022-05-13 02:00:00+00,4902,0,5262,15078,236,886,454,121,0,0,26939,90,21030,20576,15314,4902
2022-05-13 02:30:00+00,4871,0,5266,15131,224,866,438,112,0,0,26908,89,21059,20621,15355,4871
2022-05-13 03:00:00+00,4951,0,5264,15062,224,894,426,104,0,0,26925,91,20976,20550,15286,4951
2022-05-13 03:30:00+00,5119,0,5272,15152,222,856,421,99,0,0,27141,92,21067,20646,15374,5119
2022-05-13 04:00:00+00,5126,0,5262,15169,221,892,543,101,1,0,27315,92,21196,20653,15391,5126
2022-05-13 04:30:00+00,5367,0,5255,14898,220,888,940,105,107,0,27780,96,21420,20480,15225,5367
2022-05-13 05:00:00+00,6372,0,5256,14952,243,774,1068,106,419,0,29190,104,21938,20870,15614,6372
2022-05-13 05:30:00+00,7683,0,5252,14882,288,882,1087,130,777,0,30981,116,22286,21199,15947,7683
2022-05-13 06:00:00+00,9133,0,5260,15029,398,906,1081,227,1290,224,33548,126,23058,21977,16717,9133
2022-05-13 06:30:00+00,9953,0,5260,15190,399,906,1101,271,1964,30,35074,130,23914,22813,17553,9953
2022-05-13 07:00:00+00,9700,0,5258,15824,398,858,1347,288,2582,60,36315,123,25409,24062,18804,9700
2022-05-13 07:30:00+00,9288,0,5257,16331,392,810,1413,248,3335,60,37134,115,26728,25315,20058,9288
2022-05-13 08:00:00+00,8249,0,5254,16563,307,830,1409,204,3809,216,36841,105,27342,25933,20679,8249
2022-05-13 08:30:00+00,7939,0,5252,16935,278,634,1421,189,3949,30,36627,100,27835,26414,21162,7939
2022-05-13 09:00:00+00,7669,0,5252,17002,261,488,1421,150,4574,198,37015,93,28510,27089,21837,7669
2022-05-13 09:30:00+00,7082,0,5251,17178,257,478,1420,155,5156,82,37059,86,29262,27842,22591,7082
2022-05-13 10:00:00+00,5292,0,5255,17299,225,1256,1415,199,5532,0,36473,75,29726,28311,23056,5292
2022-05-13 10:30:00+00,4990,0,5256,17264,221,1336,1408,134,6076,0,36685,71,30225,28817,23561,4990
2022-05-13 11:00:00+00,4521,0,5255,17261,220,1642,1403,118,6513,0,36933,64,30652,29249,23994,4521
2022-05-13 11:30:00+00,4300,0,5262,17242,217,1466,1371,170,6974,0,37002,60,31066,29695,24433,4300
2022-05-13 12:00:00+00,4138,0,5259,17220,204,1354,1397,191,7267,0,37030,58,31347,29950,24691,4138
2022-05-13 12:30:00+00,3933,0,5259,17229,205,1352,1275,215,7269,0,36737,56,31237,29962,24703,3933
2022-05-13 13:00:00+00,4008,0,5244,16977,207,1424,1260,195,7465,0,36780,56,31153,29893,24649,4008
2022-05-13 13:30:00+00,3760,0,5239,17190,209,1424,1219,129,7368,0,36538,53,31225,30006,24767,3760
2022-05-13 14:00:00+00,3457,0,5246,17381,237,1604,1252,111,7097,0,36385,50,31213,29961,24715,3457
2022-05-13 14:30:00+00,4074,0,5242,17203,254,1416,1267,115,6596,0,36167,56,30562,29295,24053,4074
2022-05-13 15:00:00+00,6011,0,5245,16921,264,0,1228,137,5901,0,35707,72,29559,28331,23086,6011
2022-05-13 15:30:00+00,6913,0,5250,16654,309,6,1218,130,5115,0,35595,82,28546,27328,22078,6913
2022-05-13 16:00:00+00,9586,0,5247,16365,427,0,1332,170,4108,74,37309,107,27479,26147,20900,9586
2022-05-13 16:30:00+00,11020,0,5247,15527,446,0,1358,196,3298,174,37266,122,25876,24518,19271,11020
2022-05-13 17:00:00+00,12110,0,5247,15033,457,0,1372,194,2526,0,36939,136,24635,23263,18016,12110
2022-05-13 17:30:00+00,12509,0,5242,15165,459,0,1374,212,1850,36,36847,141,24090,22716,17474,12509
2022-05-13 18:00:00+00,13312,0,5240,14140,478,0,1375,236,1184,408,36373,152,22417,21042,15802,13312
2022-05-13 18:30:00+00,13900,0,5242,13344,486,0,1379,335,645,126,35457,163,21096,19717,14475,13900
2022-05-13 19:00:00+00,14119,0,5245,12574,508,0,1350,293,209,372,34670,169,19886,18536,13291,14119
2022-05-13 19:30:00+00,14265,0,5240,11837,525,0,1328,341,7,528,34071,173,18937,17609,12369,14265
2022-05-13 20:00:00+00,14385,0,5242,10906,524,0,1327,356,0,980,33720,176,17999,16672,11430,14385
2022-05-13 20:30:00+00,14349,0,5238,10211,522,0,1371,388,0,998,33077,180,17342,15971,10733,14349
2022-05-13 21:00:00+00,14276,0,5233,9717,486,0,1362,436,0,640,32150,185,16798,15436,10203,14276
2022-05-13 21:30:00+00,14360,0,5233,9235,456,0,1096,434,0,30,30844,193,16020,14924,9691,14360
2022-05-13 22:00:00+00,14322,0,5237,8371,379,0,480,278,0,400,29467,197,14467,13987,8750,14322
2022-05-13 22:30:00+00,14018,0,5239,7813,326,0,419,169,0,368,28352,198,13797,13378,8139,14018
2022-05-13 23:00:00+00,13978,0,5243,7535,245,0,415,200,0,0,27616,203,13438,13023,7780,13978
2022-05-13 23:30:00+00,13572,0,5246,7377,264,0,413,157,0,0,27029,201,13300,12887,7641,13572
2022-05-14 00:00:00+00,13362,0,5240,7126,228,0,424,140,0,0,26520,202,13018,12594,7354,13362
2022-05-14 00:30:00+00,13413,0,5244,6902,208,0,418,145,0,0,26330,204,12772,12354,7110,13413
2022-05-14 01:00:00+00,13313,0,5244,6815,208,0,417,132,0,0,26129,204,12684,12267,7023,13313
2022-05-14 01:30:00+00,13344,0,5249,6593,208,0,415,121,0,0,25930,206,12465,12050,6801,13344
2022-05-14 02:00:00+00,13429,0,5239,6268,209,0,431,140,0,0,25716,209,12147,11716,6477,13429
2022-05-14 02:30:00+00,13488,0,5243,6019,209,0,419,130,0,0,25508,212,11890,11471,6228,13488
2022-05-14 03:00:00+00,13618,0,5237,5656,210,0,429,132,0,0,25282,216,11532,11103,5866,13618
2022-05-14 03:30:00+00,13804,0,5241,5356,209,0,421,125,0,0,25156,220,11227,10806,5565,13804
2022-05-14 04:00:00+00,14095,0,5242,5067,209,0,425,125,2,0,25165,224,10945,10520,5278,14095
2022-05-14 04:30:00+00,14291,0,5239,4735,211,0,424,123,153,0,25176,227,10762,10338,5099,14291
2022-05-14 05:00:00+00,14646,0,5236,4291,261,0,437,177,507,272,25827,228,10732,10295,5059,14646
2022-05-14 05:30:00+00,15207,0,5240,3739,290,0,634,295,981,284,26670,231,10884,10250,5010,15207
2022-05-14 06:00:00+00,15967,0,5239,3283,376,0,761,425,1656,230,27937,233,11315,10554,5315,15967
2022-05-14 06:30:00+00,16552,0,5241,3076,380,0,762,412,2355,230,29008,233,11814,11052,5811,16552
2022-05-14 07:00:00+00,15998,0,5239,3145,447,0,763,350,3239,476,29657,220,12833,12070,6831,15998
2022-05-14 07:30:00+00,16394,0,5246,3091,450,0,762,337,3987,494,30761,217,13536,12774,7528,16394
2022-05-14 08:00:00+00,16900,0,5240,2968,452,516,761,225,4682,98,31842,220,14103,13342,8102,16900
2022-05-14 08:30:00+00,16963,0,5242,2844,450,572,762,215,5714,0,32762,215,15012,14250,9008,16963
2022-05-14 09:00:00+00,15944,0,5240,2687,405,730,759,128,6401,84,32378,205,15492,14733,9493,15944
2022-05-14 09:30:00+00,15575,0,5242,2691,387,750,760,118,7319,0,32842,198,16399,15639,10397,15575
2022-05-14 10:00:00+00,14747,0,5241,2741,330,1060,759,120,7904,0,32902,191,16975,16216,10975,14747
2022-05-14 10:30:00+00,14291,0,5238,2606,299,1100,757,121,8551,144,33107,184,17451,16694,11456,14291
2022-05-14 11:00:00+00,13551,0,5243,2462,283,1998,760,119,8962,0,33378,176,17710,16950,11707,13551
2022-05-14 11:30:00+00,13006,0,5244,2394,283,2034,758,120,9175,0,33014,172,17854,17096,11852,13006
2022-05-14 12:00:00+00,12746,0,5246,2324,256,1762,756,131,9481,0,32702,170,18063,17307,12061,12746
2022-05-14 12:30:00+00,12314,0,5242,2320,248,1760,758,121,9423,0,32186,167,17991,17233,11991,12314
2022-05-14 13:00:00+00,12308,0,5223,2370,227,1434,757,120,9210,0,31649,168,17787,17030,11807,12308
2022-05-14 13:30:00+00,12130,0,5217,2392,209,1388,757,121,8752,0,30966,169,17327,16570,11353,12130
2022-05-14 14:00:00+00,14281,0,5218,2438,257,0,760,129,8182,106,31371,184,16855,16095,10877,14281
2022-05-14 14:30:00+00,15270,0,5215,2418,306,0,761,157,7485,22,31634,195,16185,15424,10209,15270
2022-05-14 15:00:00+00,15927,0,5215,2343,405,0,760,170,6638,102,31560,203,15361,14601,9386,15927
2022-05-14 15:30:00+00,16663,0,5218,2266,462,0,760,246,5674,146,31435,214,14380,13620,8402,16663
2022-05-14 16:00:00+00,17043,0,5219,2156,537,274,760,636,4705,718,32048,219,13377,12617,7398,17043
2022-05-14 16:30:00+00,17553,0,5218,2037,587,344,761,712,3623,1316,32151,226,12226,11465,6247,17553
2022-05-14 17:00:00+00,17664,0,5244,1851,635,660,764,764,2675,1360,31617,232,11169,10405,5161,17664
2022-05-14 17:30:00+00,17558,0,5255,1764,636,694,666,791,1874,1858,31096,234,10195,9529,4274,17558
2022-05-14 18:00:00+00,17502,0,5260,1727,631,694,423,860,1161,1860,30118,241,9202,8779,3519,17502
2022-05-14 18:30:00+00,17552,0,5255,1679,628,694,422,842,555,1590,29217,249,8539,8117,2862,17552
2022-05-14 19:00:00+00,17505,0,5253,1703,613,694,572,774,173,1698,28985,250,8314,7742,2489,17505
2022-05-14 19:30:00+00,17087,0,5257,1733,597,694,766,774,9,1644,28561,249,8362,7596,2339,17087
2022-05-14 20:00:00+00,16900,0,5265,1797,598,694,772,711,0,1648,28385,247,8432,7660,2395,16900
2022-05-14 20:30:00+00,16669,0,5314,1865,590,694,771,544,0,1596,28043,245,8540,7769,2455,16669
2022-05-14 21:00:00+00,16828,0,5324,1902,574,764,772,554,0,1214,27932,250,8572,7800,2476,16828
2022-05-14 21:30:00+00,16617,0,5342,1934,546,726,747,535,0,816,27263,252,8569,7822,2480,16617
2022-05-14 22:00:00+00,17239,0,5344,2087,531,314,480,477,0,466,26938,262,8442,7962,2618,17239
2022-05-14 22:30:00+00,16801,0,5348,2155,509,272,434,333,0,194,26046,261,8446,8012,2664,16801
2022-05-14 23:00:00+00,16357,0,5342,2257,328,22,429,259,0,2,24996,264,8356,7927,2585,16357
2022-05-14 23:30:00+00,15881,0,5341,2355,328,0,428,201,0,0,24534,261,8452,8024,2683,15881
2022-05-15 00:00:00+00,15760,0,5336,2342,311,80,420,147,0,0,24396,260,8409,7989,2653,15760
2022-05-15 00:30:00+00,15420,0,5336,2385,310,76,429,157,0,36,24149,257,8460,8031,2695,15420
2022-05-15 01:00:00+00,15802,0,5368,2544,271,264,419,141,0,0,24809,260,8602,8183,2815,15802
2022-05-15 01:30:00+00,15310,0,5360,2731,200,246,422,141,0,0,24410,256,8713,8291,2931,15310
2022-05-15 02:00:00+00,14983,0,5371,2756,199,252,425,127,0,0,24113,253,8751,8326,2955,14983
2022-05-15 02:30:00+00,14856,0,5396,2884,199,268,427,127,0,0,24157,251,8906,8479,3083,14856
2022-05-15 03:00:00+00,14447,0,5409,3110,199,290,421,120,0,0,23996,246,9138,8718,3308,14447
2022-05-15 03:30:00+00,14220,0,5410,3488,199,276,425,119,0,0,24137,241,9522,9097,3687,14220
2022-05-15 04:00:00+00,13795,0,5429,3773,199,130,441,135,0,0,23902,234,9842,9401,3972,13795
2022-05-15 04:30:00+00,13804,0,5438,3803,199,220,432,130,29,0,24055,234,9901,9469,4031,13804
2022-05-15 05:00:00+00,13759,0,5438,3960,300,136,430,142,157,0,24322,229,10285,9855,4417,13759
2022-05-15 05:30:00+00,13761,0,5438,4241,345,134,416,127,353,0,24815,225,10793,10377,4939,13761
2022-05-15 06:00:00+00,13487,0,5431,4321,498,40,426,141,706,0,25050,217,11382,10956,5525,13487
2022-05-15 06:30:00+00,13733,0,5436,4339,515,150,415,172,1282,0,26042,214,11987,11572,6136,13733
2022-05-15 07:00:00+00,13551,0,5433,4372,440,0,416,147,1989,6,26354,206,12650,12234,6801,13551
2022-05-15 07:30:00+00,13890,0,5441,4480,439,0,416,176,2621,92,27555,202,13397,12981,7540,13890
2022-05-15 08:00:00+00,11740,0,5443,4996,436,1330,321,138,2904,26,27334,179,14100,13779,8336,11740
2022-05-15 08:30:00+00,11737,0,5441,5318,423,1492,116,192,3341,150,28210,174,14639,14523,9082,11737
2022-05-15 09:00:00+00,11886,0,5441,5696,296,2514,116,153,3347,52,29502,172,14896,14780,9339,11886
2022-05-15 09:30:00+00,11900,0,5437,6446,270,2550,116,116,3940,0,30775,165,16209,16093,10656,11900
2022-05-15 10:00:00+00,11866,0,5430,7146,214,3206,115,116,4389,0,32482,158,17294,17179,11749,11866
2022-05-15 10:30:00+00,11758,0,5435,7775,212,3230,116,118,4052,0,32696,155,17590,17474,12039,11758
2022-05-15 11:00:00+00,11693,0,5433,8324,195,4058,115,160,4350,0,34328,148,18417,18302,12869,11693
2022-05-15 11:30:00+00,11542,0,5434,9020,194,4102,115,157,4049,0,34613,145,18812,18697,13263,11542
2022-05-15 12:00:00+00,11407,0,5443,9861,178,4062,110,155,3986,0,35201,141,19578,19468,14025,11407
2022-05-15 12:30:00+00,11166,0,5457,10799,178,4058,110,155,4168,0,36091,135,20712,20602,15145,11166
2022-05-15 13:00:00+00,11029,0,5451,11381,193,3066,114,175,3788,0,35197,135,20927,20813,15362,11029
2022-05-15 13:30:00+00,10860,0,5454,11894,178,3006,116,166,3175,0,34849,134,20817,20701,15247,10860
2022-05-15 14:00:00+00,10813,0,5453,12345,175,0,116,168,2723,0,31793,136,20812,20696,15243,10813
2022-05-15 14:30:00+00,10895,0,5454,13039,185,0,116,161,2268,0,32118,136,21062,20946,15492,10895
2022-05-15 15:00:00+00,11093,0,5453,13231,336,76,115,172,2063,134,32673,137,21198,21083,15630,11093
2022-05-15 15:30:00+00,11559,0,5488,13276,402,236,115,177,1793,0,33047,143,21074,20959,15471,11559
2022-05-15 16:00:00+00,11967,0,5496,13171,514,336,116,384,1559,652,34195,146,20856,20740,15244,11967
2022-05-15 16:30:00+00,12437,0,5502,12959,546,386,116,493,1078,860,34377,152,20201,20085,14583,12437
2022-05-15 17:00:00+00,12678,0,5496,13102,546,424,116,509,762,888,34521,155,20022,19906,14410,12678
2022-05-15 17:30:00+00,12820,0,5502,13056,546,440,119,506,534,924,34447,157,19757,19638,14136,12820
2022-05-15 18:00:00+00,12861,0,5496,13723,533,546,116,499,352,542,34668,158,20220,20104,14608,12861
2022-05-15 18:30:00+00,12857,0,5500,14110,523,460,115,491,185,372,34613,157,20433,20318,14818,12857
2022-05-15 19:00:00+00,12773,0,5497,14412,471,522,115,497,52,240,34579,157,20547,20432,14935,12773
2022-05-15 19:30:00+00,12493,0,5508,14571,467,322,116,326,3,0,33806,153,20665,20549,15041,12493
2022-05-15 20:00:00+00,12213,0,5568,14788,360,228,116,309,0,20,33602,149,20832,20716,15148,12213
2022-05-15 20:30:00+00,11957,0,5560,14460,349,144,116,225,0,68,32879,148,20485,20369,14809,11957
2022-05-15 21:00:00+00,11235,0,5559,14227,284,22,116,185,0,0,31628,142,20186,20070,14511,11235
2022-05-15 21:30:00+00,9731,0,5554,14149,287,0,143,195,0,42,30101,130,20133,19990,14436,9731
2022-05-15 22:00:00+00,7877,0,5555,14454,262,50,312,210,0,0,28720,112,20583,20271,14716,7877
2022-05-15 22:30:00+00,6366,0,5547,14589,218,272,416,187,0,0,27595,99,20770,20354,14807,6366
2022-05-15 23:00:00+00,6267,0,5549,14493,197,454,416,166,0,0,27542,101,20655,20239,14690,6267
2022-05-15 23:30:00+00,5633,0,5557,14025,148,496,414,157,0,0,26430,96,20144,19730,14173,5633
2022-05-16 00:00:00+00,5317,0,5550,13939,146,626,414,172,0,0,26164,95,20049,19635,14085,5317
2022-05-16 00:30:00+00,5724,0,5552,13715,145,662,414,192,0,0,26404,101,19826,19412,13860,5724
2022-05-16 01:00:00+00,6520,0,5551,13321,130,660,416,182,0,0,26780,111,19418,19002,13451,6520
2022-05-16 01:30:00+00,6429,0,5554,13052,130,640,453,191,0,0,26449,111,19189,18736,13182,6429
2022-05-16 02:00:00+00,6280,0,5552,12769,133,674,482,190,0,0,26080,111,18936,18454,12902,6280
2022-05-16 02:30:00+00,6510,0,5554,12261,134,740,502,173,0,0,25874,117,18451,17949,12395,6510
2022-05-16 03:00:00+00,6874,0,5552,12179,133,686,526,176,0,0,26126,120,18390,17864,12312,6874
2022-05-16 03:30:00+00,7177,0,5558,12015,133,580,599,160,0,0,26222,123,18305,17706,12148,7177
2022-05-16 04:00:00+00,7265,0,5566,12008,152,474,787,169,2,0,26423,122,18515,17728,12162,7265
2022-05-16 04:30:00+00,8145,0,5575,11975,161,442,516,302,115,0,27231,131,18342,17826,12251,8145
2022-05-16 05:00:00+00,9630,0,5579,12246,218,192,533,312,284,0,28994,139,18860,18327,12748,9630
2022-05-16 05:30:00+00,11046,0,5581,12409,232,196,714,215,424,0,30817,149,19360,18646,13065,11046
2022-05-16 06:00:00+00,13785,0,5576,12400,330,40,757,181,659,0,33728,166,19722,18965,13389,13785
2022-05-16 06:30:00+00,15217,0,5574,12511,333,28,754,205,949,0,35571,173,20121,19367,13793,15217
2022-05-16 07:00:00+00,15415,0,5574,12495,404,119,759,210,1543,0,36519,172,20775,20016,14442,15415
2022-05-16 07:30:00+00,16089,0,5578,12245,404,37,757,198,2110,0,37419,174,21094,20337,14759,16089
2022-05-16 08:00:00+00,16422,0,5579,12385,380,16,759,281,2141,0,37963,175,21244,20485,14906,16422
2022-05-16 08:30:00+00,16504,0,5638,12143,378,2,761,233,2222,0,37881,176,21142,20381,14743,16504
2022-05-16 09:00:00+00,16632,0,5689,11587,361,65,761,219,2506,316,38136,177,20904,20143,14454,16632
2022-05-16 09:30:00+00,16545,0,5708,11036,390,144,759,558,3173,306,38620,177,21066,20307,14599,16545
2022-05-16 10:00:00+00,16759,0,5699,10381,337,124,756,588,3776,248,38668,179,20949,20193,14494,16759
2022-05-16 10:30:00+00,16476,0,5699,9953,328,132,757,633,4347,532,38857,176,21084,20327,14628,16476
2022-05-16 11:00:00+00,16758,0,5692,9379,315,166,756,647,4450,662,38825,179,20592,19836,14144,16758
2022-05-16 11:30:00+00,16754,0,5697,9347,332,38,761,710,4099,332,38070,182,20236,19475,13778,16754
2022-05-16 12:00:00+00,16651,0,5692,8912,316,0,736,647,4707,250,37911,181,20363,19627,13935,16651
2022-05-16 12:30:00+00,16570,0,5695,9007,312,0,669,474,5297,0,38024,178,20980,20311,14616,16570
2022-05-16 13:00:00+00,16618,0,5679,8776,304,0,643,432,5497,134,38083,177,20899,20256,14577,16618
2022-05-16 13:30:00+00,16505,0,5671,8717,302,0,685,404,5729,0,38013,176,21104,20419,14748,16505
2022-05-16 14:00:00+00,16587,0,5674,8549,238,0,704,335,5219,162,37468,179,20384,19680,14006,16587
2022-05-16 14:30:00+00,17066,0,5678,8305,257,0,707,251,4908,384,37556,183,19855,19148,13470,17066
2022-05-16 15:00:00+00,17209,0,5679,8106,414,46,757,253,4019,238,36721,190,18975,18218,12539,17209
2022-05-16 15:30:00+00,17430,0,5683,7919,454,200,758,369,3902,348,37063,193,18716,17958,12275,17430
2022-05-16 16:00:00+00,17507,0,5687,7433,611,208,758,603,3458,1124,37389,194,17947,17189,11502,17507
2022-05-16 16:30:00+00,17555,0,5688,7204,676,302,758,742,2788,1430,37143,198,17114,16356,10668,17555
2022-05-16 17:00:00+00,17720,0,5694,7333,678,246,758,785,1943,1686,36843,202,16406,15648,9954,17720
2022-05-16 17:30:00+00,17774,0,5690,7180,690,384,770,822,1389,1688,36387,207,15719,14949,9259,17774
2022-05-16 18:00:00+00,17665,0,5689,7219,657,532,774,907,846,1462,35751,212,15185,14411,8722,17665
2022-05-16 18:30:00+00,17395,0,5682,7003,627,550,761,741,470,1928,35157,212,14543,13782,8100,17395
2022-05-16 19:00:00+00,17524,0,5684,7302,627,712,760,672,158,1338,34777,217,14531,13771,8087,17524
2022-05-16 19:30:00+00,17535,0,5678,7554,560,728,758,498,10,944,34265,219,14560,13802,8124,17535
2022-05-16 20:00:00+00,17168,0,5681,7797,370,740,759,655,0,410,33580,221,14607,13848,8167,17168
2022-05-16 20:30:00+00,16419,0,5686,8368,356,740,763,475,0,0,32807,215,15173,14410,8724,16419
2022-05-16 21:00:00+00,15527,0,5681,8437,282,740,739,235,0,32,31673,209,15139,14400,8719,15527
2022-05-16 21:30:00+00,14403,0,5679,8298,282,740,524,198,0,190,30314,202,14784,14260,8580,14403
2022-05-16 22:00:00+00,13092,0,5683,8423,272,740,515,176,0,0,28901,194,14893,14378,8695,13092
2022-05-16 22:30:00+00,11925,0,5669,8497,254,740,524,188,0,0,27797,186,14944,14420,8751,11925
2022-05-16 23:00:00+00,11825,0,5669,7987,222,740,519,177,0,0,27139,188,14397,13878,8209,11825
2022-05-16 23:30:00+00,11826,0,5673,7865,201,740,516,177,0,0,26998,189,14255,13739,8066,11826
2022-05-17 00:00:00+00,11312,0,5676,7841,178,740,512,185,0,0,26444,186,14207,13695,8019,11312
2022-05-17 00:30:00+00,11064,0,5677,7909,178,740,521,186,0,0,26275,183,14285,13764,8087,11064
2022-05-17 01:00:00+00,10949,0,5675,7512,142,740,535,202,0,0,25755,186,13864,13329,7654,10949
2022-05-17 01:30:00+00,11132,0,5680,7084,141,740,604,194,0,0,25575,190,13509,12905,7225,11132
2022-05-17 02:00:00+00,11368,0,5684,6632,140,740,560,186,0,0,25310,195,13016,12456,6772,11368
2022-05-17 02:30:00+00,11614,0,5685,6320,142,740,555,181,0,0,25237,200,12702,12147,6462,11614
2022-05-17 03:00:00+00,11644,0,5687,6136,159,740,529,182,0,0,25077,201,12511,11982,6295,11644
2022-05-17 03:30:00+00,11638,0,5689,6029,158,740,522,177,0,0,24953,202,12398,11876,6187,11638
2022-05-17 04:00:00+00,11718,0,5685,5928,211,740,524,184,6,0,24996,203,12354,11830,6145,11718
2022-05-17 04:30:00+00,12465,0,5690,5833,228,740,516,175,161,0,25808,208,12428,11912,6222,12465
2022-05-17 05:00:00+00,14318,0,5684,5737,352,740,527,188,524,106,28176,217,12824,12297,6613,14318
2022-05-17 05:30:00+00,15730,0,5688,5824,390,740,533,188,1063,182,30338,219,13498,12965,7277,15730
2022-05-17 06:00:00+00,17117,0,5692,5807,565,740,679,323,1768,186,32877,221,14511,13832,8140,17117
2022-05-17 06:30:00+00,17391,0,5686,5884,603,740,741,556,2524,580,34705,215,15438,14697,9011,17391
2022-05-17 07:00:00+00,17420,0,5686,5765,611,740,690,588,3308,740,35548,210,16060,15370,9684,17420
2022-05-17 07:30:00+00,16919,0,5682,6134,556,724,690,557,4034,740,36036,201,17096,16406,10724,16919
2022-05-17 08:00:00+00,16926,0,5686,6354,475,580,692,564,5038,580,36895,195,18245,17553,11867,16926
2022-05-17 08:30:00+00,16705,0,5687,6367,483,436,715,503,5861,572,37329,188,19113,18398,12711,16705
2022-05-17 09:00:00+00,17055,0,5685,6399,467,397,748,368,6377,156,37652,189,19676,18928,13243,17055
2022-05-17 09:30:00+00,17088,0,5685,6436,453,326,731,252,6795,0,37766,187,20100,19369,13684,17088
2022-05-17 10:00:00+00,16930,0,5682,6723,419,336,625,222,6917,14,37868,184,20366,19741,14059,16930
2022-05-17 10:30:00+00,16773,0,5682,6832,354,324,585,239,7386,204,38379,180,20839,20254,14572,16773
2022-05-17 11:00:00+00,16578,0,5679,6925,318,450,693,264,8048,170,39125,176,21663,20970,15291,16578
2022-05-17 11:30:00+00,16317,0,5351,7188,313,392,640,291,7893,0,38385,176,21385,20745,15394,16317
2022-05-17 12:00:00+00,16174,0,5677,7374,235,334,573,315,6949,0,37631,178,20808,20235,14558,16174
2022-05-17 12:30:00+00,16202,0,5680,7689,234,142,564,261,6781,0,37553,176,20948,20384,14704,16202
2022-05-17 13:00:00+00,16451,0,5682,8268,220,152,562,218,5933,0,37486,178,20665,20103,14421,16451
2022-05-17 13:30:00+00,15725,0,5681,8903,218,60,561,205,5346,0,36699,173,20709,20148,14467,15725
2022-05-17 14:00:00+00,15153,0,5684,9541,290,0,623,212,4929,36,36468,168,21067,20444,14760,15153
2022-05-17 14:30:00+00,15361,0,5678,10264,316,0,661,222,5010,48,37560,165,21929,21268,15590,15361
2022-05-17 15:00:00+00,16041,0,5685,10679,413,2,581,232,3949,118,37700,171,21307,20726,15041,16041
2022-05-17 15:30:00+00,15976,0,5674,11494,462,2,561,240,3334,74,37816,170,21525,20964,15290,15976
2022-05-17 16:00:00+00,16196,0,5681,11742,570,1,564,276,2729,278,38037,172,21286,20722,15041,16196
2022-05-17 16:30:00+00,16250,0,5681,11938,547,1,587,303,1985,522,37814,174,20738,20151,14470,16250
2022-05-17 17:00:00+00,16350,0,5679,12778,525,0,615,406,1238,36,37627,176,20835,20220,14541,16350
2022-05-17 17:30:00+00,16305,0,5682,13195,511,2,556,399,935,0,37585,176,20879,20323,14641,16305
2022-05-17 18:00:00+00,15679,0,5677,13600,457,78,524,400,574,38,37027,173,20832,20308,14631,15679
2022-05-17 18:30:00+00,15009,0,5680,13351,398,92,523,390,260,122,35825,171,20212,19689,14009,15009
2022-05-17 19:00:00+00,14657,0,5678,12905,336,224,516,228,114,92,34750,173,19549,19033,13355,14657
2022-05-17 19:30:00+00,14086,0,5676,13209,343,248,516,223,10,0,34311,169,19754,19238,13562,14086
2022-05-17 20:00:00+00,13296,0,5665,13395,284,248,521,232,0,34,33675,163,19865,19344,13679,13296
2022-05-17 20:30:00+00,12277,0,5668,14280,263,248,510,206,0,0,33452,152,20721,20211,14543,12277
2022-05-17 21:00:00+00,10547,0,5661,14180,215,250,530,235,0,176,31794,139,20586,20056,14395,10547
2022-05-17 21:30:00+00,9378,0,5668,13871,212,249,527,200,0,52,30158,130,20278,19751,14083,9378
2022-05-17 22:00:00+00,8273,0,5661,13397,193,179,585,244,0,102,28634,122,19836,19251,13590,8273
2022-05-17 22:30:00+00,7453,0,5664,13129,184,94,555,189,0,0,27268,114,19532,18977,13313,7453
2022-05-17 23:00:00+00,7108,0,5660,13378,183,211,544,180,0,0,27263,111,19765,19221,13561,7108
2022-05-17 23:30:00+00,6370,0,5659,13583,191,251,531,183,0,0,26769,102,19964,19433,13774,6370
2022-05-18 00:00:00+00,6155,0,5653,13778,176,252,521,205,0,0,26740,100,20128,19607,13954,6155
2022-05-18 00:30:00+00,6066,0,5663,13994,169,250,513,199,0,0,26854,98,20339,19826,14163,6066
2022-05-18 01:00:00+00,6015,0,5661,14375,170,250,514,185,0,0,27171,96,20720,20206,14545,6015
2022-05-18 01:30:00+00,5846,0,5656,14061,176,250,534,200,0,0,26723,95,20427,19893,14237,5846
2022-05-18 02:00:00+00,5822,0,5660,13934,174,249,533,195,0,0,26568,95,20301,19768,14108,5822
2022-05-18 02:30:00+00,5855,0,5665,13956,175,246,535,193,0,0,26625,95,20331,19796,14131,5855
2022-05-18 03:00:00+00,5912,0,5667,13908,193,246,600,200,0,0,26726,96,20368,19768,14101,5912
2022-05-18 03:30:00+00,5886,0,5667,13463,195,246,597,185,0,0,26239,98,19922,19325,13658,5886
2022-05-18 04:00:00+00,6143,0,5667,13161,225,248,624,189,7,0,26264,102,19684,19060,13393,6143
2022-05-18 04:30:00+00,6458,0,5670,12522,225,198,652,197,175,0,26097,106,19245,18593,12922,6458
2022-05-18 05:00:00+00,7222,0,5670,12072,261,62,765,226,605,0,26884,113,19373,18608,12938,7222
2022-05-18 05:30:00+00,8152,0,5672,11329,282,0,907,217,1222,0,27781,122,19412,18505,12833,8152
2022-05-18 06:00:00+00,9510,0,5670,10391,347,2,826,217,1976,196,29134,134,19209,18383,12714,9510
2022-05-18 06:30:00+00,10723,0,5667,10236,373,1,682,326,2733,432,31174,141,19691,19009,13342,10723
2022-05-18 07:00:00+00,11824,0,5667,10406,470,0,740,357,3401,148,33013,147,20684,19944,14277,11824
2022-05-18 07:30:00+00,12487,0,5668,10166,465,0,739,331,4198,350,34404,148,21236,20497,14829,12487
2022-05-18 08:00:00+00,12965,0,5663,9776,407,0,749,346,4788,514,35208,151,21383,20634,14971,12965
2022-05-18 08:30:00+00,13292,0,5658,9474,395,2,756,354,5596,228,35755,152,21879,21123,15465,13292
2022-05-18 09:00:00+00,13706,0,5643,9175,350,17,686,372,6400,0,36350,155,22254,21568,15925,13706
2022-05-18 09:30:00+00,13695,0,5627,8650,329,52,410,237,7177,56,36233,153,22193,21783,16156,13695
2022-05-18 10:00:00+00,13838,0,5624,8444,252,78,411,240,7559,0,36447,154,22291,21880,16255,13838
2022-05-18 10:30:00+00,13960,0,5626,8358,220,88,410,209,7935,0,36805,154,22549,22139,16513,13960
2022-05-18 11:00:00+00,14142,0,5635,8286,208,220,410,142,8335,0,37377,154,22874,22464,16829,14142
2022-05-18 11:30:00+00,14242,0,5640,8308,208,194,410,142,8652,0,37796,153,23218,22808,17168,14242
2022-05-18 12:00:00+00,13665,0,5643,8353,209,156,505,141,8645,0,37317,149,23355,22850,17207,13665
2022-05-18 12:30:00+00,13781,0,5644,8224,185,158,509,142,8428,0,37071,151,22990,22481,16837,13781
2022-05-18 13:00:00+00,13913,0,5645,8245,161,216,582,146,7723,0,36631,155,22356,21774,16129,13913
2022-05-18 13:30:00+00,14084,0,5645,8485,139,246,699,142,6655,0,36095,160,21623,20924,15279,14084
2022-05-18 14:00:00+00,14363,0,5644,8874,184,248,684,152,5934,0,36083,164,21320,20636,14992,14363
2022-05-18 14:30:00+00,14976,0,5646,9404,228,248,407,153,4971,0,36033,170,20656,20249,14603,14976
2022-05-18 15:00:00+00,15333,0,5647,9797,302,246,409,185,4420,12,36351,172,20575,20166,14519,15333
2022-05-18 15:30:00+00,16169,0,5645,9559,423,246,409,194,3296,162,36103,183,19332,18923,13278,16169
2022-05-18 16:00:00+00,16855,0,5644,9672,581,232,412,317,2530,424,36667,188,18839,18427,12783,16855
2022-05-18 16:30:00+00,17097,0,5644,10251,615,214,406,477,1877,110,36691,191,18793,18387,12743,17097
2022-05-18 17:00:00+00,17041,0,5649,10522,519,224,412,458,1207,684,36716,191,18309,17897,12248,17041
2022-05-18 17:30:00+00,17145,0,5654,10739,538,242,516,580,812,170,36396,195,18259,17743,12089,17145
2022-05-18 18:00:00+00,17161,0,5653,10986,582,248,548,539,439,436,36592,194,18208,17660,12007,17161
2022-05-18 18:30:00+00,17044,0,5656,11482,568,248,409,489,215,142,36253,194,18330,17921,12265,17044
2022-05-18 19:00:00+00,16715,0,5653,12078,408,248,411,445,73,0,36031,191,18623,18212,12559,16715
2022-05-18 19:30:00+00,16013,0,5654,12332,400,248,412,323,3,0,35385,186,18801,18389,12735,16013
2022-05-18 20:00:00+00,15052,0,5652,12645,366,248,422,198,0,0,34583,178,19085,18663,13011,15052
2022-05-18 20:30:00+00,13421,0,5656,13491,352,246,410,155,0,0,33731,163,19909,19499,13843,13421
2022-05-18 21:00:00+00,11639,0,5646,13647,252,246,417,162,0,0,32009,150,19962,19545,13899,11639
2022-05-18 21:30:00+00,10343,0,5650,12991,233,246,409,177,0,0,30049,143,19283,18874,13224,10343
2022-05-18 22:00:00+00,9963,0,5650,12563,220,246,418,158,0,0,29218,142,18851,18433,12783,9963
2022-05-18 22:30:00+00,9854,0,5660,11702,217,246,419,160,0,0,28258,145,17998,17579,11919,9854
2022-05-18 23:00:00+00,9740,0,5654,11269,203,248,419,150,0,0,27683,146,17545,17126,11472,9740
2022-05-18 23:30:00+00,9348,0,5659,11460,191,248,415,141,0,0,27462,142,17725,17310,11651,9348
2022-05-19 00:00:00+00,8909,0,5640,11309,150,250,427,150,0,0,26835,139,17526,17099,11459,8909
2022-05-19 00:30:00+00,9200,0,5641,10767,150,251,433,152,0,0,26594,144,16991,16558,10917,9200
2022-05-19 01:00:00+00,9919,0,5642,9637,116,250,451,147,0,0,26162,158,15846,15395,9753,9919
2022-05-19 01:30:00+00,10145,0,5650,9096,105,248,517,141,0,0,25902,163,15368,14851,9201,10145
2022-05-19 02:00:00+00,10435,0,5648,7888,104,248,600,150,0,0,25073,173,14240,13640,7992,10435
2022-05-19 02:30:00+00,10505,0,5649,7349,104,248,659,154,0,0,24668,177,13761,13102,7453,10505
2022-05-19 03:00:00+00,10579,0,5655,7010,106,246,716,149,0,14,24475,180,13487,12771,7116,10579
2022-05-19 03:30:00+00,10761,0,5655,6746,119,248,571,153,0,20,24273,184,13091,12520,6865,10761
2022-05-19 04:00:00+00,11395,0,5652,6028,134,248,521,156,3,28,24165,195,12338,11817,6165,11395
2022-05-19 04:30:00+00,12427,0,5655,5574,186,248,648,156,126,24,25044,205,12189,11541,5886,12427
2022-05-19 05:00:00+00,14196,0,5656,5252,229,248,710,176,453,328,27248,215,12300,11590,5934,14196
2022-05-19 05:30:00+00,15847,0,5656,5020,248,234,832,177,840,498,29352,222,12596,11764,6108,15847
2022-05-19 06:00:00+00,17224,0,5655,4511,397,106,1028,412,1217,1088,31638,224,12808,11780,6125,17224
2022-05-19 06:30:00+00,17770,0,5656,4390,560,152,1045,928,1605,1138,33244,225,13256,12211,6555,17770
2022-05-19 07:00:00+00,17914,0,5654,4457,579,42,1045,938,1918,770,33317,225,13653,12608,6954,17914
2022-05-19 07:30:00+00,17789,0,5658,4832,588,88,1044,942,2210,554,33705,221,14332,13288,7630,17789
2022-05-19 08:00:00+00,17739,0,5652,5160,586,234,1047,951,2735,796,34900,215,15180,14133,8481,17739
2022-05-19 08:30:00+00,17640,0,5652,5501,585,264,1046,847,3621,376,35532,210,16405,15359,9707,17640
2022-05-19 09:00:00+00,17881,0,5651,5788,572,168,1047,795,4658,420,36980,202,17716,16669,11018,17881
2022-05-19 09:30:00+00,17956,0,5648,5818,574,46,1046,740,5605,176,37609,198,18691,17645,11997,17956
2022-05-19 10:00:00+00,17701,0,5654,5821,538,162,980,579,6273,304,38012,193,19266,18286,12632,17701
2022-05-19 10:30:00+00,17254,0,5655,6232,473,152,1034,212,7097,58,38167,185,20491,19457,13802,17254
2022-05-19 11:00:00+00,16512,0,5664,6695,423,242,991,209,7704,0,38440,177,21477,20486,14822,16512
2022-05-19 11:30:00+00,15741,0,5653,7699,244,220,652,211,8511,70,39001,165,22759,22107,16454,15741
2022-05-19 12:00:00+00,15077,0,5655,8164,195,246,401,212,8946,0,38896,158,23361,22960,17305,15077
2022-05-19 12:30:00+00,14408,0,5644,8150,195,246,400,217,9081,0,38341,154,23470,23070,17426,14408
2022-05-19 13:00:00+00,14641,0,5629,7717,195,246,401,205,8850,0,37884,158,22792,22391,16762,14641
2022-05-19 13:30:00+00,14699,0,5622,7335,197,246,412,213,8432,0,37156,162,21998,21586,15964,14699
2022-05-19 14:00:00+00,15422,0,5630,7062,225,208,400,207,7758,4,36916,170,21075,20675,15045,15422
2022-05-19 14:30:00+00,16266,0,5623,6994,234,162,402,210,7094,0,36985,178,20347,19945,14322,16266
2022-05-19 15:00:00+00,16772,0,5629,7119,330,216,411,245,6195,38,36956,185,19684,19273,13644,16772
2022-05-19 15:30:00+00,17690,0,5623,7106,397,247,563,253,5349,4,37232,194,19038,18475,12852,17690
2022-05-19 16:00:00+00,18558,0,5628,6896,465,247,740,263,4289,116,37202,204,18018,17278,11650,18558
2022-05-19 16:30:00+00,19070,0,5631,6902,574,248,747,351,3465,6,36994,211,17319,16572,10941,19070
2022-05-19 17:00:00+00,18934,0,5628,6998,641,248,748,425,2749,336,36707,212,16764,16016,10388,18934
2022-05-19 17:30:00+00,19331,0,5632,6677,649,248,748,482,1974,610,36351,219,15680,14932,9300,19331
2022-05-19 18:00:00+00,19509,0,5639,6274,696,248,753,510,1200,982,35811,225,14562,13809,8170,19509
2022-05-19 18:30:00+00,19563,0,5639,6041,710,248,756,462,670,888,34977,230,13816,13060,7421,19563
2022-05-19 19:00:00+00,19452,0,5637,5830,708,248,757,413,195,868,34108,234,13127,12370,6733,19452
2022-05-19 19:30:00+00,19377,0,5580,5825,593,212,757,419,15,780,33558,237,12770,12013,6433,19377
2022-05-19 20:00:00+00,19561,0,5516,6012,425,194,755,438,0,308,33209,241,12708,11953,6437,19561
2022-05-19 20:30:00+00,19400,0,5510,6272,402,54,758,409,0,18,32823,240,12942,12184,6674,19400
2022-05-19 21:00:00+00,18799,0,5509,6463,299,0,732,196,0,330,32328,234,13003,12271,6762,18799
2022-05-19 21:30:00+00,17833,0,5509,6524,286,2,477,173,0,102,30906,231,12796,12319,6810,17833
2022-05-19 22:00:00+00,16392,0,5505,6473,244,1,451,176,0,0,29243,225,12673,12222,6717,16392
2022-05-19 22:30:00+00,14979,0,5503,6470,242,7,497,163,0,12,27873,216,12712,12215,6712,14979
2022-05-19 23:00:00+00,13841,0,5505,6647,188,170,477,159,0,0,26987,209,12817,12340,6835,13841
2022-05-19 23:30:00+00,13146,0,5507,6959,165,248,435,166,0,0,26626,203,13066,12631,7124,13146
2022-05-20 00:00:00+00,13118,0,5503,6790,143,246,425,169,0,0,26394,204,12861,12436,6933,13118
2022-05-20 00:30:00+00,13220,0,5503,6502,142,246,422,166,0,0,26201,207,12569,12147,6644,13220
2022-05-20 01:00:00+00,13320,0,5500,6267,123,246,421,161,0,0,26038,210,12311,11890,6390,13320
2022-05-20 01:30:00+00,13059,0,5502,6308,123,246,415,155,0,0,25808,207,12348,11933,6431,13059
2022-05-20 02:00:00+00,13033,0,5505,6042,123,246,434,166,0,0,25549,209,12104,11670,6165,13033
2022-05-20 02:30:00+00,13196,0,5508,5738,123,246,421,158,0,0,25390,213,11790,11369,5861,13196
2022-05-20 03:00:00+00,13367,0,5506,5831,123,246,428,163,0,0,25664,214,11888,11460,5954,13367
2022-05-20 03:30:00+00,13397,0,5510,5983,123,246,417,158,0,0,25834,212,12033,11616,6106,13397
2022-05-20 04:00:00+00,13604,0,5506,5742,132,246,417,160,5,0,25812,216,11802,11385,5879,13604
2022-05-20 04:30:00+00,14032,0,5511,5670,175,246,424,162,87,0,26307,218,11867,11443,5932,14032
2022-05-20 05:00:00+00,15214,0,5515,5621,413,246,414,178,281,0,27882,223,12244,11830,6315,15214
2022-05-20 05:30:00+00,16452,0,5513,5956,424,246,414,219,464,190,29878,225,12771,12357,6844,16452
2022-05-20 06:00:00+00,17808,0,5514,6509,549,246,593,318,699,494,32730,223,13864,13271,7757,17808
2022-05-20 06:30:00+00,18770,0,5513,6612,596,246,651,570,1054,714,34726,223,14426,13775,8262,18770
2022-05-20 07:00:00+00,19598,0,5510,6745,600,240,656,612,1497,750,36208,224,15008,14352,8842,19598
2022-05-20 07:30:00+00,19653,0,5510,6924,600,214,662,561,1861,664,36649,221,15557,14895,9385,19653
2022-05-20 08:00:00+00,19628,0,5380,7119,596,128,676,233,2125,904,36789,216,15896,15220,9840,19628
2022-05-20 08:30:00+00,19393,0,5296,7318,557,96,752,218,2471,674,36775,213,16394,15642,10346,19393
2022-05-20 09:00:00+00,18680,0,5289,7515,478,190,601,248,2544,186,35731,212,16427,15826,10537,18680
2022-05-20 09:30:00+00,18362,0,5291,7707,483,264,417,250,2904,6,35684,209,16802,16385,11094,18362
2022-05-20 10:00:00+00,18562,0,5316,7912,477,138,417,271,3158,402,36653,205,17280,16863,11547,18562
2022-05-20 10:30:00+00,18686,0,5408,8103,401,0,434,249,3558,58,36897,203,17904,17470,12062,18686
2022-05-20 11:00:00+00,18426,0,5414,8295,226,72,411,252,4250,0,37346,199,18596,18185,12771,18426
2022-05-20 11:30:00+00,17336,0,5421,8480,204,0,329,165,4701,0,36636,189,19135,18806,13385,17336
2022-05-20 12:00:00+00,16739,0,5416,8662,204,152,413,181,4971,0,36738,184,19666,19253,13837,16739
2022-05-20 12:30:00+00,16076,0,5350,8840,204,244,412,171,5434,0,36731,178,20240,19828,14478,16076
2022-05-20 13:00:00+00,15623,0,5294,9023,204,242,421,176,5546,0,36529,174,20488,20067,14773,15623
2022-05-20 13:30:00+00,15313,0,5293,9213,209,148,410,163,5788,0,36537,170,20913,20503,15210,15313
2022-05-20 14:00:00+00,14942,0,5341,9404,238,236,423,168,5010,0,35762,170,20416,19993,14652,14942
2022-05-20 14:30:00+00,15167,0,5466,9576,241,246,507,221,4600,0,36024,173,20390,19883,14417,15167
2022-05-20 15:00:00+00,16307,0,5499,9707,278,246,638,189,3850,0,36714,182,19972,19334,13835,16307
2022-05-20 15:30:00+00,16702,0,5501,9796,339,246,762,213,3339,0,36898,186,19737,18975,13474,16702
2022-05-20 16:00:00+00,17425,0,5504,9856,484,246,767,199,2686,10,37177,192,19297,18530,13026,17425
2022-05-20 16:30:00+00,17499,0,5501,9917,464,246,776,332,2132,80,36947,195,18790,18014,12513,17499
2022-05-20 17:00:00+00,17316,0,5501,9963,477,246,786,374,1773,298,36734,194,18500,17714,12213,17316
2022-05-20 17:30:00+00,17282,0,5504,9984,490,246,789,219,1241,402,36157,196,18008,17219,11715,17282
2022-05-20 18:00:00+00,17319,0,5504,10190,457,246,789,199,825,490,36019,197,17765,16976,11472,17319
2022-05-20 18:30:00+00,16685,0,5510,10584,451,246,790,213,504,368,35351,194,17839,17049,11539,16685
2022-05-20 19:00:00+00,16011,0,5502,10815,374,236,779,231,221,64,34233,192,17691,16912,11410,16011
2022-05-20 19:30:00+00,15433,0,5508,11090,373,106,788,218,29,24,33569,187,17788,17000,11492,15433
2022-05-20 20:00:00+00,15132,0,5417,11100,343,0,783,250,0,68,33093,185,17643,16860,11443,15132
2022-05-20 20:30:00+00,14539,0,5302,11460,323,0,780,277,0,0,32681,181,17865,17085,11783,14539
2022-05-20 21:00:00+00,13500,0,5291,11663,262,0,757,205,0,0,31678,173,17973,17216,11925,13500
2022-05-20 21:30:00+00,12479,0,5296,12025,259,0,510,205,0,0,30774,164,18090,17580,12284,12479
2022-05-20 22:00:00+00,9499,0,5289,12497,231,56,440,200,0,0,28212,138,18457,18017,12728,9499
2022-05-20 22:30:00+00,8001,0,5258,12617,234,8,441,208,0,0,26767,122,18550,18109,12851,8001
2022-05-20 23:00:00+00,7386,0,4953,12682,163,86,437,197,0,0,25904,118,18235,17798,12845,7386
2022-05-20 23:30:00+00,7155,0,4935,12622,143,24,443,212,0,0,25534,115,18142,17700,12764,7155
2022-05-21 00:00:00+00,6669,0,4927,12894,143,336,449,197,0,0,25615,108,18413,17964,13037,6669
2022-05-21 00:30:00+00,6679,0,4822,12856,143,342,450,202,0,0,25494,109,18271,17821,12999,6679
2022-05-21 01:00:00+00,6249,0,4801,13136,126,334,450,188,0,0,25284,103,18513,18063,13262,6249
2022-05-21 01:30:00+00,5978,0,4798,13105,128,316,445,191,0,0,24961,100,18476,18031,13233,5978
2022-05-21 02:00:00+00,5917,0,4795,12894,129,28,443,198,0,0,24404,101,18261,17818,13023,5917
2022-05-21 02:30:00+00,6217,0,4907,12307,129,78,441,195,0,0,24274,107,17784,17343,12436,6217
2022-05-21 03:00:00+00,6626,0,5013,11852,128,182,440,211,0,0,24452,113,17433,16993,11980,6626
2022-05-21 03:30:00+00,6716,0,5022,11306,128,292,442,202,0,0,24108,118,16898,16456,11434,6716
2022-05-21 04:00:00+00,6786,0,5020,10718,141,98,441,197,25,0,23426,121,16345,15904,10884,6786
2022-05-21 04:30:00+00,7432,0,5024,10078,149,220,438,220,279,0,23840,132,15968,15530,10506,7432
2022-05-21 05:00:00+00,7770,0,5021,9476,233,396,438,211,621,64,24230,135,15789,15351,10330,7770
2022-05-21 05:30:00+00,8766,0,5023,8957,229,385,450,194,1085,0,25089,146,15744,15294,10271,8766
2022-05-21 06:00:00+00,10417,0,5018,8165,302,278,451,200,1509,0,26340,165,15445,14994,9976,10417
2022-05-21 06:30:00+00,11443,0,5016,7536,322,352,450,278,2021,178,27596,174,15345,14895,9879,11443
2022-05-21 07:00:00+00,11410,0,5016,7267,341,1118,449,490,2644,100,28835,172,15717,15268,10252,11410
2022-05-21 07:30:00+00,11901,0,5011,6956,402,1260,449,518,3062,70,29629,175,15880,15431,10420,11901
2022-05-21 08:00:00+00,11661,0,5016,7041,401,1740,449,507,3588,180,30583,167,16495,16046,11030,11661
2022-05-21 08:30:00+00,11401,0,5012,7278,399,1774,363,510,3905,152,30794,162,16957,16594,11582,11401
2022-05-21 09:00:00+00,10995,0,5010,7265,368,2138,146,435,4507,426,31290,154,17296,17150,12140,10995
2022-05-21 09:30:00+00,10969,0,5011,7142,359,2166,146,195,5282,254,31524,150,17940,17794,12783,10969
2022-05-21 10:00:00+00,10880,0,4942,7251,349,2310,141,177,5984,144,32178,146,18667,18526,13584,10880
2022-05-21 10:30:00+00,10770,0,4811,7270,328,2306,136,180,6321,12,32134,145,18866,18730,13919,10770
2022-05-21 11:00:00+00,10742,0,4808,7370,210,2094,135,180,6328,0,31867,146,18851,18716,13908,10742
2022-05-21 11:30:00+00,10375,0,4812,7482,210,2082,133,177,6312,0,31583,142,18949,18816,14004,10375
2022-05-21 12:00:00+00,9478,0,4813,7651,222,2106,132,155,6939,0,31496,131,19757,19625,14812,9478
2022-05-21 12:30:00+00,8870,0,4813,7782,225,2108,125,157,7005,0,31085,125,19950,19825,15012,8870
2022-05-21 13:00:00+00,9058,0,4857,7682,224,1942,123,159,6930,0,30975,129,19816,19693,14836,9058
2022-05-21 13:30:00+00,8834,0,4942,7592,230,1910,126,154,6443,0,30231,129,19333,19207,14265,8834
2022-05-21 14:00:00+00,9839,0,4938,7698,252,1060,139,161,6369,0,30456,138,19396,19257,14319,9839
2022-05-21 14:30:00+00,10419,0,4929,6998,264,974,142,180,5854,0,29760,149,18187,18045,13116,10419
2022-05-21 15:00:00+00,13123,0,4894,6615,365,322,142,187,5104,116,30868,175,17120,16978,12084,13123
2022-05-21 15:30:00+00,14249,0,4801,6358,428,496,143,188,4417,138,31218,189,16147,16004,11203,14249
2022-05-21 16:00:00+00,15679,0,4802,6365,579,608,142,216,3548,0,31939,205,15436,15294,10492,15679
2022-05-21 16:30:00+00,16152,0,4805,6216,603,734,142,546,2991,104,32293,213,14757,14615,9810,16152
2022-05-21 17:00:00+00,16346,0,4864,6218,624,750,143,698,2492,376,32511,216,14341,14198,9334,16346
2022-05-21 17:30:00+00,16570,0,5002,5724,646,750,145,729,1915,804,32285,220,13432,13287,8285,16570
2022-05-21 18:00:00+00,16371,0,5023,5467,632,840,147,610,1361,956,31407,223,12630,12483,7460,16371
2022-05-21 18:30:00+00,16228,0,5026,5425,631,860,145,493,785,978,30571,226,12012,11867,6841,16228
2022-05-21 19:00:00+00,16738,0,5026,5525,615,750,141,514,318,894,30521,233,11625,11484,6458,16738
2022-05-21 19:30:00+00,16693,0,5026,5596,592,750,143,394,30,766,29990,235,11387,11244,6218,16693
2022-05-21 20:00:00+00,16935,0,5028,5530,476,750,142,481,0,796,30138,238,11176,11034,6006,16935
2022-05-21 20:30:00+00,16894,0,5030,5493,443,750,305,424,0,648,29987,239,11271,10966,5936,16894
2022-05-21 21:00:00+00,16943,0,5030,5429,419,694,446,432,0,472,29865,240,11324,10878,5848,16943
2022-05-21 21:30:00+00,16490,0,5031,5697,410,622,448,381,0,222,29301,237,11586,11138,6107,16490
2022-05-21 22:00:00+00,14681,0,5034,5838,368,650,448,388,0,0,27407,228,11688,11240,6206,14681
2022-05-21 22:30:00+00,13293,0,5020,6026,337,748,448,335,0,0,26207,219,11831,11383,6363,13293
2022-05-21 23:00:00+00,12931,0,4889,5967,198,750,447,229,0,0,25411,219,11501,11054,6165,12931
2022-05-21 23:30:00+00,12185,0,4823,6264,174,750,447,226,0,0,24869,212,11708,11261,6438,12185
2022-05-22 00:00:00+00,11713,0,4811,6563,140,750,442,231,0,0,24650,206,11956,11514,6703,11713
2022-05-22 00:30:00+00,11743,0,4821,6405,140,750,440,232,0,0,24531,208,11806,11366,6545,11743
2022-05-22 01:00:00+00,11087,0,4825,6727,140,750,429,211,0,0,24169,200,12121,11692,6867,11087
2022-05-22 01:30:00+00,10423,0,4819,7070,122,750,438,210,0,0,23832,192,12449,12011,7192,10423
2022-05-22 02:00:00+00,10534,0,4817,7002,121,750,459,237,0,0,23920,193,12399,11940,7123,10534
2022-05-22 02:30:00+00,10682,0,4815,6997,121,750,457,235,0,0,24057,194,12390,11933,7118,10682
2022-05-22 03:00:00+00,10878,0,4816,7047,121,750,452,224,0,0,24288,196,12436,11984,7168,10878
2022-05-22 03:30:00+00,10681,0,4816,7107,121,750,446,182,0,0,24103,193,12490,12044,7228,10681
2022-05-22 04:00:00+00,10416,0,4858,6985,155,750,445,167,26,0,23802,191,12469,12024,7166,10416
2022-05-22 04:30:00+00,10318,0,4936,6740,155,742,459,172,216,0,23738,190,12506,12047,7111,10318
2022-05-22 05:00:00+00,10656,0,4941,6604,223,622,457,179,512,0,24194,190,12737,12280,7339,10656
2022-05-22 05:30:00+00,10622,0,4940,6494,266,652,454,175,974,0,24577,187,13128,12674,7734,10622
2022-05-22 06:00:00+00,10350,0,4942,6526,321,522,455,185,1428,148,24877,178,13672,13217,8275,10350
2022-05-22 06:30:00+00,10566,0,4937,6391,395,404,448,193,2050,334,25718,173,14221,13773,8836,10566
2022-05-22 07:00:00+00,10852,0,4938,6476,423,148,398,172,2984,296,26687,167,15219,14821,9883,10852
2022-05-22 07:30:00+00,11563,0,4935,6596,424,98,131,173,3828,310,28058,166,15914,15783,10848,11563
2022-05-22 08:00:00+00,11100,0,4938,6782,424,128,128,160,4659,292,28611,157,16931,16803,11865,11100
2022-05-22 08:30:00+00,10723,0,4937,6990,425,186,123,153,5252,328,29117,150,17727,17604,12667,10723
2022-05-22 09:00:00+00,10252,0,4937,6986,272,470,117,128,5900,202,29264,142,18212,18095,13158,10252
2022-05-22 09:30:00+00,10108,0,4886,7122,275,487,109,133,6423,20,29563,139,18815,18706,13820,10108
2022-05-22 10:00:00+00,9321,0,4823,7316,277,998,110,131,6769,0,29745,131,19295,19185,14362,9321
2022-05-22 10:30:00+00,8775,0,4822,7490,286,1264,115,129,7200,0,30081,127,19913,19798,14976,8775
2022-05-22 11:00:00+00,9137,0,4820,7623,240,1504,130,146,7645,0,31246,126,20458,20328,15508,9137
2022-05-22 11:30:00+00,9420,0,4827,7914,238,1564,112,125,7839,0,32039,127,20930,20818,15991,9420
2022-05-22 12:00:00+00,9734,0,4830,8361,238,1505,107,127,7567,0,32469,129,21103,20996,16166,9734
2022-05-22 12:30:00+00,9945,0,4842,8236,239,1528,106,127,7328,0,32351,133,20751,20645,15803,9945
2022-05-22 13:00:00+00,10257,0,4940,8293,240,1409,106,129,7132,0,32506,137,20711,20605,15665,10257
2022-05-22 13:30:00+00,10545,0,4942,8202,241,1315,108,137,6682,0,32173,141,20175,20067,15125,10545
2022-05-22 14:00:00+00,10957,0,4947,8492,263,738,109,140,5912,0,31558,149,19723,19614,14667,10957
2022-05-22 14:30:00+00,11497,0,4945,8687,267,770,108,145,5109,0,31528,157,19116,19008,14063,11497
2022-05-22 15:00:00+00,12136,0,4943,8714,344,1190,109,155,4360,22,31974,163,18470,18361,13418,12136
2022-05-22 15:30:00+00,13027,0,4918,8938,355,1195,110,154,3352,30,32079,173,17673,17563,12645,13027
2022-05-22 16:00:00+00,13858,0,4824,9258,470,1143,115,169,2790,46,32673,180,17457,17342,12518,13858
2022-05-22 16:30:00+00,14748,0,4813,9435,495,1091,123,180,2326,0,33211,188,17192,17069,12256,14748
2022-05-22 17:00:00+00,15385,0,4810,9454,529,1042,124,334,1894,616,34189,191,16811,16687,11877,15385
2022-05-22 17:30:00+00,15901,0,4804,9535,501,993,123,405,1433,532,34227,197,16396,16273,11469,15901
2022-05-22 18:00:00+00,16285,0,4884,9463,517,943,128,404,898,592,34114,202,15890,15762,10878,16285
2022-05-22 18:30:00+00,16583,0,4979,9326,522,895,143,385,575,592,33999,206,15545,15402,10423,16583
2022-05-22 19:00:00+00,16788,0,4993,9176,541,778,175,274,216,610,33552,210,15101,14926,9933,16788
2022-05-22 19:30:00+00,16779,0,4997,9149,515,622,188,252,35,294,32831,212,14884,14696,9699,16779
2022-05-22 20:00:00+00,16778,0,4995,8796,478,480,210,244,0,404,32385,214,14479,14269,9274,16778
2022-05-22 20:30:00+00,16460,0,4998,8455,512,318,282,231,0,122,31378,215,14247,13965,8967,16460
2022-05-22 21:00:00+00,16086,0,4995,8209,463,318,349,208,0,64,30692,215,14016,13667,8672,16086
2022-05-22 21:30:00+00,15370,0,5004,7808,433,114,534,209,0,0,29472,212,13779,13245,8241,15370
2022-05-22 22:00:00+00,14879,0,5002,7453,416,20,529,159,0,0,28458,210,13400,12871,7869,14879
2022-05-22 22:30:00+00,14105,0,5000,7174,389,40,540,153,0,0,27401,208,13103,12563,7563,14105
2022-05-22 23:00:00+00,14020,0,4897,6986,283,20,529,150,0,0,26885,210,12695,12166,7269,14020
2022-05-22 23:30:00+00,13756,0,4813,6787,252,0,538,154,0,0,26300,210,12390,11852,7039,13756
2022-05-23 00:00:00+00,13802,0,4814,6328,166,0,533,150,0,0,25793,215,11841,11308,6494,13802
2022-05-23 00:30:00+00,14018,0,4809,5724,158,5,545,180,0,0,25439,222,11236,10691,5882,14018
2022-05-23 01:00:00+00,14124,0,4873,5117,145,9,599,174,0,0,25042,227,10734,10135,5262,14124
2022-05-23 01:30:00+00,14187,0,4989,4644,145,14,654,174,0,0,24807,231,10432,9778,4789,14187
2022-05-23 02:00:00+00,14409,0,4996,4096,145,16,681,160,0,0,24503,237,9918,9237,4241,14409
2022-05-23 02:30:00+00,14731,0,4991,3457,144,16,886,167,0,0,24392,245,9478,8592,3601,14731
2022-05-23 03:00:00+00,14406,0,5029,3228,143,64,1134,155,0,0,24159,244,9534,8400,3371,14406
2022-05-23 03:30:00+00,14482,0,5045,2885,150,120,1232,162,0,0,24076,247,9312,8080,3035,14482
2022-05-23 04:00:00+00,14817,0,5048,2626,193,40,1300,148,9,0,24181,250,9176,7876,2828,14817
2022-05-23 04:30:00+00,15180,0,5043,2410,200,162,1517,149,119,0,24780,254,9289,7772,2729,15180
2022-05-23 05:00:00+00,15108,0,5072,2169,271,474,1743,242,360,0,25439,248,9615,7872,2800,15108
2022-05-23 05:30:00+00,16349,0,5071,1927,369,520,1839,283,662,64,27084,252,9868,8029,2958,16349
2022-05-23 06:00:00+00,16186,0,5077,1726,449,1196,1613,327,1048,410,28032,241,9913,8300,3223,16186
2022-05-23 06:30:00+00,16802,0,5074,1658,451,1288,1331,397,1493,906,29400,238,10007,8676,3602,16802
2022-05-23 07:00:00+00,16865,0,5077,1666,406,1870,1368,359,2018,1156,30785,234,10535,9167,4090,16865
2022-05-23 07:30:00+00,16606,0,5073,1658,405,1886,1514,341,2501,1444,31428,226,11151,9637,4564,16606
2022-05-23 08:00:00+00,16998,0,5072,1678,410,2492,1783,294,3016,672,32415,226,11959,10176,5104,16998
2022-05-23 08:30:00+00,16905,0,5075,1749,411,2512,1790,449,3416,362,32669,225,12441,10651,5576,16905
2022-05-23 09:00:00+00,16385,0,5081,1880,342,2892,1825,456,3727,272,32860,220,12855,11030,5949,16385
2022-05-23 09:30:00+00,16349,0,5094,2099,340,2946,1979,447,3964,110,33328,217,13476,11497,6403,16349
2022-05-23 10:00:00+00,16929,0,5080,2293,287,2682,2100,485,4123,46,34025,220,13883,11783,6703,16929
2022-05-23 10:30:00+00,17235,0,5081,2404,370,2672,2097,504,3868,32,34263,222,13820,11723,6642,17235
2022-05-23 11:00:00+00,17970,0,5079,2474,376,2030,2078,516,3872,50,34445,224,13879,11801,6722,17970
2022-05-23 11:30:00+00,18021,0,5079,2562,403,1978,1458,480,4056,236,34273,223,13558,12100,7021,18021
2022-05-23 12:00:00+00,18136,0,5079,2615,441,1640,1465,571,3955,70,33972,222,13555,12090,7011,18136
2022-05-23 12:30:00+00,17766,0,5081,2728,443,1656,1464,373,3911,0,33422,220,13627,12163,7082,17766
2022-05-23 13:00:00+00,17580,0,5078,2822,446,1798,1464,355,4005,0,33548,217,13815,12351,7273,17580
2022-05-23 13:30:00+00,17655,0,5077,2977,262,1808,1464,382,3904,48,33577,218,13684,12220,7143,17655
2022-05-23 14:00:00+00,17936,0,5073,3045,274,1774,1465,385,3763,70,33785,220,13620,12155,7082,17936
2022-05-23 14:30:00+00,18268,0,5075,2982,315,1846,1476,422,3220,136,33740,226,13068,11592,6517,18268
2022-05-23 15:00:00+00,17507,0,5079,3133,376,1866,1787,613,3103,184,33648,220,13478,11691,6612,17507
2022-05-23 15:30:00+00,17183,0,5074,3291,516,1968,2021,646,2728,672,34099,214,13630,11609,6535,17183
2022-05-23 16:00:00+00,16571,0,5072,3449,579,2470,2062,649,2241,1166,34259,207,13403,11341,6269,16571
2022-05-23 16:30:00+00,16800,0,5071,3614,595,2484,2058,584,1880,1344,34430,208,13218,11160,6089,16800
2022-05-23 17:00:00+00,16590,0,5068,3695,594,2607,2035,637,1559,1612,34397,210,12951,10916,5848,16590
2022-05-23 17:30:00+00,16640,0,5066,3836,534,2286,2023,569,1141,1524,33619,215,12600,10577,5511,16640
2022-05-23 18:00:00+00,16733,0,5067,3850,551,1820,2026,624,750,1132,32553,221,12244,10218,5151,16733
2022-05-23 18:30:00+00,16526,0,5069,3849,541,1536,2029,630,364,902,31446,224,11852,9823,4754,16526
2022-05-23 19:00:00+00,16928,0,5069,3668,592,1130,2024,440,137,578,30566,234,11490,9466,4397,16928
2022-05-23 19:30:00+00,16816,0,5071,3561,592,998,2028,411,18,572,30067,234,11270,9242,4171,16816
2022-05-23 20:00:00+00,16365,0,5108,4014,539,1126,2049,397,0,184,29782,232,11710,9661,4553,16365
2022-05-23 20:30:00+00,15722,0,5122,4144,448,1040,2029,297,0,96,28898,228,11742,9714,4592,15722
2022-05-23 21:00:00+00,16335,0,5146,4324,447,360,2017,165,0,64,28858,233,11934,9917,4771,16335
2022-05-23 21:30:00+00,14903,0,5155,4652,445,384,1999,150,0,0,27688,222,12251,10252,5097,14903
2022-05-23 22:00:00+00,13367,0,5154,4707,340,1010,1999,159,0,50,26786,210,12200,10201,5047,13367
2022-05-23 22:30:00+00,11989,0,5157,4854,302,1128,1970,147,0,12,25559,200,12283,10313,5156,11989
2022-05-23 23:00:00+00,10849,0,5157,5100,191,1396,1970,145,0,0,24808,192,12418,10448,5291,10849
2022-05-23 23:30:00+00,10395,0,5149,4988,180,1354,1973,167,0,0,24206,189,12290,10317,5168,10395
2022-05-24 00:00:00+00,10257,0,5145,4970,144,1576,1976,157,0,0,24225,188,12235,10259,5114,10257
2022-05-24 00:30:00+00,10261,0,5147,5095,138,1672,1964,146,0,0,24423,188,12344,10380,5233,10261
2022-05-24 01:00:00+00,9502,0,5147,5424,126,1566,1913,145,0,0,23823,180,12610,10697,5550,9502
2022-05-24 01:30:00+00,9129,0,5145,5552,126,1618,1793,153,0,0,23516,177,12616,10823,5678,9129
2022-05-24 02:00:00+00,9264,0,5148,5672,144,1310,1783,150,0,0,23471,181,12747,10964,5816,9264
2022-05-24 02:30:00+00,8997,0,5146,5855,144,1184,1810,150,0,0,23286,176,12955,11145,5999,8997
2022-05-24 03:00:00+00,9802,0,5148,6246,144,720,1844,148,0,0,24052,185,13382,11538,6390,9802
2022-05-24 03:30:00+00,9880,0,5149,6554,144,570,1686,143,0,0,24126,182,13533,11847,6698,9880
2022-05-24 04:00:00+00,9916,0,5152,7058,152,638,1637,145,10,0,24708,180,14009,12372,7220,9916
2022-05-24 04:30:00+00,10007,0,5158,7602,158,642,1511,151,140,0,25369,176,14569,13058,7900,10007
2022-05-24 05:00:00+00,10625,0,5161,7645,265,600,1239,157,438,0,26130,177,14748,13509,8348,10625
2022-05-24 05:30:00+00,11406,0,5165,7761,285,506,1464,180,869,154,27789,177,15543,14079,8915,11406
2022-05-24 06:00:00+00,12604,0,5165,7562,336,628,1509,201,1340,0,29345,180,15912,14403,9238,12604
2022-05-24 06:30:00+00,13647,0,5165,7514,377,538,1665,515,2119,312,31851,180,16840,15175,10010,13647
2022-05-24 07:00:00+00,14573,0,5167,7463,419,678,1988,667,2836,236,34026,182,17873,15885,10718,14573
2022-05-24 07:30:00+00,15060,0,5170,7423,479,684,1999,681,3541,436,35472,180,18611,16612,11443,15060
2022-05-24 08:00:00+00,15375,0,5167,7384,485,670,2011,475,4111,326,36004,180,19159,17148,11980,15375
2022-05-24 08:30:00+00,15578,0,5163,7355,486,662,1973,382,4774,136,36509,179,19751,17778,12615,15578
2022-05-24 09:00:00+00,15678,0,5149,7320,484,648,1712,292,5358,326,36967,177,20023,18311,13162,15678
2022-05-24 09:30:00+00,15678,0,5133,7261,147,724,535,99,5760,34,35371,180,18836,18301,13168,15678
2022-05-24 10:00:00+00,15682,0,5131,7205,0,1120,0,0,6184,0,35322,180,18520,18520,13389,15682
2022-05-24 10:30:00+00,15662,0,5132,7144,0,1612,0,0,7312,0,36862,174,19588,19588,14456,15662
2022-05-24 11:00:00+00,15706,0,5140,7091,142,2358,947,134,6529,0,38046,176,19848,18901,13762,15706
2022-05-24 11:30:00+00,15662,0,5144,7046,260,2376,2015,248,6275,0,39026,175,20740,18725,13581,15662
2022-05-24 12:00:00+00,15631,0,5147,7012,241,2582,2138,247,6501,0,39498,174,21038,18900,13754,15631
2022-05-24 12:30:00+00,15478,0,5147,6974,228,2596,2171,247,7015,0,39857,171,21535,19364,14217,15478
2022-05-24 13:00:00+00,15409,0,5148,6926,226,2082,2250,247,7163,0,39451,172,21713,19463,14315,15409
2022-05-24 13:30:00+00,15298,0,5148,6859,229,2102,2264,168,6663,0,38731,175,21163,18899,13751,15298
2022-05-24 14:00:00+00,15295,0,5148,6803,232,876,2164,147,6707,0,37372,176,21054,18890,13742,15295
2022-05-24 14:30:00+00,15414,0,5150,6775,263,862,2139,153,6084,0,36841,181,20411,18272,13122,15414
2022-05-24 15:00:00+00,15624,0,5151,6749,385,598,2193,165,5569,110,36544,182,20047,17854,12703,15624
2022-05-24 15:30:00+00,16073,0,5154,6699,422,626,2207,167,4529,24,35901,191,19010,16803,11650,16073
2022-05-24 16:00:00+00,16402,0,5154,6623,481,1028,2076,165,4121,50,36101,192,18455,16379,11225,16402
2022-05-24 16:30:00+00,16793,0,5156,6554,599,1078,2202,170,3222,70,35844,198,17733,15531,10375,16793
2022-05-24 17:00:00+00,16908,0,5155,6486,626,1124,2196,304,2499,358,35656,202,16962,14766,9611,16908
2022-05-24 17:30:00+00,17109,0,5151,6310,628,1262,2197,363,2057,488,35565,207,16343,14146,8995,17109
2022-05-24 18:00:00+00,16845,0,5149,6425,629,1304,2177,419,1244,996,35188,208,15624,13447,8298,16845
2022-05-24 18:30:00+00,17123,0,5150,5932,536,1378,2155,322,763,1142,34501,215,14536,12381,7231,17123
2022-05-24 19:00:00+00,17233,0,5148,5666,515,1378,2299,276,355,750,33620,222,13983,11684,6536,17233
2022-05-24 19:30:00+00,17180,0,5152,5576,495,1228,2512,264,53,414,32874,225,13788,11276,6124,17180
2022-05-24 20:00:00+00,17469,0,5149,5491,454,1134,2524,258,0,208,32687,232,13618,11094,5945,17469
2022-05-24 20:30:00+00,17259,0,5150,5684,449,990,2324,250,0,8,32114,231,13607,11283,6133,17259
2022-05-24 21:00:00+00,17176,0,5153,5853,333,640,1900,211,0,0,31266,235,13239,11339,6186,17176
2022-05-24 21:30:00+00,15904,0,5153,6182,317,340,1307,159,0,18,29380,226,12959,11652,6499,15904
2022-05-24 22:00:00+00,15242,0,5129,6180,365,248,954,181,0,94,28393,220,12628,11674,6545,15242
2022-05-24 22:30:00+00,14276,0,5098,5960,314,336,951,159,0,56,27150,217,12323,11372,6274,14276
2022-05-24 23:00:00+00,13737,0,5104,5651,221,784,952,157,0,16,26622,218,11928,10976,5872,13737
2022-05-24 23:30:00+00,12889,0,5108,5666,200,956,953,162,0,0,25934,214,11927,10974,5866,12889
2022-05-25 00:00:00+00,12324,0,5096,5683,145,1116,950,150,0,0,25464,210,11874,10924,5828,12324
2022-05-25 00:30:00+00,11598,0,5109,6201,243,1094,950,147,0,0,25342,200,12503,11553,6444,11598
2022-05-25 01:00:00+00,10856,0,5132,7051,254,786,950,151,0,0,25180,190,13387,12437,7305,10856
2022-05-25 01:30:00+00,10206,0,5145,7569,145,750,952,154,0,0,24921,182,13811,12859,7714,10206
2022-05-25 02:00:00+00,10167,0,5149,7826,146,752,953,167,0,0,25160,179,14074,13120,7972,10167
2022-05-25 02:30:00+00,9657,0,5150,8416,144,750,955,149,0,0,25221,171,14665,13710,8560,9657
2022-05-25 03:00:00+00,8849,0,5152,9518,144,750,954,148,0,0,25515,156,15768,14814,9662,8849
2022-05-25 03:30:00+00,8209,0,5155,10189,143,750,955,127,0,0,25528,146,16442,15487,10332,8209
2022-05-25 04:00:00+00,7724,0,5156,11296,203,750,955,125,18,0,26227,135,17628,16673,11517,7724
2022-05-25 04:30:00+00,7507,0,5156,12662,212,750,954,133,148,0,27522,126,19132,18178,13022,7507
2022-05-25 05:00:00+00,8071,0,5158,13595,322,752,1147,144,419,0,29608,125,20641,19494,14336,8071
2022-05-25 05:30:00+00,9088,0,5161,14251,368,750,1441,152,679,0,31890,130,21900,20459,15298,9088
2022-05-25 06:00:00+00,9744,0,5155,15059,474,658,1591,173,996,0,33850,129,23275,21684,16529,9744
2022-05-25 06:30:00+00,10241,0,5157,15732,486,730,1594,190,1320,0,35450,130,24289,22695,17538,10241
2022-05-25 07:00:00+00,10194,0,5152,16563,442,554,1595,215,1740,26,36481,124,25492,23897,18745,10194
2022-05-25 07:30:00+00,9927,0,5157,17156,404,538,1510,169,1996,0,36857,119,26223,24713,19556,9927
2022-05-25 08:00:00+00,9805,0,5153,17665,424,520,1582,154,2481,0,37784,113,27305,25723,20570,9805
2022-05-25 08:30:00+00,9048,0,5149,17937,428,580,1590,167,3114,110,38123,105,28218,26628,21479,9048
2022-05-25 09:00:00+00,7753,0,5150,17966,332,1490,1505,137,3470,0,37803,96,28423,26918,21768,7753
2022-05-25 09:30:00+00,7134,0,5148,18200,329,1634,1563,137,3514,2,37661,91,28754,27191,22043,7134
2022-05-25 10:00:00+00,6568,0,5149,18182,296,2502,1586,127,3512,0,37922,90,28725,27139,21990,6568
2022-05-25 10:30:00+00,6027,0,5154,18598,298,2536,1591,128,3513,0,37845,84,29154,27563,22409,6027
2022-05-25 11:00:00+00,5842,0,5148,19075,283,2672,1593,140,3592,0,38345,82,29691,28098,22950,5842
2022-05-25 11:30:00+00,5978,0,5156,19512,281,2458,1593,125,4058,0,39161,79,30600,29007,23851,5978
2022-05-25 12:00:00+00,5746,0,5156,19645,252,2444,1591,133,4264,0,39231,77,30908,29317,24161,5746
2022-05-25 12:30:00+00,5374,0,5161,19875,257,2366,1590,123,4342,0,39088,72,31225,29635,24474,5374
2022-05-25 13:00:00+00,5614,0,5157,19916,261,2192,1589,125,4147,0,39001,74,31070,29481,24324,5614
2022-05-25 13:30:00+00,5689,0,5157,19709,261,2080,1590,121,4839,0,39446,73,31556,29966,24809,5689
2022-05-25 14:00:00+00,6568,0,5162,19543,307,1106,1465,119,4792,0,39062,78,31269,29804,24642,6568
2022-05-25 14:30:00+00,6983,0,5161,19572,304,1050,1110,130,4277,0,38587,82,30424,29314,24153,6983
2022-05-25 15:00:00+00,7317,0,5160,19546,359,882,941,151,4043,0,38399,84,30049,29108,23948,7317
2022-05-25 15:30:00+00,8067,0,5159,19195,350,972,950,158,3610,0,38461,93,29264,28314,23155,8067
2022-05-25 16:00:00+00,9412,0,5158,18824,332,780,955,149,3300,0,38910,104,28569,27614,22456,9412
2022-05-25 16:30:00+00,10162,0,5151,18140,324,814,954,168,2589,142,38444,113,27158,26204,21053,10162
2022-05-25 17:00:00+00,10990,0,5151,17600,345,326,958,158,2064,394,37986,122,26118,25160,20009,10990
2022-05-25 17:30:00+00,11297,0,5148,17255,350,310,957,144,1500,416,37377,127,25210,24253,19105,11297
2022-05-25 18:00:00+00,11113,0,5147,16827,366,194,957,162,1001,292,36059,128,24298,23341,18194,11113
2022-05-25 18:30:00+00,10799,0,5144,16539,391,176,958,154,671,384,35216,128,23703,22745,17601,10799
2022-05-25 19:00:00+00,11002,0,5139,15702,507,126,959,152,278,420,34285,132,22585,21626,16487,11002
2022-05-25 19:30:00+00,11166,0,5140,15011,520,184,958,144,65,538,33726,136,21694,20736,15596,11166
2022-05-25 20:00:00+00,11142,0,5140,14510,561,334,961,116,0,552,33316,138,21172,20211,15071,11142
2022-05-25 20:30:00+00,11297,0,5138,13992,564,356,960,132,0,140,32579,143,20654,19694,14556,11297
2022-05-25 21:00:00+00,10239,0,5140,14056,510,656,959,128,0,88,31776,133,20665,19706,14566,10239
2022-05-25 21:30:00+00,9001,0,5142,14117,340,708,774,107,0,22,30211,124,20373,19599,14457,9001
2022-05-25 22:00:00+00,6727,0,5145,13939,319,1504,618,104,0,0,28356,102,20021,19403,14258,6727
2022-05-25 22:30:00+00,5430,0,5150,13767,314,1726,616,97,0,0,27100,90,19847,19231,14081,5430
2022-05-25 23:00:00+00,4575,0,5150,13552,237,2016,616,80,0,0,26226,81,19555,18939,13789,4575
2022-05-25 23:30:00+00,4439,0,5153,12731,213,2066,615,78,0,0,25295,82,18712,18097,12944,4439
2022-05-26 00:00:00+00,4535,0,5150,12167,178,2092,615,86,0,0,24823,86,18110,17495,12345,4535
2022-05-26 00:30:00+00,4551,0,5152,12148,175,2100,616,77,0,0,24819,86,18091,17475,12323,4551
2022-05-26 01:00:00+00,4579,0,5151,12142,155,2044,614,80,0,0,24765,89,18062,17448,12297,4579
2022-05-26 01:30:00+00,4619,0,5151,12339,156,2066,617,82,0,0,25030,89,18263,17646,12495,4619
2022-05-26 02:00:00+00,4623,0,5149,11995,155,2078,616,82,0,0,24698,93,17915,17299,12150,4623
2022-05-26 02:30:00+00,4562,0,5151,12223,155,2124,617,74,0,0,24906,92,18146,17529,12378,4562
2022-05-26 03:00:00+00,4614,0,5149,12201,155,2056,618,76,0,0,24869,92,18123,17505,12356,4614
2022-05-26 03:30:00+00,4609,0,5154,12179,158,2056,619,88,0,0,24863,92,18110,17491,12337,4609
2022-05-26 04:00:00+00,4579,0,5155,11956,186,2088,617,87,25,0,24693,93,17939,17322,12167,4579
2022-05-26 04:30:00+00,5486,0,5149,11741,209,2088,619,113,226,18,25649,103,17944,17325,12176,5486
2022-05-26 05:00:00+00,6965,0,5152,11480,457,2160,618,101,637,44,27614,117,18344,17726,12574,6965
2022-05-26 05:30:00+00,8782,0,5157,11523,502,2567,619,126,1037,0,30313,134,18838,18219,13062,8782
2022-05-26 06:00:00+00,9923,0,5157,11577,505,3114,622,121,1325,14,32358,140,19186,18564,13407,9923
2022-05-26 06:30:00+00,10053,0,5154,12053,550,3078,790,127,1696,426,33927,134,20243,19453,14299,10053
2022-05-26 07:00:00+00,9891,0,5155,12638,568,2808,947,134,2365,682,35188,125,21673,20726,15571,9891
2022-05-26 07:30:00+00,9944,0,5154,13050,502,2696,959,138,2741,492,35676,122,22406,21447,16293,9944
2022-05-26 08:00:00+00,10042,0,5150,13181,415,2696,958,260,3072,836,36610,121,22776,21818,16668,10042
2022-05-26 08:30:00+00,10289,0,5151,13539,260,2696,828,350,3386,364,36863,124,23164,22336,17185,10289
2022-05-26 09:00:00+00,9890,0,5145,14416,207,2696,623,122,3855,490,37444,115,24246,23623,18478,9890
2022-05-26 09:30:00+00,9330,0,5147,15081,206,2736,615,99,4142,568,37924,108,25191,24576,19429,9330
2022-05-26 10:00:00+00,8153,0,5142,15947,175,3014,624,107,4243,434,37839,99,26131,25507,20365,8153
2022-05-26 10:30:00+00,7829,0,5148,16483,172,3084,614,79,4070,206,37685,97,26487,25873,20725,7829
2022-05-26 11:00:00+00,7787,0,5147,17218,167,2860,612,75,4296,68,38230,92,27440,26828,21681,7787
2022-05-26 11:30:00+00,7389,0,5149,17188,160,2762,621,82,4380,0,37730,88,27498,26876,21728,7389
2022-05-26 12:00:00+00,6815,0,5153,17169,164,2902,623,89,4242,48,37205,85,27351,26728,21575,6815
2022-05-26 12:30:00+00,6603,0,5149,17506,166,2778,599,83,4110,0,36994,82,27530,26931,21782,6603
2022-05-26 13:00:00+00,6931,0,5153,17714,164,2698,588,79,4234,0,37561,83,27853,27265,22112,6931
2022-05-26 13:30:00+00,6441,0,5153,18053,164,2696,595,85,4025,0,37212,79,27990,27395,22242,6441
2022-05-26 14:00:00+00,6323,0,5156,18300,164,2696,589,82,4014,0,37324,77,28223,27634,22478,6323
2022-05-26 14:30:00+00,6082,0,5155,18525,164,2696,600,117,3685,0,37024,76,28129,27529,22374,6082
2022-05-26 15:00:00+00,6288,0,5159,18724,189,2716,602,138,3151,0,36967,78,27825,27223,22064,6288
2022-05-26 15:30:00+00,6983,0,5156,18363,235,2718,586,110,2920,0,37071,85,27260,26674,21518,6983
2022-05-26 16:00:00+00,7826,0,5153,17935,210,2846,607,113,2488,16,37194,95,26393,25786,20633,7826
2022-05-26 16:30:00+00,8452,0,5152,17611,231,2848,618,106,2355,74,37447,101,25967,25349,20197,8452
2022-05-26 17:00:00+00,8992,0,5149,17588,236,2490,624,121,1603,10,36813,107,25200,24576,19427,8992
2022-05-26 17:30:00+00,9359,0,5146,17272,221,2490,626,128,1210,112,36564,112,24475,23849,18703,9359
2022-05-26 18:00:00+00,9444,0,5144,17121,201,2178,622,119,790,418,36037,114,23878,23256,18112,9444
2022-05-26 18:30:00+00,9247,0,5145,17128,203,2118,615,117,448,288,35309,114,23539,22924,17779,9247
2022-05-26 19:00:00+00,9447,0,5141,16696,173,2004,615,109,191,418,34794,118,22816,22201,17060,9447
2022-05-26 19:30:00+00,9559,0,5144,16233,172,1922,618,109,47,154,33958,121,22214,21596,16452,9559
2022-05-26 20:00:00+00,9533,0,5139,15717,172,2000,608,120,0,0,33289,122,21636,21028,15889,9533
2022-05-26 20:30:00+00,9196,0,5141,15220,173,1956,596,126,0,60,32468,121,21130,20534,15393,9196
2022-05-26 21:00:00+00,8321,0,5138,15311,168,1702,563,113,0,144,31460,114,21180,20617,15479,8321
2022-05-26 21:30:00+00,7195,0,5141,15531,175,1672,538,96,0,60,30408,103,21385,20847,15706,7195
2022-05-26 22:00:00+00,6097,0,5140,15428,176,1570,528,121,0,0,29060,89,21272,20744,15604,6097
2022-05-26 22:30:00+00,4570,0,5147,15573,175,1664,462,97,0,0,27688,72,21357,20895,15748,4570
2022-05-26 23:00:00+00,3998,0,5145,15319,175,1722,469,85,0,0,26913,66,21108,20639,15494,3998
2022-05-26 23:30:00+00,3751,0,5153,15116,176,1650,470,85,0,0,26401,62,20915,20445,15292,3751
2022-05-27 00:00:00+00,3931,0,5155,14976,171,1642,469,87,0,0,26431,67,20771,20302,15147,3931
2022-05-27 00:30:00+00,4330,0,5156,15035,161,1680,457,75,0,0,26894,72,20809,20352,15196,4330
2022-05-27 01:00:00+00,4291,0,5152,15187,151,1478,468,85,0,0,26812,69,20958,20490,15338,4291
2022-05-27 01:30:00+00,4166,0,5155,14982,161,1404,469,80,0,0,26417,67,20767,20298,15143,4166
2022-05-27 02:00:00+00,3666,0,5152,15503,163,1389,461,75,0,0,26410,59,21279,20818,15666,3666
2022-05-27 02:30:00+00,3622,0,5151,15632,166,1381,462,74,0,0,26488,59,21411,20949,15798,3622
2022-05-27 03:00:00+00,3633,0,5153,15730,178,1300,463,75,0,0,26532,58,21524,21061,15908,3633
2022-05-27 03:30:00+00,3643,0,5155,15561,210,1300,459,73,0,0,26401,59,21385,20926,15771,3643
2022-05-27 04:00:00+00,3786,0,5155,15439,252,1254,461,76,43,0,26466,61,21350,20889,15734,3786
2022-05-27 04:30:00+00,4238,0,5155,15041,254,1374,466,81,285,0,26894,69,21201,20735,15580,4238
2022-05-27 05:00:00+00,5109,0,5151,15134,253,1582,445,87,737,0,28498,79,21720,21275,16124,5109
2022-05-27 05:30:00+00,6033,0,5149,15251,259,1870,650,124,1294,0,30630,89,22603,21953,16804,6033
2022-05-27 06:00:00+00,6730,0,5152,15516,306,2040,768,104,1924,0,32540,92,23666,22898,17746,6730
2022-05-27 06:30:00+00,6450,0,5152,15916,308,2102,757,131,2777,24,33617,86,24910,24153,19001,6450
2022-05-27 07:00:00+00,6287,0,5154,16177,314,2692,778,127,3785,4,35318,83,26208,25430,20276,6287
2022-05-27 07:30:00+00,6193,0,5157,16128,367,2696,778,107,4548,136,36110,80,26978,26200,21043,6193
2022-05-27 08:00:00+00,6114,0,5150,15915,305,2696,783,111,5161,296,36531,78,27314,26531,21381,6114
2022-05-27 08:30:00+00,6082,0,5153,15822,280,2696,618,82,5978,0,36711,77,27851,27233,22080,6082
2022-05-27 09:00:00+00,5760,0,5148,15785,267,2696,509,79,6824,0,37068,72,28533,28024,22876,5760
2022-05-27 09:30:00+00,5336,0,5146,15648,261,2696,443,77,7696,0,37303,67,29194,28751,23605,5336
2022-05-27 10:00:00+00,4716,0,5144,15507,369,2754,417,88,8291,0,37286,61,29728,29311,24167,4716
2022-05-27 10:30:00+00,4540,0,5144,15455,370,2754,370,85,8577,0,37295,59,29916,29546,24402,4540
2022-05-27 11:00:00+00,4569,0,5141,15412,363,2754,357,91,8874,22,37583,59,30147,29790,24649,4569
2022-05-27 11:30:00+00,4436,0,5140,15101,364,2754,369,102,8989,90,37345,58,29963,29594,24454,4436
2022-05-27 12:00:00+00,4913,0,5149,14886,287,2754,353,78,8751,0,37171,63,29426,29073,23924,4913
2022-05-27 12:30:00+00,4680,0,5144,14699,288,2754,356,81,8744,0,36746,61,29231,28875,23731,4680
2022-05-27 13:00:00+00,4575,0,5150,14694,288,2698,372,87,8633,0,36497,60,29137,28765,23615,4575
2022-05-27 13:30:00+00,4649,0,5146,14549,287,2696,383,84,8050,0,35844,62,28415,28032,22886,4649
2022-05-27 14:00:00+00,4447,0,5146,14506,274,2696,372,94,7406,0,34941,61,27704,27332,22186,4447
2022-05-27 14:30:00+00,4846,0,5148,14203,276,2696,362,111,6696,0,34338,67,26685,26323,21175,4846
2022-05-27 15:00:00+00,5854,0,5151,13926,314,2500,390,113,6235,0,34483,77,26016,25626,20475,5854
2022-05-27 15:30:00+00,6677,0,5158,14135,327,2472,379,99,5491,16,34754,85,25490,25111,19953,6677
2022-05-27 16:00:00+00,8985,0,5159,13966,340,1714,640,117,4677,132,35730,104,24782,24142,18983,8985
2022-05-27 16:30:00+00,10184,0,5153,13870,292,1714,696,144,3813,210,36076,117,23824,23128,17975,10184
2022-05-27 17:00:00+00,11023,0,5155,13644,307,1352,696,128,3077,258,35640,126,22879,22183,17028,11023
2022-05-27 17:30:00+00,11414,0,5152,13156,368,1348,696,147,2204,488,34973,133,21576,20880,15728,11414
2022-05-27 18:00:00+00,12010,0,5152,12958,451,1102,695,133,1421,648,34570,141,20677,19982,14830,12010
2022-05-27 18:30:00+00,12131,0,5149,12549,473,1102,696,141,897,718,33856,146,19764,19068,13919,12131
2022-05-27 19:00:00+00,11750,0,5145,12209,620,1282,697,189,381,840,33113,145,19052,18355,13210,11750
2022-05-27 19:30:00+00,11982,0,5148,11517,642,1284,697,185,71,780,32306,152,18075,17378,12230,11982
2022-05-27 20:00:00+00,11767,0,5147,10818,646,1094,711,223,0,800,31206,154,17322,16611,11464,11767
2022-05-27 20:30:00+00,11597,0,5145,10183,639,1100,745,303,0,1104,30816,155,16712,15967,10822,11597
2022-05-27 21:00:00+00,11888,0,5145,9624,511,1228,727,297,0,522,29942,164,16007,15280,10135,11888
2022-05-27 21:30:00+00,11438,0,5148,9841,449,1232,463,326,0,20,28917,162,15901,15438,10290,11438
2022-05-27 22:00:00+00,10504,0,5143,10297,450,1286,162,272,0,106,28220,152,16052,15890,10747,10504
2022-05-27 22:30:00+00,8360,0,5145,10555,544,1286,213,292,0,442,26837,128,16457,16244,11099,8360
2022-05-27 23:00:00+00,7445,0,5146,10658,328,1762,349,185,0,2,25875,121,16481,16132,10986,7445
2022-05-27 23:30:00+00,6859,0,5146,10391,322,1842,355,143,0,152,25210,116,16214,15859,10713,6859
2022-05-28 00:00:00+00,7168,0,5149,9968,239,1736,353,108,0,390,25111,120,15709,15356,10207,7168
2022-05-28 00:30:00+00,7133,0,5157,9857,217,1812,354,158,0,0,24688,123,15585,15231,10074,7133
2022-05-28 01:00:00+00,6854,0,5153,9664,218,1546,366,119,0,0,23920,119,15400,15034,9882,6854
2022-05-28 01:30:00+00,6751,0,5158,9641,214,1512,356,106,0,0,23738,118,15369,15013,9855,6751
2022-05-28 02:00:00+00,6734,0,5155,9124,214,1716,372,96,0,100,23511,119,14865,14493,9338,6734
2022-05-28 02:30:00+00,7075,0,5157,8590,213,1742,358,117,0,0,23252,127,14318,13960,8803,7075
2022-05-28 03:00:00+00,7219,0,5153,8170,213,1782,370,131,0,0,23038,132,13906,13536,8383,7219
2022-05-28 03:30:00+00,6990,0,5154,8245,214,1764,357,105,0,0,22829,128,13970,13613,8459,6990
2022-05-28 04:00:00+00,6647,0,5152,8071,247,1980,371,111,31,0,22610,129,13872,13501,8349,6647
2022-05-28 04:30:00+00,7263,0,5152,7650,263,2138,367,116,245,0,23194,139,13677,13310,8158,7263
2022-05-28 05:00:00+00,7617,0,5157,7476,387,2268,363,114,625,0,24007,146,14008,13645,8488,7617
2022-05-28 05:30:00+00,8395,0,5155,7115,401,2128,361,127,1155,0,24837,152,14187,13826,8671,8395
2022-05-28 06:00:00+00,9392,0,5156,6622,445,2106,361,177,1855,14,26128,159,14439,14078,8922,9392
2022-05-28 06:30:00+00,9895,0,5155,6364,445,2060,356,202,2585,0,27062,160,14905,14549,9394,9895
2022-05-28 07:00:00+00,9644,0,5156,6131,436,2004,354,158,3362,0,27245,155,15439,15085,9929,9644
2022-05-28 07:30:00+00,10136,0,5157,5878,437,2002,354,176,4059,0,28199,156,15885,15531,10374,10136
2022-05-28 08:00:00+00,10594,0,5158,5711,422,2002,353,193,4723,0,29156,158,16367,16014,10856,10594
2022-05-28 08:30:00+00,10894,0,5156,5620,424,2002,355,179,5254,0,29884,158,16809,16454,11298,10894
2022-05-28 09:00:00+00,10510,0,5155,5611,455,2140,363,226,5684,20,30164,152,17268,16905,11750,10510
2022-05-28 09:30:00+00,10860,0,5150,5153,451,2160,379,234,5954,138,30479,155,17087,16708,11558,10860
2022-05-28 10:00:00+00,10850,0,5151,4820,394,2228,365,240,6186,160,30394,156,16916,16551,11400,10850
2022-05-28 10:30:00+00,10823,0,5152,4927,390,2228,355,198,6467,16,30556,154,17291,16936,11784,10823
2022-05-28 11:00:00+00,10771,0,5145,5286,295,2062,354,192,6716,0,30821,152,17796,17442,12297,10771
2022-05-28 11:30:00+00,10139,0,5146,5689,290,2060,364,176,6738,32,30634,145,18227,17863,12717,10139
2022-05-28 12:00:00+00,9175,0,5142,5922,273,2154,366,191,6717,68,30008,135,18420,18054,12912,9175
2022-05-28 12:30:00+00,8847,0,5148,6133,270,2100,353,190,6842,0,29883,131,18746,18393,13245,8847
2022-05-28 13:00:00+00,9069,0,5146,6356,270,1982,356,138,6650,0,29968,132,18778,18422,13276,9069
2022-05-28 13:30:00+00,8461,0,5149,6662,270,1952,354,121,6390,0,29360,126,18825,18471,13322,8461
2022-05-28 14:00:00+00,7322,0,5149,7034,248,2096,355,109,6065,0,28379,114,18851,18496,13347,7322
2022-05-28 14:30:00+00,7149,0,5149,7483,225,2056,360,109,5709,0,28241,112,18926,18566,13417,7149
2022-05-28 15:00:00+00,8202,0,5150,7625,266,1886,358,112,5082,0,28681,124,18481,18123,12973,8202
2022-05-28 15:30:00+00,8957,0,5148,7810,288,1847,362,161,4483,0,29057,133,18091,17729,12581,8957
2022-05-28 16:00:00+00,11103,0,5149,8195,372,1679,356,151,3880,0,30885,152,17952,17596,12447,11103
2022-05-28 16:30:00+00,11552,0,5148,8668,511,1634,359,153,3196,10,31231,156,17882,17523,12375,11552
2022-05-28 17:00:00+00,11815,0,5148,8763,470,1604,361,213,2597,72,31043,160,17339,16978,11830,11815
2022-05-28 17:30:00+00,11939,0,5147,8606,506,1547,361,258,1984,22,30370,166,16604,16243,11096,11939
2022-05-28 18:00:00+00,11906,0,5148,8509,650,1437,367,302,1412,574,30305,165,16086,15719,10571,11906
2022-05-28 18:30:00+00,11767,0,5151,8584,639,1404,356,272,885,478,29536,167,15615,15259,10108,11767
2022-05-28 19:00:00+00,11527,0,5146,8419,567,1481,366,224,393,278,28400,172,14891,14525,9379,11527
2022-05-28 19:30:00+00,11086,0,5146,8356,570,1451,362,202,85,0,27258,172,14519,14157,9011,11086
2022-05-28 20:00:00+00,10650,0,5144,8383,648,1335,364,211,1,82,26818,169,14540,14176,9032,10650
2022-05-28 20:30:00+00,9888,0,5144,8149,600,1295,364,225,0,358,26023,162,14257,13893,8749,9888
2022-05-28 21:00:00+00,9085,0,5143,7837,577,1248,358,222,0,194,24664,158,13915,13557,8414,9085
2022-05-28 21:30:00+00,7943,0,5142,8109,575,1145,356,211,0,118,23600,145,14182,13826,8684,7943
2022-05-28 22:00:00+00,6844,0,5136,8295,486,2170,371,175,0,296,23773,125,14288,13917,8781,6844
2022-05-28 22:30:00+00,5860,0,5137,8009,479,2100,361,172,0,0,22118,114,13986,13625,8488,5860
2022-05-28 23:00:00+00,5145,0,5135,7984,310,2086,359,150,0,0,21169,107,13788,13429,8294,5145
2022-05-28 23:30:00+00,4730,0,5132,7772,291,2070,357,146,0,0,20498,102,13552,13195,8063,4730
2022-05-29 00:00:00+00,4756,0,5136,7685,216,2458,355,115,0,0,20721,102,13392,13037,7901,4756
2022-05-29 00:30:00+00,4896,0,5143,7596,216,2524,358,136,0,0,20869,105,13313,12955,7812,4896
2022-05-29 01:00:00+00,4866,0,5146,7762,216,2206,368,116,0,0,20680,104,13492,13124,7978,4866
2022-05-29 01:30:00+00,4705,0,5148,7727,215,2174,366,107,0,0,20442,101,13456,13090,7942,4705
2022-05-29 02:00:00+00,4688,0,5148,7782,196,1749,381,106,0,0,20050,101,13507,13126,7978,4688
2022-05-29 02:30:00+00,4733,0,5149,7223,191,1747,386,87,0,0,19516,104,12949,12563,7414,4733
2022-05-29 03:00:00+00,4803,0,5152,7221,190,1446,373,90,0,0,19275,110,12936,12563,7411,4803
2022-05-29 03:30:00+00,4787,0,5149,7126,190,1452,371,87,0,0,19162,110,12836,12465,7316,4787
2022-05-29 04:00:00+00,4451,0,5150,7524,220,1338,369,106,20,0,19178,103,13283,12914,7764,4451
2022-05-29 04:30:00+00,4302,0,5149,7959,237,1334,372,109,190,0,19652,98,13907,13535,8386,4302
2022-05-29 05:00:00+00,4284,0,5150,7768,305,1690,366,105,523,0,20191,96,14112,13746,8596,4284
2022-05-29 05:30:00+00,4319,0,5152,7625,318,1704,375,112,944,0,20549,95,14414,14039,8887,4319
2022-05-29 06:00:00+00,4904,0,5147,7523,342,1670,375,115,1527,0,21603,101,14914,14539,9392,4904
2022-05-29 06:30:00+00,4662,0,5153,8027,349,1676,369,112,2106,0,22454,93,16004,15635,10482,4662
2022-05-29 07:00:00+00,4462,0,5152,8408,425,2110,372,124,2565,0,23618,88,16922,16550,11398,4462
2022-05-29 07:30:00+00,5010,0,5148,7736,434,2138,390,128,3182,138,24304,94,16890,16500,11352,5010
2022-05-29 08:00:00+00,4903,0,5152,6989,421,4006,376,115,3641,300,25903,93,16579,16203,11051,4903
2022-05-29 08:30:00+00,6193,0,5151,6758,423,4094,383,117,4169,0,27288,107,16884,16501,11350,6193
2022-05-29 09:00:00+00,6363,0,5146,6507,440,4466,376,146,4585,0,28029,107,17054,16678,11532,6363
2022-05-29 09:30:00+00,6692,0,5144,6008,437,4488,407,201,4763,140,28280,111,16759,16352,11208,6692
2022-05-29 10:00:00+00,6933,0,5143,5749,451,4782,454,248,4729,72,28561,115,16526,16072,10929,6933
2022-05-29 10:30:00+00,7143,0,5142,5731,455,4788,565,266,4731,104,28925,117,16624,16059,10917,7143
2022-05-29 11:00:00+00,7581,0,5145,5512,539,4820,584,270,4861,142,29453,120,16641,16057,10912,7581
2022-05-29 11:30:00+00,7943,0,5140,5516,542,4812,526,257,4954,78,29768,123,16678,16152,11012,7943
2022-05-29 12:00:00+00,8341,0,5136,5317,382,5054,526,201,4819,76,29851,129,16180,15654,10518,8341
2022-05-29 12:30:00+00,8638,0,5140,5322,359,5054,496,147,4768,0,29924,132,16085,15589,10449,8638
2022-05-29 13:00:00+00,9029,0,5134,5707,349,4998,503,113,4702,0,30534,134,16395,15892,10758,9029
2022-05-29 13:30:00+00,9381,0,5136,5908,335,4996,502,133,4522,0,30913,137,16403,15901,10765,9381
2022-05-29 14:00:00+00,9848,0,5137,6082,291,4998,499,144,4397,0,31395,141,16406,15907,10770,9848
2022-05-29 14:30:00+00,10435,0,5143,6375,292,4986,512,153,4102,0,31998,145,16424,15912,10769,10435
2022-05-29 15:00:00+00,11124,0,5139,6370,340,4754,530,150,3728,0,32135,153,16107,15577,10438,11124
2022-05-29 15:30:00+00,12067,0,5144,6224,345,4742,564,159,3097,0,32342,164,15374,14810,9666,12067
2022-05-29 16:00:00+00,12949,0,5146,6104,422,2172,560,184,2689,0,30226,181,14921,14361,9215,12949
2022-05-29 16:30:00+00,13892,0,5145,6222,424,2078,558,205,2435,0,30959,188,14784,14226,9081,13892
2022-05-29 17:00:00+00,14581,0,5150,5897,551,498,591,353,1891,614,30125,200,14080,13489,8339,14581
2022-05-29 17:30:00+00,15138,0,5148,5493,556,488,607,443,1429,688,29990,209,13233,12626,7478,15138
2022-05-29 18:00:00+00,15559,0,5151,5274,660,88,575,559,1043,1034,29943,214,12703,12128,6977,15559
2022-05-29 18:30:00+00,15900,0,5146,4919,677,151,568,623,655,1120,29759,221,11965,11397,6251,15900
2022-05-29 19:00:00+00,16158,0,5147,4779,658,174,567,620,308,1246,29657,225,11459,10892,5745,16158
2022-05-29 19:30:00+00,16214,0,5144,4404,656,190,584,639,84,1090,29004,231,10872,10288,5144,16214
2022-05-29 20:00:00+00,16272,0,5142,4215,636,316,576,615,2,1054,28828,233,10571,9995,4853,16272
2022-05-29 20:30:00+00,15984,0,5145,3942,634,306,585,632,0,966,28194,234,10306,9721,4576,15984
2022-05-29 21:00:00+00,15620,0,5146,3669,606,300,568,603,0,716,27228,237,9989,9421,4275,15620
2022-05-29 21:30:00+00,14912,0,5143,3676,588,274,577,439,0,128,25737,238,9984,9407,4264,14912
2022-05-29 22:00:00+00,15067,0,5142,3526,537,24,576,315,0,464,25651,238,9781,9205,4063,15067
2022-05-29 22:30:00+00,14826,0,5140,3196,463,174,575,246,0,360,24980,243,9374,8799,3659,14826
2022-05-29 23:00:00+00,14810,0,5142,2749,243,188,573,252,0,86,24043,252,8707,8134,2992,14810
2022-05-29 23:30:00+00,14921,0,5138,2603,217,152,576,205,0,0,23812,255,8534,7958,2820,14921
2022-05-30 00:00:00+00,14852,0,5142,2450,180,240,574,117,0,0,23555,258,8346,7772,2630,14852
2022-05-30 00:30:00+00,14851,0,5142,2343,180,246,584,128,0,0,23474,259,8249,7665,2523,14851
2022-05-30 01:00:00+00,14850,0,5145,2452,179,246,590,129,0,0,23591,257,8366,7776,2631,14850
2022-05-30 01:30:00+00,14805,0,5149,2498,178,246,631,109,0,0,23616,256,8456,7825,2676,14805
2022-05-30 02:00:00+00,14808,0,5147,2627,178,246,660,109,0,0,23775,255,8612,7952,2805,14808
2022-05-30 02:30:00+00,14696,0,5149,2817,175,246,682,116,0,0,23881,252,8823,8141,2992,14696
2022-05-30 03:00:00+00,15090,0,5147,2864,171,246,753,106,0,0,24377,254,8935,8182,3035,15090
2022-05-30 03:30:00+00,15092,0,5150,2818,170,234,950,106,0,0,24520,253,9088,8138,2988,15092
2022-05-30 04:00:00+00,15316,0,5145,2814,168,162,976,144,36,0,24761,253,9139,8163,3018,15316
2022-05-30 04:30:00+00,15794,0,5143,2856,164,242,974,146,262,0,25581,254,9399,8425,3282,15794
2022-05-30 05:00:00+00,15097,0,5145,2844,261,160,1028,215,560,0,25310,245,9838,8810,3665,15097
2022-05-30 05:30:00+00,15735,0,5141,2647,343,30,1111,391,926,0,26324,246,10168,9057,3916,15735
2022-05-30 06:00:00+00,16602,0,5146,2354,522,37,1374,514,1323,10,27882,246,10719,9345,4199,16602
2022-05-30 06:30:00+00,17178,0,5140,2002,578,48,1634,664,1894,426,29564,242,11248,9614,4474,17178
2022-05-30 07:00:00+00,17319,0,5143,1896,509,964,1637,476,2508,234,30686,241,11693,10056,4913,17319
2022-05-30 07:30:00+00,17480,0,5141,1910,494,1082,1605,545,2913,300,31470,238,12063,10458,5317,17480
2022-05-30 08:00:00+00,17098,0,5139,1896,448,1936,1601,583,3433,42,32176,234,12517,10916,5777,17098
2022-05-30 08:30:00+00,17085,0,5141,1945,434,1950,1602,580,3415,8,32160,234,12537,10935,5794,17085
2022-05-30 09:00:00+00,16830,0,5141,1815,406,2688,1605,571,3405,274,32735,228,12372,10767,5626,16830
2022-05-30 09:30:00+00,17408,0,5144,1738,401,2692,1603,432,3448,40,32906,233,12334,10731,5587,17408
2022-05-30 10:00:00+00,17468,0,5138,1728,376,2170,1602,432,3540,72,32526,235,12384,10782,5644,17468
2022-05-30 10:30:00+00,17544,0,5154,1731,361,2186,1621,361,3626,160,32744,234,12493,10872,5718,17544
2022-05-30 11:00:00+00,18089,0,5135,1600,341,2480,1632,364,3664,34,33339,237,12372,10740,5605,18089
2022-05-30 11:30:00+00,18020,0,5137,1647,342,2498,1633,351,3993,0,33621,234,12752,11119,5982,18020
2022-05-30 12:00:00+00,18703,0,5136,1776,284,1309,1637,355,4847,310,34356,234,13680,12043,6907,18703
2022-05-30 12:30:00+00,18760,0,5131,1837,283,1302,1636,308,4773,180,34210,235,13660,12024,6893,18760
2022-05-30 13:00:00+00,18974,0,5135,1774,285,1546,1645,311,4525,12,34207,235,13364,11719,6584,18974
2022-05-30 13:30:00+00,18832,0,5133,1837,285,1555,1620,226,4754,0,34242,232,13629,12009,6876,18832
2022-05-30 14:00:00+00,19262,0,5141,1996,287,1460,1765,234,3701,0,33846,238,12890,11125,5984,19262
2022-05-30 14:30:00+00,19118,0,5142,2068,307,1478,1957,245,3440,0,33755,238,12914,10957,5815,19118
2022-05-30 15:00:00+00,18393,0,5147,2387,351,1348,1960,294,3217,0,33097,233,13062,11102,5955,18393
2022-05-30 15:30:00+00,18035,0,5146,3133,527,1340,1957,375,2800,132,33445,228,13563,11606,6460,18035
2022-05-30 16:00:00+00,18128,0,5146,3357,623,1142,1965,425,2533,512,33831,226,13624,11659,6513,18128
2022-05-30 16:30:00+00,19156,0,5150,2786,649,1150,1968,442,2084,430,33815,238,12637,10669,5519,19156
2022-05-30 17:00:00+00,19438,0,5148,2775,666,1004,1975,677,1606,956,34245,238,12170,10195,5047,19438
2022-05-30 17:30:00+00,19362,0,5148,2809,664,1008,1973,694,1193,964,33815,240,11787,9814,4666,19362
2022-05-30 18:00:00+00,18400,0,5149,2574,681,1620,1970,657,835,1436,33322,234,11209,9239,4090,18400
2022-05-30 18:30:00+00,18389,0,5149,2385,680,1722,1977,616,453,1044,32415,242,10644,8667,3518,18389
2022-05-30 19:00:00+00,18910,0,5147,2526,660,936,1987,537,200,538,31441,254,10520,8533,3386,18910
2022-05-30 19:30:00+00,18531,0,5144,2667,602,790,1986,461,50,594,30825,252,10449,8463,3319,18531
2022-05-30 20:00:00+00,18406,0,5147,2795,602,792,1989,399,0,702,30832,250,10533,8544,3397,18406
2022-05-30 20:30:00+00,18535,0,5143,2846,573,694,1989,294,0,376,30450,252,10551,8562,3419,18535
2022-05-30 21:00:00+00,19284,0,5143,2750,544,708,1985,286,0,166,30866,257,10422,8437,3294,19284
2022-05-30 21:30:00+00,18481,0,5139,2403,541,694,1980,188,0,38,29464,257,10063,8083,2944,18481
2022-05-30 22:00:00+00,18500,0,5139,2182,402,694,1979,177,0,0,29073,261,9702,7723,2584,18500
2022-05-30 22:30:00+00,17599,0,5136,2218,382,770,1979,182,0,0,28266,257,9715,7736,2600,17599
2022-05-30 23:00:00+00,17566,0,5137,2267,265,782,1981,169,0,0,28167,260,9650,7669,2532,17566
2022-05-30 23:30:00+00,17107,0,5140,2253,240,796,1995,148,0,0,27679,258,9628,7633,2493,17107
2022-05-31 00:00:00+00,17810,0,5138,2089,185,602,1993,165,0,0,27982,265,9405,7412,2274,17810
2022-05-31 00:30:00+00,17946,0,5143,2021,183,566,1987,165,0,0,28011,267,9334,7347,2204,17946
2022-05-31 01:00:00+00,17785,0,5147,2124,184,410,1983,164,0,0,27797,266,9438,7455,2308,17785
2022-05-31 01:30:00+00,17532,0,5149,2255,183,390,1988,164,0,0,27661,264,9575,7587,2438,17532
2022-05-31 02:00:00+00,17150,0,5155,2397,182,258,1996,165,0,0,27303,262,9730,7734,2579,17150
2022-05-31 02:30:00+00,17061,0,5153,2462,180,246,1989,156,0,0,27247,261,9784,7795,2642,17061
2022-05-31 03:00:00+00,17088,0,5155,2260,179,242,2062,152,0,0,27138,263,9656,7594,2439,17088
2022-05-31 03:30:00+00,17131,0,5154,2108,179,246,2088,137,0,0,27044,265,9530,7442,2288,17131
2022-05-31 04:00:00+00,17370,0,5153,1900,178,278,2147,146,12,0,27184,267,9390,7243,2090,17370
2022-05-31 04:30:00+00,17632,0,5150,2005,179,274,2280,176,137,0,27833,265,9751,7471,2321,17632
2022-05-31 05:00:00+00,16558,0,5145,2163,345,528,2438,202,398,0,27777,249,10489,8051,2906,16558
2022-05-31 05:30:00+00,17548,0,5142,2284,383,490,2580,315,745,48,29535,248,11134,8554,3412,17548
2022-05-31 06:00:00+00,16467,0,5146,2107,444,922,2594,489,1082,140,29391,237,11373,8779,3633,16467
2022-05-31 06:30:00+00,16754,0,5143,1930,463,984,2557,697,1443,556,30527,234,11536,8979,3836,16754
2022-05-31 07:00:00+00,17584,0,5145,2077,480,1202,2525,565,2124,292,31994,238,12351,9826,4681,17584
2022-05-31 07:30:00+00,18236,0,5146,2078,505,1308,2535,466,2900,34,33208,237,13164,10629,5483,18236
2022-05-31 08:00:00+00,18620,0,5154,1957,503,2202,2615,336,3405,0,34792,236,13634,11019,5865,18620
2022-05-31 08:30:00+00,18608,0,5153,1883,486,2216,2619,280,3732,0,34977,235,13873,11254,6101,18608
2022-05-31 09:00:00+00,18926,0,5145,1966,398,1832,2625,269,4497,0,35658,228,14631,12006,6861,18926
2022-05-31 09:30:00+00,18292,0,5146,2078,378,1810,2625,216,5019,32,35596,220,15246,12621,7475,18292
2022-05-31 10:00:00+00,18090,0,5148,2117,365,1656,2627,171,5388,0,35562,219,15645,13018,7870,18090
2022-05-31 10:30:00+00,18109,0,5146,2258,365,1588,2621,158,5319,0,35564,218,15709,13088,7942,18109
2022-05-31 11:00:00+00,19271,0,5147,2320,347,968,2616,234,5864,34,36801,220,16294,13678,8531,19271
2022-05-31 11:30:00+00,18875,0,5163,2622,330,694,2620,392,6023,0,36719,214,16758,14138,8975,18875
2022-05-31 12:00:00+00,18975,0,5151,2829,286,694,2641,316,6300,0,37192,212,17207,14566,9415,18975
2022-05-31 12:30:00+00,18661,0,5141,3104,275,688,2641,202,5806,0,36518,212,16967,14326,9185,18661
2022-05-31 13:00:00+00,18618,0,5135,3458,293,520,2628,204,5633,0,36489,211,17147,14519,9384,18618
2022-05-31 13:30:00+00,18520,0,5133,3637,293,516,2529,144,5545,0,36317,211,17137,14608,9475,18520
2022-05-31 14:00:00+00,18606,0,5136,3574,293,666,2492,129,5715,34,36645,209,17210,14718,9582,18606
2022-05-31 14:30:00+00,18714,0,5140,3577,315,682,2510,164,5126,0,36228,213,16668,14158,9018,18714
2022-05-31 15:00:00+00,18627,0,5144,3693,339,692,2628,166,4658,0,35947,214,16462,13834,8690,18627
2022-05-31 15:30:00+00,18977,0,5142,3524,370,694,2648,320,4012,0,35687,221,15696,13048,7906,18977
2022-05-31 16:00:00+00,19467,0,5141,3130,500,694,2647,373,3640,40,35632,227,15058,12411,7270,19467
2022-05-31 16:30:00+00,19429,0,5143,3019,615,694,2649,600,2876,288,35313,231,14302,11653,6510,19429
2022-05-31 17:00:00+00,19150,0,5143,2830,680,694,2648,632,2330,1028,35135,229,13631,10983,5840,19150
2022-05-31 17:30:00+00,19099,0,5143,3069,681,708,2648,622,1949,1116,35035,229,13490,10842,5699,19099
2022-05-31 18:00:00+00,19153,0,5144,3046,629,708,2582,663,1386,1116,34427,234,12787,10205,5061,19153
2022-05-31 18:30:00+00,19217,0,5148,2876,639,708,2657,731,744,918,33638,241,12064,9407,4259,19217
2022-05-31 19:00:00+00,19037,0,5146,2959,660,782,2686,781,347,324,32722,248,11798,9112,3966,19037
2022-05-31 19:30:00+00,18699,0,5144,2889,604,846,2688,633,107,320,31930,249,11432,8744,3600,18699
2022-05-31 20:00:00+00,19098,0,5144,2645,528,846,2688,589,1,146,31685,256,11006,8318,3174,19098
2022-05-31 20:30:00+00,18790,0,5139,2466,521,846,2669,583,0,214,31228,255,10795,8126,2987,18790
2022-05-31 21:00:00+00,18930,0,5138,2005,423,904,2403,499,0,160,30462,262,9969,7566,2428,18930
2022-05-31 21:30:00+00,18403,0,5133,1802,406,866,2045,390,0,84,29129,264,9386,7341,2208,18403
2022-05-31 22:00:00+00,18095,0,5128,1847,363,859,2048,303,0,28,28671,263,9386,7338,2210,18095
2022-05-31 22:30:00+00,17404,0,5132,1906,337,765,1904,178,0,0,27626,260,9279,7375,2243,17404
2022-05-31 23:00:00+00,16927,0,5139,1971,257,522,1718,155,0,0,26689,262,9085,7367,2228,16927
2022-05-31 23:30:00+00,16542,0,5140,1939,234,482,1701,149,0,0,26187,262,9014,7313,2173,16542
2022-06-01 00:00:00+00,17381,0,5142,2062,201,210,1698,124,0,0,26818,267,9103,7405,2263,17381
2022-06-01 00:30:00+00,17415,0,5137,1996,197,182,1720,139,0,0,26785,268,9050,7330,2193,17415
2022-06-01 01:00:00+00,17457,0,5137,1855,196,195,1734,152,0,0,26726,270,8922,7188,2051,17457
2022-06-01 01:30:00+00,17397,0,5139,1728,198,159,1720,138,0,0,26479,271,8785,7065,1926,17397
2022-06-01 02:00:00+00,17420,0,5140,1707,199,141,1714,118,0,0,26439,271,8760,7046,1906,17420
2022-06-01 02:30:00+00,17240,0,5145,1612,195,214,1716,118,0,0,26240,272,8668,6952,1807,17240
2022-06-01 03:00:00+00,17487,0,5143,1572,194,178,1712,120,0,0,26406,273,8621,6909,1766,17487
2022-06-01 03:30:00+00,17179,0,5147,1622,194,145,1706,111,0,0,26104,271,8668,6962,1816,17179
2022-06-01 04:00:00+00,16929,0,5143,1625,192,203,1716,107,52,0,25967,270,8728,7012,1869,16929
2022-06-01 04:30:00+00,17661,0,5148,1616,198,109,1716,103,277,0,26828,270,8955,7239,2091,17661
2022-06-01 05:00:00+00,18183,0,5144,1688,295,534,1815,209,641,142,28651,262,9583,7768,2624,18183
2022-06-01 05:30:00+00,18818,0,5144,1527,323,632,2346,457,1182,20,30449,260,10522,8176,3032,18818
2022-06-01 06:00:00+00,18122,0,5140,1492,427,716,2836,454,1800,32,31019,246,11695,8859,3719,18122
2022-06-01 06:30:00+00,18543,0,5142,1422,426,694,2937,555,2583,252,32554,240,12510,9573,4431,18543
2022-06-01 07:00:00+00,18334,0,5144,1394,489,996,2946,454,3431,2,33190,235,13404,10458,5314,18334
2022-06-01 07:30:00+00,18448,0,5142,1374,551,1010,2947,488,4036,0,33996,231,14050,11103,5961,18448
2022-06-01 08:00:00+00,18631,0,5145,1316,528,1382,2945,485,4600,12,35044,233,14534,11589,6444,18631
2022-06-01 08:30:00+00,18610,0,5145,1312,520,1260,2945,350,5034,0,35176,230,14956,12011,6866,18610
2022-06-01 09:00:00+00,18987,0,5142,1237,471,1042,2944,327,5119,174,35443,228,14913,11969,6827,18987
2022-06-01 09:30:00+00,19026,0,5140,1259,449,1060,2943,158,4995,366,35396,227,14786,11843,6703,19026
2022-06-01 10:00:00+00,18940,0,5147,1228,438,1224,2945,122,5475,424,35943,224,15233,12288,7141,18940
2022-06-01 10:30:00+00,18971,0,5143,1255,439,1230,2942,149,5167,290,35586,227,14946,12004,6861,18971
2022-06-01 11:00:00+00,18929,0,5115,1260,330,1654,2937,143,5094,104,35566,231,14736,11799,6684,18929
2022-06-01 11:30:00+00,18972,0,5109,1167,282,1632,2940,131,5306,10,35549,232,14804,11864,6755,18972
2022-06-01 12:00:00+00,18966,0,5107,1119,225,938,2840,109,6108,98,35510,229,15399,12559,7452,18966
2022-06-01 12:30:00+00,18829,0,5109,1145,208,906,2739,101,6360,0,35397,228,15561,12822,7713,18829
2022-06-01 13:00:00+00,19208,0,5109,1158,250,620,2846,108,6112,262,35673,228,15475,12629,7520,19208
2022-06-01 13:30:00+00,19182,0,5141,1074,249,606,2931,100,5647,0,34930,233,15042,12111,6970,19182
2022-06-01 14:00:00+00,19059,0,5171,969,249,726,2926,102,5584,62,34848,234,14899,11973,6802,19059
2022-06-01 14:30:00+00,19013,0,5187,958,256,734,2896,103,5347,20,34514,235,14644,11748,6561,19013
2022-06-01 15:00:00+00,18786,0,5190,987,309,722,2789,122,4868,0,33773,236,14143,11354,6164,18786
2022-06-01 15:30:00+00,18917,0,5196,1030,362,760,2824,235,4505,104,33933,237,13917,11093,5897,18917
2022-06-01 16:00:00+00,19147,0,5204,1053,456,1124,2927,319,4153,50,34433,237,13793,10866,5662,19147
2022-06-01 16:30:00+00,19324,0,5201,1034,488,1156,2927,411,3542,310,34393,240,13192,10265,5064,19324
2022-06-01 17:00:00+00,19859,0,5204,1006,531,950,2919,534,2802,844,34649,244,12462,9543,4339,19859
2022-06-01 17:30:00+00,19931,0,5217,974,544,946,2877,520,2109,1098,34216,247,11721,8844,3627,19931
2022-06-01 18:00:00+00,20016,0,5219,970,537,798,2931,549,1430,1404,33854,250,11087,8156,2937,20016
2022-06-01 18:30:00+00,20019,0,5222,950,535,798,2934,485,861,1248,33052,255,10502,7568,2346,20019
2022-06-01 19:00:00+00,20045,0,5221,916,532,694,2908,418,406,904,32044,261,9983,7075,1854,20045
2022-06-01 19:30:00+00,20029,0,5220,828,530,744,2788,461,104,836,31540,266,9470,6682,1462,20029
2022-06-01 20:00:00+00,19769,0,5229,759,501,794,2810,444,2,582,30890,269,9301,6491,1262,19769
2022-06-01 20:30:00+00,19728,0,5243,687,509,794,2835,326,0,356,30478,271,9274,6439,1196,19728
2022-06-01 21:00:00+00,19904,0,5264,701,562,694,2801,435,0,366,30727,271,9328,6527,1263,19904
2022-06-01 21:30:00+00,19632,0,5281,656,415,684,2556,215,0,212,29651,273,8908,6352,1071,19632
2022-06-01 22:00:00+00,19179,0,5286,656,403,642,2400,276,0,182,29024,274,8745,6345,1059,19179
2022-06-01 22:30:00+00,18611,0,5287,656,372,642,2164,223,0,74,28029,274,8479,6315,1028,18611
2022-06-01 23:00:00+00,18602,0,5300,668,238,278,2179,114,0,58,27437,279,8385,6206,906,18602
2022-06-01 23:30:00+00,18246,0,5310,665,236,246,2068,108,0,0,26879,280,8279,6211,901,18246
2022-06-02 00:00:00+00,17707,0,5305,675,202,58,2147,95,0,0,26189,277,8329,6182,877,17707
2022-06-02 00:30:00+00,17617,0,5314,696,199,120,2002,109,0,0,26057,278,8211,6209,895,17617
2022-06-02 01:00:00+00,17376,0,5334,708,200,110,1965,114,0,0,25807,278,8207,6242,908,17376
2022-06-02 01:30:00+00,17064,0,5336,703,200,38,1977,116,0,0,25434,276,8216,6239,903,17064
2022-06-02 02:00:00+00,17090,0,5341,695,200,106,2154,111,0,0,25697,275,8390,6236,895,17090
2022-06-02 02:30:00+00,16980,0,5372,659,200,102,2160,118,0,0,25591,275,8391,6231,859,16980
2022-06-02 03:00:00+00,16978,0,5390,626,198,150,2159,132,0,0,25633,275,8373,6214,824,16978
2022-06-02 03:30:00+00,16773,0,5398,670,198,102,2159,110,0,0,25410,273,8425,6266,868,16773
2022-06-02 04:00:00+00,16897,0,5397,701,198,106,2161,148,67,0,25675,273,8524,6363,966,16897
2022-06-02 04:30:00+00,17003,0,5401,668,210,138,2160,151,366,0,26097,271,8805,6645,1244,17003
2022-06-02 05:00:00+00,16751,0,5401,646,293,210,2162,157,854,0,26474,265,9356,7194,1793,16751
2022-06-02 05:30:00+00,16982,0,5405,626,310,134,2168,211,1453,0,27289,259,9962,7794,2389,16982
2022-06-02 06:00:00+00,17028,0,5399,645,357,252,2163,345,2194,0,28383,249,10758,8595,3196,17028
2022-06-02 06:30:00+00,17230,0,5398,599,357,290,2170,434,3005,94,29577,243,11529,9359,3961,17230
2022-06-02 07:00:00+00,16616,0,5399,552,356,306,2173,370,3906,278,29956,231,12386,10213,4814,16616
2022-06-02 07:30:00+00,16803,0,5403,577,340,300,2172,346,4857,102,30900,226,13349,11177,5774,16803
2022-06-02 08:00:00+00,16668,0,5413,557,306,532,2189,297,5723,0,31685,224,14188,11999,6586,16668
2022-06-02 08:30:00+00,16583,0,5421,587,304,526,2166,294,6458,78,32417,218,14936,12770,7349,16583
2022-06-02 09:00:00+00,16633,0,5427,639,289,198,2032,439,6902,156,32715,212,15289,13257,7830,16633
2022-06-02 09:30:00+00,16597,0,5436,712,290,198,2029,417,7341,22,33042,210,15808,13779,8343,16597
2022-06-02 10:00:00+00,16655,0,5438,775,288,764,2030,367,7375,0,33692,212,15906,13876,8438,16655
2022-06-02 10:30:00+00,16643,0,5447,834,286,820,2023,340,7655,82,34130,209,16245,14222,8775,16643
2022-06-02 11:00:00+00,16804,0,5452,877,252,988,2022,246,7456,0,34097,210,16059,14037,8585,16804
2022-06-02 11:30:00+00,16679,0,5450,885,251,980,2022,170,7255,0,33692,210,15863,13841,8391,16679
2022-06-02 12:00:00+00,16609,0,5448,1028,209,348,2020,157,7236,0,33055,209,15941,13921,8473,16609
2022-06-02 12:30:00+00,16383,0,5448,1165,225,340,2032,153,6782,0,32528,211,15652,13620,8172,16383
2022-06-02 13:00:00+00,16728,0,5451,1333,211,92,2041,150,6944,0,32950,210,15980,13939,8488,16728
2022-06-02 13:30:00+00,16481,0,5458,1491,222,92,2035,188,6461,0,32428,210,15667,13632,8174,16481
2022-06-02 14:00:00+00,16970,0,5466,1615,278,61,2034,209,6060,0,32693,214,15453,13419,7953,16970
2022-06-02 14:30:00+00,17123,0,5469,1605,272,31,2044,254,5631,28,32457,218,15021,12977,7508,17123
2022-06-02 15:00:00+00,17184,0,5480,1735,274,94,2046,187,5044,0,32044,221,14579,12533,7053,17184
2022-06-02 15:30:00+00,17875,0,5480,1801,351,170,2034,240,4553,46,32550,226,14219,12185,6705,17875
2022-06-02 16:00:00+00,18162,0,5491,1870,506,544,2015,340,3897,468,33293,225,13779,11764,6273,18162
2022-06-02 16:30:00+00,18675,0,5504,1962,534,584,2010,435,2991,514,33209,233,13001,10991,5487,18675
2022-06-02 17:00:00+00,18490,0,5510,2080,586,684,2012,492,2443,910,33207,232,12631,10619,5109,18490
2022-06-02 17:30:00+00,18609,0,5513,2197,565,694,2014,527,1846,964,32929,236,12135,10121,4608,18609
2022-06-02 18:00:00+00,18380,0,5515,2339,578,694,2016,508,1279,918,32227,238,11727,9711,4196,18380
2022-06-02 18:30:00+00,18431,0,5514,2391,579,694,2009,522,771,598,31509,244,11264,9255,3741,18431
2022-06-02 19:00:00+00,17649,0,5514,2444,575,694,2016,525,375,1030,30822,239,10924,8908,3394,17649
2022-06-02 19:30:00+00,17648,0,5511,2576,551,694,2016,501,103,838,30438,242,10757,8741,3230,17648
2022-06-02 20:00:00+00,18193,0,5511,2689,488,694,2016,501,1,90,30183,251,10705,8689,3178,18193
2022-06-02 20:30:00+00,18094,0,5509,2692,472,692,2017,411,0,52,29939,250,10690,8673,3164,18094
2022-06-02 21:00:00+00,18121,0,5506,2631,355,684,2016,274,0,306,29893,250,10508,8492,2986,18121
2022-06-02 21:30:00+00,17839,0,5514,2549,333,672,2015,176,0,30,29128,252,10411,8396,2882,17839
2022-06-02 22:00:00+00,17198,0,5519,2504,299,280,2008,153,0,76,28037,252,10330,8322,2803,17198
2022-06-02 22:30:00+00,15690,0,5519,2670,289,256,1998,270,0,0,26692,245,10476,8478,2959,15690
2022-06-02 23:00:00+00,15206,0,5529,2897,254,104,1988,250,0,0,26228,242,10668,8680,3151,15206
2022-06-02 23:30:00+00,14424,0,5516,3102,249,112,1976,211,0,0,25590,236,10843,8867,3351,14424
2022-06-03 00:00:00+00,14651,0,5512,3089,235,122,1974,189,0,46,25818,237,10810,8836,3324,14651
2022-06-03 00:30:00+00,14646,0,5510,3196,235,90,1973,161,0,0,25811,236,10914,8941,3431,14646
2022-06-03 01:00:00+00,14630,0,5523,3113,234,170,1974,146,0,0,25790,237,10844,8870,3347,14630
2022-06-03 01:30:00+00,14591,0,5526,3011,225,190,1974,139,0,0,25656,238,10736,8762,3236,14591
2022-06-03 02:00:00+00,14544,0,5527,2951,197,172,1976,149,0,0,25516,239,10651,8675,3148,14544
2022-06-03 02:30:00+00,14446,0,5529,3028,197,184,1975,136,0,0,25495,237,10729,8754,3225,14446
2022-06-03 03:00:00+00,14171,0,5534,3180,196,36,2120,142,0,0,25379,232,11030,8910,3376,14171
2022-06-03 03:30:00+00,14019,0,5540,3151,199,14,2217,148,0,0,25288,231,11107,8890,3350,14019
2022-06-03 04:00:00+00,14353,0,5540,2910,211,16,2221,161,48,0,25460,235,10930,8709,3169,14353
2022-06-03 04:30:00+00,14359,0,5545,2966,237,32,2204,158,248,0,25749,232,11200,8996,3451,14359
2022-06-03 05:00:00+00,14222,0,5545,3128,336,0,2032,154,566,0,25983,227,11607,9575,4030,14222
2022-06-03 05:30:00+00,14475,0,5546,3198,349,0,1943,245,1052,0,26808,224,12088,10145,4599,14475
2022-06-03 06:00:00+00,14763,0,5548,3349,349,0,1938,385,1544,172,28048,220,12728,10790,5242,14763
2022-06-03 06:30:00+00,15001,0,5545,3330,352,0,2084,500,1998,134,28944,218,13309,11225,5680,15001
2022-06-03 07:00:00+00,14742,0,5538,3664,383,0,2068,457,2527,0,29379,211,14180,12112,6574,14742
2022-06-03 07:30:00+00,14774,0,5536,3958,378,50,2082,464,3092,0,30334,205,15046,12964,7428,14774
2022-06-03 08:00:00+00,14407,0,5552,4318,344,272,2112,407,3940,0,31352,195,16266,14154,8602,14407
2022-06-03 08:30:00+00,14444,0,5558,4595,360,288,2117,317,4686,0,32365,188,17316,15199,9641,14444
2022-06-03 09:00:00+00,14562,0,5567,4861,350,318,2109,177,5881,64,33889,179,18768,16659,11092,14562
2022-06-03 09:30:00+00,13964,0,5571,5306,328,314,2084,134,6878,0,34579,168,20167,18083,12512,13964
2022-06-03 10:00:00+00,13643,0,5571,5869,306,0,2060,142,7374,0,34965,162,21180,19120,13549,13643
2022-06-03 10:30:00+00,13376,0,5576,6280,267,0,1924,144,7668,0,35235,157,21715,19791,14215,13376
2022-06-03 11:00:00+00,13348,0,5584,6504,243,64,1710,140,8200,0,35793,154,22241,20531,14947,13348
2022-06-03 11:30:00+00,13573,0,5591,6449,239,64,1644,139,7642,0,35341,158,21565,19921,14330,13573
2022-06-03 12:00:00+00,13981,0,5596,6408,197,0,1755,143,6851,0,34931,165,20807,19052,13456,13981
2022-06-03 12:30:00+00,13565,0,5595,6479,197,0,1734,144,6630,0,34344,163,20635,18901,13306,13565
2022-06-03 13:00:00+00,13213,0,5593,6676,198,0,1671,157,6054,0,33562,162,20192,18521,12928,13213
2022-06-03 13:30:00+00,13025,0,5590,6887,198,0,1656,155,5580,0,33091,162,19911,18255,12665,13025
2022-06-03 14:00:00+00,13217,0,5588,6940,243,0,1670,184,5314,0,33156,165,19755,18085,12497,13217
2022-06-03 14:30:00+00,13662,0,5589,7006,258,0,1672,188,4666,0,33041,171,19191,17519,11930,13662
2022-06-03 15:00:00+00,13972,0,5589,7013,286,0,1675,186,4454,60,33235,173,19017,17342,11753,13972
2022-06-03 15:30:00+00,14475,0,5587,7265,290,0,1902,182,3676,0,33377,179,18720,16818,11231,14475
2022-06-03 16:00:00+00,14871,0,5588,7456,397,0,2260,192,3237,32,34033,182,18938,16678,11090,14871
2022-06-03 16:30:00+00,15147,0,5592,7585,401,0,2269,383,2439,44,33860,188,18286,16017,10425,15147
2022-06-03 17:00:00+00,14903,0,5602,7762,406,0,2257,470,1920,148,33468,188,17947,15690,10088,14903
2022-06-03 17:30:00+00,14258,0,5597,7970,406,0,2268,542,1388,274,32703,185,17629,15361,9764,14258
2022-06-03 18:00:00+00,13818,0,5598,8246,500,0,2267,516,983,262,32190,182,17594,15327,9729,13818
2022-06-03 18:30:00+00,13533,0,5598,8520,498,0,2263,515,705,222,31854,181,17584,15321,9723,13533
2022-06-03 19:00:00+00,13889,0,5598,8712,498,14,2266,436,322,70,31805,185,17396,15130,9532,13889
2022-06-03 19:30:00+00,13705,0,5598,8919,498,0,2264,246,101,0,31331,183,17380,15116,9518,13705
2022-06-03 20:00:00+00,13843,0,5602,9219,344,64,2244,228,2,0,31546,185,17411,15167,9565,13843
2022-06-03 20:30:00+00,13452,0,5608,9538,339,70,2251,232,0,0,31490,180,17736,15485,9877,13452
2022-06-03 21:00:00+00,12814,0,5608,9897,338,0,2255,182,0,0,31094,173,18098,15843,10235,12814
2022-06-03 21:30:00+00,11729,0,5603,10042,329,0,2246,243,0,0,30192,164,18220,15974,10372,11729
2022-06-03 22:00:00+00,9345,0,5613,9869,277,0,2246,251,0,0,27601,146,18005,15759,10146,9345
2022-06-03 22:30:00+00,8061,0,5614,9764,272,0,2246,330,0,0,26287,135,17896,15650,10036,8061
2022-06-03 23:00:00+00,7271,0,5613,9755,201,82,2261,337,0,38,25558,128,17830,15569,9956,7271
2022-06-03 23:30:00+00,7291,0,5614,9256,200,154,2244,209,0,54,25022,131,17314,15070,9456,7291
2022-06-04 00:00:00+00,7316,0,5609,8997,184,302,2236,197,0,0,24841,135,17026,14790,9181,7316
2022-06-04 00:30:00+00,7625,0,5610,8849,183,318,2163,176,0,0,24924,139,16805,14642,9032,7625
2022-06-04 01:00:00+00,7464,0,5606,8719,185,398,2141,185,0,0,24698,139,16651,14510,8904,7464
2022-06-04 01:30:00+00,7034,0,5607,8650,186,458,2219,174,0,0,24328,136,16662,14443,8836,7034
2022-06-04 02:00:00+00,6924,0,5591,8618,186,482,2213,182,0,0,24196,135,16608,14395,8804,6924
2022-06-04 02:30:00+00,7188,0,5587,8598,167,440,1956,198,0,0,24134,138,16308,14352,8765,7188
2022-06-04 03:00:00+00,7681,0,5608,8515,167,540,1602,185,0,0,24298,145,15892,14290,8682,7681
2022-06-04 03:30:00+00,7689,0,5617,8332,167,604,1602,164,0,0,24175,147,15718,14116,8499,7689
2022-06-04 04:00:00+00,6784,0,5617,8361,167,586,1601,170,30,0,23316,137,15776,14175,8558,6784
2022-06-04 04:30:00+00,6830,0,5617,8299,199,630,1601,175,145,0,23496,137,15861,14260,8643,6830
2022-06-04 05:00:00+00,7716,0,5622,8002,305,666,1600,191,353,0,24455,147,15882,14282,8660,7716
2022-06-04 05:30:00+00,8171,0,5626,7855,404,602,1596,210,612,0,25076,150,16093,14497,8871,8171
2022-06-04 06:00:00+00,8788,0,5621,8000,413,640,1603,216,988,0,26269,153,16625,15022,9401,8788
2022-06-04 06:30:00+00,9259,0,5624,8253,472,472,1602,247,1366,16,27311,151,17317,15715,10091,9259
2022-06-04 07:00:00+00,9741,0,5623,8189,479,206,1602,338,1788,140,28106,150,17681,16079,10456,9741
2022-06-04 07:30:00+00,10061,0,5621,7853,479,96,1600,575,2280,388,28953,151,17833,16233,10612,10061
2022-06-04 08:00:00+00,9799,0,5619,7633,480,514,1603,535,2652,216,29051,147,17987,16384,10765,9799
2022-06-04 08:30:00+00,10380,0,5619,7593,477,536,1600,538,2879,12,29634,152,18168,16568,10949,10380
2022-06-04 09:00:00+00,10265,0,5620,7681,479,1398,1584,575,3071,110,30783,145,18435,16851,11231,10265
2022-06-04 09:30:00+00,10178,0,5621,7728,465,1466,1596,547,3814,18,31433,141,19224,17628,12007,10178
2022-06-04 10:00:00+00,9954,0,5620,7988,283,1824,1599,469,4372,0,32109,138,19862,18263,12643,9954
2022-06-04 10:30:00+00,9792,0,5622,8020,243,1924,1597,329,5145,0,32672,133,20627,19030,13408,9792
2022-06-04 11:00:00+00,8996,0,5621,8133,180,2650,1599,183,5829,0,33191,128,21362,19763,14142,8996
2022-06-04 11:30:00+00,8606,0,5619,8215,179,2756,1600,153,6028,0,33156,124,21641,20041,14422,8606
2022-06-04 12:00:00+00,8826,0,5621,8098,176,2284,1597,169,6696,0,33467,125,22188,20591,14970,8826
2022-06-04 12:30:00+00,8631,0,5618,7979,162,2150,1596,177,6420,0,32733,124,21775,20179,14561,8631
2022-06-04 13:00:00+00,8850,0,5616,7928,160,1490,1597,177,6143,0,31961,125,21444,19847,14231,8850
2022-06-04 13:30:00+00,8418,0,5621,8153,161,1472,1597,155,6251,0,31828,120,21783,20186,14565,8418
2022-06-04 14:00:00+00,7755,0,5618,8231,191,1878,1465,151,6201,0,31490,117,21706,20241,14623,7755
2022-06-04 14:30:00+00,7904,0,5613,8464,204,1880,1275,151,5994,0,31485,119,21550,20275,14662,7904
2022-06-04 15:00:00+00,9147,0,5613,8279,298,1176,1277,163,5443,0,31396,133,20910,19633,14020,9147
2022-06-04 15:30:00+00,10504,0,5614,8287,311,1024,1364,152,4914,16,32186,145,20490,19126,13512,10504
2022-06-04 16:00:00+00,12267,0,5615,8566,439,330,1519,178,4075,0,32989,158,20214,18695,13080,12267
2022-06-04 16:30:00+00,12893,0,5611,8664,439,336,1607,239,3430,0,33219,166,19751,18144,12533,12893
2022-06-04 17:00:00+00,13344,0,5609,8561,473,366,1570,314,2792,24,33053,172,19005,17435,11826,13344
2022-06-04 17:30:00+00,13353,0,5615,8404,475,442,1576,398,2133,8,32404,176,18203,16627,11012,13353
2022-06-04 18:00:00+00,12704,0,5613,8469,486,832,1585,407,1473,256,31825,172,17626,16041,10428,12704
2022-06-04 18:30:00+00,12407,0,5612,8771,486,792,1593,415,829,290,31195,171,17291,15698,10086,12407
2022-06-04 19:00:00+00,12459,0,5613,8875,486,808,1681,463,312,292,30989,173,16967,15286,9673,12459
2022-06-04 19:30:00+00,12277,0,5610,8867,486,814,1758,448,78,292,30630,173,16799,15041,9431,12277
2022-06-04 20:00:00+00,12318,0,5614,8637,474,842,1978,348,1,232,30444,175,16704,14726,9112,12318
2022-06-04 20:30:00+00,12294,0,5616,8570,458,834,2205,283,0,0,30260,176,16849,14644,9028,12294
2022-06-04 21:00:00+00,11935,0,5619,9018,443,468,2235,263,0,0,29981,173,17315,15080,9461,11935
2022-06-04 21:30:00+00,10943,0,5618,9317,424,482,2221,239,0,18,29262,165,17580,15359,9741,10943
2022-06-04 22:00:00+00,9136,0,5621,9186,391,342,1908,269,0,128,26981,151,17106,15198,9577,9136
2022-06-04 22:30:00+00,8606,0,5623,8826,388,302,1945,230,0,28,25948,148,16782,14837,9214,8606
2022-06-04 23:00:00+00,8475,0,5618,8678,285,290,2013,229,0,72,25660,147,16594,14581,8963,8475
2022-06-04 23:30:00+00,8105,0,5620,8660,198,304,2052,187,0,0,25126,145,16530,14478,8858,8105
2022-06-05 00:00:00+00,7553,0,5613,8765,168,422,1847,182,0,0,24550,140,16393,14546,8933,7553
2022-06-05 00:30:00+00,7397,0,5612,8561,168,432,1874,196,0,72,24312,140,16215,14341,8729,7397
2022-06-05 01:00:00+00,7389,0,5625,8458,162,452,2081,173,0,48,24388,140,16326,14245,8620,7389
2022-06-05 01:30:00+00,7235,0,5623,8346,158,492,2094,158,0,0,24106,140,16221,14127,8504,7235
2022-06-05 02:00:00+00,6996,0,5643,8461,158,472,2066,160,0,0,23956,136,16328,14262,8619,6996
2022-06-05 02:30:00+00,7058,0,5657,8560,158,494,2048,157,0,0,24132,137,16423,14375,8718,7058
2022-06-05 03:00:00+00,6865,0,5670,8673,158,528,1802,162,0,0,23858,135,16303,14501,8831,6865
2022-06-05 03:30:00+00,6655,0,5677,9006,158,462,1774,154,0,0,23886,129,16615,14841,9164,6655
2022-06-05 04:00:00+00,6662,0,5705,8722,158,186,1851,175,2,0,23461,127,16438,14587,8882,6662
2022-06-05 04:30:00+00,7211,0,5724,8503,165,139,2088,157,37,0,24024,133,16517,14429,8705,7211
2022-06-05 05:00:00+00,7046,0,5735,8232,205,93,2064,156,131,0,23663,132,16367,14303,8568,7046
2022-06-05 05:30:00+00,7643,0,5736,7892,219,14,2036,158,270,0,23968,138,16153,14117,8381,7643
2022-06-05 06:00:00+00,7802,0,5742,8002,251,104,1818,157,417,0,24293,139,16230,14412,8670,7802
2022-06-05 06:30:00+00,8273,0,5737,7782,255,268,2035,173,524,0,25047,146,16333,14298,8561,8273
2022-06-05 07:00:00+00,8561,0,5741,7536,312,736,2239,170,668,0,25963,149,16496,14257,8516,8561
2022-06-05 07:30:00+00,9304,0,5756,6965,377,946,2247,189,924,146,26854,158,16269,14022,8266,9304
2022-06-05 08:00:00+00,9156,0,5764,6794,427,1414,2152,218,1278,70,27273,153,16415,14263,8499,9156
2022-06-05 08:30:00+00,9372,0,5766,6717,482,1442,2158,323,1562,390,28212,152,16685,14527,8761,9372
2022-06-05 09:00:00+00,9307,0,5771,6517,570,2202,2082,382,1760,216,28807,154,16700,14618,8847,9307
2022-06-05 09:30:00+00,9462,0,5773,6366,588,2228,2093,544,1948,354,29356,154,16768,14675,8902,9462
2022-06-05 10:00:00+00,9759,0,5852,6248,576,2040,2101,556,2238,258,29628,155,17015,14914,9062,9759
2022-06-05 10:30:00+00,9925,0,5863,6379,597,2068,2225,589,2236,382,30264,155,17300,15075,9212,9925
2022-06-05 11:00:00+00,10143,0,5866,6164,480,1772,2236,599,2156,836,30252,149,16902,14666,8800,10143
2022-06-05 11:30:00+00,10747,0,5871,6278,564,1788,2221,634,2138,428,30669,155,17072,14851,8980,10747
2022-06-05 12:00:00+00,11004,0,5864,6279,522,2128,2235,611,2092,0,30735,157,16992,14757,8893,11004
2022-06-05 12:30:00+00,11017,0,5877,6180,521,2148,2225,591,2015,0,30574,158,16818,14593,8716,11017
2022-06-05 13:00:00+00,10806,0,5876,6113,392,2212,2240,624,1984,0,30247,161,16605,14365,8489,10806
2022-06-05 13:30:00+00,10643,0,5873,6009,291,2226,2251,613,1858,0,29764,161,16282,14031,8158,10643
2022-06-05 14:00:00+00,10784,0,5869,5776,248,2266,2265,583,1749,0,29540,163,15907,13642,7773,10784
2022-06-05 14:30:00+00,11128,0,5862,5614,298,2254,2275,463,1562,148,29604,166,15611,13336,7474,11128
2022-06-05 15:00:00+00,11932,0,5867,5446,501,1892,2280,323,1314,480,30035,170,15408,13128,7261,11932
2022-06-05 15:30:00+00,13126,0,5869,5314,528,1876,2274,417,1139,368,30911,181,15124,12850,6981,13126
2022-06-05 16:00:00+00,14513,0,5871,5571,533,1224,2281,382,974,488,31837,195,15230,12949,7078,14513
2022-06-05 16:30:00+00,15036,0,5870,5692,515,1210,2274,419,763,300,32079,200,15114,12840,6970,15036
2022-06-05 17:00:00+00,15276,0,5865,5616,505,1038,2274,523,595,574,32266,201,14855,12581,6716,15276
2022-06-05 17:30:00+00,14920,0,5862,5423,521,1064,2277,534,431,590,31622,201,14514,12237,6375,14920
2022-06-05 18:00:00+00,14415,0,5868,5380,514,1308,2284,555,277,630,31231,197,14323,12039,6171,14415
2022-06-05 18:30:00+00,14332,0,5870,5215,496,1308,2253,442,152,566,30634,199,13986,11733,5863,14332
2022-06-05 19:00:00+00,14864,0,5868,5127,494,960,2271,458,75,636,30753,205,13835,11564,5696,14864
2022-06-05 19:30:00+00,14724,0,5863,4960,495,916,2239,432,26,504,30159,206,13583,11344,5481,14724
2022-06-05 20:00:00+00,15258,0,5858,4796,495,538,2290,508,0,74,29817,217,13439,11149,5291,15258
2022-06-05 20:30:00+00,15290,0,5865,4603,498,504,2279,422,0,0,29461,219,13245,10966,5101,15290
2022-06-05 21:00:00+00,15687,0,5873,4499,452,244,2281,367,0,0,29403,224,13105,10824,4951,15687
2022-06-05 21:30:00+00,14709,0,5870,4442,337,222,2315,299,0,58,28252,219,12964,10649,4779,14709
2022-06-05 22:00:00+00,11151,0,5865,4191,319,1384,2119,245,0,40,25314,190,12494,10375,4510,11151
2022-06-05 22:30:00+00,9632,0,5869,4018,322,1440,2294,267,0,148,23990,177,12503,10209,4340,9632
2022-06-05 23:00:00+00,8962,0,5861,4016,244,1164,2056,267,0,0,22570,175,12177,10121,4260,8962
2022-06-05 23:30:00+00,8792,0,5860,3974,231,1128,1890,222,0,0,22097,174,11955,10065,4205,8792
2022-06-06 00:00:00+00,8350,0,5865,4011,181,1146,2122,194,0,0,21869,170,12179,10057,4192,8350
2022-06-06 00:30:00+00,8528,0,5859,3734,181,1130,2062,207,0,0,21701,174,11836,9774,3915,8528
2022-06-06 01:00:00+00,8347,0,5865,3695,180,1214,2184,185,0,0,21670,176,11924,9740,3875,8347
2022-06-06 01:30:00+00,8224,0,5861,3668,161,1258,2231,181,0,0,21584,175,11921,9690,3829,8224
2022-06-06 02:00:00+00,8611,0,5864,3778,161,1408,2239,174,0,0,22235,178,12042,9803,3939,8611
2022-06-06 02:30:00+00,8373,0,5854,4007,161,1410,2244,175,0,0,22224,173,12266,10022,4168,8373
2022-06-06 03:00:00+00,7748,0,5859,4171,179,1932,2039,175,0,0,22103,169,12248,10209,4350,7748
2022-06-06 03:30:00+00,7663,0,5863,4329,179,1936,1873,168,0,0,22011,168,12244,10371,4508,7663
2022-06-06 04:00:00+00,7709,0,5895,4246,177,2124,1861,175,3,0,22190,168,12182,10321,4426,7709
2022-06-06 04:30:00+00,8066,0,5967,4188,177,2150,1796,176,33,0,22552,171,12160,10364,4398,8066
2022-06-06 05:00:00+00,9027,0,5975,4225,204,2534,1869,177,134,0,24145,177,12407,10538,4563,9027
2022-06-06 05:30:00+00,10439,0,5973,4195,227,2552,1944,185,324,0,25839,187,12663,10719,4746,10439
2022-06-06 06:00:00+00,13223,0,5979,3960,337,2352,2235,206,561,0,28853,207,13072,10837,4858,13223
2022-06-06 06:30:00+00,14408,0,5978,3773,434,2342,2282,355,885,198,30655,212,13352,11070,5092,14408
2022-06-06 07:00:00+00,15262,0,5977,3723,410,2470,2285,341,1206,344,32018,212,13601,11316,5339,15262
2022-06-06 07:30:00+00,15535,0,5978,3487,392,2476,2308,421,1644,516,32757,212,13809,11501,5523,15535
2022-06-06 08:00:00+00,15940,0,5977,3378,391,3110,2309,416,2041,184,33746,211,14096,11787,5810,15940
2022-06-06 08:30:00+00,16024,0,5975,3299,403,3144,2313,420,2340,174,34092,210,14330,12017,6042,16024
2022-06-06 09:00:00+00,16105,0,5975,3736,436,3142,2330,397,2607,0,34728,207,15084,12754,6779,16105
2022-06-06 09:30:00+00,16173,0,5972,3810,349,3140,2334,430,2947,130,35285,204,15412,13078,7106,16173
2022-06-06 10:00:00+00,16189,0,5981,3764,419,2930,2306,418,3064,166,35237,205,15534,13228,7247,16189
2022-06-06 10:30:00+00,16124,0,5978,3873,417,2916,2316,343,3228,0,35195,204,15812,13496,7518,16124
2022-06-06 11:00:00+00,15626,0,5967,4285,323,3718,2327,248,3349,14,35857,194,16251,13924,7957,15626
2022-06-06 11:30:00+00,15493,0,5956,4453,302,3752,2323,203,3500,0,35982,192,16534,14211,8255,15493
2022-06-06 12:00:00+00,15952,0,5942,4653,244,2626,2293,230,3637,0,35577,199,16769,14476,8534,15952
2022-06-06 12:30:00+00,15127,0,5936,4845,226,2580,2313,200,3777,0,35004,192,17097,14784,8848,15127
2022-06-06 13:00:00+00,15230,0,5934,4930,228,2194,2306,193,3824,0,34839,193,17222,14916,8982,15230
2022-06-06 13:30:00+00,15055,0,5939,4835,230,2184,2306,184,4049,0,34782,192,17359,15053,9114,15055
2022-06-06 14:00:00+00,15239,0,5943,4782,239,2002,2317,189,4308,0,35019,192,17589,15272,9329,15239
2022-06-06 14:30:00+00,15351,0,5936,4778,241,2002,2323,308,4398,34,35371,193,17676,15353,9417,15351
2022-06-06 15:00:00+00,16030,0,5933,4796,298,1868,2324,288,3869,0,35406,199,17220,14896,8963,16030
2022-06-06 15:30:00+00,16690,0,5936,4916,305,1864,2319,344,3259,12,35645,205,16735,14416,8480,16690
2022-06-06 16:00:00+00,16859,0,5937,4918,466,2222,2321,375,2837,36,35971,205,16479,14158,8221,16859
2022-06-06 16:30:00+00,17001,0,5941,4889,458,2250,2324,459,2418,176,35916,208,16030,13706,7765,17001
2022-06-06 17:00:00+00,17012,0,5936,4820,499,1860,2347,535,1950,396,35355,209,15552,13205,7269,17012
2022-06-06 17:30:00+00,17227,0,5938,4733,507,1860,2346,505,1463,288,34867,215,14987,12641,6703,17227
2022-06-06 18:00:00+00,17353,0,5940,4746,508,1319,2342,515,930,694,34347,220,14466,12124,6184,17353
2022-06-06 18:30:00+00,17282,0,5944,4676,503,1191,2344,502,568,576,33585,224,14035,11691,5747,17282
2022-06-06 19:00:00+00,17023,0,5937,4506,503,672,2351,653,303,734,32682,225,13600,11249,5312,17023
2022-06-06 19:30:00+00,16974,0,5940,4211,500,666,2347,623,87,756,32104,228,13085,10738,4798,16974
2022-06-06 20:00:00+00,16884,0,5940,4031,480,636,2344,580,4,462,31361,232,12799,10455,4515,16884
2022-06-06 20:30:00+00,16565,0,5937,4034,472,636,2347,456,0,180,30627,233,12790,10443,4506,16565
2022-06-06 21:00:00+00,16869,0,5941,4074,423,642,2341,305,0,106,30701,234,12779,10438,4497,16869
2022-06-06 21:30:00+00,15531,0,5941,4228,405,640,2342,292,0,20,29399,226,12916,10574,4633,15531
2022-06-06 22:00:00+00,14732,0,5947,4344,378,336,2327,194,0,0,28258,218,12996,10669,4722,14732
2022-06-06 22:30:00+00,13196,0,5945,4548,371,336,2305,172,0,0,26873,207,13169,10864,4919,13196
2022-06-06 23:00:00+00,12705,0,5966,4658,175,0,2306,167,0,0,25977,205,13105,10799,4833,12705
2022-06-06 23:30:00+00,12178,0,6037,4672,174,0,2321,188,0,0,25570,201,13204,10883,4846,12178
2022-06-07 00:00:00+00,12365,0,6040,4711,174,0,2305,168,0,0,25763,202,13230,10925,4885,12365
2022-06-07 00:30:00+00,12417,0,6068,4645,158,0,2315,184,0,0,25787,203,13186,10871,4803,12417
2022-06-07 01:00:00+00,11741,0,6134,4383,114,0,2319,199,0,0,24890,199,12950,10631,4497,11741
2022-06-07 01:30:00+00,11787,0,6140,3883,114,0,2314,170,0,0,24408,204,12451,10137,3997,11787
2022-06-07 02:00:00+00,11705,0,6137,3518,115,54,2323,176,0,0,24028,206,12093,9770,3633,11705
2022-06-07 02:30:00+00,12054,0,6138,3200,114,56,2323,178,0,0,24063,211,11775,9452,3314,12054
2022-06-07 03:00:00+00,12879,0,6138,2987,115,0,2312,182,0,0,24613,220,11552,9240,3102,12879
2022-06-07 03:30:00+00,12823,0,6141,2925,133,0,2311,170,0,0,24503,220,11510,9199,3058,12823
2022-06-07 04:00:00+00,12881,0,6137,2868,114,74,2313,187,57,0,24631,221,11489,9176,3039,12881
2022-06-07 04:30:00+00,13849,0,6143,2696,115,126,2320,198,350,0,25797,227,11624,9304,3161,13849
2022-06-07 05:00:00+00,15814,0,6195,2494,188,18,2336,233,802,0,28080,235,12014,9678,3484,15814
2022-06-07 05:30:00+00,17268,0,6210,2318,212,0,2341,387,1339,0,30075,239,12420,10079,3869,17268
2022-06-07 06:00:00+00,17898,0,6206,2050,403,246,2343,452,1875,56,31529,240,12877,10534,4328,17898
2022-06-07 06:30:00+00,18564,0,6208,1874,454,260,2343,569,2371,490,33133,238,13250,10907,4699,18564
2022-06-07 07:00:00+00,18198,0,6203,1591,475,1398,2252,570,2990,70,33747,239,13511,11259,5056,18198
2022-06-07 07:30:00+00,18483,0,6207,1407,488,1426,2028,514,3801,114,34468,236,13931,11903,5696,18483
2022-06-07 08:00:00+00,18442,0,6204,1336,421,1854,2162,491,4352,148,35410,231,14475,12313,6109,18442
2022-06-07 08:30:00+00,17822,0,6206,1350,421,1870,2241,479,4989,66,35444,224,15207,12966,6760,17822
2022-06-07 09:00:00+00,17977,0,6203,1348,405,1930,2246,360,5536,138,36144,221,15738,13492,7290,17977
2022-06-07 09:30:00+00,18017,0,6198,1216,372,1916,2253,353,5781,52,36158,221,15820,13567,7369,18017
2022-06-07 10:00:00+00,18268,0,6200,1109,253,1726,2263,405,5996,16,36236,223,15821,13558,7358,18268
2022-06-07 10:30:00+00,18007,0,6203,1100,240,1724,2261,397,5682,288,35902,223,15486,13225,7022,18007
2022-06-07 11:00:00+00,18135,0,6206,1095,305,1802,2211,338,5827,294,36213,222,15644,13433,7227,18135
2022-06-07 11:30:00+00,18381,0,6206,1073,310,1798,2200,277,6218,16,36479,222,16007,13807,7601,18381
2022-06-07 12:00:00+00,18213,0,6205,1208,309,1492,2306,240,5789,26,35788,224,15817,13511,7306,18213
2022-06-07 12:30:00+00,18030,0,6207,1270,294,1488,2340,229,5584,0,35442,224,15695,13355,7148,18030
2022-06-07 13:00:00+00,17966,0,6201,1351,269,1476,2340,192,4959,0,34754,227,15120,12780,6579,17966
2022-06-07 13:30:00+00,17895,0,6196,1443,266,1470,2342,184,4855,0,34651,226,15102,12760,6564,17895
2022-06-07 14:00:00+00,17942,0,6198,1664,290,796,2340,184,5301,0,34715,221,15793,13453,7255,17942
2022-06-07 14:30:00+00,18125,0,6199,1925,296,772,2342,192,4692,66,34609,224,15454,13112,6913,18125
2022-06-07 15:00:00+00,17681,0,6204,2090,352,930,2347,232,4486,0,34322,221,15479,13132,6928,17681
2022-06-07 15:30:00+00,18430,0,6205,2127,365,932,2345,269,4197,0,34870,226,15239,12894,6689,18430
2022-06-07 16:00:00+00,18822,0,6206,2258,354,410,2345,577,3524,68,34564,231,14687,12342,6136,18822
2022-06-07 16:30:00+00,18778,0,6205,2196,495,398,2346,678,2786,750,34632,231,14028,11682,5477,18778
2022-06-07 17:00:00+00,18826,0,6209,2342,580,266,2344,889,2193,996,34645,233,13668,11324,5115,18826
2022-06-07 17:30:00+00,18943,0,6208,2498,586,266,2347,955,1724,654,34181,238,13363,11016,4808,18943
2022-06-07 18:00:00+00,18823,0,6206,2782,533,114,2347,991,1071,980,33847,238,12939,10592,4386,18823
2022-06-07 18:30:00+00,18513,0,6211,2763,538,200,2346,899,606,1128,33204,239,12464,10118,3907,18513
2022-06-07 19:00:00+00,18980,0,6208,2845,514,316,2348,830,282,936,33259,245,12197,9849,3641,18980
2022-06-07 19:30:00+00,18981,0,6208,3019,481,406,2344,558,70,706,32773,248,12122,9778,3570,18981
2022-06-07 20:00:00+00,18983,0,6212,3032,448,508,2345,514,2,798,32842,248,12039,9694,3482,18983
2022-06-07 20:30:00+00,18915,0,6217,3105,423,550,2347,533,0,190,32280,252,12092,9745,3528,18915
2022-06-07 21:00:00+00,18457,0,6211,3382,347,610,2343,435,0,0,31785,251,12283,9940,3729,18457
2022-06-07 21:30:00+00,16969,0,6212,3615,347,700,2321,209,0,58,30431,241,12495,10174,3962,16969
2022-06-07 22:00:00+00,14949,0,6215,3844,319,676,2291,173,0,0,28467,229,12669,10378,4163,14949
2022-06-07 22:30:00+00,13085,0,6212,4252,309,748,2305,194,0,0,27105,215,13078,10773,4561,13085
2022-06-07 23:00:00+00,12211,0,6214,4464,226,750,2284,213,0,0,26362,208,13188,10904,4690,12211
2022-06-07 23:30:00+00,11999,0,6216,4395,219,694,2258,180,0,40,26001,207,13088,10830,4614,11999
2022-06-08 00:00:00+00,12225,0,6221,4621,179,556,2265,178,0,0,26245,206,13286,11021,4800,12225
2022-06-08 00:30:00+00,12111,0,6224,4855,179,540,2271,165,0,0,26345,203,13529,11258,5034,12111
2022-06-08 01:00:00+00,12223,0,6220,5033,65,640,2267,160,0,0,26608,204,13585,11318,5098,12223
2022-06-08 01:30:00+00,11810,0,6225,5262,65,494,2268,163,0,0,26287,198,13820,11552,5327,11810
2022-06-08 02:00:00+00,12002,0,6217,5376,65,570,2274,176,0,0,26680,199,13932,11658,5441,12002
2022-06-08 02:30:00+00,12066,0,6217,5360,65,570,2272,176,0,0,26726,200,13914,11642,5425,12066
2022-06-08 03:00:00+00,12012,0,6223,5577,65,490,2256,163,0,0,26786,197,14121,11865,5642,12012
2022-06-08 03:30:00+00,11355,0,6223,6181,65,448,2176,162,0,0,26610,187,14645,12469,6246,11355
2022-06-08 04:00:00+00,10960,0,6213,6363,65,196,1758,168,4,0,25727,182,14403,12645,6432,10960
2022-06-08 04:30:00+00,11179,0,6222,6755,82,232,1584,173,91,0,26318,181,14734,13150,6928,11179
2022-06-08 05:00:00+00,11910,0,6214,7139,196,314,1670,192,349,0,27984,182,15568,13898,7684,11910
2022-06-08 05:30:00+00,13229,0,6212,7336,195,418,1840,192,594,0,30016,189,16177,14337,8125,13229
2022-06-08 06:00:00+00,14092,0,6208,6984,282,430,1965,375,1094,366,31796,192,16533,14568,8360,14092
2022-06-08 06:30:00+00,14929,0,6216,6569,338,480,2150,340,1817,496,33335,194,17090,14940,8724,14929
2022-06-08 07:00:00+00,15183,0,6216,6605,337,518,2227,331,2547,522,34486,191,17932,15705,9489,15183
2022-06-08 07:30:00+00,15221,0,6217,6467,299,578,2233,364,3187,588,35154,189,18403,16170,9953,15221
2022-06-08 08:00:00+00,15275,0,6217,6528,289,744,2258,541,3797,82,35731,190,19089,16831,10614,15275
2022-06-08 08:30:00+00,15116,0,6219,6687,288,698,2260,491,4450,0,36209,184,19904,17644,11425,15116
2022-06-08 09:00:00+00,15335,0,6216,6396,249,982,2258,320,4458,0,36214,189,19577,17319,11103,15335
2022-06-08 09:30:00+00,15365,0,6219,6112,240,890,2269,318,5131,4,36548,186,19971,17702,11483,15365
2022-06-08 10:00:00+00,15506,0,6233,5973,199,616,2305,416,5943,0,37191,183,20653,18348,12115,15506
2022-06-08 10:30:00+00,15360,0,6220,5845,198,642,2307,454,6163,0,37189,182,20733,18426,12206,15360
2022-06-08 11:00:00+00,15256,0,6222,5689,158,776,2305,420,6550,34,37410,180,20924,18619,12397,15256
2022-06-08 11:30:00+00,14717,0,6217,6050,167,706,2307,331,6349,0,36844,175,21090,18783,12566,14717
2022-06-08 12:00:00+00,14595,0,6216,6160,157,658,2054,330,6335,0,36505,174,20922,18868,12652,14595
2022-06-08 12:30:00+00,14659,0,6214,6288,126,566,1747,255,6328,0,36183,173,20703,18956,12742,14659
2022-06-08 13:00:00+00,14798,0,6214,6226,106,608,1804,222,6588,0,36566,174,20938,19134,12920,14798
2022-06-08 13:30:00+00,14719,0,6211,6463,96,470,1711,214,6142,0,36026,174,20623,18912,12701,14719
2022-06-08 14:00:00+00,14640,0,6209,6828,124,484,1703,202,6460,0,36650,171,21324,19621,13412,14640
2022-06-08 14:30:00+00,14907,0,6206,7298,130,518,1723,207,6016,0,37005,172,21373,19650,13444,14907
2022-06-08 15:00:00+00,14377,0,6215,8066,205,746,1720,228,5563,0,37120,166,21769,20049,13834,14377
2022-06-08 15:30:00+00,14962,0,6211,8087,221,894,1758,251,4704,0,37088,174,20981,19223,13012,14962
2022-06-08 16:00:00+00,16419,0,6208,7322,279,1008,1762,259,3770,24,37051,190,19341,17579,11371,16419
2022-06-08 16:30:00+00,17134,0,6219,7158,280,1100,1797,259,3189,0,37136,198,18643,16846,10627,17134
2022-06-08 17:00:00+00,16408,0,6208,7252,314,1214,1861,259,2649,348,36513,195,18284,16423,10215,16408
2022-06-08 17:30:00+00,16423,0,6207,7085,328,1214,1885,284,2145,592,36163,198,17650,15765,9558,16423
2022-06-08 18:00:00+00,16578,0,6212,6693,359,1214,1863,272,1363,888,35442,203,16490,14627,8415,16578
2022-06-08 18:30:00+00,16851,0,6209,6126,360,1214,1873,302,830,894,34659,211,15398,13525,7316,16851
2022-06-08 19:00:00+00,17400,0,6215,5793,360,1118,1863,284,414,332,33779,223,14645,12782,6567,17400
2022-06-08 19:30:00+00,17188,0,6212,5351,357,1012,1878,285,157,296,32736,226,13955,12077,5865,17188
2022-06-08 20:00:00+00,17157,0,6220,5167,335,620,2088,252,8,64,31911,230,13818,11730,5510,17157
2022-06-08 20:30:00+00,16819,0,6219,4593,325,430,2269,240,0,106,31001,230,13406,11137,4918,16819
2022-06-08 21:00:00+00,16807,0,6225,4605,243,122,2291,228,0,92,30613,229,13364,11073,4848,16807
2022-06-08 21:30:00+00,15517,0,6228,5060,248,34,2088,224,0,88,29487,219,13624,11536,5308,15517
2022-06-08 22:00:00+00,14697,0,6220,5723,225,162,1567,224,0,36,28854,212,13735,12168,5948,14697
2022-06-08 22:30:00+00,12978,0,6227,6304,213,422,1419,226,0,0,27789,200,14163,12744,6517,12978
2022-06-08 23:00:00+00,11368,0,6223,7361,132,290,1398,228,0,0,27000,180,15114,13716,7493,11368
2022-06-08 23:30:00+00,10191,0,6223,8112,131,238,1425,229,0,0,26549,164,15891,14466,8243,10191
2022-06-09 00:00:00+00,10467,0,6223,8087,117,126,1413,217,0,0,26650,166,15840,14427,8204,10467
2022-06-09 00:30:00+00,10884,0,6224,7798,115,92,1448,215,0,0,26776,171,15585,14137,7913,10884
2022-06-09 01:00:00+00,11078,0,6221,7875,95,0,1421,207,0,0,26897,171,15612,14191,7970,11078
2022-06-09 01:30:00+00,10764,0,6222,7979,95,68,1446,212,0,0,26786,168,15742,14296,8074,10764
2022-06-09 02:00:00+00,10259,0,6216,7858,79,98,1463,217,0,0,26190,165,15616,14153,7937,10259
2022-06-09 02:30:00+00,10527,0,6220,7736,79,98,1397,209,0,0,26266,168,15432,14035,7815,10527
2022-06-09 03:00:00+00,10555,0,6214,7590,79,98,1405,203,0,0,26144,170,15288,13883,7669,10555
2022-06-09 03:30:00+00,10700,0,6211,7452,80,98,1423,204,0,0,26168,172,15166,13743,7532,10700
2022-06-09 04:00:00+00,10627,0,6214,7262,123,172,1436,211,90,0,26135,172,15125,13689,7475,10627
2022-06-09 04:30:00+00,11084,0,6217,6975,125,266,1421,206,371,0,26665,177,15109,13688,7471,11084
2022-06-09 05:00:00+00,12474,0,6210,6315,157,246,1466,220,787,254,28129,187,14935,13469,7259,12474
2022-06-09 05:30:00+00,14839,0,6218,5757,200,301,1693,203,1232,4,30447,204,15100,13407,7189,14839
2022-06-09 06:00:00+00,16024,0,6207,5409,241,234,2238,225,1802,0,32380,206,15897,13659,7452,16024
2022-06-09 06:30:00+00,17038,0,6206,5101,242,224,2150,481,2489,0,33931,211,16188,14038,7832,17038
2022-06-09 07:00:00+00,17485,0,6208,4689,256,150,2009,515,3272,284,34868,209,16434,14425,8217,17485
2022-06-09 07:30:00+00,17347,0,6212,4442,261,150,2083,574,4051,428,35548,204,17049,14966,8754,17347
2022-06-09 08:00:00+00,17434,0,6212,4340,280,0,2230,576,4610,462,36144,202,17672,15442,9230,17434
2022-06-09 08:30:00+00,17374,0,6210,4358,277,0,2208,579,5055,200,36261,201,18108,15900,9690,17374
2022-06-09 09:00:00+00,17752,0,6213,4544,238,0,2343,719,5282,226,37317,202,18620,16277,10064,17752
2022-06-09 09:30:00+00,17618,0,6215,4991,235,14,2353,605,5431,286,37748,197,19225,16872,10657,17618
2022-06-09 10:00:00+00,17491,0,6212,5588,199,160,2230,566,5128,204,37778,197,19357,17127,10915,17491
2022-06-09 10:30:00+00,17189,0,6217,6359,195,432,2043,473,4929,102,37939,195,19743,17700,11483,17189
2022-06-09 11:00:00+00,17021,0,6120,7036,160,608,2280,335,4783,2,38345,193,20379,18099,11979,17021
2022-06-09 11:30:00+00,16657,0,6105,7431,160,582,2265,317,5080,0,38597,187,21041,18776,12671,16657
2022-06-09 12:00:00+00,16964,0,6107,7661,153,600,1778,300,4923,0,38486,190,20622,18844,12737,16964
2022-06-09 12:30:00+00,16857,0,6105,7990,133,470,1511,296,4305,0,37667,190,20044,18533,12428,16857
2022-06-09 13:00:00+00,15349,0,6108,8381,99,624,1413,308,4149,0,36431,182,20150,18737,12629,15349
2022-06-09 13:30:00+00,14454,0,6107,9028,97,660,1414,254,3795,0,35808,174,20440,19026,12920,14454
2022-06-09 14:00:00+00,14030,0,6101,9558,112,402,1437,196,3483,0,35319,168,20691,19254,13153,14030
2022-06-09 14:30:00+00,14239,0,6098,9998,115,588,1418,214,3062,0,35732,171,20691,19273,13175,14239
2022-06-09 15:00:00+00,14874,0,6101,9752,206,666,1236,206,2543,0,35584,179,19838,18602,12501,14874
2022-06-09 15:30:00+00,15445,0,6103,9744,235,668,1137,206,2429,0,35967,183,19648,18511,12408,15445
2022-06-09 16:00:00+00,15346,0,6101,10199,378,964,1134,224,1909,0,36255,184,19721,18587,12486,15346
2022-06-09 16:30:00+00,15195,0,6174,10419,424,984,1134,267,1558,0,36155,184,19709,18575,12401,15195
2022-06-09 17:00:00+00,15017,0,6183,10316,424,1064,1136,284,1335,380,36139,183,19394,18258,12075,15017
2022-06-09 17:30:00+00,14712,0,6184,10557,424,1052,1136,234,1054,360,35713,181,19355,18219,12035,14712
2022-06-09 18:00:00+00,13823,0,6182,10990,408,886,1137,236,770,728,35160,172,19487,18350,12168,13823
2022-06-09 18:30:00+00,13301,0,6177,11125,401,884,1138,240,501,584,34351,170,19342,18204,12027,13301
2022-06-09 19:00:00+00,13578,0,6174,10986,369,794,1136,261,286,320,33904,175,18951,17815,11641,13578
2022-06-09 19:30:00+00,13697,0,6175,10580,346,794,1134,261,102,268,33357,179,18337,17203,11028,13697
2022-06-09 20:00:00+00,13581,0,6178,10573,303,878,1133,240,6,46,32938,181,18193,17060,10882,13581
2022-06-09 20:30:00+00,12609,0,6181,10945,259,872,1129,208,0,0,32203,173,18514,17385,11204,12609
2022-06-09 21:00:00+00,11633,0,6175,11522,124,804,1130,236,0,0,31624,163,18951,17821,11646,11633
2022-06-09 21:30:00+00,10312,0,6186,11606,111,736,1131,202,0,0,30284,152,19034,17903,11717,10312
2022-06-09 22:00:00+00,9173,0,6187,11744,111,588,1122,255,0,0,29180,140,19164,18042,11855,9173
2022-06-09 22:30:00+00,8212,0,6188,11790,111,488,1064,204,0,0,28057,130,19153,18089,11901,8212
2022-06-09 23:00:00+00,8093,0,6189,11822,111,548,728,208,0,0,27699,130,18850,18122,11933,8093
2022-06-09 23:30:00+00,7776,0,6190,12077,111,548,728,207,0,0,27637,125,19106,18378,12188,7776
2022-06-10 00:00:00+00,7577,0,6192,12330,96,546,721,200,0,0,27662,122,19339,18618,12426,7577
2022-06-10 00:30:00+00,7640,0,6191,12257,99,542,724,200,0,0,27653,123,19271,18547,12356,7640
2022-06-10 01:00:00+00,7320,0,6191,12243,81,692,715,192,0,0,27434,122,19230,18515,12324,7320
2022-06-10 01:30:00+00,6915,0,6187,12350,81,746,723,203,0,0,27205,118,19341,18618,12431,6915
2022-06-10 02:00:00+00,6564,0,6183,12585,81,746,719,201,0,0,27079,114,19568,18849,12666,6564
2022-06-10 02:30:00+00,7059,0,6181,12305,77,746,722,208,0,0,27298,120,19285,18563,12382,7059
2022-06-10 03:00:00+00,7244,0,6179,11807,76,746,718,201,0,0,26971,124,18780,18062,11883,7244
2022-06-10 03:30:00+00,7175,0,6184,11594,76,746,725,205,0,0,26705,124,18579,17854,11670,7175
2022-06-10 04:00:00+00,7109,0,6183,11714,115,746,712,201,57,0,26838,123,18782,18070,11886,7109
2022-06-10 04:30:00+00,7617,0,6186,11481,133,738,719,211,334,0,27419,127,18853,18134,11948,7617
2022-06-10 05:00:00+00,7928,0,6190,11720,203,508,706,207,783,0,28245,124,19602,18896,12706,7928
2022-06-10 05:30:00+00,8667,0,6187,12345,229,578,712,207,1308,0,30233,127,20781,20069,13882,8667
2022-06-10 06:00:00+00,9993,0,6181,12566,262,736,728,224,2017,0,32707,135,21754,21026,14845,9993
2022-06-10 06:30:00+00,10769,0,6178,12426,263,762,722,231,2852,0,34203,139,22441,21719,15541,10769
2022-06-10 07:00:00+00,11264,0,6177,12371,263,948,717,213,3547,62,35562,141,23075,22358,16181,11264
2022-06-10 07:30:00+00,11333,0,6176,12020,262,956,714,215,4268,188,36132,139,23440,22726,16550,11333
2022-06-10 08:00:00+00,11318,0,6179,12098,265,700,721,208,4922,62,36473,135,24185,23464,17285,11318
2022-06-10 08:30:00+00,10760,0,6186,12357,248,486,718,199,5634,66,36654,126,25143,24425,18239,10760
2022-06-10 09:00:00+00,10330,0,6180,12381,168,512,728,197,6067,0,36563,122,25524,24796,18616,10330
2022-06-10 09:30:00+00,9919,0,6187,12512,165,550,739,210,6698,0,36980,116,26301,25562,19375,9919
2022-06-10 10:00:00+00,9552,0,6186,12619,147,484,981,192,7177,0,37338,111,27110,26129,19943,9552
2022-06-10 10:30:00+00,8864,0,6188,12973,145,282,1048,204,7675,0,37379,102,28029,26981,20793,8864
2022-06-10 11:00:00+00,8654,0,6186,13132,112,296,1047,196,7993,0,37616,99,28470,27423,21237,8654
2022-06-10 11:30:00+00,8243,0,6189,13242,107,296,1051,207,7998,0,37333,96,28587,27536,21347,8243
2022-06-10 12:00:00+00,8463,0,6189,13304,101,288,1049,268,8099,0,37761,97,28742,27693,21504,8463
2022-06-10 12:30:00+00,8098,0,6188,13308,97,300,1047,272,7995,0,37305,95,28635,27588,21400,8098
2022-06-10 13:00:00+00,8156,0,6180,13149,96,364,1045,279,7921,0,37190,97,28391,27346,21166,8156
2022-06-10 13:30:00+00,8455,0,6186,12789,94,412,1045,279,7643,0,36903,102,27757,26712,20526,8455
2022-06-10 14:00:00+00,7658,0,6181,12913,109,554,1046,228,7063,0,35752,96,27312,26266,20085,7658
2022-06-10 14:30:00+00,7825,0,6185,13084,109,552,1048,203,6250,0,35256,99,26676,25628,19443,7825
2022-06-10 15:00:00+00,8409,0,6181,13282,139,408,1050,212,5674,0,35355,104,26326,25276,19095,8409
2022-06-10 15:30:00+00,8616,0,6183,13731,165,512,1050,200,5144,42,35643,107,26273,25223,19040,8616
2022-06-10 16:00:00+00,8898,0,6180,14023,242,542,1014,227,4260,148,35534,111,25719,24705,18525,8898
2022-06-10 16:30:00+00,9477,0,6181,13944,251,464,1021,320,3434,196,35288,118,24831,23810,17629,9477
2022-06-10 17:00:00+00,9470,0,6180,14292,282,550,917,401,2868,218,35178,120,24539,23622,17442,9470
2022-06-10 17:30:00+00,9768,0,6182,14107,277,534,988,416,2336,396,35004,124,23890,22902,16720,9768
2022-06-10 18:00:00+00,10397,0,6182,13585,277,514,1041,311,1565,406,34278,133,22650,21609,15427,10397
2022-06-10 18:30:00+00,10490,0,6182,13499,274,512,1055,239,1105,360,33716,135,22115,21060,14878,10490
2022-06-10 19:00:00+00,10944,0,6176,13089,287,420,1053,261,574,294,33098,143,21179,20126,13950,10944
2022-06-10 19:30:00+00,10914,0,6169,12710,287,310,1033,299,182,90,31994,147,20381,19348,13179,10914
2022-06-10 20:00:00+00,10841,0,6174,12646,286,430,1010,249,12,0,31648,149,20128,19118,12944,10841
2022-06-10 20:30:00+00,10205,0,6172,12932,286,366,1097,408,0,0,31466,143,20487,19390,13218,10205
2022-06-10 21:00:00+00,9575,0,6173,12933,254,470,1096,317,0,0,30818,138,20456,19360,13187,9575
2022-06-10 21:30:00+00,8741,0,6176,13159,241,378,932,250,0,0,29877,129,20508,19576,13400,8741
2022-06-10 22:00:00+00,6604,0,6174,13231,244,342,858,418,0,0,27871,110,20507,19649,13475,6604
2022-06-10 22:30:00+00,5055,0,6178,12955,248,516,855,468,0,326,26601,93,20236,19381,13203,5055
2022-06-10 23:00:00+00,5194,0,6177,12974,172,678,861,442,0,44,26542,98,20184,19323,13146,5194
2022-06-10 23:30:00+00,4928,0,6173,12937,168,748,866,345,0,0,26165,95,20144,19278,13105,4928
2022-06-11 00:00:00+00,4520,0,6179,12940,135,746,857,410,0,0,25787,91,20111,19254,13075,4520
2022-06-11 00:30:00+00,4614,0,6178,12796,115,746,869,398,0,0,25716,93,19958,19089,12911,4614
2022-06-11 01:00:00+00,4432,0,6183,12423,113,746,860,287,0,0,25044,91,19579,18719,12536,4432
2022-06-11 01:30:00+00,4274,0,6180,12313,110,748,870,210,0,0,24705,89,19473,18603,12423,4274
2022-06-11 02:00:00+00,4241,0,6179,12350,109,748,877,180,0,0,24684,88,19515,18638,12459,4241
2022-06-11 02:30:00+00,4250,0,6180,12226,109,748,866,171,0,0,24550,88,19381,18515,12335,4250
2022-06-11 03:00:00+00,4489,0,6181,11947,109,748,868,173,0,0,24515,92,19105,18237,12056,4489
2022-06-11 03:30:00+00,4235,0,6186,11950,106,686,863,167,0,0,24193,88,19105,18242,12056,4235
2022-06-11 04:00:00+00,4247,0,6179,11789,138,648,877,157,77,0,24112,88,19060,18183,12004,4247
2022-06-11 04:30:00+00,4549,0,6182,11890,141,652,869,145,362,0,24790,90,19444,18575,12393,4549
2022-06-11 05:00:00+00,4710,0,6183,11990,189,648,853,152,803,0,25528,90,20018,19165,12982,4710
2022-06-11 05:30:00+00,4838,0,6185,12147,191,668,855,177,1382,0,26443,90,20760,19905,13720,4838
2022-06-11 06:00:00+00,5236,0,6184,12338,204,434,877,187,2039,0,27499,89,21642,20765,14581,5236
2022-06-11 06:30:00+00,5623,0,6182,12549,233,430,886,183,2762,200,29048,89,22612,21726,15544,5623
2022-06-11 07:00:00+00,5388,0,6183,12765,239,772,868,186,3650,296,30348,86,23706,22838,16654,5388
2022-06-11 07:30:00+00,5076,0,6184,12970,232,944,902,192,4376,368,31244,82,24664,23762,17578,5076
2022-06-11 08:00:00+00,4990,0,6181,13136,182,952,939,202,4875,212,31669,80,25313,24374,18193,4990
2022-06-11 08:30:00+00,5032,0,6176,13256,182,740,885,154,5459,192,32076,75,25958,25073,18897,5032
2022-06-11 09:00:00+00,5007,0,6161,13349,158,498,951,149,5984,266,32524,69,26604,25653,19491,5007
2022-06-11 09:30:00+00,4844,0,6145,13437,135,504,999,142,6106,84,32396,68,26822,25823,19678,4844
2022-06-11 10:00:00+00,4054,0,6143,13537,94,822,1066,140,6655,0,32511,60,27495,26429,20286,4054
2022-06-11 10:30:00+00,3851,0,6145,13636,86,884,1349,146,6643,0,32741,59,27860,26511,20365,3851
2022-06-11 11:00:00+00,3616,0,6155,13729,84,1838,1277,151,6896,0,33746,61,28141,26864,20709,3616
2022-06-11 11:30:00+00,3752,0,6160,13790,83,1804,1252,148,7163,0,34152,61,28448,27196,21036,3752
2022-06-11 12:00:00+00,3725,0,6163,13847,83,2110,1080,147,7214,0,34370,61,28388,27308,21144,3725
2022-06-11 12:30:00+00,3667,0,6165,13926,83,2058,874,157,7597,0,34527,59,28645,27771,21606,3667
2022-06-11 13:00:00+00,3637,0,6166,14019,83,1422,938,148,7160,0,33573,58,28366,27428,21262,3637
2022-06-11 13:30:00+00,3433,0,6167,14095,85,1342,843,141,6896,0,33002,55,28086,27243,21076,3433
2022-06-11 14:00:00+00,3883,0,6167,14149,102,438,950,143,6731,0,32563,54,28099,27149,20982,3883
2022-06-11 14:30:00+00,4098,0,6169,14179,102,478,1058,143,6353,0,32580,57,27861,26803,20634,4098
2022-06-11 15:00:00+00,4913,0,6170,14200,121,42,1437,146,5437,0,32467,67,27366,25929,19758,4913
2022-06-11 15:30:00+00,5454,0,6173,14233,143,58,1371,153,5087,0,32672,73,27007,25636,19463,5454
2022-06-11 16:00:00+00,6255,0,6183,14284,255,224,1334,171,4506,0,33212,83,26562,25228,19045,6255
2022-06-11 16:30:00+00,6541,0,6177,14575,272,266,1206,271,3798,56,33162,87,26028,24822,18645,6541
2022-06-11 17:00:00+00,6872,0,6177,14589,300,434,1122,481,3020,0,32995,94,25208,24086,17909,6872
2022-06-11 17:30:00+00,7408,0,6175,14528,278,460,1206,496,2282,178,33011,101,24469,23263,17088,7408
2022-06-11 18:00:00+00,7624,0,6181,14280,276,492,1233,540,1512,628,32766,103,23482,22249,16068,7624
2022-06-11 18:30:00+00,7760,0,6185,14031,273,478,1190,504,890,698,32009,107,22569,21379,15194,7760
2022-06-11 19:00:00+00,7773,0,6182,13759,271,506,1158,470,432,732,31283,108,21802,20644,14462,7773
2022-06-11 19:30:00+00,7836,0,6171,13191,283,430,1164,482,161,952,30670,110,20970,19806,13635,7836
2022-06-11 20:00:00+00,7905,0,6170,12667,287,216,1300,477,10,1176,30208,113,20434,19134,12964,7905
2022-06-11 20:30:00+00,8041,0,6164,11995,296,210,1354,478,0,1350,29888,116,19809,18455,12291,8041
2022-06-11 21:00:00+00,8064,0,6168,12126,290,0,1364,472,0,1054,29538,118,19948,18584,12416,8064
2022-06-11 21:30:00+00,7659,0,6171,11975,261,0,1367,462,0,762,28657,116,19774,18407,12236,7659
2022-06-11 22:00:00+00,6767,0,6169,11869,241,0,1421,436,0,184,27087,110,19700,18279,12110,6767
2022-06-11 22:30:00+00,5527,0,6174,12081,230,40,1304,417,0,90,25863,96,19789,18485,12311,5527
2022-06-11 23:00:00+00,5089,0,6172,11838,194,402,1265,347,0,134,25441,94,19469,18204,12032,5089
2022-06-11 23:30:00+00,4965,0,6177,11644,194,502,1241,299,0,72,25094,95,19256,18015,11838,4965
2022-06-12 00:00:00+00,5062,0,6162,11391,194,398,1305,250,0,98,24860,97,19052,17747,11585,5062
2022-06-12 00:30:00+00,4830,0,6176,11727,194,398,1297,204,0,0,24826,93,19394,18097,11921,4830
2022-06-12 01:00:00+00,4771,0,6178,11976,131,448,1167,229,0,0,24900,92,19452,18285,12107,4771
2022-06-12 01:30:00+00,4632,0,6184,11821,121,448,1189,248,0,0,24643,91,19315,18126,11942,4632
2022-06-12 02:00:00+00,4550,0,6182,11516,121,448,1233,213,0,14,24277,91,19052,17819,11637,4550
2022-06-12 02:30:00+00,4562,0,6184,11186,121,448,1449,203,0,0,24153,93,18940,17491,11307,4562
2022-06-12 03:00:00+00,4473,0,6187,10870,121,448,1455,202,0,92,23848,92,18633,17178,10991,4473
2022-06-12 03:30:00+00,4386,0,6187,10480,121,448,1387,205,0,100,23314,93,18175,16788,10601,4386
2022-06-12 04:00:00+00,4498,0,6189,10112,121,448,1398,228,77,148,23219,95,17897,16499,10310,4498
2022-06-12 04:30:00+00,4651,0,6188,10071,111,448,1390,342,351,66,23618,98,18111,16721,10533,4651
2022-06-12 05:00:00+00,4215,0,6184,10129,180,448,1341,217,744,0,23458,89,18578,17237,11053,4215
2022-06-12 05:30:00+00,4498,0,6178,9889,192,448,1417,180,1239,0,24041,92,18915,17498,11320,4498
2022-06-12 06:00:00+00,4678,0,6187,9580,271,446,1419,283,1913,0,24777,93,19370,17951,11764,4678
2022-06-12 06:30:00+00,4580,0,6188,9647,275,456,1487,354,2556,18,25561,90,20153,18666,12478,4580
2022-06-12 07:00:00+00,3670,0,6191,9824,276,1646,1228,188,3517,110,26650,77,21036,19808,13617,3670
2022-06-12 07:30:00+00,3777,0,6187,9891,276,1808,1382,143,4286,0,27750,78,22022,20640,14453,3777
2022-06-12 08:00:00+00,4192,0,6174,9760,249,2316,1461,150,5025,0,29327,82,22669,21208,15034,4192
2022-06-12 08:30:00+00,4157,0,6170,9627,247,2454,1539,156,5501,0,29851,81,23084,21545,15375,4157
2022-06-12 09:00:00+00,4264,0,6171,9776,205,2768,1546,150,5891,0,30771,79,23589,22043,15872,4264
2022-06-12 09:30:00+00,4132,0,6170,9869,201,2772,1526,161,6105,0,30936,77,23871,22345,16175,4132
2022-06-12 10:00:00+00,3665,0,6173,9830,147,3138,1392,205,6471,46,31067,75,24013,22621,16448,3665
2022-06-12 10:30:00+00,3506,0,6179,9770,145,3378,1402,217,6597,0,31194,76,24093,22691,16512,3506
2022-06-12 11:00:00+00,3492,0,6178,9739,122,3318,1404,168,6709,0,31129,75,24152,22748,16570,3492
2022-06-12 11:30:00+00,3270,0,6182,9939,115,3208,1381,145,7012,0,31252,70,24629,23248,17066,3270
2022-06-12 12:00:00+00,3136,0,6181,9895,112,3053,1325,143,7100,0,30945,67,24613,23288,17107,3136
2022-06-12 12:30:00+00,3205,0,6178,9667,109,2851,1457,155,7351,0,30973,65,24762,23305,17127,3205
2022-06-12 13:00:00+00,3026,0,6182,9941,113,2581,1475,144,7427,0,30890,60,25138,23663,17481,3026
2022-06-12 13:30:00+00,2823,0,6180,10210,113,2583,1385,142,7267,0,30703,58,25155,23770,17590,2823
2022-06-12 14:00:00+00,3097,0,6182,10404,113,2362,1432,148,6910,0,30648,60,25041,23609,17427,3097
2022-06-12 14:30:00+00,3350,0,6180,10625,115,2311,1334,147,6376,0,30437,62,24630,23296,17116,3350
2022-06-12 15:00:00+00,4534,0,6178,10802,176,1855,1410,192,5593,0,30740,80,24159,22749,16571,4534
2022-06-12 15:30:00+00,5434,0,6185,11163,186,1872,1301,234,4829,0,31204,91,23664,22363,16178,5434
2022-06-12 16:00:00+00,7541,0,6180,11493,264,1277,1464,381,4165,0,32765,112,23566,22102,15922,7541
2022-06-12 16:30:00+00,8445,0,6181,11676,277,1262,1508,317,3569,0,33235,121,23211,21703,15522,8445
2022-06-12 17:00:00+00,8977,0,6176,11372,317,1545,1465,377,2850,0,33078,128,22180,20715,14539,8977
2022-06-12 17:30:00+00,9421,0,6176,11003,329,1609,1433,611,2213,0,32796,138,21154,19721,13545,9421
2022-06-12 18:00:00+00,9470,0,6170,10572,360,1541,1247,789,1540,338,32027,141,19889,18642,12472,9470
2022-06-12 18:30:00+00,9674,0,6171,10152,362,1419,1229,803,945,536,31292,145,18859,17630,11459,9674
2022-06-12 19:00:00+00,9620,0,6175,9998,379,1247,1237,735,479,760,30630,146,18268,17031,10856,9620
2022-06-12 19:30:00+00,9488,0,6178,9712,390,985,1238,759,136,1050,29936,144,17654,16416,10238,9488
2022-06-12 20:00:00+00,9096,0,6176,9589,399,870,1235,654,8,994,29021,139,17407,16172,9996,9096
2022-06-12 20:30:00+00,9173,0,6167,9652,394,794,1046,576,0,728,28530,140,17259,16213,10046,9173
2022-06-12 21:00:00+00,9104,0,6168,9958,324,726,917,531,0,688,28416,137,17367,16450,10282,9104
2022-06-12 21:30:00+00,8487,0,6170,10343,312,664,907,407,0,282,27572,131,17732,16825,10655,8487
2022-06-12 22:00:00+00,8203,0,6164,10589,274,302,922,464,0,358,27276,128,17949,17027,10863,8203
2022-06-12 22:30:00+00,7211,0,6166,10349,244,310,919,490,0,380,26069,121,17678,16759,10593,7211
2022-06-12 23:00:00+00,6866,0,6167,10183,122,274,919,387,0,414,25332,121,17391,16472,10305,6866
2022-06-12 23:30:00+00,6411,0,6176,10553,116,282,907,224,0,74,24743,114,17752,16845,10669,6411
2022-06-13 00:00:00+00,6150,0,6173,10892,98,267,902,201,0,32,24715,110,18065,17163,10990,6150
2022-06-13 00:30:00+00,6000,0,6176,10940,98,248,906,237,0,140,24745,107,18120,17214,11038,6000
2022-06-13 01:00:00+00,5880,0,6182,10925,82,248,904,199,0,210,24630,106,18093,17189,11007,5880
2022-06-13 01:30:00+00,5981,0,6177,10515,78,248,898,193,0,170,24260,109,17668,16770,10593,5981
2022-06-13 02:00:00+00,6064,0,6182,10177,77,248,746,199,0,210,23903,111,17182,16436,10254,6064
2022-06-13 02:30:00+00,6126,0,6184,9990,76,248,720,188,0,214,23746,112,16970,16250,10066,6126
2022-06-13 03:00:00+00,6264,0,6189,10047,75,230,735,274,0,168,23982,114,17046,16311,10122,6264
2022-06-13 03:30:00+00,6057,0,6188,10158,75,240,663,248,0,182,23811,111,17084,16421,10233,6057
2022-06-13 04:00:00+00,6266,0,6188,10193,121,206,784,195,70,142,24165,112,17356,16572,10384,6266
2022-06-13 04:30:00+00,6936,0,6189,9854,120,86,1070,186,349,204,24994,118,17582,16512,10323,6936
2022-06-13 05:00:00+00,7896,0,6187,9347,233,480,1159,228,821,352,26703,127,17747,16588,10401,7896
2022-06-13 05:30:00+00,9511,0,6186,9271,247,542,1201,188,1314,266,28726,141,18219,17018,10832,9511
2022-06-13 06:00:00+00,11618,0,6173,9061,391,224,1367,244,1962,168,31208,157,18954,17587,11414,11618
2022-06-13 06:30:00+00,12561,0,6170,8591,417,70,1556,441,2673,222,32701,162,19407,17851,11681,12561
2022-06-13 07:00:00+00,12797,0,6168,7737,371,410,1564,440,3375,306,33168,162,19215,17651,11483,12797
2022-06-13 07:30:00+00,12963,0,6177,7202,378,448,1563,505,4039,410,33685,162,19359,17796,11619,12963
2022-06-13 08:00:00+00,12870,0,6193,6676,403,1058,1563,409,4479,542,34193,165,19314,17751,11558,12870
2022-06-13 08:30:00+00,12926,0,6177,6099,359,1172,1560,525,4531,1030,34379,167,18726,17166,10989,12926
2022-06-13 09:00:00+00,13026,0,6166,5654,336,2186,1556,501,4741,624,34790,171,18453,16897,10731,13026
2022-06-13 09:30:00+00,13229,0,6168,5094,333,2240,1557,561,4574,578,34334,177,17726,16169,10001,13229
2022-06-13 10:00:00+00,13299,0,6173,5076,367,2568,1550,676,4914,196,34819,178,18080,16530,10357,13299
2022-06-13 10:30:00+00,13392,0,6174,5103,273,2592,1551,680,5206,140,35111,177,18307,16756,10582,13392
2022-06-13 11:00:00+00,13416,0,6169,5039,283,2758,1547,540,5916,222,35890,173,18954,17407,11238,13416
2022-06-13 11:30:00+00,13666,0,6177,4886,296,2792,1537,416,6125,218,36113,173,19021,17484,11307,13666
2022-06-13 12:00:00+00,13694,0,6170,4822,165,2776,1531,303,6062,50,35573,175,18750,17219,11049,13694
2022-06-13 12:30:00+00,13393,0,6169,4882,151,2774,1517,232,6272,0,35390,172,18991,17474,11305,13393
2022-06-13 13:00:00+00,13470,2,6170,4806,151,2780,1528,226,6195,0,35329,173,18850,17322,11152,13472
2022-06-13 13:30:00+00,13592,4,6169,4623,151,2796,1516,232,6061,0,35144,176,18520,17004,10835,13596
2022-06-13 14:00:00+00,12954,7,6177,4730,151,2658,1494,224,5577,0,33972,174,18129,16635,10458,12961
2022-06-13 14:30:00+00,13285,9,6168,4741,164,2656,1449,233,5277,0,33982,178,17799,16350,10182,13294
2022-06-13 15:00:00+00,14066,11,6177,4916,195,2598,1512,253,4872,0,34600,184,17672,16160,9983,14077
2022-06-13 15:30:00+00,14451,36,6167,4962,260,2594,1516,495,4400,66,34947,189,17305,15789,9622,14487
2022-06-13 16:00:00+00,14790,133,6168,5061,353,2638,1528,580,3939,182,35372,193,17049,15521,9353,14923
2022-06-13 16:30:00+00,14987,223,6167,5056,344,2640,1532,628,3217,320,35114,200,16316,14784,8617,15210
2022-06-13 17:00:00+00,15371,225,6164,5070,358,2136,1529,653,2708,324,34538,206,15829,14300,8136,15596
2022-06-13 17:30:00+00,15191,230,6157,4932,358,2128,1539,654,2092,584,33865,208,15078,13539,7382,15421
2022-06-13 18:00:00+00,15582,229,6158,4501,382,2242,1548,653,1352,630,33277,218,13941,12393,6235,15811
2022-06-13 18:30:00+00,15616,229,6166,4173,455,2234,1546,633,874,658,32584,223,13214,11668,5502,15845
2022-06-13 19:00:00+00,16144,230,6160,3878,473,1280,1550,622,408,722,31467,229,12469,10919,4759,16374
2022-06-13 19:30:00+00,15952,230,6164,3552,474,1248,1550,620,120,526,30436,234,11860,10310,4146,16182
2022-06-13 20:00:00+00,16355,232,6167,3113,449,940,1543,618,8,704,30129,237,11280,9737,3570,16587
2022-06-13 20:30:00+00,16286,222,6170,3060,439,894,1549,495,0,378,29493,239,11218,9669,3499,16508
2022-06-13 21:00:00+00,16111,111,6166,3161,360,1000,1542,377,0,368,29196,236,11229,9687,3521,16222
2022-06-13 21:30:00+00,15487,0,6158,3365,201,1066,1487,289,0,168,28221,232,11211,9724,3566,15487
2022-06-13 22:00:00+00,14281,0,6158,3433,200,1156,1475,267,0,24,26994,222,11266,9791,3633,14281
2022-06-13 22:30:00+00,13229,0,6167,3384,199,1168,1536,253,0,28,25964,215,11286,9750,3583,13229
2022-06-13 23:00:00+00,13039,0,6164,3325,140,832,1541,227,0,166,25434,217,11170,9629,3465,13039
2022-06-13 23:30:00+00,13069,0,6167,3253,142,848,1536,214,0,0,25229,220,11098,9562,3395,13069
2022-06-14 00:00:00+00,13117,0,6165,3091,99,506,1581,226,0,0,24785,226,10936,9355,3190,13117
2022-06-14 00:30:00+00,13138,0,6166,2901,139,522,1581,258,0,0,24705,229,10787,9206,3040,13138
2022-06-14 01:00:00+00,13053,0,6176,3041,224,370,1579,245,0,0,24688,226,11020,9441,3265,13053
2022-06-14 01:30:00+00,12976,0,6174,3059,148,250,1582,234,0,0,24423,225,10963,9381,3207,12976
2022-06-14 02:00:00+00,12947,0,6173,3019,93,246,1585,201,0,0,24264,225,10870,9285,3112,12947
2022-06-14 02:30:00+00,12811,0,6176,2903,94,258,1637,215,0,0,24094,225,10810,9173,2997,12811
2022-06-14 03:00:00+00,12934,0,6180,2832,93,384,1638,214,0,0,24275,228,10743,9105,2925,12934
2022-06-14 03:30:00+00,12696,0,6181,2966,94,334,1633,207,0,0,24111,225,10874,9241,3060,12696
2022-06-14 04:00:00+00,12576,0,6179,2914,119,566,1652,221,64,0,24291,226,10928,9276,3097,12576
2022-06-14 04:30:00+00,13182,0,6179,2877,122,720,1654,228,351,0,25313,229,11183,9529,3350,13182
2022-06-14 05:00:00+00,13015,0,6166,2688,315,1080,1662,285,781,36,26028,221,11612,9950,3784,13015
2022-06-14 05:30:00+00,14727,0,6171,2517,337,990,1664,278,1290,0,27974,227,11979,10315,4144,14727
2022-06-14 06:00:00+00,15985,0,6164,2568,247,1418,1663,315,1910,86,30356,229,12552,10889,4725,15985
2022-06-14 06:30:00+00,16679,0,6160,2435,249,1254,1663,503,2685,420,32048,224,13192,11529,5369,16679
2022-06-14 07:00:00+00,15912,0,6163,2483,251,2360,1660,430,3454,82,32795,218,14011,12351,6188,15912
2022-06-14 07:30:00+00,15961,0,6162,2486,259,2410,1668,261,4338,46,33591,212,14913,13245,7083,15961
2022-06-14 08:00:00+00,16411,0,6166,2407,246,2502,1652,280,5117,242,35023,209,15588,13936,7770,16411
2022-06-14 08:30:00+00,16331,0,6172,2418,210,2492,1668,343,5867,30,35531,205,16335,14667,8495,16331
2022-06-14 09:00:00+00,16206,0,6165,2477,169,1866,1672,396,6403,88,35442,202,16886,15214,9049,16206
2022-06-14 09:30:00+00,16191,0,6160,2682,224,1846,1674,202,6740,174,35893,197,17480,15806,9646,16191
2022-06-14 10:00:00+00,16252,0,6155,2676,175,1780,1662,232,6773,212,35917,198,17441,15779,9624,16252
2022-06-14 10:30:00+00,16141,0,6164,2769,172,1778,1670,336,7531,0,36561,194,18306,16636,10472,16141
2022-06-14 11:00:00+00,16355,0,6144,2763,173,1022,1674,351,7951,264,36697,186,18705,17031,10887,16355
2022-06-14 11:30:00+00,16303,0,6140,2661,165,1012,1680,356,8240,180,36737,186,18886,17206,11066,16303
2022-06-14 12:00:00+00,16124,0,6132,2607,155,872,1682,355,8439,152,36518,187,19015,17333,11201,16124
2022-06-14 12:30:00+00,15866,0,6140,2577,168,840,1659,215,8423,164,36052,185,18967,17308,11168,15866
2022-06-14 13:00:00+00,15957,0,6137,2587,176,174,1653,325,8142,226,35377,187,18695,17042,10905,15957
2022-06-14 13:30:00+00,15847,0,6142,2673,176,166,1677,250,8029,146,35106,186,18697,17020,10878,15847
2022-06-14 14:00:00+00,15909,0,6144,2683,176,502,1687,200,7756,54,35111,192,18446,16759,10615,15909
2022-06-14 14:30:00+00,16070,0,6145,2795,192,590,1691,194,7124,96,34897,196,17947,16256,10111,16070
2022-06-14 15:00:00+00,16275,0,6149,2900,262,1222,1692,195,6591,68,35354,198,17594,15902,9753,16275
2022-06-14 15:30:00+00,16474,0,6144,2900,307,1270,1695,455,5742,246,35233,203,16788,15093,8949,16474
2022-06-14 16:00:00+00,16700,0,6148,2882,537,1410,1694,716,4906,202,35195,206,16167,14473,8325,16700
2022-06-14 16:30:00+00,16849,0,6146,2881,547,1454,1694,793,4072,422,34858,210,15340,13646,7500,16849
2022-06-14 17:00:00+00,16919,0,6148,2938,640,1710,1694,852,3225,838,34964,209,14645,12951,6803,16919
2022-06-14 17:30:00+00,16963,0,6147,2969,646,1752,1692,836,2393,1108,34506,212,13847,12155,6008,16963
2022-06-14 18:00:00+00,17005,0,6141,2981,661,1368,1693,917,1694,1238,33698,215,13170,11477,5336,17005
2022-06-14 18:30:00+00,17030,0,6141,2901,668,1362,1696,930,1113,1118,32959,220,12519,10823,4682,17030
2022-06-14 19:00:00+00,16969,0,6143,3058,626,1556,1694,937,563,1148,32694,224,12084,10390,4247,16969
2022-06-14 19:30:00+00,16556,0,6148,3090,622,1566,1698,949,207,1208,32044,223,11765,10067,3919,16556
2022-06-14 20:00:00+00,16847,0,6148,3070,529,1410,1697,881,20,594,31196,230,11464,9767,3619,16847
2022-06-14 20:30:00+00,16551,0,6150,3008,521,1394,1696,799,0,308,30427,231,11375,9679,3529,16551
2022-06-14 21:00:00+00,16843,0,6156,3040,444,1234,1695,537,0,220,30169,234,11335,9640,3484,16843
2022-06-14 21:30:00+00,16220,0,6148,3127,328,1238,1696,302,0,0,29059,233,11299,9603,3455,16220
2022-06-14 22:00:00+00,16007,0,6145,2847,380,822,1685,203,0,0,28089,236,11057,9372,3227,16007
2022-06-14 22:30:00+00,15291,0,6139,2799,373,760,1681,190,0,0,27233,233,10992,9311,3172,15291
2022-06-14 23:00:00+00,15164,0,6143,2896,332,458,1686,174,0,0,26853,236,11057,9371,3228,15164
2022-06-14 23:30:00+00,15018,0,6140,2845,229,290,1686,162,0,0,26370,236,10900,9214,3074,15018
2022-06-15 00:00:00+00,15153,0,6137,2714,219,118,1684,187,0,0,26212,240,10754,9070,2933,15153
2022-06-15 00:30:00+00,15004,0,6143,2979,214,126,1684,177,0,0,26327,236,11020,9336,3193,15004
2022-06-15 01:00:00+00,14877,0,6139,2811,179,236,1688,181,0,0,26111,238,10817,9129,2990,14877
2022-06-15 01:30:00+00,15027,0,6140,2343,179,172,1685,184,0,0,25730,243,10347,8662,2522,15027
2022-06-15 02:00:00+00,15164,0,6150,2212,180,152,1688,172,0,0,25718,245,10230,8542,2392,15164
2022-06-15 02:30:00+00,15245,0,6147,1951,180,152,1687,172,0,0,25534,248,9965,8278,2131,15245
2022-06-15 03:00:00+00,15253,0,6153,1789,180,244,1681,167,0,0,25467,250,9803,8122,1969,15253
2022-06-15 03:30:00+00,15238,0,6159,1739,180,246,1691,163,0,0,25416,251,9769,8078,1919,15238
2022-06-15 04:00:00+00,15109,0,6151,1560,181,278,1691,174,89,0,25233,251,9672,7981,1830,15109
2022-06-15 04:30:00+00,15468,0,6154,1419,186,426,1694,179,399,0,25925,253,9852,8158,2004,15468
2022-06-15 05:00:00+00,15291,0,6156,1493,318,564,1704,199,864,62,26651,246,10535,8831,2675,15291
2022-06-15 05:30:00+00,16229,0,6156,1562,442,641,1709,346,1428,230,28743,243,11297,9588,3432,16229
2022-06-15 06:00:00+00,16584,0,6158,1565,492,678,1706,363,2060,14,29620,240,11981,10275,4117,16584
2022-06-15 06:30:00+00,16748,0,6151,1489,521,598,1706,500,2868,452,31033,230,12735,11029,4878,16748
2022-06-15 07:00:00+00,16784,0,6148,1498,478,2078,1706,434,3714,408,33248,224,13544,11838,5690,16784
2022-06-15 07:30:00+00,16795,0,6151,1535,474,2166,1709,743,4593,118,34284,221,14462,12753,6602,16795
2022-06-15 08:00:00+00,16446,0,6151,1558,362,2446,1707,776,5621,0,35067,213,15399,13692,7541,16446
2022-06-15 08:30:00+00,16506,0,6144,1698,305,2450,1707,359,6369,0,35538,207,16223,14516,8372,16506
2022-06-15 09:00:00+00,16460,0,6156,1785,246,2096,1706,302,7136,0,35887,204,17029,15323,9167,16460
2022-06-15 09:30:00+00,16250,0,6158,1840,244,2046,1704,308,7706,0,36256,200,17652,15948,9790,16250
2022-06-15 10:00:00+00,16191,0,6166,1886,215,1764,1696,312,8160,0,36390,199,18123,16427,10261,16191
2022-06-15 10:30:00+00,16043,0,6142,1934,184,1740,1691,306,8625,0,36665,196,18576,16885,10743,16043
2022-06-15 11:00:00+00,16031,0,6141,2126,180,1604,1693,233,8912,0,36920,193,19052,17359,11218,16031
2022-06-15 11:30:00+00,15944,0,6140,2318,178,1596,1694,214,8605,0,36689,193,18935,17241,11101,15944
2022-06-15 12:00:00+00,15930,0,6147,2520,253,1290,1691,203,8419,0,36453,193,19030,17339,11192,15930
2022-06-15 12:30:00+00,15907,0,6147,2766,270,1288,1688,284,8125,0,36475,194,18996,17308,11161,15907
2022-06-15 13:00:00+00,16076,0,6148,2854,270,914,1690,352,7286,0,35590,196,18248,16558,10410,16076
2022-06-15 13:30:00+00,16205,0,6143,2998,320,878,1689,380,6651,0,35264,199,17801,16112,9969,16205
2022-06-15 14:00:00+00,16430,78,6147,3176,245,782,1691,386,6200,56,35191,205,17459,15768,9621,16508
2022-06-15 14:30:00+00,16567,236,6145,3280,233,788,1695,391,5684,180,35199,211,17037,15342,9197,16803
2022-06-15 15:00:00+00,16483,428,6148,3420,350,1104,1704,556,5306,104,35603,215,16928,15224,9076,16911
2022-06-15 15:30:00+00,16863,491,6146,3616,410,1155,1706,673,4571,56,35686,222,16449,14743,8597,17354
2022-06-15 16:00:00+00,16912,487,6148,3727,602,1441,1712,719,4058,182,35988,220,16247,14535,8387,17399
2022-06-15 16:30:00+00,16839,489,6148,3746,612,1507,1711,755,3317,706,35830,221,15534,13823,7675,17328
2022-06-15 17:00:00+00,16306,495,6149,3723,589,1689,1711,753,2811,896,35123,217,14983,13272,7123,16801
2022-06-15 17:30:00+00,16227,495,6147,3839,442,1734,1710,790,2191,948,34522,220,14329,12619,6472,16722
2022-06-15 18:00:00+00,16233,494,6155,4032,437,1644,1711,844,1587,800,33937,221,13922,12211,6056,16727
2022-06-15 18:30:00+00,15843,493,6145,4076,437,1680,1711,864,1070,828,33147,222,13439,11728,5583,16336
2022-06-15 19:00:00+00,16587,493,6146,4179,439,1447,1709,700,504,606,32811,234,12977,11268,5122,17080
2022-06-15 19:30:00+00,16703,333,6151,4272,425,1367,1708,557,184,216,31916,236,12740,11032,4881,17036
2022-06-15 20:00:00+00,16581,15,6146,4233,355,1186,1712,558,15,344,31145,232,12461,10749,4603,16596
2022-06-15 20:30:00+00,16713,0,6146,3899,342,1154,1710,526,0,98,30588,238,12097,10387,4241,16713
2022-06-15 21:00:00+00,16808,0,6146,3879,261,830,1712,434,0,202,30272,241,11998,10286,4140,16808
2022-06-15 21:30:00+00,16215,0,6154,3874,250,798,1713,277,0,0,29281,240,11991,10278,4124,16215
2022-06-15 22:00:00+00,14552,0,6158,3965,257,1008,1711,244,0,0,27895,225,12091,10380,4222,14552
2022-06-15 22:30:00+00,13737,0,6147,3638,251,1130,1711,229,0,0,26843,223,11747,10036,3889,13737
2022-06-15 23:00:00+00,13520,0,6138,3548,174,812,1712,211,0,0,26115,223,11572,9860,3722,13520
2022-06-15 23:30:00+00,13478,0,6138,3332,138,648,1712,190,0,0,25636,224,11320,9608,3470,13478
2022-06-16 00:00:00+00,13628,0,6137,3209,116,576,1707,194,0,0,25567,227,11169,9462,3325,13628
2022-06-16 00:30:00+00,13666,0,6144,3120,114,560,1712,184,0,0,25500,228,11090,9378,3234,13666
2022-06-16 01:00:00+00,13950,0,6137,2824,103,462,1711,196,0,0,25383,234,10775,9064,2927,13950
2022-06-16 01:30:00+00,14079,0,6143,2581,109,464,1703,178,0,0,25257,238,10536,8833,2690,14079
2022-06-16 02:00:00+00,14201,0,6142,2219,106,442,1713,173,0,0,24996,243,10180,8467,2325,14201
2022-06-16 02:30:00+00,14242,0,6152,2026,106,412,1714,189,0,0,24841,245,9998,8284,2132,14242
2022-06-16 03:00:00+00,14213,0,6148,1853,106,510,1714,185,0,0,24729,245,9821,8107,1959,14213
2022-06-16 03:30:00+00,13904,0,6157,1937,104,562,1715,175,0,0,24554,243,9913,8198,2041,13904
2022-06-16 04:00:00+00,13673,0,6149,1707,104,908,1715,177,114,0,24547,239,9789,8074,1925,13673
2022-06-16 04:30:00+00,14206,0,6158,1652,132,1140,1716,188,429,0,25621,241,10087,8371,2213,14206
2022-06-16 05:00:00+00,14422,3,6152,1524,254,1726,1719,197,885,0,26882,236,10534,8815,2663,14425
2022-06-16 05:30:00+00,15444,168,6157,1637,497,1636,1723,278,1370,4,28914,238,11384,9661,3504,15612
2022-06-16 06:00:00+00,16294,405,6149,1552,528,2206,1732,296,2003,268,31433,240,11964,10232,4083,16699
2022-06-16 06:30:00+00,16705,447,6158,1437,563,2154,1738,388,2864,452,32906,234,12760,11022,4864,17152
2022-06-16 07:00:00+00,16570,446,6158,1250,475,2554,1751,461,3736,112,33513,231,13370,11619,5461,17016
2022-06-16 07:30:00+00,16455,446,6154,1268,480,2604,1759,336,4612,0,34114,225,14273,12514,6360,16901
2022-06-16 08:00:00+00,16254,446,6150,1383,432,3030,1764,291,5530,48,35328,218,15259,13495,7345,16700
2022-06-16 08:30:00+00,15989,447,6153,1522,324,3032,1766,233,6208,0,35674,212,15973,14207,8054,16436
2022-06-16 09:00:00+00,15989,447,6144,1653,214,2666,1765,213,6666,84,35841,209,16442,14677,8533,16436
2022-06-16 09:30:00+00,15821,447,6148,1722,190,2658,1764,225,7094,82,36151,206,16918,15154,9006,16268
2022-06-16 10:00:00+00,15487,446,6154,1827,138,2862,1764,233,7560,10,36481,202,17443,15679,9525,15933
2022-06-16 10:30:00+00,15311,447,6150,1810,138,2860,1763,187,7842,116,36624,199,17703,15940,9790,15758
2022-06-16 11:00:00+00,15111,447,6142,1924,141,2918,1761,190,7817,292,36743,196,17785,16024,9882,15558
2022-06-16 11:30:00+00,14944,446,6149,2128,138,2918,1761,211,8139,56,36890,194,18315,16554,10405,15390
2022-06-16 12:00:00+00,14739,493,6147,2312,141,2952,1760,184,8264,0,36992,192,18624,16864,10717,15232
2022-06-16 12:30:00+00,14533,496,6153,2318,149,2952,1760,172,8274,0,36807,191,18654,16894,10741,15029
2022-06-16 13:00:00+00,14557,495,6151,2516,135,2656,1756,168,7755,0,36189,193,18313,16557,10406,15052
2022-06-16 13:30:00+00,14314,495,6146,2592,139,2650,1671,184,7430,0,35621,193,17978,16307,10161,14809
2022-06-16 14:00:00+00,15189,492,6150,2586,136,2480,1713,187,7002,0,35935,201,17587,15874,9724,15681
2022-06-16 14:30:00+00,15453,493,6151,2642,157,2616,1756,200,6440,18,35926,206,17146,15390,9239,15946
2022-06-16 15:00:00+00,15987,388,6148,2869,271,2492,1759,237,5896,100,36147,207,16943,15184,9036,16375
2022-06-16 15:30:00+00,16565,243,6148,3056,447,2532,1760,423,4933,98,36205,211,16344,14584,8436,16808
2022-06-16 16:00:00+00,16884,229,6150,3128,639,2244,1762,569,3853,490,35948,213,15532,13770,7620,17113
2022-06-16 16:30:00+00,17086,322,6149,3192,653,2236,1761,599,3060,682,35740,219,14815,13054,6905,17408
2022-06-16 17:00:00+00,17184,469,6155,3524,540,2164,1578,502,2446,800,35362,224,14243,12665,6510,17653
2022-06-16 17:30:00+00,17477,492,6156,3767,430,2128,1358,474,1747,746,34775,230,13458,12100,5944,17969
2022-06-16 18:00:00+00,17715,497,6156,3819,484,1676,1456,458,1100,758,34119,233,13015,11559,5403,18212
2022-06-16 18:30:00+00,17639,495,6155,4021,484,1718,1431,411,611,688,33653,236,12702,11271,5116,18134
2022-06-16 19:00:00+00,17503,494,6157,4139,420,1714,1642,482,308,412,33271,238,12666,11024,4867,17997
2022-06-16 19:30:00+00,17084,393,6152,4477,314,1756,1455,260,84,514,32489,233,12482,11027,4875,17477
2022-06-16 20:00:00+00,17025,33,6155,5058,281,1824,1189,235,4,126,31930,226,12687,11498,5343,17058
2022-06-16 20:30:00+00,16611,0,6160,5340,237,1854,1164,231,0,0,31597,223,12901,11737,5577,16611
2022-06-16 21:00:00+00,16205,0,6156,5452,154,1830,1165,173,0,0,31135,221,12927,11762,5606,16205
2022-06-16 21:30:00+00,14135,0,6156,6252,138,1910,1175,168,0,0,29934,204,13721,12546,6390,14135
2022-06-16 22:00:00+00,12654,0,6153,6377,151,1854,1573,180,0,0,28942,193,14254,12681,6528,12654
2022-06-16 22:30:00+00,11208,0,6166,6690,154,1848,1663,196,0,0,27925,180,14673,13010,6844,11208
2022-06-16 23:00:00+00,9773,0,6156,7102,134,1848,1552,178,0,0,26743,166,14944,13392,7236,9773
2022-06-16 23:30:00+00,9342,0,6156,7323,133,1826,1560,173,0,0,26513,161,15172,13612,7456,9342
2022-06-17 00:00:00+00,9327,0,6147,7358,97,1802,1206,176,0,0,26113,161,14808,13602,7455,9327
2022-06-17 00:30:00+00,9355,0,6146,7403,97,1696,1019,180,0,0,25896,160,14665,13646,7500,9355
2022-06-17 01:00:00+00,9450,0,6146,7499,97,1648,1017,165,0,0,26022,160,14759,13742,7596,9450
2022-06-17 01:30:00+00,9085,0,6146,7784,97,1498,1015,185,0,0,25810,153,15042,14027,7881,9085
2022-06-17 02:00:00+00,8966,0,6147,8226,78,1124,1015,174,0,0,25730,152,15466,14451,8304,8966
2022-06-17 02:30:00+00,8738,0,6152,8507,79,966,1015,171,0,0,25628,147,15753,14738,8586,8738
2022-06-17 03:00:00+00,9178,0,6150,8520,79,702,1016,155,0,0,25800,154,15765,14749,8599,9178
2022-06-17 03:30:00+00,9077,0,6155,8934,79,518,930,198,0,0,25891,149,16098,15168,9013,9077
2022-06-17 04:00:00+00,8953,0,6155,9092,79,310,917,211,37,0,25754,147,16280,15363,9208,8953
2022-06-17 04:30:00+00,9143,0,6161,9355,85,268,897,202,232,0,26343,145,16730,15833,9672,9143
2022-06-17 05:00:00+00,9170,0,6157,9568,126,658,900,208,648,0,27435,140,17399,16499,10342,9170
2022-06-17 05:30:00+00,9699,0,6159,10171,171,1010,1216,234,1162,0,29822,142,18879,17663,11504,9699
2022-06-17 06:00:00+00,8785,97,6157,10398,270,1518,1472,343,1883,142,31065,131,20180,18708,12551,8882
2022-06-17 06:30:00+00,9029,378,6155,10360,255,1512,1580,537,2529,0,32335,139,20879,19299,13144,9407
2022-06-17 07:00:00+00,9212,497,6153,11114,253,1312,1584,486,3320,38,33969,134,22424,20840,14687,9709
2022-06-17 07:30:00+00,9396,498,6153,11243,253,1198,1581,442,3911,0,34675,131,23141,21560,15407,9894
2022-06-17 08:00:00+00,9287,496,6153,11601,261,1096,1583,356,4934,0,35767,124,24532,22949,16796,9783
2022-06-17 08:30:00+00,8719,497,6147,12086,246,1096,1585,218,5816,0,36410,115,25880,24295,18148,9216
2022-06-17 09:00:00+00,8729,496,6150,11801,161,1096,1583,171,6373,0,36560,114,26068,24485,18335,9225
2022-06-17 09:30:00+00,8154,496,6149,12177,158,1096,1510,174,7279,0,37193,106,27273,25763,19614,8650
2022-06-17 10:00:00+00,7954,425,6148,12384,154,1096,1277,182,7939,0,37559,100,27902,26625,20477,8379
2022-06-17 10:30:00+00,7954,232,6149,12908,156,1090,1120,208,8445,0,38262,93,28778,27658,21509,8186
2022-06-17 11:00:00+00,8308,229,6155,13286,151,980,1131,195,8633,0,39068,96,29356,28225,22070,8537
2022-06-17 11:30:00+00,8046,230,6153,13463,165,952,1188,159,8617,0,38973,93,29586,28398,22245,8276
2022-06-17 12:00:00+00,7961,230,6148,13783,182,604,1159,149,8874,0,39090,91,30146,28987,22839,8191
2022-06-17 12:30:00+00,7291,230,6147,14093,183,574,1197,150,8895,0,38760,85,30515,29318,23171,7521
2022-06-17 13:00:00+00,7289,229,6145,14157,183,346,1140,149,8613,0,38251,86,30238,29098,22953,7518
2022-06-17 13:30:00+00,7145,231,6148,13952,188,332,1174,154,8136,0,37460,86,29598,28424,22276,7376
2022-06-17 14:00:00+00,7753,230,6150,13618,193,592,1162,156,7571,0,37425,93,28694,27532,21382,7983
2022-06-17 14:30:00+00,8340,230,6149,13507,192,660,1393,148,6942,0,37561,99,28183,26790,20641,8570
2022-06-17 15:00:00+00,8545,229,6148,13219,177,1026,1516,176,6208,0,37244,103,27268,25752,19604,8774
2022-06-17 15:30:00+00,9033,324,6152,12975,216,1074,1540,598,5285,0,37197,114,26168,24628,18476,9357
2022-06-17 16:00:00+00,9451,465,6153,13106,273,1094,1540,770,4320,0,37172,124,25392,23852,17699,9916
2022-06-17 16:30:00+00,9986,489,6152,13101,306,1096,1546,858,3457,108,37099,131,24562,23016,16864,10475
2022-06-17 17:00:00+00,10869,489,6151,12796,392,1096,1548,841,2610,264,37056,140,23497,21949,15798,11358
2022-06-17 17:30:00+00,11608,489,6154,12297,397,1096,1551,836,1914,460,36802,149,22313,20762,14608,12097
2022-06-17 18:00:00+00,11750,493,6154,11805,379,1096,1549,821,1336,396,35779,155,21223,19674,13520,12243
2022-06-17 18:30:00+00,11760,494,6159,11451,334,1096,1552,704,835,386,34771,158,20331,18779,12620,12254
2022-06-17 19:00:00+00,11454,498,6156,11087,279,1144,1551,488,429,464,33550,159,19502,17951,11795,11952
2022-06-17 19:30:00+00,11310,498,6154,10667,277,1146,1551,412,151,350,32516,161,18800,17249,11095,11808
2022-06-17 20:00:00+00,11754,498,6154,10485,292,1129,1555,560,11,90,32528,168,18497,16942,10788,12252
2022-06-17 20:30:00+00,11482,498,6155,10492,288,1113,1455,620,0,0,32103,167,18390,16935,10780,11980
2022-06-17 21:00:00+00,11568,498,6150,10063,234,1096,1472,540,0,0,31621,170,17919,16447,10297,12066
2022-06-17 21:30:00+00,11372,498,6155,9346,218,1096,1487,398,0,0,30570,172,17206,15719,9564,11870
2022-06-17 22:00:00+00,11059,498,6153,8804,202,1154,1336,262,0,0,29468,173,16495,15159,9006,11557
2022-06-17 22:30:00+00,10541,498,6159,8079,198,1306,979,326,0,0,28086,176,15415,14436,8277,11039
2022-06-17 23:00:00+00,10396,451,6159,7543,188,1456,813,264,0,0,27270,178,14703,13890,7731,10847
2022-06-17 23:30:00+00,10403,230,6162,6989,183,1550,814,239,0,0,26570,177,14148,13334,7172,10633
2022-06-18 00:00:00+00,10171,230,6157,6705,162,1592,812,216,0,0,26045,180,13836,13024,6867,10401
2022-06-18 00:30:00+00,9827,219,6144,6580,162,1634,815,271,0,0,25652,179,13701,12886,6742,10046
2022-06-18 01:00:00+00,9807,0,6144,6571,146,1540,813,266,0,0,25287,173,13674,12861,6717,9807
2022-06-18 01:30:00+00,9290,0,6149,6514,145,1476,811,223,0,0,24608,168,13618,12808,6658,9290
2022-06-18 02:00:00+00,9432,0,6148,6501,145,1238,813,235,0,0,24512,171,13607,12794,6646,9432
2022-06-18 02:30:00+00,9550,0,6148,6475,145,1212,813,175,0,0,24518,172,13581,12768,6620,9550
2022-06-18 03:00:00+00,9227,0,6147,6607,134,1106,816,150,0,0,24187,169,13704,12888,6741,9227
2022-06-18 03:30:00+00,8801,0,6149,6858,108,1082,770,119,0,0,23887,163,13885,13115,6966,8801
2022-06-18 04:00:00+00,9169,0,6138,6503,100,986,779,122,43,0,23840,167,13563,12784,6646,9169
2022-06-18 04:30:00+00,9146,0,6144,6382,110,1068,818,123,235,0,24026,168,13689,12871,6727,9146
2022-06-18 05:00:00+00,9115,0,6149,6198,159,1030,819,132,541,0,24143,167,13866,13047,6898,9115
2022-06-18 05:30:00+00,9478,0,6151,6378,176,956,819,138,886,0,24982,165,14410,13591,7440,9478
2022-06-18 06:00:00+00,9226,0,6155,6430,218,1580,819,124,1300,0,25852,163,14922,14103,7948,9226
2022-06-18 06:30:00+00,10032,0,6153,6510,254,1682,857,211,1668,0,27367,167,15442,14585,8432,10032
2022-06-18 07:00:00+00,10401,0,6151,6579,270,1852,897,389,2234,0,28773,163,16131,15234,9083,10401
2022-06-18 07:30:00+00,10916,0,6117,6467,269,1862,915,419,2725,0,29690,165,16493,15578,9461,10916
2022-06-18 08:00:00+00,11274,0,6022,6693,270,2212,945,618,3031,296,31361,167,16961,16016,9994,11274
2022-06-18 08:30:00+00,11466,0,5929,6992,263,2196,943,730,3527,238,32284,165,17654,16711,10782,11466
2022-06-18 09:00:00+00,11487,0,5683,7590,279,2158,944,660,3838,26,32665,163,18334,17390,11707,11487
2022-06-18 09:30:00+00,11665,0,5682,7768,272,2229,946,659,4219,0,33440,161,18886,17940,12258,11665
2022-06-18 10:00:00+00,11599,0,5686,7925,249,2400,946,474,3906,0,33185,161,18712,17766,12080,11599
2022-06-18 10:30:00+00,11191,0,5676,8421,237,2574,947,284,3276,0,32606,160,18557,17610,11934,11191
2022-06-18 11:00:00+00,11511,0,5654,8610,187,2550,946,138,3315,0,32911,160,18712,17766,12112,11511
2022-06-18 11:30:00+00,11600,0,5658,8901,172,2370,945,122,2818,0,32586,161,18494,17549,11891,11600
2022-06-18 12:00:00+00,11317,0,5674,9182,144,1864,945,314,2924,0,32364,159,18869,17924,12250,11317
2022-06-18 12:30:00+00,11173,0,5688,9316,128,1822,943,395,2770,0,32235,159,18845,17902,12214,11173
2022-06-18 13:00:00+00,10319,0,5686,9427,128,1700,933,244,2546,0,30983,154,18720,17787,12101,10319
2022-06-18 13:30:00+00,10031,0,5679,9875,127,1724,931,117,2833,0,31317,148,19445,18514,12835,10031
2022-06-18 14:00:00+00,10444,0,5679,9699,127,1424,933,120,2607,0,31033,156,19045,18112,12433,10444
2022-06-18 14:30:00+00,10791,0,5679,9801,127,1424,934,127,2159,0,31042,161,18700,17766,12087,10791
2022-06-18 15:00:00+00,11222,0,5683,10379,137,1200,935,117,1665,0,31338,163,18799,17864,12181,11222
2022-06-18 15:30:00+00,11897,0,5675,10515,158,1320,936,139,1271,0,31911,170,18555,17619,11944,11897
2022-06-18 16:00:00+00,12313,0,5686,10432,224,1026,938,209,1037,124,31989,171,18317,17379,11693,12313
2022-06-18 16:30:00+00,12699,0,5688,10364,248,1140,936,294,921,4,32294,177,18157,17221,11533,12699
2022-06-18 17:00:00+00,12874,0,5690,10360,296,1298,936,397,801,8,32660,180,18083,17147,11457,12874
2022-06-18 17:30:00+00,12663,0,5688,10133,307,1254,938,501,743,158,32385,179,17809,16871,11183,12663
2022-06-18 18:00:00+00,12861,0,5688,10028,318,752,938,459,611,152,31807,178,17583,16645,10957,12861
2022-06-18 18:30:00+00,12260,0,5693,10156,302,750,938,444,502,64,31109,174,17591,16653,10960,12260
2022-06-18 19:00:00+00,12833,0,5694,9986,299,750,939,244,250,0,30995,180,17168,16229,10535,12833
2022-06-18 19:30:00+00,12524,0,5691,9908,297,750,941,135,160,0,30406,179,16997,16056,10365,12524
2022-06-18 20:00:00+00,12244,0,5695,9623,271,750,940,146,33,0,29702,179,16562,15622,9927,12244
2022-06-18 20:30:00+00,11992,0,5693,9468,259,750,939,150,0,0,29251,179,16359,15420,9727,11992
2022-06-18 21:00:00+00,11606,0,5699,9606,232,742,939,143,0,0,28967,175,16476,15537,9838,11606
2022-06-18 21:30:00+00,10557,0,5698,9737,221,620,939,196,0,28,27996,165,16595,15656,9958,10557
2022-06-18 22:00:00+00,8891,0,5692,9427,206,418,941,339,0,72,25986,150,16266,15325,9633,8891
2022-06-18 22:30:00+00,7692,0,5698,9564,210,176,940,397,0,44,24721,135,16412,15472,9774,7692
2022-06-18 23:00:00+00,6344,0,5703,9397,153,394,939,212,0,52,23194,119,16192,15253,9550,6344
2022-06-18 23:30:00+00,5404,0,5695,9712,150,498,937,131,0,0,22527,106,16494,15557,9862,5404
2022-06-19 00:00:00+00,4463,0,5704,9994,121,868,932,128,0,0,22210,92,16751,15819,10115,4463
2022-06-19 00:30:00+00,4158,0,5702,10222,117,912,849,114,0,0,22074,87,16890,16041,10339,4158
2022-06-19 01:00:00+00,4270,0,5688,10037,98,678,736,116,0,0,21623,91,16559,15823,10135,4270
2022-06-19 01:30:00+00,4198,0,5693,9851,99,618,731,102,0,0,21292,90,16374,15643,9950,4198
2022-06-19 02:00:00+00,3979,0,5693,9952,90,458,613,100,0,0,20885,88,16348,15735,10042,3979
2022-06-19 02:30:00+00,4000,0,5697,9766,83,470,592,104,0,0,20712,90,16138,15546,9849,4000
2022-06-19 03:00:00+00,4065,0,5697,9769,82,236,591,111,0,0,20551,86,16139,15548,9851,4065
2022-06-19 03:30:00+00,3829,0,5699,9678,82,242,591,115,0,0,20236,83,16050,15459,9760,3829
2022-06-19 04:00:00+00,4084,0,5697,8991,82,528,620,114,65,0,20181,96,15455,14835,9138,4084
2022-06-19 04:30:00+00,4310,0,5701,8616,85,606,618,108,327,0,20372,101,15348,14730,9028,4310
2022-06-19 05:00:00+00,4256,0,5701,8535,117,592,592,104,649,0,20546,94,15594,15002,9301,4256
2022-06-19 05:30:00+00,4291,0,5701,8323,139,602,595,122,1110,0,20883,93,15868,15273,9572,4291
2022-06-19 06:00:00+00,4582,0,5706,8402,184,676,744,109,1725,0,22128,89,16761,16017,10311,4582
2022-06-19 06:30:00+00,4778,0,5703,8527,185,810,893,111,2249,0,23256,91,17557,16664,10961,4778
2022-06-19 07:00:00+00,4624,0,5710,8684,189,2194,923,104,2886,0,25314,93,18392,17469,11759,4624
2022-06-19 07:30:00+00,4539,0,5712,8808,192,2438,931,112,3740,0,26472,91,19383,18452,12740,4539
2022-06-19 08:00:00+00,4724,0,5713,8581,186,3098,916,127,4484,0,27829,92,19880,18964,13251,4724
2022-06-19 08:30:00+00,4732,0,5714,8963,186,3238,796,137,4902,0,28668,90,20561,19765,14051,4732
2022-06-19 09:00:00+00,5822,0,5717,8613,185,2746,913,137,4805,156,29094,97,20233,19320,13603,5822
2022-06-19 09:30:00+00,6626,0,5712,8609,180,2734,913,131,4963,0,29868,104,20377,19464,13752,6626
2022-06-19 10:00:00+00,7421,0,5698,8134,180,2778,911,169,4907,178,30376,115,19830,18919,13221,7421
2022-06-19 10:30:00+00,8043,0,5705,7767,171,2826,915,430,4931,240,31028,123,19489,18574,12869,8043
2022-06-19 11:00:00+00,7935,0,5710,7509,119,3654,917,232,4997,178,31251,127,19252,18335,12625,7935
2022-06-19 11:30:00+00,8145,0,5707,7396,118,3672,922,133,5007,146,31246,128,19150,18228,12521,8145
2022-06-19 12:00:00+00,7263,0,5701,7396,137,3874,926,122,5470,0,30889,121,19630,18704,13003,7263
2022-06-19 12:30:00+00,7116,0,5702,7217,137,3852,826,130,5170,18,30168,121,19052,18226,12524,7116
2022-06-19 13:00:00+00,7838,0,5709,6686,149,3744,926,124,4478,0,29654,134,17948,17022,11313,7838
2022-06-19 13:30:00+00,8230,0,5713,6795,149,3560,932,119,4548,0,30046,136,18137,17205,11492,8230
2022-06-19 14:00:00+00,9202,0,5708,7013,149,2906,932,122,3763,0,29795,149,17565,16633,10925,9202
2022-06-19 14:30:00+00,9851,0,5700,7039,155,3038,934,149,3425,0,30291,158,17253,16319,10619,9851
2022-06-19 15:00:00+00,10273,0,5705,7155,177,2502,932,734,2986,90,30554,159,16955,16023,10318,10273
2022-06-19 15:30:00+00,11266,0,5706,7206,211,2496,934,926,2666,66,31477,168,16723,15789,10083,11266
2022-06-19 16:00:00+00,12898,0,5708,7405,296,1596,932,949,2091,258,32133,182,16432,15500,9792,12898
2022-06-19 16:30:00+00,13451,0,5710,7378,309,1598,935,856,1714,410,32361,186,16046,15111,9401,13451
2022-06-19 17:00:00+00,13258,0,5704,7389,310,2042,935,749,1334,544,32265,184,15672,14737,9033,13258
2022-06-19 17:30:00+00,13483,0,5703,7436,311,2217,936,592,859,460,31997,187,15245,14309,8606,13483
2022-06-19 18:00:00+00,13155,0,5704,7740,340,2114,936,726,628,378,31721,185,15348,14412,8708,13155
2022-06-19 18:30:00+00,13105,0,5704,7664,373,2090,935,573,411,442,31297,184,15087,14152,8448,13105
2022-06-19 19:00:00+00,13488,0,5701,7271,402,2020,938,590,244,372,31026,191,14556,13618,7917,13488
2022-06-19 19:30:00+00,13080,0,5709,7215,371,1976,938,262,107,576,30234,186,14340,13402,7693,13080
2022-06-19 20:00:00+00,13060,0,5708,7441,321,1586,938,399,23,410,29886,187,14431,13493,7785,13060
2022-06-19 20:30:00+00,12870,0,5706,7853,321,1458,941,457,0,146,29752,185,14821,13880,8174,12870
2022-06-19 21:00:00+00,12970,0,5709,7637,315,1334,935,406,0,134,29440,187,14596,13661,7952,12970
2022-06-19 21:30:00+00,12519,0,5711,7350,364,1204,917,209,0,242,28516,183,14342,13425,7714,12519
2022-06-19 22:00:00+00,12131,0,5712,7478,277,888,908,319,0,52,27765,184,14375,13467,7755,12131
2022-06-19 22:30:00+00,11155,0,5712,7253,262,998,886,268,0,108,26642,180,14113,13227,7515,11155
2022-06-19 23:00:00+00,10730,0,5711,7330,181,758,898,230,0,22,25860,181,14120,13222,7511,10730
2022-06-19 23:30:00+00,10266,0,5707,7585,164,700,908,147,0,0,25477,176,14364,13456,7749,10266
2022-06-20 00:00:00+00,10401,0,5711,7740,143,578,906,142,0,0,25621,176,14500,13594,7883,10401
2022-06-20 00:30:00+00,10671,0,5703,7275,119,580,905,164,0,0,25417,182,14002,13097,7394,10671
2022-06-20 01:00:00+00,10689,0,5712,7284,107,656,813,151,0,0,25412,183,13916,13103,7391,10689
2022-06-20 01:30:00+00,10652,0,5703,6963,102,750,720,165,0,0,25055,187,13488,12768,7065,10652
2022-06-20 02:00:00+00,10967,0,5704,6630,104,752,569,155,0,0,24881,192,13007,12438,6734,10967
2022-06-20 02:30:00+00,11227,0,5694,6447,104,752,568,161,0,0,24953,196,12813,12245,6551,11227
2022-06-20 03:00:00+00,11456,0,5700,6098,89,752,570,148,0,0,24813,200,12457,11887,6187,11456
2022-06-20 03:30:00+00,11479,0,5699,5520,85,752,613,158,0,0,24306,205,11917,11304,5605,11479
2022-06-20 04:00:00+00,12058,0,5703,4882,85,752,857,149,70,0,24556,214,11597,10740,5037,12058
2022-06-20 04:30:00+00,13033,0,5704,4518,87,758,976,167,396,32,25671,220,11681,10705,5001,13033
2022-06-20 05:00:00+00,14195,0,5708,4401,184,1046,1127,178,815,16,27670,220,12235,11108,5400,14195
2022-06-20 05:30:00+00,15238,170,5711,4444,220,964,1300,214,1449,178,29888,222,13124,11824,6113,15408
2022-06-20 06:00:00+00,15335,369,5711,4485,554,1064,1463,515,2184,384,32064,213,14397,12934,7223,15704
2022-06-20 06:30:00+00,15360,374,5708,4891,577,924,1365,633,2925,756,33513,203,15466,14101,8393,15734
2022-06-20 07:00:00+00,15442,432,5708,5019,577,1002,1418,614,3834,856,34902,197,16556,15138,9430,15874
2022-06-20 07:30:00+00,15590,301,5707,5205,578,1030,1427,634,4366,572,35410,193,17283,15856,10149,15891
2022-06-20 08:00:00+00,15447,304,5711,5261,535,1738,1417,495,5141,406,36455,191,18065,16648,10937,15751
2022-06-20 08:30:00+00,15075,428,5712,5328,400,1832,1407,290,5862,148,36482,189,18709,17302,11590,15503
2022-06-20 09:00:00+00,14603,381,5711,5297,352,1504,1376,198,6655,8,36085,182,19391,18015,12304,14984
2022-06-20 09:30:00+00,14453,254,5707,5388,320,1476,1276,217,7400,0,36491,175,20091,18815,13108,14707
2022-06-20 10:00:00+00,14866,339,5699,5248,183,1098,1306,271,8012,284,37306,179,20448,19142,13443,15205
2022-06-20 10:30:00+00,15120,419,5707,4997,147,1054,1278,419,8630,10,37781,182,20759,19481,13774,15539
2022-06-20 11:00:00+00,15015,375,5712,5080,123,1108,1306,207,8949,2,37877,182,21170,19864,14152,15390
2022-06-20 11:30:00+00,14770,230,5717,5237,119,1100,1328,121,9339,0,37961,175,21740,20412,14695,15000
2022-06-20 12:00:00+00,14492,228,5702,5464,102,1026,1386,126,9439,10,37975,173,22093,20707,15005,14720
2022-06-20 12:30:00+00,14291,230,5703,5371,102,1008,1384,139,9244,130,37602,173,21804,20420,14717,14521
2022-06-20 13:00:00+00,14445,229,5703,5404,102,898,1382,128,8856,120,37267,175,21447,20065,14362,14674
2022-06-20 13:30:00+00,14585,239,5700,5175,101,894,1382,123,8400,10,36609,179,20758,19376,13676,14824
2022-06-20 14:00:00+00,14786,251,5708,4772,118,1020,1383,118,7760,6,35922,185,19741,18358,12650,15037
2022-06-20 14:30:00+00,15180,440,5703,4565,109,1060,1383,153,7338,144,36075,194,19098,17715,12012,15620
2022-06-20 15:00:00+00,15638,494,5703,4546,201,896,1442,353,6452,140,35865,196,18344,16902,11199,16132
2022-06-20 15:30:00+00,15993,500,5697,4292,272,958,1453,642,5912,300,36019,202,17626,16173,10476,16493
2022-06-20 16:00:00+00,16576,500,5700,4035,426,1448,1454,859,5113,208,36319,210,16728,15274,9574,17076
2022-06-20 16:30:00+00,16878,454,5698,4011,597,1510,1454,827,4203,706,36338,211,15963,14509,8811,17332
2022-06-20 17:00:00+00,16438,323,5704,4070,629,1724,1454,907,3376,692,35317,209,15233,13779,8075,16761
2022-06-20 17:30:00+00,16622,386,5701,3870,606,1773,1455,949,2464,884,34710,217,14096,12641,6940,17008
2022-06-20 18:00:00+00,16928,399,5700,3818,521,1768,1456,946,1760,1092,34388,224,13255,11799,6099,17327
2022-06-20 18:30:00+00,17058,460,5696,3702,519,1754,1454,921,1135,1084,33783,231,12506,11052,5356,17518
2022-06-20 19:00:00+00,16956,419,5700,3366,566,1966,1458,869,607,1092,32999,233,11697,10239,4539,17375
2022-06-20 19:30:00+00,16509,394,5696,3311,603,1930,1459,708,186,968,31764,234,11255,9796,4100,16903
2022-06-20 20:00:00+00,16655,370,5697,3088,564,1932,1458,590,21,442,30817,243,10828,9370,3673,17025
2022-06-20 20:30:00+00,16541,330,5690,2952,400,2006,1454,559,0,202,30134,247,10496,9042,3352,16871
2022-06-20 21:00:00+00,16630,338,5696,3030,311,2125,1456,478,0,2,30066,248,10493,9037,3341,16968
2022-06-20 21:30:00+00,15649,230,5693,3103,374,1946,1234,430,0,0,28659,240,10404,9170,3477,15879
2022-06-20 22:00:00+00,15002,229,5706,3204,377,1268,905,451,0,0,27142,245,10192,9287,3581,15231
2022-06-20 22:30:00+00,14934,228,5692,3286,306,1166,910,206,0,0,26728,244,10194,9284,3592,15162
2022-06-20 23:00:00+00,15672,30,5693,3327,200,482,910,145,0,0,26459,245,10130,9220,3527,15702
2022-06-20 23:30:00+00,15392,20,5699,3445,181,280,908,123,0,0,26048,241,10233,9325,3626,15412
2022-06-21 00:00:00+00,16013,10,5692,3511,138,98,642,126,0,0,26230,247,9983,9341,3649,16023
2022-06-21 00:30:00+00,15988,0,5695,3502,113,96,572,122,0,0,26088,247,9882,9310,3615,15988
2022-06-21 01:00:00+00,16194,0,5699,3474,96,152,585,120,0,0,26320,249,9854,9269,3570,16194
2022-06-21 01:30:00+00,16018,0,5692,3391,94,106,573,121,0,0,25995,249,9750,9177,3485,16018
2022-06-21 02:00:00+00,15881,0,5698,3383,94,56,579,119,0,0,25810,248,9754,9175,3477,15881
2022-06-21 02:30:00+00,15663,0,5696,3278,94,46,790,120,0,0,25687,246,9858,9068,3372,15663
2022-06-21 03:00:00+00,15632,0,5694,3081,94,16,909,113,0,0,25539,247,9778,8869,3175,15632
2022-06-21 03:30:00+00,15611,0,5695,2824,94,32,912,115,0,0,25284,250,9526,8614,2918,15611
2022-06-21 04:00:00+00,15487,0,5693,2584,93,170,910,117,90,0,25144,252,9370,8460,2767,15487
2022-06-21 04:30:00+00,16144,0,5699,2563,97,198,911,114,364,0,26090,253,9634,8723,3024,16144
2022-06-21 05:00:00+00,15811,66,5695,2395,325,234,995,141,831,0,26494,248,10241,9246,3551,15878
2022-06-21 05:30:00+00,16623,133,5700,2176,359,270,954,228,1384,6,27833,251,10573,9619,3919,16756
2022-06-21 06:00:00+00,16625,346,5703,1955,524,894,1145,504,2041,138,29875,250,11368,10223,4520,16971
2022-06-21 06:30:00+00,17373,264,5699,1956,618,958,1150,602,2905,450,31975,242,12328,11178,5479,17637
2022-06-21 07:00:00+00,17771,240,5704,1912,538,1674,1151,589,3674,356,33609,239,12979,11828,6124,18011
2022-06-21 07:30:00+00,17812,303,5701,1738,503,1720,1136,641,4584,198,34336,236,13662,12526,6825,18115
2022-06-21 08:00:00+00,17702,488,5704,1710,398,1788,1128,442,5440,162,34962,235,14380,13252,7548,18190
2022-06-21 08:30:00+00,17392,499,5700,1646,393,1794,1144,426,6257,326,35577,228,15140,13996,8296,17891
2022-06-21 09:00:00+00,17308,500,5699,1526,245,2088,1395,296,6826,56,35939,224,15691,14296,8597,17808
2022-06-21 09:30:00+00,17314,367,5701,1376,257,2132,1479,215,7423,16,36280,218,16236,14757,9056,17681
2022-06-21 10:00:00+00,17151,231,5694,1267,207,2178,1493,207,7847,0,36275,212,16508,15015,9321,17382
2022-06-21 10:30:00+00,17167,230,5688,1166,211,2192,1518,237,8273,16,36698,210,16856,15338,9650,17397
2022-06-21 11:00:00+00,17196,229,5689,1071,184,2380,1523,289,8235,94,36890,210,16702,15179,9490,17425
2022-06-21 11:30:00+00,17025,231,5692,1036,160,2398,1522,258,8614,0,36936,208,17024,15502,9810,17256
2022-06-21 12:00:00+00,16987,230,5693,1036,248,2398,1527,232,8664,34,37049,207,17168,15641,9948,17217
2022-06-21 12:30:00+00,16965,230,5684,1019,248,2382,1523,213,8522,156,36942,207,16996,15473,9789,17195
2022-06-21 13:00:00+00,17145,325,5687,994,256,2198,1523,217,8390,190,36925,211,16850,15327,9640,17470
2022-06-21 13:30:00+00,17015,474,5684,985,273,2182,1524,236,8061,56,36490,216,16527,15003,9319,17489
2022-06-21 14:00:00+00,16950,500,5691,1018,403,1878,1573,481,7524,0,36018,215,16209,14636,8945,17450
2022-06-21 14:30:00+00,16901,501,5685,1059,436,1880,1597,722,7026,108,35915,217,15803,14206,8521,17402
2022-06-21 15:00:00+00,17113,499,5695,1130,462,1788,1583,809,6329,206,35614,220,15199,13616,7921,17612
2022-06-21 15:30:00+00,17689,500,5695,1202,471,1790,1589,964,5404,384,35688,227,14361,12772,7077,18189
2022-06-21 16:00:00+00,17783,501,5696,1235,516,2252,1580,1059,4621,682,35925,234,13648,12068,6372,18284
2022-06-21 16:30:00+00,18071,499,5696,1273,516,2232,1570,1125,3825,804,35611,239,12880,11310,5614,18570
2022-06-21 17:00:00+00,18034,497,5695,1237,586,1960,1597,906,3068,1352,34932,239,12183,10586,4891,18531
2022-06-21 17:30:00+00,18222,498,5694,1252,582,1904,1602,848,2344,1576,34522,242,11474,9872,4178,18720
2022-06-21 18:00:00+00,18410,499,5695,1280,598,1424,1612,816,1674,1612,33620,245,10859,9247,3552,18909
2022-06-21 18:30:00+00,18462,446,5688,1273,597,1388,1629,867,1097,1360,32807,251,10284,8655,2967,18908
2022-06-21 19:00:00+00,18570,395,5687,1181,536,1446,1647,861,602,1328,32253,259,9653,8006,2319,18965
2022-06-21 19:30:00+00,18391,369,5680,1143,533,1450,1651,771,214,1010,31212,265,9221,7570,1890,18760
2022-06-21 20:00:00+00,18096,329,5684,1139,509,1444,1658,627,24,724,30234,273,9014,7356,1672,18425
2022-06-21 20:30:00+00,17926,290,5689,1103,425,1478,1652,489,0,618,29670,274,8869,7217,1528,18216
2022-06-21 21:00:00+00,17901,371,5681,1102,381,1746,1647,332,0,366,29527,275,8811,7164,1483,18272
2022-06-21 21:30:00+00,17218,372,5683,1124,312,1900,1643,267,0,322,28841,274,8762,7119,1436,17590
2022-06-21 22:00:00+00,17354,350,5681,1214,247,1720,1638,293,0,0,28497,273,8780,7142,1461,17704
2022-06-21 22:30:00+00,16953,34,5681,1145,218,1674,1657,255,0,0,27617,264,8701,7044,1363,16987
2022-06-21 23:00:00+00,17406,0,5679,1159,180,894,1581,162,0,0,27061,267,8599,7018,1339,17406
2022-06-21 23:30:00+00,17023,0,5678,1218,164,804,1428,156,0,0,26471,265,8488,7060,1382,17023
2022-06-22 00:00:00+00,17598,0,5686,1293,150,482,1405,160,0,0,26774,272,8534,7129,1443,17598
2022-06-22 00:30:00+00,17881,0,5691,1357,127,434,1396,130,0,0,27016,273,8571,7175,1484,17881
2022-06-22 01:00:00+00,17706,0,5694,1458,109,412,1481,126,0,0,26986,274,8742,7261,1567,17706
2022-06-22 01:30:00+00,17099,0,5692,1563,106,334,1497,128,0,0,26419,269,8858,7361,1669,17099
2022-06-22 02:00:00+00,17186,0,5697,1671,106,248,1521,134,0,0,26563,268,8995,7474,1777,17186
2022-06-22 02:30:00+00,17113,0,5689,1689,107,211,1550,151,0,0,26510,267,9035,7485,1796,17113
2022-06-22 03:00:00+00,17250,0,5698,1770,107,246,1641,131,0,0,26843,266,9216,7575,1877,17250
2022-06-22 03:30:00+00,17184,0,5693,1880,108,236,1637,138,0,0,26876,265,9318,7681,1988,17184
2022-06-22 04:00:00+00,16753,0,5702,2009,127,124,1580,129,67,0,26491,260,9485,7905,2203,16753
2022-06-22 04:30:00+00,16722,0,5697,1966,133,223,1640,131,328,0,26840,258,9764,8124,2427,16722
2022-06-22 05:00:00+00,16964,0,5696,2160,227,294,1652,152,737,0,27882,253,10472,8820,3124,16964
2022-06-22 05:30:00+00,17597,116,5697,2484,236,368,1525,210,1281,0,29514,251,11223,9698,4001,17713
2022-06-22 06:00:00+00,17222,390,5695,2648,306,1016,1502,651,1949,58,31437,247,12100,10598,4903,17612
2022-06-22 06:30:00+00,17852,498,5704,2941,295,1068,1641,603,2743,108,33453,243,13324,11683,5979,18350
2022-06-22 07:00:00+00,18345,492,5696,3267,283,992,1653,555,3640,124,35047,237,14539,12886,7190,18837
2022-06-22 07:30:00+00,18266,495,5701,3183,282,976,1637,876,4573,16,36005,232,15376,13739,8038,18761
2022-06-22 08:00:00+00,17923,500,5697,3143,281,594,1632,891,5512,176,36349,225,16265,14633,8936,18423
2022-06-22 08:30:00+00,17749,499,5701,3292,284,562,1634,845,6403,158,37127,218,17314,15680,9979,18248
2022-06-22 09:00:00+00,17477,495,5701,3225,221,476,1627,809,7153,294,37478,213,17927,16300,10599,17972
2022-06-22 09:30:00+00,17347,485,5705,3334,210,476,1605,788,7826,204,37980,209,18680,17075,11370,17832
2022-06-22 10:00:00+00,17198,297,5697,3538,171,434,1606,461,8397,74,37873,200,19409,17803,12106,17495
2022-06-22 10:30:00+00,17304,230,5697,3696,169,454,1606,402,8853,26,38437,196,20021,18415,12718,17534
2022-06-22 11:00:00+00,17223,231,5696,3788,164,742,1603,346,9158,22,38973,196,20409,18806,13110,17454
2022-06-22 11:30:00+00,17037,230,5684,3705,159,738,1602,237,9127,220,38739,194,20277,18675,12991,17267
2022-06-22 12:00:00+00,16938,231,5689,3660,159,592,1600,265,9167,540,38841,191,20275,18675,12986,17169
2022-06-22 12:30:00+00,16870,230,5690,3611,159,592,1603,389,9124,174,38442,193,20187,18584,12894,17100
2022-06-22 13:00:00+00,16557,344,5686,3655,156,556,1602,356,8788,388,38088,194,19887,18285,12599,16901
2022-06-22 13:30:00+00,16307,474,5694,3958,155,556,1604,367,8361,0,37476,198,19772,18168,12474,16781
2022-06-22 14:00:00+00,15495,493,5687,4170,115,510,1568,369,7883,0,36290,195,19423,17855,12168,15988
2022-06-22 14:30:00+00,15911,496,5676,4216,152,568,1459,446,7280,84,36288,200,18783,17324,11648,16407
2022-06-22 15:00:00+00,15763,498,5675,4391,286,1366,1451,595,6425,158,36608,203,18228,16777,11102,16261
2022-06-22 15:30:00+00,16578,497,5676,4581,295,1404,1373,659,5603,32,36698,211,17528,16155,10479,17075
2022-06-22 16:00:00+00,16498,499,5684,4733,391,1452,1366,837,4778,298,36536,209,16952,15586,9902,16997
2022-06-22 16:30:00+00,17167,498,5686,4629,415,1492,1371,802,3846,416,36322,217,15947,14576,8890,17665
2022-06-22 17:00:00+00,17330,487,5687,4599,565,1072,1385,914,3057,632,35728,220,15293,13908,8221,17817
2022-06-22 17:30:00+00,17566,498,5684,4562,566,1068,1390,1018,2349,674,35375,226,14551,13161,7477,18064
2022-06-22 18:00:00+00,17437,499,5689,4649,500,1428,1363,1011,1662,622,34860,228,13863,12500,6811,17936
2022-06-22 18:30:00+00,17359,500,5686,4579,417,1454,1373,1000,1084,550,34002,232,13139,11766,6080,17859
2022-06-22 19:00:00+00,17529,500,5687,4550,343,1348,1451,954,591,380,33333,238,12622,11171,5484,18029
2022-06-22 19:30:00+00,17226,368,5684,4653,315,1344,1469,695,209,362,32325,235,12330,10861,5177,17594
2022-06-22 20:00:00+00,17901,336,5686,4734,258,1598,1478,457,21,382,32851,240,12177,10699,5013,18237
2022-06-22 20:30:00+00,17458,288,5683,4743,251,1642,1601,330,0,60,32056,239,12278,10677,4994,17746
2022-06-22 21:00:00+00,17327,259,5683,4701,245,1870,1663,224,0,0,31972,243,12292,10629,4946,17586
2022-06-22 21:30:00+00,16681,67,5685,4826,215,1836,1489,244,0,0,31043,236,12215,10726,5041,16748
2022-06-22 22:00:00+00,15489,0,5684,4708,180,1358,1306,202,0,0,28927,233,11878,10572,4888,15489
2022-06-22 22:30:00+00,14915,0,5687,4538,167,1262,1293,129,0,0,27991,231,11685,10392,4705,14915
2022-06-22 23:00:00+00,15574,0,5685,4295,100,742,1288,121,0,0,27805,239,11368,10080,4395,15574
2022-06-22 23:30:00+00,15160,0,5687,4170,93,742,1294,122,0,0,27268,238,11244,9950,4263,15160
2022-06-23 00:00:00+00,15544,0,5684,4036,93,404,1290,132,0,0,27183,239,11103,9813,4129,15544
2022-06-23 00:30:00+00,15397,0,5684,3997,93,398,1292,129,0,0,26990,239,11066,9774,4090,15397
2022-06-23 01:00:00+00,15350,0,5686,4095,47,204,1238,133,0,0,26753,237,11066,9828,4142,15350
2022-06-23 01:30:00+00,15077,0,5686,4145,44,204,1196,134,0,0,26486,235,11071,9875,4189,15077
2022-06-23 02:00:00+00,15379,0,5688,4017,43,0,1122,135,0,0,26384,236,10870,9748,4060,15379
2022-06-23 02:30:00+00,15543,0,5688,3890,43,0,1172,126,0,0,26462,238,10793,9621,3933,15543
2022-06-23 03:00:00+00,15497,5,5692,3767,43,0,1154,111,0,0,26269,239,10656,9502,3810,15502
2022-06-23 03:30:00+00,15344,24,5685,3699,43,0,1204,111,0,0,26110,239,10631,9427,3742,15368
2022-06-23 04:00:00+00,15055,95,5690,3387,75,256,1246,113,66,0,25983,243,10464,9218,3528,15150
2022-06-23 04:30:00+00,15174,230,5684,3259,79,296,1196,125,319,0,26362,247,10537,9341,3657,15404
2022-06-23 05:00:00+00,15522,407,5688,3193,198,658,1208,193,719,0,27786,252,11006,9798,4110,15929
2022-06-23 05:30:00+00,16351,606,5691,3115,261,726,1385,162,1197,0,29494,256,11649,10264,4573,16957
2022-06-23 06:00:00+00,17558,704,5686,3060,336,1108,1557,289,1745,0,32043,255,12384,10827,5141,18262
2022-06-23 06:30:00+00,18016,736,5687,3001,337,1160,1625,406,2365,40,33373,253,13015,11390,5703,18752
2022-06-23 07:00:00+00,18046,763,5687,2782,381,1546,1395,440,2960,402,34402,246,13205,11810,6123,18809
2022-06-23 07:30:00+00,17776,867,5691,2518,462,1580,1334,753,3542,324,34847,245,13547,12213,6522,18643
2022-06-23 08:00:00+00,17619,923,5690,2348,457,1738,1335,763,3975,408,35256,246,13805,12470,6780,18542
2022-06-23 08:30:00+00,17472,948,5690,2372,445,1714,1597,805,4453,306,35802,242,14557,12960,7270,18420
2022-06-23 09:00:00+00,17758,988,5693,2459,379,1434,1614,589,4781,122,35817,245,14926,13312,7619,18746
2022-06-23 09:30:00+00,18097,986,5494,2511,377,1432,1609,312,5220,352,36390,242,15211,13602,8108,19083
2022-06-23 10:00:00+00,17842,988,5688,2410,378,1766,1590,425,5311,0,36398,240,15377,13787,8099,18830
2022-06-23 10:30:00+00,17455,982,5684,2381,382,1814,1618,290,5124,178,35908,238,15189,13571,7887,18437
2022-06-23 11:00:00+00,17336,983,5684,2356,346,2082,1620,399,5626,56,36488,234,15632,14012,8328,18319
2022-06-23 11:30:00+00,17167,983,5684,2512,339,2108,1622,556,6096,0,37067,230,16253,14631,8947,18150
2022-06-23 12:00:00+00,17311,985,5677,2642,318,2172,1616,252,5997,0,36970,229,16250,14634,8957,18296
2022-06-23 12:30:00+00,17215,987,5673,2761,314,2184,1617,442,5549,136,36878,230,15914,14297,8624,18202
2022-06-23 13:00:00+00,17032,986,5677,2934,315,2034,1619,617,4868,0,36082,235,15413,13794,8117,18018
2022-06-23 13:30:00+00,16653,989,5667,3088,133,2026,1619,590,4633,0,35398,235,15140,13521,7854,17642
2022-06-23 14:00:00+00,16365,989,5672,3318,180,2400,1591,596,4411,0,35522,232,15172,13581,7909,17354
2022-06-23 14:30:00+00,16483,987,5668,3503,226,2436,1623,564,4010,0,35500,233,15030,13407,7739,17470
2022-06-23 15:00:00+00,16863,989,5670,3455,361,2152,1623,780,3428,0,35321,236,14537,12914,7244,17852
2022-06-23 15:30:00+00,17273,990,5661,3344,340,2136,1623,886,2816,22,35091,243,13784,12161,6500,18263
2022-06-23 16:00:00+00,17365,990,5664,3469,376,2140,1603,878,2546,356,35387,243,13658,12055,6391,18355
2022-06-23 16:30:00+00,17456,946,5663,3558,486,2140,1400,919,1996,538,35102,244,13103,11703,6040,18402
2022-06-23 17:00:00+00,17119,882,5673,3602,623,2248,1376,976,1636,872,35007,238,12910,11534,5861,18001
2022-06-23 17:30:00+00,17227,772,5673,3393,648,2256,1284,949,1162,894,34258,241,12160,10876,5203,17999
2022-06-23 18:00:00+00,17254,776,5685,3154,641,2202,1276,897,769,938,33592,248,11525,10249,4564,18030
2022-06-23 18:30:00+00,17264,611,5675,2952,616,2194,1280,804,470,1012,32878,249,10993,9713,4038,17875
2022-06-23 19:00:00+00,17877,749,5677,2924,429,2036,1277,737,260,700,32666,260,10567,9290,3613,18626
2022-06-23 19:30:00+00,18247,733,5677,2695,406,1956,1276,689,97,348,32124,267,10151,8875,3198,18980
2022-06-23 20:00:00+00,18158,736,5681,2718,390,2130,1342,550,7,64,31776,270,10138,8796,3115,18894
2022-06-23 20:30:00+00,17563,719,5678,2892,376,2060,1482,502,0,88,31360,264,10428,8946,3268,18282
2022-06-23 21:00:00+00,18045,421,5675,3100,317,1542,1606,453,0,94,31253,255,10698,9092,3417,18466
2022-06-23 21:30:00+00,17551,67,5681,3215,316,1422,1624,393,0,0,30269,244,10836,9212,3531,17618
2022-06-23 22:00:00+00,16810,0,5681,3078,231,854,1633,157,0,0,28444,242,10623,8990,3309,16810
2022-06-23 22:30:00+00,15892,0,5684,2867,212,798,1626,171,0,0,27250,239,10389,8763,3079,15892
2022-06-23 23:00:00+00,15542,0,5685,2867,169,406,1584,176,0,0,26429,241,10305,8721,3036,15542
2022-06-23 23:30:00+00,15267,0,5683,2634,134,324,1632,149,0,0,25823,242,10083,8451,2768,15267
2022-06-24 00:00:00+00,15978,0,5684,2373,71,0,1497,147,0,0,25750,253,9625,8128,2444,15978
2022-06-24 00:30:00+00,15966,0,5688,2404,72,0,1506,141,0,0,25777,253,9670,8164,2476,15966
2022-06-24 01:00:00+00,16108,0,5685,2547,198,0,1564,361,0,0,26463,251,9994,8430,2745,16108
2022-06-24 01:30:00+00,15882,0,5690,2776,271,0,1491,460,0,0,26570,247,10228,8737,3047,15882
2022-06-24 02:00:00+00,15947,0,5680,2826,124,0,1486,402,0,0,26465,249,10116,8630,2950,15947
2022-06-24 02:30:00+00,16187,0,5678,2588,55,0,1553,352,0,0,26413,253,9874,8321,2643,16187
2022-06-24 03:00:00+00,16352,0,5682,2548,229,0,1640,191,0,0,26642,251,10099,8459,2777,16352
2022-06-24 03:30:00+00,16188,0,5683,2565,239,0,1640,138,0,0,26453,250,10127,8487,2804,16188
2022-06-24 04:00:00+00,15503,0,5679,2808,208,0,1612,136,14,0,25960,244,10321,8709,3030,15503
2022-06-24 04:30:00+00,15659,3,5674,2920,175,0,1595,187,128,0,26341,244,10492,8897,3223,15662
2022-06-24 05:00:00+00,15736,154,5683,3175,282,76,1583,293,334,0,27316,242,11057,9474,3791,15890
2022-06-24 05:30:00+00,16189,229,5681,3504,296,132,1643,438,638,0,28750,241,11762,10119,4438,16418
2022-06-24 06:00:00+00,16011,229,5680,3669,483,534,1492,573,1002,210,29883,230,12326,10834,5154,16240
2022-06-24 06:30:00+00,16550,229,5676,3602,520,582,1520,531,1432,980,31622,224,12750,11230,5554,16779
2022-06-24 07:00:00+00,17339,239,5677,3594,547,1128,1638,548,1851,824,33385,225,13307,11669,5992,17578
2022-06-24 07:30:00+00,17507,231,5679,3577,544,1202,1614,473,2455,974,34256,220,13869,12255,6576,17738
2022-06-24 08:00:00+00,17622,235,5674,3658,515,1622,1607,408,2745,754,34840,219,14199,12592,6918,17857
2022-06-24 08:30:00+00,17264,229,5688,4030,500,1662,1483,619,3169,568,35212,214,14870,13387,7699,17493
2022-06-24 09:00:00+00,16936,235,5683,4237,456,1838,1393,535,3427,246,34986,213,15196,13803,8120,17171
2022-06-24 09:30:00+00,16820,229,5685,4433,440,1846,1419,471,3600,270,35213,210,15577,14158,8473,17049
2022-06-24 10:00:00+00,16827,229,5682,4573,396,1888,1396,391,3587,0,34969,211,15634,14238,8556,17056
2022-06-24 10:30:00+00,16833,179,5685,4806,389,1912,1387,327,3519,16,35053,209,15786,14399,8714,17012
2022-06-24 11:00:00+00,17018,0,5683,4966,271,2114,1390,314,4060,0,35816,204,16370,14980,9297,17018
2022-06-24 11:30:00+00,16706,0,5681,5421,265,2074,1385,313,4675,18,36538,196,17427,16042,10361,16706
2022-06-24 12:00:00+00,16455,0,5681,5709,243,1588,1378,233,4849,32,36168,188,17860,16482,10801,16455
2022-06-24 12:30:00+00,15890,0,5675,5984,225,1592,1380,193,4817,0,35756,184,18081,16701,11026,15890
2022-06-24 13:00:00+00,16153,0,5679,6169,199,1376,1387,194,4068,6,35231,190,17502,16115,10436,16153
2022-06-24 13:30:00+00,16350,0,5670,5814,175,1192,1380,215,3807,74,34677,195,16846,15466,9796,16350
2022-06-24 14:00:00+00,16499,0,5677,5504,175,794,1382,272,3283,0,33586,203,16021,14639,8962,16499
2022-06-24 14:30:00+00,16631,0,5664,5279,190,900,1464,291,3659,98,34176,204,16256,14792,9128,16631
2022-06-24 15:00:00+00,17220,0,5670,5359,271,1108,1499,291,2918,162,34498,212,15717,14218,8548,17220
2022-06-24 15:30:00+00,17220,0,5667,5704,305,1208,1613,546,2390,96,34749,215,15679,14066,8399,17220
2022-06-24 16:00:00+00,17239,0,5667,5737,336,1226,1512,678,2088,572,35055,212,15340,13828,8161,17239
2022-06-24 16:30:00+00,17278,0,5670,5588,343,1336,1538,753,2024,810,35340,213,15163,13625,7955,17278
2022-06-24 17:00:00+00,17510,0,5678,5853,375,1262,1522,764,1518,264,34746,219,14946,13424,7746,17510
2022-06-24 17:30:00+00,17035,0,5673,6104,376,1186,1586,690,1157,262,34069,216,14896,13310,7637,17035
2022-06-24 18:00:00+00,16713,0,5683,6502,390,1134,1451,372,761,0,33006,216,14787,13336,7653,16713
2022-06-24 18:30:00+00,16574,0,5682,7099,368,948,1468,254,533,10,32936,211,15150,13682,8000,16574
2022-06-24 19:00:00+00,16341,0,5681,7992,272,518,1391,166,315,12,32688,208,15651,14260,8579,16341
2022-06-24 19:30:00+00,15220,0,5677,9009,272,484,1150,160,107,16,32095,198,16215,15065,9388,15220
2022-06-24 20:00:00+00,14558,0,5679,9862,272,270,1007,151,9,18,31826,189,16829,15822,10143,14558
2022-06-24 20:30:00+00,13414,0,5679,10738,265,204,904,148,0,0,31352,176,17586,16682,11003,13414
2022-06-24 21:00:00+00,12786,0,5678,10993,248,246,886,145,0,32,31014,171,17805,16919,11241,12786
2022-06-24 21:30:00+00,11116,0,5681,11481,247,180,902,134,0,0,29741,155,18311,17409,11728,11116
2022-06-24 22:00:00+00,9600,0,5675,11596,231,364,906,146,0,160,28678,142,18408,17502,11827,9600
2022-06-24 22:30:00+00,8276,0,5679,11948,229,574,905,139,0,18,27768,130,18761,17856,12177,8276
2022-06-24 23:00:00+00,7191,0,5684,12232,170,448,901,133,0,14,26773,119,18987,18086,12402,7191
2022-06-24 23:30:00+00,6310,0,5681,12686,166,428,885,139,0,0,26295,108,19418,18533,12852,6310
2022-06-25 00:00:00+00,5860,0,5688,12790,145,524,890,118,0,0,26015,103,19513,18623,12935,5860
2022-06-25 00:30:00+00,5327,0,5688,13450,145,414,874,112,0,0,26010,93,20157,19283,13595,5327
2022-06-25 01:00:00+00,4831,0,5691,13724,111,478,880,122,0,0,25837,88,20406,19526,13835,4831
2022-06-25 01:30:00+00,4331,0,5692,14180,87,376,765,111,0,0,25542,78,20724,19959,14267,4331
2022-06-25 02:00:00+00,4198,0,5688,14632,69,428,649,112,0,0,25776,76,21038,20389,14701,4198
2022-06-25 02:30:00+00,4140,0,5687,14791,66,362,562,110,0,0,25718,74,21106,20544,14857,4140
2022-06-25 03:00:00+00,4042,0,5688,14878,65,416,540,119,0,0,25748,73,21171,20631,14943,4042
2022-06-25 03:30:00+00,4049,0,5683,14739,65,356,548,111,0,0,25551,73,21035,20487,14804,4049
2022-06-25 04:00:00+00,4120,0,5683,14530,64,396,547,123,49,0,25512,75,20873,20326,14643,4120
2022-06-25 04:30:00+00,4436,0,5684,14261,70,532,568,125,337,0,26013,81,20920,20352,14668,4436
2022-06-25 05:00:00+00,5261,0,5685,13988,199,616,752,118,799,0,27418,90,21423,20671,14986,5261
2022-06-25 05:30:00+00,5200,0,5688,13808,228,672,845,120,1418,0,27979,89,21987,21142,15454,5200
2022-06-25 06:00:00+00,5646,0,5685,13440,253,418,867,117,2025,0,28451,90,22270,21403,15718,5646
2022-06-25 06:30:00+00,6323,0,5692,13336,254,538,887,118,2739,0,29887,96,22908,22021,16329,6323
2022-06-25 07:00:00+00,7126,0,5685,12827,254,710,894,125,3547,0,31168,105,23207,22313,16628,7126
2022-06-25 07:30:00+00,7554,0,5684,12792,243,732,758,146,4269,0,32178,107,23746,22988,17304,7554
2022-06-25 08:00:00+00,7055,0,5680,12502,206,488,537,176,4680,0,31324,100,23605,23068,17388,7055
2022-06-25 08:30:00+00,7385,0,5680,12372,201,444,538,176,5331,14,32141,101,24122,23584,17904,7385
2022-06-25 09:00:00+00,7348,0,5683,12431,167,456,587,163,6003,0,32838,98,24871,24284,18601,7348
2022-06-25 09:30:00+00,6794,0,5684,12542,153,506,618,103,6413,0,32813,92,25410,24792,19108,6794
2022-06-25 10:00:00+00,6182,0,5687,12822,123,680,645,100,6684,0,32923,82,25961,25316,19629,6182
2022-06-25 10:30:00+00,6217,0,5685,12662,120,626,640,101,7335,46,33432,80,26442,25802,20116,6217
2022-06-25 11:00:00+00,6441,0,5689,12527,98,790,632,110,7573,0,33860,85,26519,25887,20198,6441
2022-06-25 11:30:00+00,6385,0,5688,12744,97,596,550,111,7576,0,33747,82,26655,26105,20417,6385
2022-06-25 12:00:00+00,6236,0,5686,12789,95,402,543,112,6915,142,32920,83,26028,25485,19799,6236
2022-06-25 12:30:00+00,5934,0,5687,13049,79,372,575,112,6975,0,32783,80,26365,25790,20103,5934
2022-06-25 13:00:00+00,5355,0,5684,13333,73,474,545,111,6804,0,32379,75,26439,25894,20210,5355
2022-06-25 13:30:00+00,4711,0,5683,13671,72,530,534,100,6438,0,31739,69,26398,25864,20181,4711
2022-06-25 14:00:00+00,4810,0,5686,13885,86,520,540,100,5731,0,31358,71,25928,25388,19702,4810
2022-06-25 14:30:00+00,5338,0,5687,13576,94,586,539,102,5715,0,31637,78,25611,25072,19385,5338
2022-06-25 15:00:00+00,5830,0,5689,13477,143,522,656,109,4894,0,31320,85,24859,24203,18514,5830
2022-06-25 15:30:00+00,6330,0,5682,13922,140,520,696,109,4351,74,31824,90,24791,24095,18413,6330
2022-06-25 16:00:00+00,7771,0,5686,13412,185,698,647,110,3835,344,32688,107,23765,23118,17432,7771
2022-06-25 16:30:00+00,8661,0,5688,13358,205,734,664,110,3178,0,32598,118,23093,22429,16741,8661
2022-06-25 17:00:00+00,8804,0,5686,12929,231,1010,701,111,2646,434,32552,120,22193,21492,15806,8804
2022-06-25 17:30:00+00,9005,0,5695,12875,231,1114,890,118,1847,152,31927,126,21538,20648,14953,9005
2022-06-25 18:00:00+00,8912,0,5689,12990,236,996,897,203,1498,278,31699,127,21310,20413,14724,8912
2022-06-25 18:30:00+00,8896,0,5689,13179,239,968,871,173,972,356,31343,128,20950,20079,14390,8896
2022-06-25 19:00:00+00,9186,0,5688,12979,239,848,906,167,494,14,30521,135,20306,19400,13712,9186
2022-06-25 19:30:00+00,9313,0,5691,12502,229,834,903,129,170,0,29771,140,19495,18592,12901,9313
2022-06-25 20:00:00+00,9540,0,5682,12191,208,754,908,148,14,0,29445,145,19003,18095,12413,9540
2022-06-25 20:30:00+00,9445,0,5678,12241,208,752,910,140,0,0,29374,144,19037,18127,12449,9445
2022-06-25 21:00:00+00,9202,0,5698,12465,208,744,909,193,0,96,29515,140,19280,18371,12673,9202
2022-06-25 21:30:00+00,8850,0,5702,12385,203,616,909,181,0,0,28846,136,19199,18290,12588,8850
2022-06-25 22:00:00+00,7049,0,5695,12876,208,738,904,153,0,242,27865,115,19683,18779,13084,7049
2022-06-25 22:30:00+00,6311,0,5647,12883,225,912,774,168,0,0,26920,110,19529,18755,13108,6311
2022-06-25 23:00:00+00,6799,0,5092,12782,166,992,849,154,0,4,26838,118,18889,18040,12948,6799
2022-06-25 23:30:00+00,6294,0,5057,12711,160,988,888,139,0,0,26237,113,18816,17928,12871,6294
2022-06-26 00:00:00+00,6108,0,5049,12702,148,752,825,129,0,90,25803,112,18724,17899,12850,6108
2022-06-26 00:30:00+00,6042,0,5053,12604,146,752,775,115,0,80,25567,112,18578,17803,12750,6042
2022-06-26 01:00:00+00,5699,0,5056,12931,131,750,772,114,0,14,25467,107,18890,18118,13062,5699
2022-06-26 01:30:00+00,5531,0,5057,13007,128,750,656,110,0,0,25239,104,18848,18192,13135,5531
2022-06-26 02:00:00+00,5406,0,5053,12569,130,750,660,128,0,0,24696,105,18412,17752,12699,5406
2022-06-26 02:30:00+00,5187,0,5060,12722,107,750,622,111,0,0,24559,102,18511,17889,12829,5187
2022-06-26 03:00:00+00,5004,0,5066,12917,73,750,617,118,0,0,24545,99,18673,18056,12990,5004
2022-06-26 03:30:00+00,4721,0,5067,12815,82,750,570,111,0,0,24116,96,18534,17964,12897,4721
2022-06-26 04:00:00+00,5059,0,5056,12765,76,750,600,117,74,0,24497,100,18571,17971,12915,5059
2022-06-26 04:30:00+00,5067,0,5058,12715,76,750,687,120,330,0,24803,99,18866,18179,13121,5067
2022-06-26 05:00:00+00,5232,0,5059,12852,130,750,746,113,734,0,25616,99,19521,18775,13716,5232
2022-06-26 05:30:00+00,5034,0,5056,13326,139,708,623,114,1336,0,26336,92,20480,19857,14801,5034
2022-06-26 06:00:00+00,4477,0,5059,13662,175,624,572,117,2014,0,26700,81,21482,20910,15851,4477
2022-06-26 06:30:00+00,4455,0,5059,13435,181,532,568,120,2690,18,27058,78,21933,21365,16306,4455
2022-06-26 07:00:00+00,4352,0,5059,13482,189,310,559,125,3370,0,27446,71,22659,22100,17041,4352
2022-06-26 07:30:00+00,4513,0,5058,13625,187,190,569,128,3878,96,28244,70,23317,22748,17690,4513
2022-06-26 08:00:00+00,4368,0,5057,14044,172,130,617,111,4606,54,29159,65,24496,23879,18822,4368
2022-06-26 08:30:00+00,4388,0,5056,14258,159,102,857,105,5396,34,30355,63,25726,24869,19813,4388
2022-06-26 09:00:00+00,4849,0,5055,14542,133,0,895,109,5805,124,31512,65,26430,25535,20480,4849
2022-06-26 09:30:00+00,4792,0,5053,14819,136,0,888,105,6276,92,32161,63,27172,26284,21231,4792
2022-06-26 10:00:00+00,3912,0,5054,15225,112,612,887,110,6308,0,32220,61,27586,26699,21645,3912
2022-06-26 10:30:00+00,3765,0,5057,15783,111,720,885,102,6954,0,33377,59,28790,27905,22848,3765
2022-06-26 11:00:00+00,4095,0,5051,16075,94,608,787,118,6906,0,33734,60,28913,28126,23075,4095
2022-06-26 11:30:00+00,4200,0,5057,16427,89,606,857,102,7265,0,34603,60,29695,28838,23781,4200
2022-06-26 12:00:00+00,4342,0,5056,16655,44,303,880,103,7242,0,34625,58,29877,28997,23941,4342
2022-06-26 12:30:00+00,4181,0,5058,16727,41,0,878,108,7252,0,34245,52,29956,29078,24020,4181
2022-06-26 13:00:00+00,4075,0,5057,16755,41,0,868,103,7027,0,33926,51,29748,28880,23823,4075
2022-06-26 13:30:00+00,4123,0,5059,16946,41,0,883,102,6150,0,33304,53,29079,28196,23137,4123
2022-06-26 14:00:00+00,4455,0,5056,16947,55,0,889,112,5737,0,33251,57,28684,27795,22739,4455
2022-06-26 14:30:00+00,4840,0,5055,16967,57,0,889,125,5380,0,33313,62,28348,27459,22404,4840
2022-06-26 15:00:00+00,5872,0,5061,16567,141,0,885,116,5009,0,33651,73,27663,26778,21717,5872
2022-06-26 15:30:00+00,6823,0,5057,16501,153,0,876,138,4380,0,33928,84,26967,26091,21034,6823
2022-06-26 16:00:00+00,7563,0,5057,16283,194,0,871,129,3844,64,34005,92,26249,25378,20321,7563
2022-06-26 16:30:00+00,8601,0,5062,15760,205,0,872,164,3252,190,34106,104,25151,24279,19217,8601
2022-06-26 17:00:00+00,8648,0,5061,15361,258,0,885,177,2619,164,33173,108,24184,23299,18238,8648
2022-06-26 17:30:00+00,8987,0,5063,15175,270,0,911,178,2061,130,32775,113,23480,22569,17506,8987
2022-06-26 18:00:00+00,9061,0,5057,15084,275,0,913,205,1471,136,32202,116,22800,21887,16830,9061
2022-06-26 18:30:00+00,9173,0,5059,14736,275,0,914,255,948,122,31482,121,21932,21018,15959,9173
2022-06-26 19:00:00+00,9385,0,5060,14735,265,0,914,344,511,146,31360,125,21485,20571,15511,9385
2022-06-26 19:30:00+00,9561,0,5063,14199,322,0,916,402,194,50,30707,130,20694,19778,14715,9561
2022-06-26 20:00:00+00,9905,0,5059,13929,269,0,914,339,21,34,30470,135,20192,19278,14219,9905
2022-06-26 20:30:00+00,10024,0,5062,13627,239,0,914,263,0,0,30129,137,19842,18928,13866,10024
2022-06-26 21:00:00+00,10031,0,5064,13303,253,0,914,256,0,0,29821,139,19534,18620,13556,10031
2022-06-26 21:30:00+00,9250,0,5064,13003,277,0,915,156,0,0,28665,133,19259,18344,13280,9250
2022-06-26 22:00:00+00,9667,0,5063,12434,210,0,914,125,0,42,28455,139,18621,17707,12644,9667
2022-06-26 22:30:00+00,9504,0,5067,11984,180,0,912,110,0,0,27757,140,18143,17231,12164,9504
2022-06-26 23:00:00+00,9265,0,5067,11548,141,0,870,103,0,0,26994,140,17626,16756,11689,9265
2022-06-26 23:30:00+00,9348,0,5064,11027,132,0,816,115,0,0,26502,144,17039,16223,11159,9348
2022-06-27 00:00:00+00,9271,0,5067,10621,118,72,889,103,0,0,26141,146,16695,15806,10739,9271
2022-06-27 00:30:00+00,9546,0,5066,10080,118,90,908,116,0,0,25924,152,16172,15264,10198,9546
2022-06-27 01:00:00+00,9912,0,5065,9246,83,116,909,106,0,0,25437,161,15303,14394,9329,9912
2022-06-27 01:30:00+00,9987,0,5066,8768,80,160,906,109,0,0,25076,165,14820,13914,8848,9987
2022-06-27 02:00:00+00,10265,0,5064,8457,66,200,910,103,0,0,25065,171,14497,13587,8523,10265
2022-06-27 02:30:00+00,10459,0,5065,8232,69,186,913,102,0,0,25026,174,14279,13366,8301,10459
2022-06-27 03:00:00+00,10830,1,5058,7839,90,194,912,118,0,0,25042,180,13899,12987,7929,10831
2022-06-27 03:30:00+00,11209,2,5059,7202,93,44,914,104,0,0,24627,186,13268,12354,7295,11211
2022-06-27 04:00:00+00,11761,101,5058,6693,93,36,913,105,40,0,24800,197,12797,11884,6826,11862
2022-06-27 04:30:00+00,12886,219,5058,6216,89,24,912,116,233,0,25753,211,12508,11596,6538,13105
2022-06-27 05:00:00+00,13438,229,5061,5994,126,138,913,128,509,0,26536,216,12603,11690,6629,13667
2022-06-27 05:30:00+00,14560,242,5061,5805,138,50,912,145,872,66,27851,220,12788,11876,6815,14802
2022-06-27 06:00:00+00,14858,239,5062,5754,249,0,912,249,1387,190,28900,217,13364,12452,7390,15097
2022-06-27 06:30:00+00,15373,238,5064,5697,319,22,910,539,1763,596,30521,215,13753,12843,7779,15611
2022-06-27 07:00:00+00,15996,231,5065,5816,403,848,908,645,2123,1300,33335,210,14315,13407,8342,16227
2022-06-27 07:30:00+00,15594,235,5064,6051,401,964,908,406,2519,1420,33562,203,14943,14035,8971,15829
2022-06-27 08:00:00+00,16187,231,5066,6121,482,742,910,320,3272,1136,34467,197,15851,14941,9875,16418
2022-06-27 08:30:00+00,16181,234,5062,6081,473,786,908,219,3587,1124,34655,195,16111,15203,10141,16415
2022-06-27 09:00:00+00,16120,230,5066,6207,333,1366,909,405,4108,944,35688,199,16623,15714,10648,16350
2022-06-27 09:30:00+00,15788,229,5061,6301,302,1476,908,362,4563,996,35986,195,17135,16227,11166,16017
2022-06-27 10:00:00+00,16151,230,5069,6475,292,1354,892,321,5117,766,36667,195,17845,16953,11884,16381
2022-06-27 10:30:00+00,15993,229,5071,6666,292,1334,788,333,5039,432,36177,196,17856,17068,11997,16222
2022-06-27 11:00:00+00,15823,230,5051,7019,243,1316,732,345,5557,158,36474,193,18602,17870,12819,16053
2022-06-27 11:30:00+00,15663,230,5046,7111,243,1404,667,382,5824,208,36778,191,18891,18224,13178,15893
2022-06-27 12:00:00+00,16022,229,5043,7337,145,682,693,303,6315,62,36831,190,19533,18840,13797,16251
2022-06-27 12:30:00+00,15583,228,5047,7668,176,682,662,177,6087,0,36310,187,19640,18978,13931,15811
2022-06-27 13:00:00+00,15963,229,5054,7960,201,524,725,130,6486,0,37272,184,20426,19701,14647,16192
2022-06-27 13:30:00+00,15676,230,5051,8069,206,696,771,129,6463,0,37291,183,20560,19789,14738,15906
2022-06-27 14:00:00+00,15450,230,5052,8456,223,744,815,128,6193,0,37291,182,20739,19924,14872,15680
2022-06-27 14:30:00+00,15500,230,5049,8336,235,752,856,140,5840,82,37020,184,20316,19460,14411,15730
2022-06-27 15:00:00+00,15840,230,5046,7715,312,1022,872,192,5538,266,37033,188,19483,18611,13565,16070
2022-06-27 15:30:00+00,16343,230,5052,7852,337,1074,908,400,4735,0,36931,196,18884,17976,12924,16573
2022-06-27 16:00:00+00,15874,230,5048,8164,351,1384,859,483,4154,234,36781,192,18576,17717,12669,16104
2022-06-27 16:30:00+00,16258,228,5047,7403,368,1412,843,593,3564,622,36338,199,17225,16382,11335,16486
2022-06-27 17:00:00+00,16313,2,5053,6972,395,1392,813,768,2748,576,35032,203,15981,15168,10115,16315
2022-06-27 17:30:00+00,16266,0,5049,6474,395,1388,673,915,1980,984,34124,208,14571,13898,8849,16266
2022-06-27 18:00:00+00,16536,0,5050,6150,395,1378,785,859,1584,938,33675,214,13964,13179,8129,16536
2022-06-27 18:30:00+00,16089,0,5046,6492,391,1374,734,955,1063,820,32964,214,13726,12992,7946,16089
2022-06-27 19:00:00+00,16020,0,5046,6438,377,1470,717,917,656,1064,32705,216,13234,12517,7471,16020
2022-06-27 19:30:00+00,16229,0,5050,6230,369,1464,871,554,214,660,31641,223,12734,11863,6813,16229
2022-06-27 20:00:00+00,16725,0,5053,6246,376,1284,903,511,28,230,31356,230,12606,11703,6650,16725
2022-06-27 20:30:00+00,16247,0,5053,6580,416,1266,825,481,0,0,30868,226,12874,12049,6996,16247
2022-06-27 21:00:00+00,16205,0,5050,7016,378,864,907,351,0,84,30855,225,13351,12444,7394,16205
2022-06-27 21:30:00+00,15350,0,5048,7341,377,826,869,171,0,0,29982,218,13635,12766,7718,15350
2022-06-27 22:00:00+00,14376,0,5047,7600,346,774,802,126,0,0,29071,211,13795,12993,7946,14376
2022-06-27 22:30:00+00,12800,0,5050,7752,347,758,879,131,0,0,27717,200,14028,13149,8099,12800
2022-06-27 23:00:00+00,12641,0,5047,7989,312,750,904,131,0,0,27774,197,14252,13348,8301,12641
2022-06-27 23:30:00+00,12134,0,5047,8187,270,750,827,127,0,0,27342,192,14331,13504,8457,12134
2022-06-28 00:00:00+00,11812,0,5046,8075,242,750,852,137,0,0,26914,191,14215,13363,8317,11812
2022-06-28 00:30:00+00,11611,0,5048,8089,204,748,888,116,0,0,26704,189,14229,13341,8293,11611
2022-06-28 01:00:00+00,11434,0,5049,8175,164,748,888,88,0,0,26546,188,14276,13388,8339,11434
2022-06-28 01:30:00+00,11123,0,5048,8574,162,748,890,84,0,0,26629,182,14674,13784,8736,11123
2022-06-28 02:00:00+00,10856,0,5050,8923,161,748,889,85,0,0,26712,178,15023,14134,9084,10856
2022-06-28 02:30:00+00,10545,0,5052,8987,161,750,867,85,0,0,26447,175,15067,14200,9148,10545
2022-06-28 03:00:00+00,10364,0,5055,9234,145,752,863,81,0,0,26494,172,15297,14434,9379,10364
2022-06-28 03:30:00+00,10246,0,5054,9207,145,750,794,76,0,0,26272,171,15200,14406,9352,10246
2022-06-28 04:00:00+00,10529,0,5054,9419,172,652,778,73,67,0,26744,171,15490,14712,9658,10529
2022-06-28 04:30:00+00,11194,0,5056,9494,174,596,863,76,320,0,27773,173,15907,15044,9988,11194
2022-06-28 05:00:00+00,11795,0,5057,9525,223,616,862,143,669,0,28890,176,16336,15474,10417,11795
2022-06-28 05:30:00+00,12836,0,5056,9670,245,544,856,410,1177,0,30794,180,17004,16148,11092,12836
2022-06-28 06:00:00+00,13426,0,5059,9700,382,652,856,456,1885,0,32416,180,17882,17026,11967,13426
2022-06-28 06:30:00+00,14032,0,5059,9782,366,534,858,428,2614,0,33673,178,18679,17821,12762,14032
2022-06-28 07:00:00+00,14156,0,5059,10061,322,320,858,407,3236,0,34419,173,19536,18678,13619,14156
2022-06-28 07:30:00+00,13850,0,5060,10363,318,202,828,298,3747,150,34816,165,20316,19488,14428,13850
2022-06-28 08:00:00+00,13831,0,5057,10764,244,312,860,183,3963,134,35348,163,20888,20028,14971,13831
2022-06-28 08:30:00+00,13642,0,5059,11297,242,292,847,98,4368,124,35969,157,21813,20966,15907,13642
2022-06-28 09:00:00+00,13783,0,5058,11943,217,210,724,90,4627,0,36652,154,22569,21845,16787,13783
2022-06-28 09:30:00+00,13817,0,5056,12364,210,184,603,85,4717,0,37036,152,22950,22347,17291,13817
2022-06-28 10:00:00+00,13845,0,5057,12510,221,196,603,85,4899,0,37416,151,23290,22687,17630,13845
2022-06-28 10:30:00+00,13877,0,5058,12543,222,222,683,128,4819,0,37552,152,23325,22642,17584,13877
2022-06-28 11:00:00+00,13957,0,5055,12798,184,222,763,150,5163,0,38292,150,23963,23200,18145,13957
2022-06-28 11:30:00+00,14025,0,5056,12728,159,144,652,192,5210,0,38166,150,23805,23153,18097,14025
2022-06-28 12:00:00+00,13160,0,5059,13134,142,370,540,186,5199,0,37790,145,24074,23534,18475,13160
2022-06-28 12:30:00+00,12463,0,5057,13392,139,398,524,138,5188,0,37299,139,24300,23776,18719,12463
2022-06-28 13:00:00+00,11909,0,5055,13810,138,568,529,140,5383,0,37532,135,24915,24386,19331,11909
2022-06-28 13:30:00+00,11728,0,5056,14566,153,574,555,132,5017,0,37781,132,25347,24792,19736,11728
2022-06-28 14:00:00+00,11693,0,5054,14841,170,578,551,87,4692,0,37666,132,25308,24757,19703,11693
2022-06-28 14:30:00+00,12015,0,5053,14973,172,606,563,89,4067,0,37538,136,24828,24265,19212,12015
2022-06-28 15:00:00+00,12641,0,5056,14764,231,592,548,115,3615,0,37562,142,24214,23666,18610,12641
2022-06-28 15:30:00+00,13260,0,5055,14731,234,710,714,113,3189,0,38006,149,23923,23209,18154,13260
2022-06-28 16:00:00+00,13414,0,5051,14434,305,356,880,169,2683,0,37292,150,23353,22473,17422,13414
2022-06-28 16:30:00+00,13470,0,5054,14044,342,276,883,600,2133,118,36920,155,22456,21573,16519,13470
2022-06-28 17:00:00+00,13532,0,5053,13800,341,58,886,751,1525,170,36116,158,21605,20719,15666,13532
2022-06-28 17:30:00+00,13634,0,5055,13851,315,0,887,768,1173,154,35837,159,21281,20394,15339,13634
2022-06-28 18:00:00+00,13840,0,5055,13603,323,0,887,773,777,6,35264,164,20645,19758,14703,13840
2022-06-28 18:30:00+00,13931,0,5057,13301,308,0,886,785,544,0,34812,167,20096,19210,14153,13931
2022-06-28 19:00:00+00,13974,0,5054,13090,261,0,885,812,331,98,34505,170,19621,18736,13682,13974
2022-06-28 19:30:00+00,13991,0,5057,12991,262,0,886,722,132,18,34059,171,19328,18442,13385,13991
2022-06-28 20:00:00+00,14319,0,5054,12883,261,0,884,606,9,0,34016,174,19091,18207,13153,14319
2022-06-28 20:30:00+00,14323,0,5058,12472,262,0,887,571,0,0,33574,176,18680,17792,12734,14323
2022-06-28 21:00:00+00,13837,0,5057,12405,248,0,885,449,0,0,32881,173,18595,17710,12653,13837
2022-06-28 21:30:00+00,13278,0,5052,12101,245,0,884,131,0,0,31691,170,18282,17398,12346,13278
2022-06-28 22:00:00+00,12729,0,5052,11927,230,0,883,102,0,0,30923,167,18092,17209,12157,12729
2022-06-28 22:30:00+00,11924,0,5050,11678,200,0,899,84,0,0,29835,162,17827,16928,11878,11924
2022-06-28 23:00:00+00,11787,0,5048,11486,165,0,907,79,0,0,29472,162,17606,16698,11650,11787
2022-06-28 23:30:00+00,11668,0,5050,11310,165,9,908,81,0,0,29191,162,17433,16525,11475,11668
2022-06-29 00:00:00+00,11455,0,5052,11145,149,18,926,80,0,0,28825,162,17272,16346,11294,11455
2022-06-29 00:30:00+00,11246,0,5051,10787,149,110,929,82,0,0,28354,163,16916,15987,10936,11246
2022-06-29 01:00:00+00,10845,0,5052,10288,156,278,944,87,0,0,27650,164,16440,15496,10444,10845
2022-06-29 01:30:00+00,10972,0,5050,9842,156,248,869,88,0,0,27225,168,15917,15048,9998,10972
2022-06-29 02:00:00+00,11532,0,5051,8844,123,260,940,93,0,0,26843,179,14958,14018,8967,11532
2022-06-29 02:30:00+00,11903,0,5049,8372,121,252,947,113,0,0,26757,185,14489,13542,8493,11903
2022-06-29 03:00:00+00,12254,0,5052,8397,121,318,948,107,0,0,27197,188,14518,13570,8518,12254
2022-06-29 03:30:00+00,12377,0,5051,8144,121,306,961,104,0,0,27064,191,14277,13316,8265,12377
2022-06-29 04:00:00+00,12007,0,5060,8143,120,268,1029,104,12,0,26743,187,14364,13335,8275,12007
2022-06-29 04:30:00+00,12304,8,5057,8004,127,360,1079,106,100,0,27145,191,14367,13288,8231,12312
2022-06-29 05:00:00+00,13020,30,5059,7703,163,554,1270,105,284,0,28188,199,14479,13209,8150,13050
2022-06-29 05:30:00+00,14324,177,5058,7409,179,576,1458,110,568,92,29951,208,14672,13214,8156,14501
2022-06-29 06:00:00+00,14446,450,5061,7278,316,916,1563,171,868,0,31069,211,15086,13523,8462,14896
2022-06-29 06:30:00+00,14857,679,5060,6908,343,832,1582,646,1377,282,32566,216,15270,13688,8628,15536
2022-06-29 07:00:00+00,15054,653,5061,6608,358,1028,1582,767,2184,736,34031,207,15793,14211,9150,15707
2022-06-29 07:30:00+00,15331,767,5061,6263,472,968,1580,769,2753,626,34590,208,16129,14549,9488,16098
2022-06-29 08:00:00+00,15113,798,5058,6150,421,1656,1581,546,3290,844,35457,205,16500,14919,9861,15911
2022-06-29 08:30:00+00,15513,832,5065,5926,316,1730,1571,290,3869,522,35634,208,16747,15176,10111,16345
2022-06-29 09:00:00+00,15587,751,5056,6180,237,1820,1580,298,4336,550,36395,203,17389,15809,10753,16338
2022-06-29 09:30:00+00,15985,740,5057,6175,261,1832,1578,307,4386,486,36807,205,17457,15879,10822,16725
2022-06-29 10:00:00+00,15954,802,5053,6162,238,2038,1577,294,5069,282,37469,205,18099,16522,11469,16756
2022-06-29 10:30:00+00,15676,830,5053,6445,197,2010,1575,441,6252,54,38533,198,19522,17947,12894,16506
2022-06-29 11:00:00+00,15643,830,5051,6775,157,1866,1583,360,6497,14,38776,196,20063,18480,13429,16473
2022-06-29 11:30:00+00,15470,788,5051,6911,135,1852,1591,284,6353,116,38551,194,20041,18450,13399,16258
2022-06-29 12:00:00+00,15452,653,5055,6866,250,1366,1593,316,6680,676,38907,181,20444,18851,13796,16105
2022-06-29 12:30:00+00,15664,638,5052,6850,312,1376,1592,337,6352,104,38277,186,20158,18566,13514,16302
2022-06-29 13:00:00+00,15812,607,5053,6885,236,1338,1593,326,5773,14,37637,189,19540,17947,12894,16419
2022-06-29 13:30:00+00,15911,600,5051,6645,175,1336,1582,349,5158,136,36943,194,18611,17029,11978,16511
2022-06-29 14:00:00+00,16359,603,5057,6268,242,1322,1487,488,4860,0,36686,201,17914,16427,11370,16962
2022-06-29 14:30:00+00,16592,785,5056,6026,236,1320,1472,736,4522,14,36759,210,17312,15840,10784,17377
2022-06-29 15:00:00+00,16507,825,5060,6077,351,1400,1460,874,3741,0,36295,215,16689,15229,10169,17332
2022-06-29 15:30:00+00,16606,808,5051,6026,362,1428,1461,912,3183,286,36123,217,16083,14622,9571,17414
2022-06-29 16:00:00+00,16675,648,5053,5812,322,1802,1467,961,3071,826,36637,215,15725,14258,9205,17323
2022-06-29 16:30:00+00,17102,667,5053,5315,336,1818,1435,943,2448,1056,36173,222,14587,13152,8099,17769
2022-06-29 17:00:00+00,16956,722,5053,4975,476,1702,1472,751,1999,980,35086,226,13975,12503,7450,17678
2022-06-29 17:30:00+00,17078,738,5058,4813,558,1702,1457,443,1483,1294,34624,230,13369,11912,6854,17816
2022-06-29 18:00:00+00,17238,801,5060,4442,558,1476,1412,662,994,1124,33767,240,12466,11054,5994,18039
2022-06-29 18:30:00+00,16724,737,5055,4327,522,1430,1389,595,624,1246,32649,239,11917,10528,5473,17461
2022-06-29 19:00:00+00,16518,724,5056,4224,445,1422,1385,683,283,1288,32028,241,11393,10008,4952,17242
2022-06-29 19:30:00+00,16101,703,5056,4110,439,1358,1388,773,95,1308,31331,240,11088,9700,4644,16804
2022-06-29 20:00:00+00,16590,626,5055,3963,404,1478,1388,720,4,658,30886,249,10814,9426,4371,17216
2022-06-29 20:30:00+00,16019,576,5052,3905,404,1554,1388,748,0,636,30282,246,10749,9361,4309,16595
2022-06-29 21:00:00+00,16272,524,5049,4128,372,1268,1492,694,0,560,30359,248,11041,9549,4500,16796
2022-06-29 21:30:00+00,16132,462,5054,3919,335,1262,1544,331,0,434,29473,248,10852,9308,4254,16594
2022-06-29 22:00:00+00,15327,491,5050,3737,269,1798,1541,351,0,0,28564,251,10597,9056,4006,15818
2022-06-29 22:30:00+00,15046,528,5049,3875,234,1990,1538,357,0,0,28617,251,10696,9158,4109,15574
2022-06-29 23:00:00+00,14766,633,5044,3236,111,1218,1509,190,0,0,26707,260,9900,8391,3347,15399
2022-06-29 23:30:00+00,14593,688,5047,3101,108,1120,1454,126,0,0,26237,262,9710,8256,3209,15281
2022-06-30 00:00:00+00,14924,638,5042,2892,108,870,1454,141,0,0,26069,270,9496,8042,3000,15562
2022-06-30 00:30:00+00,15239,731,5051,2721,108,844,1456,132,0,0,26282,276,9336,7880,2829,15970
2022-06-30 01:00:00+00,15051,648,5054,2754,108,756,1454,170,0,0,25995,273,9370,7916,2862,15699
2022-06-30 01:30:00+00,14991,605,5050,2588,109,750,1371,267,0,0,25731,274,9118,7747,2697,15596
2022-06-30 02:00:00+00,15327,728,5055,2465,94,774,1460,244,0,0,26147,280,9074,7614,2559,16055
2022-06-30 02:30:00+00,15252,732,5057,2242,91,778,1460,260,0,0,25872,282,8850,7390,2333,15984
2022-06-30 03:00:00+00,15324,737,5059,1688,77,874,1456,340,0,0,25555,288,8280,6824,1765,16061
2022-06-30 03:30:00+00,15261,731,5062,1648,136,904,1533,357,0,0,25632,286,8379,6846,1784,15992
2022-06-30 04:00:00+00,15609,730,5062,1617,175,1165,1538,191,34,0,26120,282,8426,6888,1826,16339
2022-06-30 04:30:00+00,15903,706,5061,1505,205,1352,1534,141,191,0,26597,282,8496,6962,1901,16609
2022-06-30 05:00:00+00,16359,604,5064,1348,283,1746,1440,175,546,0,27565,275,8681,7241,2177,16963
2022-06-30 05:30:00+00,16604,711,5063,1461,308,1737,1433,365,941,0,28623,273,9206,7773,2710,17315
2022-06-30 06:00:00+00,16297,525,5060,1336,526,1868,1434,632,1622,92,29391,256,9978,8544,3484,16822
2022-06-30 06:30:00+00,17329,460,5065,1131,440,1769,1302,914,2033,380,30823,255,9971,8669,3604,17789
2022-06-30 07:00:00+00,17090,526,5066,1157,447,1821,1162,787,2929,386,31371,247,10761,9599,4533,17616
2022-06-30 07:30:00+00,16795,641,5064,1213,447,1788,1175,770,3383,440,31716,243,11282,10107,5043,17436
2022-06-30 08:00:00+00,17004,632,5061,1138,387,2081,1192,759,3946,276,32476,242,11724,10532,5471,17636
2022-06-30 08:30:00+00,17065,643,5059,1008,401,2096,1329,683,4220,0,32503,243,12017,10688,5629,17708
2022-06-30 09:00:00+00,16948,725,5057,901,377,2213,1493,674,4764,0,33152,240,12592,11099,6042,17673
2022-06-30 09:30:00+00,17184,969,5056,906,340,2236,1470,489,5002,0,33651,245,12774,11304,6248,18153
2022-06-30 10:00:00+00,17043,981,5053,965,303,2374,1356,383,5129,0,33587,244,12806,11450,6397,18024
2022-06-30 10:30:00+00,17244,990,5050,1053,284,2385,1342,307,4970,0,33625,246,12699,11357,6307,18234
2022-06-30 11:00:00+00,17030,978,5049,1089,260,2726,1295,416,5783,18,34645,238,13476,12181,7132,18008
2022-06-30 11:30:00+00,16792,837,5046,1107,266,2758,1324,520,5672,36,34359,235,13415,12091,7045,17629
2022-06-30 12:00:00+00,17181,771,5051,1239,325,2532,1316,511,5508,44,34478,236,13439,12123,7072,17952
2022-06-30 12:30:00+00,16879,842,5051,1558,297,2582,1391,490,5887,132,35108,231,14184,12793,7742,17721
2022-06-30 13:00:00+00,17033,864,5052,1352,502,1737,1582,414,5220,136,33892,241,13708,12126,7074,17897
2022-06-30 13:30:00+00,17151,863,5052,1396,488,2454,1584,356,4676,6,34026,244,13196,11612,6560,18014
2022-06-30 14:00:00+00,17649,977,5049,1597,378,2214,1542,392,4433,164,34396,252,12999,11457,6408,18626
2022-06-30 14:30:00+00,17714,986,5045,1723,384,2268,1558,532,4004,424,34638,254,12714,11156,6111,18700
2022-06-30 15:00:00+00,17742,988,5048,2033,565,1712,1584,697,3534,870,34773,247,12764,11180,6132,18730
2022-06-30 15:30:00+00,18057,965,5043,2359,587,1676,1671,727,3433,820,35338,246,13093,11422,6379,19022
2022-06-30 16:00:00+00,17748,740,5047,2544,516,1766,1618,799,3255,1100,35133,239,12980,11362,6315,18488
2022-06-30 16:30:00+00,17908,700,5049,2515,523,1780,1692,814,2756,1616,35353,238,12535,10843,5794,18608
2022-06-30 17:00:00+00,18219,721,5050,2514,558,1560,1690,826,2279,1396,34813,243,12091,10401,5351,18940
2022-06-30 17:30:00+00,18122,762,5051,2454,555,1558,1643,729,1828,1398,34100,247,11531,9888,4837,18884
2022-06-30 18:00:00+00,17904,849,5049,2408,484,1514,1687,756,1341,1056,33048,257,10969,9282,4233,18753
2022-06-30 18:30:00+00,17701,851,5048,2315,539,1578,1662,680,905,1012,32291,261,10469,8807,3759,18552
2022-06-30 19:00:00+00,17665,814,5052,2290,538,1474,1712,658,520,782,31505,264,10112,8400,3348,18479
2022-06-30 19:30:00+00,17602,777,5051,2374,534,1474,1666,630,188,466,30762,268,9813,8147,3096,18379
2022-06-30 20:00:00+00,17662,690,5053,2355,460,1720,1835,605,13,26,30419,273,9716,7881,2828,18352
2022-06-30 20:30:00+00,17244,621,5050,2332,487,1740,1859,560,0,142,30035,268,9728,7869,2819,17865
2022-06-30 21:00:00+00,17422,947,5051,2452,446,1716,2067,410,0,140,30651,273,10016,7949,2898,18369
2022-06-30 21:30:00+00,17122,790,5055,2593,437,1656,1804,337,0,0,29794,270,9889,8085,3030,17912
2022-06-30 22:00:00+00,16665,820,5058,2685,337,1016,1853,328,0,0,28762,269,9933,8080,3022,17485
2022-06-30 22:30:00+00,16157,643,5052,2621,297,1110,1573,259,0,0,27712,266,9543,7970,2918,16800
2022-06-30 23:00:00+00,16016,711,5049,2424,249,866,1408,254,0,0,26977,276,9130,7722,2673,16727
2022-06-30 23:30:00+00,15888,729,5046,2426,229,856,1399,210,0,0,26783,277,9100,7701,2655,16617
2022-07-01 00:00:00+00,15871,689,5041,2436,207,576,1398,221,0,0,26439,279,9082,7684,2643,16560
2022-07-01 00:30:00+00,15893,536,5044,2461,207,544,1392,206,0,0,26283,275,9104,7712,2668,16429
2022-07-01 01:00:00+00,15678,469,5045,2584,207,504,1160,197,0,0,25844,273,8996,7836,2791,16147
2022-07-01 01:30:00+00,15629,480,5049,2465,206,504,1047,157,0,0,25537,275,8767,7720,2671,16109
2022-07-01 02:00:00+00,15902,477,5050,2298,188,504,1244,152,0,0,25815,277,8780,7536,2486,16379
2022-07-01 02:30:00+00,15865,473,5057,2253,189,504,1414,132,0,0,25887,276,8913,7499,2442,16338
2022-07-01 03:00:00+00,15964,706,5054,2315,193,504,1443,146,0,0,26325,281,9005,7562,2508,16670
2022-07-01 03:30:00+00,15685,782,5060,2613,192,504,1335,145,0,0,26316,279,9200,7865,2805,16467
2022-07-01 04:00:00+00,15578,615,5061,2714,193,504,1411,205,39,0,26320,273,9418,8007,2946,16193
2022-07-01 04:30:00+00,15819,644,5065,2761,214,504,1442,385,174,0,27008,272,9656,8214,3149,16463
2022-07-01 05:00:00+00,15243,715,5066,2849,264,516,1459,410,402,0,26924,268,10040,8581,3515,15958
2022-07-01 05:30:00+00,15395,687,5062,2900,302,568,1514,391,782,56,27657,263,10560,9046,3984,16082
2022-07-01 06:00:00+00,16205,681,5067,3031,460,838,1511,713,1302,422,30230,253,11371,9860,4793,16886
2022-07-01 06:30:00+00,16726,770,5061,3029,463,774,1439,810,1925,778,31775,248,11917,10478,5417,17496
2022-07-01 07:00:00+00,16606,868,5066,2928,488,1612,1545,827,2817,678,33435,243,12844,11299,6233,17474
2022-07-01 07:30:00+00,16534,735,5066,2992,426,1636,1599,832,3380,650,33850,235,13463,11864,6798,17269
2022-07-01 08:00:00+00,16643,687,5061,3180,450,1610,1687,644,4042,648,34652,231,14420,12733,7672,17330
2022-07-01 08:30:00+00,16457,707,5060,3374,462,1568,1683,700,4568,742,35321,225,15147,13464,8404,17164
2022-07-01 09:00:00+00,16620,808,5059,3497,471,1102,1914,575,5145,364,35555,224,16086,14172,9113,17428
2022-07-01 09:30:00+00,16632,725,5059,3702,473,1100,1833,409,5364,352,35649,219,16431,14598,9539,17357
2022-07-01 10:00:00+00,16618,749,5057,3827,372,978,2058,391,5295,214,35559,219,16609,14551,9494,17367
2022-07-01 10:30:00+00,16357,838,5064,3950,375,1056,2133,445,5449,0,35667,219,16971,14838,9774,17195
2022-07-01 11:00:00+00,16165,753,5062,4289,387,1328,1981,356,5857,0,36178,214,17576,15595,10533,16918
2022-07-01 11:30:00+00,16232,764,5054,4316,368,1404,1818,273,5440,0,35669,217,16996,15178,10124,16996
2022-07-01 12:00:00+00,16047,608,5060,4390,363,1560,1760,276,5276,0,35340,216,16849,15089,10029,16655
2022-07-01 12:30:00+00,15898,461,5056,4312,294,1566,1652,249,5568,0,35056,212,16882,15230,10174,16359
2022-07-01 13:00:00+00,15815,460,5057,4545,282,1197,1762,231,5719,0,35068,212,17365,15603,10546,16275
2022-07-01 13:30:00+00,15081,464,5053,4840,282,1135,1749,187,4962,0,33753,211,16886,15137,10084,15545
2022-07-01 14:00:00+00,15427,463,5054,5095,283,780,1577,243,4824,4,33750,211,16833,15256,10202,15890
2022-07-01 14:30:00+00,15375,473,5049,5465,286,782,1619,273,4870,18,34210,208,17289,15670,10621,15848
2022-07-01 15:00:00+00,15556,462,5056,5843,299,668,1754,324,4075,0,34037,209,17027,15273,10217,16018
2022-07-01 15:30:00+00,15497,462,5057,6261,395,698,1835,316,3583,0,34104,208,17131,15296,10239,15959
2022-07-01 16:00:00+00,15020,450,5054,7191,453,1090,1878,390,3183,112,34821,199,17759,15881,10827,15470
2022-07-01 16:30:00+00,14914,217,5052,7521,462,1140,1813,459,2908,634,35120,190,17756,15943,10891,15131
2022-07-01 17:00:00+00,15692,108,5053,7335,504,1292,1881,500,2113,456,34935,199,16886,15005,9952,15800
2022-07-01 17:30:00+00,15968,0,5056,6766,489,1280,1973,499,1703,264,33998,205,15987,14014,8958,15968
2022-07-01 18:00:00+00,15778,0,5054,6918,489,986,2032,577,1133,322,33289,207,15626,13594,8540,15778
2022-07-01 18:30:00+00,15915,0,5059,6833,485,924,2118,483,752,196,32765,211,15247,13129,8070,15915
2022-07-01 19:00:00+00,15744,0,5057,7222,404,680,2134,517,358,316,32432,211,15175,13041,7984,15744
2022-07-01 19:30:00+00,15741,0,5059,7215,381,634,2136,460,130,344,32100,213,14921,12785,7726,15741
2022-07-01 20:00:00+00,15946,0,5060,6969,301,504,2136,405,11,34,31366,220,14477,12341,7281,15946
2022-07-01 20:30:00+00,15573,0,5061,6851,256,504,2138,286,0,28,30697,219,14306,12168,7107,15573
2022-07-01 21:00:00+00,15664,0,5063,6804,270,504,2138,213,0,142,30798,218,14275,12137,7074,15664
2022-07-01 21:30:00+00,15277,0,5061,6973,279,504,1980,127,0,16,30217,216,14293,12313,7252,15277
2022-07-01 22:00:00+00,14508,0,5069,7230,200,442,1907,118,0,0,29474,210,14406,12499,7430,14508
2022-07-01 22:30:00+00,13350,0,5069,7803,188,294,1557,139,0,0,28400,198,14617,13060,7991,13350
2022-07-01 23:00:00+00,13082,0,5064,8101,159,160,1365,120,0,0,28051,193,14689,13324,8260,13082
2022-07-01 23:30:00+00,12490,0,5059,8247,150,136,1330,122,0,0,27534,188,14786,13456,8397,12490
2022-07-02 00:00:00+00,12142,0,5057,8261,134,170,1414,115,0,0,27293,186,14866,13452,8395,12142
2022-07-02 00:30:00+00,11762,0,5050,8049,133,322,1448,119,0,0,26883,186,14680,13232,8182,11762
2022-07-02 01:00:00+00,11644,0,5055,8070,121,308,1356,115,0,0,26669,185,14602,13246,8191,11644
2022-07-02 01:30:00+00,11364,0,5053,8022,117,294,1346,118,0,0,26314,183,14538,13192,8139,11364
2022-07-02 02:00:00+00,11381,0,5057,7393,114,296,1430,120,0,0,25791,187,13994,12564,7507,11381
2022-07-02 02:30:00+00,11656,0,5059,7340,113,262,1397,121,0,0,25948,189,13909,12512,7453,11656
2022-07-02 03:00:00+00,11424,0,5063,7580,113,334,1377,117,0,0,26008,187,14133,12756,7693,11424
2022-07-02 03:30:00+00,11089,0,5063,7485,113,314,1343,121,0,0,25528,185,14004,12661,7598,11089
2022-07-02 04:00:00+00,11275,0,5065,7080,115,290,1381,121,46,0,25373,188,13687,12306,7241,11275
2022-07-02 04:30:00+00,11555,0,5065,6880,158,354,1448,124,254,0,25838,191,13805,12357,7292,11555
2022-07-02 05:00:00+00,11679,0,5069,7197,197,240,1431,116,513,0,26442,186,14407,12976,7907,11679
2022-07-02 05:30:00+00,11686,0,5067,7497,204,270,1444,142,894,0,27204,182,15106,13662,8595,11686
2022-07-02 06:00:00+00,10878,0,5068,7801,304,260,1210,160,1404,118,27203,169,15787,14577,9509,10878
2022-07-02 06:30:00+00,11445,0,5071,8187,316,148,1199,187,1949,0,28502,167,16722,15523,10452,11445
2022-07-02 07:00:00+00,11246,0,5066,8430,284,624,1224,143,2451,32,29500,165,17455,16231,11165,11246
2022-07-02 07:30:00+00,11484,0,5068,8880,315,640,1221,148,3032,0,30788,162,18516,17295,12227,11484
2022-07-02 08:00:00+00,11041,0,5066,9072,274,1374,1189,133,3494,48,31691,157,19095,17906,12840,11041
2022-07-02 08:30:00+00,11212,0,5067,9170,275,1430,1199,119,3637,0,32109,157,19348,18149,13082,11212
2022-07-02 09:00:00+00,10571,0,5061,9223,255,2028,1130,127,3931,0,32326,148,19600,18470,13409,10571
2022-07-02 09:30:00+00,10527,0,5058,9387,256,2112,1113,127,4580,0,33160,144,20394,19281,14223,10527
2022-07-02 10:00:00+00,10374,0,5058,9303,223,2480,976,133,4809,0,33356,140,20369,19393,14335,10374
2022-07-02 10:30:00+00,9853,0,5064,9473,188,2526,937,115,5619,0,33775,132,21281,20344,15280,9853
2022-07-02 11:00:00+00,9427,0,5059,9424,181,2590,954,115,5383,0,33133,130,21001,20047,14988,9427
2022-07-02 11:30:00+00,9478,0,5058,9175,171,2590,969,124,5253,0,32818,132,20626,19657,14599,9478
2022-07-02 12:00:00+00,9596,0,5054,8996,148,2570,952,115,5594,0,33025,132,20744,19792,14738,9596
2022-07-02 12:30:00+00,9364,0,5049,8921,132,2520,937,109,5731,0,32763,130,20770,19833,14784,9364
2022-07-02 13:00:00+00,9666,0,5050,9187,132,1708,967,122,4989,0,31821,135,20325,19358,14308,9666
2022-07-02 13:30:00+00,9857,0,5054,9251,132,1524,939,108,4852,0,31717,137,20228,19289,14235,9857
2022-07-02 14:00:00+00,11231,0,5052,9045,132,434,963,121,4676,0,31654,145,19868,18905,13853,11231
2022-07-02 14:30:00+00,11816,0,5054,8763,149,352,954,117,4196,0,31401,153,19116,18162,13108,11816
2022-07-02 15:00:00+00,12430,0,5055,8890,225,72,958,127,3854,0,31611,161,18982,18024,12969,12430
2022-07-02 15:30:00+00,12988,0,5056,8698,260,224,1237,194,3618,16,32291,168,18869,17632,12576,12988
2022-07-02 16:00:00+00,13092,0,5063,8616,314,486,1502,272,3285,18,32648,171,18780,17278,12215,13092
2022-07-02 16:30:00+00,13347,0,5059,8597,306,534,1466,390,3048,98,32845,174,18476,17010,11951,13347
2022-07-02 17:00:00+00,13217,0,5063,8681,379,906,1461,368,2683,340,33098,171,18267,16806,11743,13217
2022-07-02 17:30:00+00,13294,0,5058,8086,382,1052,1467,277,2076,778,32470,175,17069,15602,10544,13294
2022-07-02 18:00:00+00,13453,0,5063,7567,395,1498,1456,264,1421,744,31861,182,15902,14446,9383,13453
2022-07-02 18:30:00+00,13319,0,5061,7461,436,1542,1459,284,896,704,31162,184,15313,13854,8793,13319
2022-07-02 19:00:00+00,13299,0,5059,7407,382,1594,1469,363,548,820,30941,186,14865,13396,8337,13299
2022-07-02 19:30:00+00,14086,0,5060,6490,381,1602,1468,359,188,770,30404,200,13587,12119,7059,14086
2022-07-02 20:00:00+00,14150,0,5060,6040,376,1602,1471,568,19,668,29954,206,12966,11495,6435,14150
2022-07-02 20:30:00+00,14149,0,5061,5915,363,1602,1464,664,0,432,29650,209,12803,11339,6278,14149
2022-07-02 21:00:00+00,14109,0,5058,5825,350,1602,1500,700,0,146,29290,212,12733,11233,6175,14109
2022-07-02 21:30:00+00,13715,0,5054,5641,332,1578,1401,545,0,242,28508,210,12428,11027,5973,13715
2022-07-02 22:00:00+00,13386,0,5063,5534,260,1350,1131,322,0,266,27312,210,11988,10857,5794,13386
2022-07-02 22:30:00+00,12659,0,5063,5749,253,1290,1026,268,0,10,26318,206,12091,11065,6002,12659
2022-07-02 23:00:00+00,12484,0,5065,5401,256,922,1218,220,0,238,25804,208,11940,10722,5657,12484
2022-07-02 23:30:00+00,12537,0,5061,4992,256,880,1508,212,0,0,25446,213,11817,10309,5248,12537
2022-07-03 00:00:00+00,12523,0,5054,4622,198,952,1526,160,0,0,25035,216,11400,9874,4820,12523
2022-07-03 00:30:00+00,12505,0,5044,4523,163,926,1463,145,0,0,24769,217,11193,9730,4686,12505
2022-07-03 01:00:00+00,12488,0,5049,4571,162,602,1521,143,0,0,24536,219,11303,9782,4733,12488
2022-07-03 01:30:00+00,12229,0,5045,4508,128,560,1526,149,0,0,24145,219,11207,9681,4636,12229
2022-07-03 02:00:00+00,11867,0,5051,4738,128,506,1530,145,0,0,23965,214,11447,9917,4866,11867
2022-07-03 02:30:00+00,11362,0,5054,4504,127,504,1528,174,0,0,23253,213,11213,9685,4631,11362
2022-07-03 03:00:00+00,11152,0,5058,4490,100,504,1528,481,0,0,23313,212,11176,9648,4590,11152
2022-07-03 03:30:00+00,11140,0,5059,4639,74,504,1522,512,0,0,23450,211,11294,9772,4713,11140
2022-07-03 04:00:00+00,11181,0,5053,4570,72,504,1530,518,34,0,23462,212,11259,9729,4676,11181
2022-07-03 04:30:00+00,11181,0,5059,4461,72,504,1529,337,207,0,23350,211,11328,9799,4740,11181
2022-07-03 05:00:00+00,11164,0,5061,4499,103,504,1529,127,500,0,23487,207,11692,10163,5102,11164
2022-07-03 05:30:00+00,11087,0,5063,4532,106,492,1528,113,950,0,23871,202,12179,10651,5588,11087
2022-07-03 06:00:00+00,11007,0,5066,4529,179,420,1527,152,1596,0,24476,194,12897,11370,6304,11007
2022-07-03 06:30:00+00,11001,0,5062,4633,188,330,1524,227,2151,0,25116,188,13558,12034,6972,11001
2022-07-03 07:00:00+00,10788,0,5063,4630,203,1106,1418,153,2848,0,26209,186,14162,12744,7681,10788
2022-07-03 07:30:00+00,10781,0,5060,4599,198,1218,1409,120,3238,0,26623,184,14504,13095,8035,10781
2022-07-03 08:00:00+00,10102,0,5061,4831,207,2368,1251,118,3730,0,27668,171,15080,13829,8768,10102
2022-07-03 08:30:00+00,10838,0,5060,4787,199,2474,1231,115,4342,0,29046,173,15619,14388,9328,10838
2022-07-03 09:00:00+00,11137,0,5063,5020,179,3074,1260,110,4713,0,30556,169,16235,14975,9912,11137
2022-07-03 09:30:00+00,11026,0,5055,5394,181,3132,1101,111,4845,0,30845,165,16576,15475,10420,11026
2022-07-03 10:00:00+00,10975,0,5051,5486,133,3234,944,116,5262,0,31201,161,16876,15932,10881,10975
2022-07-03 10:30:00+00,11317,0,5051,5481,120,3246,941,116,5549,0,31821,162,17142,16201,11150,11317
2022-07-03 11:00:00+00,11547,0,5051,5492,104,3024,956,122,5576,0,31872,165,17179,16223,11172,11547
2022-07-03 11:30:00+00,11321,0,5056,5839,101,2976,950,114,5738,0,32095,161,17684,16734,11678,11321
2022-07-03 12:00:00+00,10985,0,5058,6232,82,2708,950,116,5480,0,31611,159,17802,16852,11794,10985
2022-07-03 12:30:00+00,10248,0,5062,6655,76,2646,940,111,5564,0,31302,151,18297,17357,12295,10248
2022-07-03 13:00:00+00,10815,0,5054,6712,75,2336,968,121,5025,0,31106,160,17834,16866,11812,10815
2022-07-03 13:30:00+00,11205,0,5060,6864,73,2286,948,112,5288,0,31836,161,18233,17285,12225,11205
2022-07-03 14:00:00+00,11429,0,5057,6967,72,2058,969,123,5220,0,31895,164,18285,17316,12259,11429
2022-07-03 14:30:00+00,11577,0,5061,6800,76,2078,946,195,5243,0,31976,167,18126,17180,12119,11577
2022-07-03 15:00:00+00,12311,0,5061,7108,143,1224,1048,306,4890,0,32091,173,18250,17202,12141,12311
2022-07-03 15:30:00+00,12302,46,5058,7472,162,1216,1161,324,4288,0,32029,175,18141,16980,11922,12348
2022-07-03 16:00:00+00,12954,92,5052,7477,193,642,1401,366,4014,90,32281,175,18137,16736,11684,13046
2022-07-03 16:30:00+00,13101,216,5048,7696,189,684,1789,409,3614,360,33106,177,18336,16547,11499,13317
2022-07-03 17:00:00+00,13505,236,5052,7596,220,1166,1857,604,2920,386,33542,184,17645,15788,10736,13741
2022-07-03 17:30:00+00,13476,238,5052,7763,274,1192,1850,675,2233,322,33075,186,17172,15322,10270,13714
2022-07-03 18:00:00+00,13605,236,5050,7935,277,1408,1855,694,1649,298,33007,189,16766,14911,9861,13841
2022-07-03 18:30:00+00,13769,245,5046,7607,285,1428,1868,615,1058,444,32365,195,15864,13996,8950,14014
2022-07-03 19:00:00+00,14033,231,5048,7414,275,1310,1851,474,533,522,31691,200,15121,13270,8222,14264
2022-07-03 19:30:00+00,14004,229,5048,7284,272,1270,1840,542,164,176,30829,207,14608,12768,7720,14233
2022-07-03 20:00:00+00,14049,230,5046,7375,246,980,1841,603,11,52,30433,211,14519,12678,7632,14279
2022-07-03 20:30:00+00,13945,230,5051,7733,243,940,1803,488,0,0,30433,208,14830,13027,7976,14175
2022-07-03 21:00:00+00,13766,230,5049,7826,187,538,1546,234,0,0,29376,209,14608,13062,8013,13996
2022-07-03 21:30:00+00,12769,226,5041,7764,185,440,1541,188,0,0,28154,202,14531,12990,7949,12995
2022-07-03 22:00:00+00,12405,0,5044,7878,192,458,1254,205,0,0,27436,194,14368,13114,8070,12405
2022-07-03 22:30:00+00,11256,0,5047,8394,198,504,964,150,0,0,26513,182,14603,13639,8592,11256
2022-07-03 23:00:00+00,10960,0,5050,8965,111,504,951,128,0,0,26669,176,15077,14126,9076,10960
2022-07-03 23:30:00+00,10339,0,5056,9454,105,504,941,107,0,0,26506,168,15556,14615,9559,10339
2022-07-04 00:00:00+00,10075,0,5049,9781,90,504,938,111,0,0,26548,164,15858,14920,9871,10075
2022-07-04 00:30:00+00,9485,0,5053,10257,90,502,939,102,0,0,26428,156,16339,15400,10347,9485
2022-07-04 01:00:00+00,9284,0,5040,10254,90,392,937,107,0,0,26104,153,16321,15384,10344,9284
2022-07-04 01:30:00+00,9528,0,5039,10171,90,398,939,99,0,0,26264,155,16239,15300,10261,9528
2022-07-04 02:00:00+00,9238,0,5008,10487,74,266,941,106,0,0,26120,150,16510,15569,10561,9238
2022-07-04 02:30:00+00,9358,0,4993,10259,74,258,941,106,0,0,25989,152,16267,15326,10333,9358
2022-07-04 03:00:00+00,9402,0,4994,10085,74,200,942,129,0,0,25826,153,16095,15153,10159,9402
2022-07-04 03:30:00+00,9196,0,4996,10191,74,148,941,113,0,0,25659,150,16202,15261,10265,9196
2022-07-04 04:00:00+00,9321,0,4993,10227,74,292,941,110,27,0,25985,152,16262,15321,10328,9321
2022-07-04 04:30:00+00,9823,0,4999,10134,76,318,952,113,166,0,26581,157,16327,15375,10376,9823
2022-07-04 05:00:00+00,9924,0,5000,10413,102,286,1047,122,467,0,27361,154,17029,15982,10982,9924
2022-07-04 05:30:00+00,10499,0,5002,10727,113,434,1513,119,874,0,29281,156,18229,16716,11714,10499
2022-07-04 06:00:00+00,10781,0,5000,10869,183,598,2093,122,1402,26,31074,155,19547,17454,12454,10781
2022-07-04 06:30:00+00,11563,0,5002,10872,199,636,2171,183,1880,58,32564,159,20124,17953,12951,11563
2022-07-04 07:00:00+00,11642,0,5006,11034,272,1124,2187,203,2613,0,34081,160,21112,18925,13919,11642
2022-07-04 07:30:00+00,11508,0,5002,11580,276,1156,2191,211,3117,82,35123,154,22166,19975,14973,11508
2022-07-04 08:00:00+00,11786,0,5004,11739,275,1254,2186,194,3644,16,36098,154,22848,20662,15658,11786
2022-07-04 08:30:00+00,11937,0,5001,11597,271,1182,2183,179,3910,170,36430,153,22962,20779,15778,11937
2022-07-04 09:00:00+00,11948,0,5004,11777,216,1356,2182,405,4223,42,37153,154,23402,21220,16216,11948
2022-07-04 09:30:00+00,11831,0,5004,12070,213,1318,2109,621,5217,0,38383,149,24613,22504,17500,11831
2022-07-04 10:00:00+00,11883,0,4998,12242,163,1220,1944,623,5585,0,38658,147,24932,22988,17990,11883
2022-07-04 10:30:00+00,11758,0,5007,12578,160,1066,1953,600,5636,0,38758,143,25334,23381,18374,11758
2022-07-04 11:00:00+00,11737,0,5009,12737,137,888,1957,580,6140,0,39185,139,25980,24023,19014,11737
2022-07-04 11:30:00+00,11754,0,4999,12688,136,816,1983,353,6050,88,38867,138,25856,23873,18874,11754
2022-07-04 12:00:00+00,11127,0,5002,12596,124,1016,1938,133,5846,54,37836,136,25506,23568,18566,11127
2022-07-04 12:30:00+00,10855,0,5006,12714,122,998,1925,110,5931,4,37665,133,25698,23773,18767,10855
2022-07-04 13:00:00+00,10821,0,5003,12767,105,1098,1930,109,5953,0,37786,134,25758,23828,18825,10821
2022-07-04 13:30:00+00,10658,0,5000,12957,104,1134,1926,103,5803,0,37685,133,25790,23864,18864,10658
2022-07-04 14:00:00+00,10825,0,5001,12816,106,1088,2019,102,5541,0,37498,136,25483,23464,18463,10825
2022-07-04 14:30:00+00,11092,0,4998,12738,107,1142,2143,114,5014,20,37368,140,25000,22857,17859,11092
2022-07-04 15:00:00+00,11552,0,5001,12786,190,812,2151,111,4870,0,37473,140,24998,22847,17846,11552
2022-07-04 15:30:00+00,12224,0,5002,12521,196,960,2167,137,4480,0,37687,148,24366,22199,17197,12224
2022-07-04 16:00:00+00,12322,0,4990,12252,307,1228,2168,142,4078,114,37601,152,23795,21627,16637,12322
2022-07-04 16:30:00+00,13182,0,4958,11898,273,1212,2170,138,3342,36,37209,163,22641,20471,15513,13182
2022-07-04 17:00:00+00,13110,0,4961,11544,274,1336,2169,210,2727,0,36331,163,21675,19506,14545,13110
2022-07-04 17:30:00+00,13092,0,4960,11179,275,1520,2173,254,2147,132,35732,168,20734,18561,13601,13092
2022-07-04 18:00:00+00,13064,0,4957,10791,282,1950,2173,307,1547,438,35509,171,19750,17577,12620,13064
2022-07-04 18:30:00+00,13344,0,4958,10385,282,2010,2174,320,952,382,34807,178,18751,16577,11619,13344
2022-07-04 19:00:00+00,13462,0,4958,9827,281,1690,2175,418,462,400,33673,181,17703,15528,10570,13462
2022-07-04 19:30:00+00,13206,0,4956,9512,279,1700,2176,430,150,394,32803,183,17073,14897,9941,13206
2022-07-04 20:00:00+00,13244,0,4959,9449,259,1540,2174,296,13,110,32044,182,16854,14680,9721,13244
2022-07-04 20:30:00+00,13038,0,4960,9185,237,1494,2176,241,0,26,31357,183,16558,14382,9422,13038
2022-07-04 21:00:00+00,13136,0,4961,9177,226,1312,2176,239,0,28,31255,187,16540,14364,9403,13136
2022-07-04 21:30:00+00,11941,0,4963,9147,223,1102,2173,223,0,0,29772,179,16506,14333,9370,11941
2022-07-04 22:00:00+00,11560,0,4963,8976,184,242,1994,163,0,56,28138,174,16117,14123,9160,11560
2022-07-04 22:30:00+00,10963,0,4963,9041,156,156,1714,106,0,0,27099,170,15874,14160,9197,10963
2022-07-04 23:00:00+00,11044,0,4959,8795,109,146,2043,106,0,0,27202,173,15906,13863,8904,11044
2022-07-04 23:30:00+00,10572,0,4965,8756,103,78,2039,112,0,0,26625,168,15863,13824,8859,10572
2022-07-05 00:00:00+00,10457,0,4968,8375,98,192,2117,110,0,0,26317,171,15558,13441,8473,10457
2022-07-05 00:30:00+00,10512,0,4967,8081,98,180,2168,112,0,0,26118,173,15314,13146,8179,10512
2022-07-05 01:00:00+00,10986,0,4966,7661,82,264,2177,114,0,0,26250,181,14886,12709,7743,10986
2022-07-05 01:30:00+00,11328,0,4963,7458,80,192,2177,108,0,0,26306,185,14678,12501,7538,11328
2022-07-05 02:00:00+00,11457,0,4953,7450,65,172,2179,109,0,0,26385,186,14647,12468,7515,11457
2022-07-05 02:30:00+00,11632,0,4951,7229,62,150,2181,120,0,0,26325,189,14423,12242,7291,11632
2022-07-05 03:00:00+00,11773,0,4956,6697,62,246,2181,209,0,0,26124,195,13896,11715,6759,11773
2022-07-05 03:30:00+00,11881,0,4956,6393,62,184,2179,231,0,0,25886,197,13590,11411,6455,11881
2022-07-05 04:00:00+00,11852,0,4957,6117,72,108,2175,139,28,0,25448,198,13349,11174,6217,11852
2022-07-05 04:30:00+00,12658,8,4958,5606,102,184,2174,109,195,0,25994,207,13035,10861,5903,12666
2022-07-05 05:00:00+00,13579,16,4960,5424,133,264,1879,105,512,14,26886,213,12908,11029,6069,13595
2022-07-05 05:30:00+00,14391,37,4958,5551,191,370,1926,137,944,102,28607,213,13570,11644,6686,14428
2022-07-05 06:00:00+00,14715,182,4962,5594,370,836,2135,275,1478,0,30547,212,14539,12404,7442,14897
2022-07-05 06:30:00+00,14632,497,4958,5527,432,880,1959,444,2111,600,32040,211,14987,13028,8070,15129
2022-07-05 07:00:00+00,14782,763,4964,5701,457,1674,1960,457,2728,450,33936,214,15810,13850,8886,15545
2022-07-05 07:30:00+00,15186,698,4963,5446,424,1708,1966,404,3344,234,34373,213,16143,14177,9214,15884
2022-07-05 08:00:00+00,15827,697,4963,5077,422,2318,1988,231,3738,452,35713,215,16188,14200,9237,16524
2022-07-05 08:30:00+00,16180,855,4968,4922,425,2348,1957,173,4138,242,36208,219,16410,14453,9485,17035
2022-07-05 09:00:00+00,16187,982,4967,4762,407,2314,1928,176,4510,106,36339,223,16574,14646,9679,17169
2022-07-05 09:30:00+00,16193,932,4968,4516,411,2314,1954,135,4903,44,36370,221,16752,14798,9830,17125
2022-07-05 10:00:00+00,15931,755,4969,4255,367,2388,1948,167,5315,136,36231,214,16854,14906,9937,16686
2022-07-05 10:30:00+00,15894,708,4891,4043,363,2398,1998,260,5631,136,36322,213,16926,14928,10037,16602
2022-07-05 11:00:00+00,15662,705,4864,4024,355,2398,2051,307,5866,136,36368,210,17160,15109,10245,16367
2022-07-05 11:30:00+00,15319,782,4857,4105,353,2400,2053,307,6104,136,36416,208,17472,15419,10562,16101
2022-07-05 12:00:00+00,15897,661,4858,4280,354,2400,1989,280,6107,216,37042,208,17588,15599,10741,16558
2022-07-05 12:30:00+00,15903,776,4860,4359,178,2432,1906,257,5694,14,36379,214,16997,15091,10231,16679
2022-07-05 13:00:00+00,15931,727,4864,4218,167,2444,1905,139,5467,70,35932,217,16621,14716,9852,16658
2022-07-05 13:30:00+00,15827,890,4867,4146,169,2480,1919,238,5348,62,35946,222,16449,14530,9663,16717
2022-07-05 14:00:00+00,15366,977,4865,4120,185,2640,1924,254,5242,24,35597,222,16336,14412,9547,16343
2022-07-05 14:30:00+00,15697,932,4862,4044,331,2644,2029,207,4966,26,35738,223,16232,14203,9341,16629
2022-07-05 15:00:00+00,15499,892,4867,4056,406,2570,2066,295,4506,288,35445,222,15901,13835,8968,16391
2022-07-05 15:30:00+00,15765,816,4865,3606,472,2676,2198,527,4133,392,35450,227,15274,13076,8211,16581
2022-07-05 16:00:00+00,15232,800,4873,3390,520,2590,2359,854,3620,1074,35312,224,14762,12403,7530,16032
2022-07-05 16:30:00+00,15568,826,4869,3240,523,2694,2479,902,3197,1138,35436,230,14308,11829,6960,16394
2022-07-05 17:00:00+00,15460,805,4873,3108,533,2886,2474,910,2701,1260,35010,234,13689,11215,6342,16265
2022-07-05 17:30:00+00,15642,782,4873,3039,564,2876,2475,882,2194,1260,34587,238,13145,10670,5797,16424
2022-07-05 18:00:00+00,15691,767,4879,2999,565,2594,2471,942,1528,1346,33782,242,12442,9971,5092,16458
2022-07-05 18:30:00+00,15839,787,4874,2936,560,2576,2474,861,1028,1264,33199,248,11872,9398,4524,16626
2022-07-05 19:00:00+00,15700,877,4870,2857,519,2584,2390,800,533,1260,32390,254,11169,8779,3909,16577
2022-07-05 19:30:00+00,15463,894,4871,2792,505,2476,2173,849,164,1256,31443,257,10505,8332,3461,16357
2022-07-05 20:00:00+00,16137,953,4869,2894,429,1762,2174,918,13,1026,31175,259,10379,8205,3336,17090
2022-07-05 20:30:00+00,15704,889,4857,3251,378,1762,2174,823,0,888,30726,253,10660,8486,3629,16593
2022-07-05 21:00:00+00,15650,896,4785,3595,271,1864,2083,673,0,582,30399,255,10734,8651,3866,16546
2022-07-05 21:30:00+00,15120,917,4772,4160,263,1864,1729,397,0,318,29540,251,10924,9195,4423,16037
2022-07-05 22:00:00+00,13851,953,4774,4898,206,1700,1902,214,0,128,28626,239,11780,9878,5104,14804
2022-07-05 22:30:00+00,12421,857,4769,5101,161,1642,2087,288,0,10,27336,228,12118,10031,5262,13278
2022-07-05 23:00:00+00,12006,783,4771,5367,146,1488,2108,208,0,26,26903,219,12392,10284,5513,12789
2022-07-05 23:30:00+00,11345,578,4772,5864,145,1524,2174,132,0,0,26534,205,12955,10781,6009,11923
2022-07-06 00:00:00+00,10865,324,4770,6266,155,1670,2169,126,0,0,26346,193,13360,11192,6422,11189
2022-07-06 00:30:00+00,10273,390,4773,6797,155,1760,2169,128,0,0,26445,187,13894,11725,6952,10663
2022-07-06 01:00:00+00,9955,291,4778,7612,69,1762,2171,123,0,0,26761,177,14630,12459,7681,10246
2022-07-06 01:30:00+00,9670,230,4778,8027,68,1666,2111,122,0,0,26672,170,14984,12873,8095,9900
2022-07-06 02:00:00+00,9609,231,4776,8549,50,1306,1928,121,0,0,26570,169,15303,13375,8599,9840
2022-07-06 02:30:00+00,9411,235,4770,8573,50,1274,1927,123,0,0,26363,168,15320,13393,8623,9646
2022-07-06 03:00:00+00,9761,259,4766,8648,48,902,1928,118,0,0,26430,174,15390,13462,8696,10020
2022-07-06 03:30:00+00,10001,235,4766,8449,46,862,1925,112,0,0,26396,177,15186,13261,8495,10236
2022-07-06 04:00:00+00,10253,298,4769,8428,46,782,1923,212,9,0,26720,180,15175,13252,8483,10551
2022-07-06 04:30:00+00,10442,326,4774,8577,46,828,1924,413,111,0,27441,182,15432,13508,8734,10768
2022-07-06 05:00:00+00,10729,300,4778,8981,86,1274,1918,451,314,0,28831,177,16077,14159,9381,11029
2022-07-06 05:30:00+00,10994,381,4775,9284,99,1322,1926,488,597,0,29866,178,16681,14755,9980,11375
2022-07-06 06:00:00+00,10859,636,4776,9230,174,1712,1921,474,945,0,30727,179,17046,15125,10349,11495
2022-07-06 06:30:00+00,11422,873,4779,9494,175,1700,1920,644,1237,0,32244,185,17605,15685,10906,12295
2022-07-06 07:00:00+00,11762,976,4777,9814,170,1806,1922,564,1709,0,33500,186,18392,16470,11693,12738
2022-07-06 07:30:00+00,11665,982,4749,10273,154,1788,1917,558,2329,0,34415,180,19422,17505,12756,12647
2022-07-06 08:00:00+00,11377,978,4745,10743,152,1658,1920,599,2879,102,35153,172,20439,18519,13774,12355
2022-07-06 08:30:00+00,11190,980,4752,10949,152,1684,1936,566,3239,118,35566,168,21028,19092,14340,12170
2022-07-06 09:00:00+00,11245,977,4600,11373,139,1518,1946,688,3556,172,36214,167,21614,19668,15068,12222
2022-07-06 09:30:00+00,11246,985,4598,11609,134,1452,1957,781,3933,0,36695,166,22231,20274,15676,12231
2022-07-06 10:00:00+00,11303,979,4596,11643,81,1354,1963,712,4221,94,36946,168,22504,20541,15945,12282
2022-07-06 10:30:00+00,11203,938,4596,11959,67,1310,1959,644,4508,0,37184,164,23089,21130,16534,12141
2022-07-06 11:00:00+00,11137,816,4596,12184,82,1982,1952,526,4555,0,37830,164,23369,21417,16821,11953
2022-07-06 11:30:00+00,11057,810,4589,12499,84,1868,1963,277,4483,0,37630,160,23618,21655,17066,11867
2022-07-06 12:00:00+00,10653,840,4591,12733,73,1550,1961,173,4510,0,37084,158,23868,21907,17316,11493
2022-07-06 12:30:00+00,10460,561,4586,12964,71,1468,1914,137,4570,0,36731,149,24105,22191,17605,11021
2022-07-06 13:00:00+00,10332,463,4591,12957,88,1548,1865,87,4596,0,36527,147,24097,22232,17641,10795
2022-07-06 13:30:00+00,9712,460,4594,13924,106,1590,1801,83,4591,0,36861,139,25016,23215,18621,10172
2022-07-06 14:00:00+00,9836,467,4592,14351,117,1242,1735,140,4597,0,37077,137,25392,23657,19065,10303
2022-07-06 14:30:00+00,9778,472,4595,14586,143,1278,1726,143,4296,0,37017,137,25346,23620,19025,10250
2022-07-06 15:00:00+00,9364,484,4606,14463,249,1496,1776,147,4180,0,36765,132,25274,23498,18892,9848
2022-07-06 15:30:00+00,9879,304,4590,14514,184,1680,1843,146,3651,352,37143,133,24782,22939,18349,10183
2022-07-06 16:00:00+00,9627,236,4588,14761,219,2304,1888,144,3156,234,37157,129,24612,22724,18136,9863
2022-07-06 16:30:00+00,9671,78,4593,15265,222,2368,1814,144,2628,366,37149,126,24522,22708,18115,9749
2022-07-06 17:00:00+00,9697,0,4591,15457,275,2326,1912,155,2068,388,36869,122,24303,22391,17800,9697
2022-07-06 17:30:00+00,10153,0,4590,15245,278,2390,1923,157,1541,308,36585,129,23577,21654,17064,10153
2022-07-06 18:00:00+00,10810,0,4595,15237,270,2406,1923,456,1143,0,36840,137,23168,21245,16650,10810
2022-07-06 18:30:00+00,10389,0,4592,15173,262,2212,1867,507,692,64,35758,134,22586,20719,16127,10389
2022-07-06 19:00:00+00,10424,0,4588,14942,228,2058,1836,331,345,8,34760,135,21939,20103,15515,10424
2022-07-06 19:30:00+00,10006,0,4586,14838,225,1996,1814,188,96,62,33811,132,21559,19745,15159,10006
2022-07-06 20:00:00+00,9731,0,4589,14606,320,1448,1896,221,5,0,32816,130,21416,19520,14931,9731
2022-07-06 20:30:00+00,9121,0,4590,14673,320,1322,1966,211,0,0,32203,124,21549,19583,14993,9121
2022-07-06 21:00:00+00,9308,0,4587,14703,273,840,2037,119,0,0,31867,127,21600,19563,14976,9308
2022-07-06 21:30:00+00,8349,0,4593,14971,205,662,1949,100,0,0,30829,116,21718,19769,15176,8349
2022-07-06 22:00:00+00,7457,0,4587,14931,206,306,1955,108,0,0,29550,110,21679,19724,15137,7457
2022-07-06 22:30:00+00,6446,0,4591,15269,197,384,1811,108,0,0,28806,101,21868,20057,15466,6446
2022-07-06 23:00:00+00,6277,0,4585,14934,139,376,1944,109,0,0,28364,103,21602,19658,15073,6277
2022-07-06 23:30:00+00,6199,0,4587,14163,137,494,1933,108,0,0,27621,107,20820,18887,14300,6199
2022-07-07 00:00:00+00,6501,0,4593,13689,136,504,1948,108,0,0,27479,112,20366,18418,13825,6501
2022-07-07 00:30:00+00,6896,0,4586,12710,136,504,1961,120,0,0,26913,120,19393,17432,12846,6896
2022-07-07 01:00:00+00,7096,0,4591,12158,136,504,1954,200,0,0,26639,125,18839,16885,12294,7096
2022-07-07 01:30:00+00,7149,0,4590,12253,132,504,1962,189,0,0,26779,125,18937,16975,12385,7149
2022-07-07 02:00:00+00,7115,0,4592,12004,116,502,1961,185,0,0,26475,126,18673,16712,12120,7115
2022-07-07 02:30:00+00,7114,0,4594,11757,117,502,1958,138,0,0,26180,127,18426,16468,11874,7114
2022-07-07 03:00:00+00,7392,0,4594,11495,117,420,1959,108,0,0,26085,130,18165,16206,11612,7392
2022-07-07 03:30:00+00,7545,0,4597,11590,118,380,1680,108,0,0,26018,130,17985,16305,11708,7545
2022-07-07 04:00:00+00,8662,0,4589,11245,121,304,1501,111,5,0,26538,142,17461,15960,11371,8662
2022-07-07 04:30:00+00,9900,0,4588,10572,137,364,1505,110,59,0,27235,158,16861,15356,10768,9900
2022-07-07 05:00:00+00,11908,0,4593,10234,193,230,1675,110,189,0,29132,173,16884,15209,10616,11908
2022-07-07 05:30:00+00,13284,0,4593,10216,193,96,1935,113,400,0,30830,181,17337,15402,10809,13284
2022-07-07 06:00:00+00,14267,0,4596,10118,239,402,2067,116,689,278,32772,182,17709,15642,11046,14267
2022-07-07 06:30:00+00,15473,0,4595,9996,281,484,2178,132,1017,410,34566,186,18067,15889,11294,15473
2022-07-07 07:00:00+00,15742,0,4596,9675,324,1300,2173,140,1397,108,35455,190,18165,15992,11396,15742
2022-07-07 07:30:00+00,15659,0,4596,9545,330,1392,2171,317,1828,24,35862,188,18470,16299,11703,15659
2022-07-07 08:00:00+00,15841,0,4597,9194,305,1476,2172,351,2303,204,36443,187,18571,16399,11802,15841
2022-07-07 08:30:00+00,15860,0,4599,9025,303,1490,2177,430,2787,0,36671,187,18891,16714,12115,15860
2022-07-07 09:00:00+00,15797,0,4608,8823,303,1876,2162,341,3321,0,37231,189,19217,17055,12447,15797
2022-07-07 09:30:00+00,15681,0,4596,8857,299,1904,2168,311,3803,0,37619,185,19723,17555,12959,15681
2022-07-07 10:00:00+00,15405,0,4595,8863,243,2222,2090,243,4301,0,37962,180,20092,18002,13407,15405
2022-07-07 10:30:00+00,15189,28,4595,8741,233,2260,2151,172,4776,0,38145,177,20496,18345,13750,15217
2022-07-07 11:00:00+00,15248,195,4600,8812,171,2140,2148,152,5377,0,38843,177,21108,18960,14360,15443
2022-07-07 11:30:00+00,14553,232,4595,8603,168,2134,2102,149,6080,94,38710,171,21548,19446,14851,14785
2022-07-07 12:00:00+00,14587,230,4593,8451,139,2052,1948,149,6755,0,38904,171,21886,19938,15345,14817
2022-07-07 12:30:00+00,14106,238,4589,8106,139,2034,1854,142,7062,0,38270,169,21750,19896,15307,14344
2022-07-07 13:00:00+00,13886,233,4583,7590,139,2110,1847,119,7460,64,38031,168,21619,19772,15189,14119
2022-07-07 13:30:00+00,13596,335,4581,7354,151,2094,1766,111,7541,0,37529,170,21393,19627,15046,13931
2022-07-07 14:00:00+00,13593,449,4585,7305,136,1890,1521,108,7310,10,36907,175,20857,19336,14751,14042
2022-07-07 14:30:00+00,14139,479,4582,6806,144,1906,1709,105,6952,116,36938,182,20193,18484,13902,14618
2022-07-07 15:00:00+00,14341,481,4587,6828,215,2222,1848,127,6414,0,37063,184,19892,18044,13457,14822
2022-07-07 15:30:00+00,14404,614,4586,7021,251,2240,1960,147,5674,160,37057,187,19492,17532,12946,15018
2022-07-07 16:00:00+00,14760,818,4586,6479,288,1940,2036,352,4885,528,36672,196,18274,16238,11652,15578
2022-07-07 16:30:00+00,15234,825,4585,6036,262,1918,2057,582,4048,572,36119,207,16988,14931,10346,16059
2022-07-07 17:00:00+00,15381,870,4584,5981,368,1582,2036,730,3166,660,35358,212,16135,14099,9515,16251
2022-07-07 17:30:00+00,15765,983,4583,5925,372,1578,2040,759,2354,684,35043,223,15274,13234,8651,16748
2022-07-07 18:00:00+00,16362,983,4586,5864,407,1542,2019,796,1634,560,34753,234,14510,12491,7905,17345
2022-07-07 18:30:00+00,16756,987,4590,5377,409,1528,2038,775,1045,442,33947,245,13459,11421,6831,17743
2022-07-07 19:00:00+00,16792,985,4587,4875,284,1326,2029,785,549,632,32844,251,12324,10295,5708,17777
2022-07-07 19:30:00+00,16757,989,4587,4733,282,1292,2039,843,185,694,32401,254,11826,9787,5200,17746
2022-07-07 20:00:00+00,15991,988,4586,4707,270,1310,2017,927,15,824,31635,250,11595,9578,4992,16979
2022-07-07 20:30:00+00,15534,990,4585,4495,271,1238,1923,885,0,980,30901,248,11274,9351,4766,16524
2022-07-07 21:00:00+00,15452,990,4585,4388,268,1218,1925,739,0,848,30413,249,11166,9241,4656,16442
2022-07-07 21:30:00+00,15225,786,4583,4276,253,1174,1923,585,0,398,29203,247,11035,9112,4529,16011
2022-07-07 22:00:00+00,15058,493,4586,4238,252,1444,1922,356,0,560,28909,234,10998,9076,4490,15551
2022-07-07 22:30:00+00,14603,306,4585,4167,224,1608,1922,304,0,204,27923,232,10898,8976,4391,14909
2022-07-07 23:00:00+00,14868,260,4589,4214,155,1418,1906,236,0,0,27646,238,10864,8958,4368,15128
2022-07-07 23:30:00+00,14725,1,4585,4392,151,1340,1823,140,0,0,27157,229,10951,9128,4543,14726
2022-07-08 00:00:00+00,14770,0,4592,4515,151,926,1822,108,0,0,26884,231,11080,9258,4666,14770
2022-07-08 00:30:00+00,14770,0,4592,4731,151,820,1822,109,0,0,26995,230,11296,9474,4882,14770
2022-07-08 01:00:00+00,14625,0,4589,4866,132,586,1822,110,0,0,26730,230,11409,9587,4998,14625
2022-07-08 01:30:00+00,14325,0,4592,4947,132,570,1824,109,0,0,26499,228,11495,9671,5079,14325
2022-07-08 02:00:00+00,14192,0,4589,4958,132,572,1825,109,0,0,26377,229,11504,9679,5090,14192
2022-07-08 02:30:00+00,14139,0,4591,4845,132,576,1826,110,0,0,26219,229,11394,9568,4977,14139
2022-07-08 03:00:00+00,13984,0,4597,4733,132,760,1826,108,0,0,26140,226,11288,9462,4865,13984
2022-07-08 03:30:00+00,13705,0,4600,4881,132,778,1827,108,0,0,26031,222,11440,9613,5013,13705
2022-07-08 04:00:00+00,13215,0,4595,5145,134,1160,1922,109,21,0,26301,213,11817,9895,5300,13215
2022-07-08 04:30:00+00,13525,110,4591,5180,136,1304,1946,109,206,0,27107,216,12059,10113,5522,13635
2022-07-08 05:00:00+00,13732,341,4593,5459,164,1584,1945,107,588,0,28513,214,12749,10804,6211,14073
2022-07-08 05:30:00+00,14657,613,4587,5531,200,1706,2001,120,1111,0,30526,222,13430,11429,6842,15270
2022-07-08 06:00:00+00,15066,729,4588,5338,299,1614,2008,403,1732,48,31825,223,13965,11957,7369,15795
2022-07-08 06:30:00+00,15327,665,4593,5097,389,1534,2007,596,2432,128,32768,218,14518,12511,7918,15992
2022-07-08 07:00:00+00,15608,717,4591,4854,379,1412,2007,692,3167,246,33673,217,14998,12991,8400,16325
2022-07-08 07:30:00+00,15718,781,4595,4608,410,1396,2008,765,3871,384,34536,215,15492,13484,8889,16499
2022-07-08 08:00:00+00,15567,850,4605,4532,391,1738,2007,660,4877,298,35525,213,16412,14405,9800,16417
2022-07-08 08:30:00+00,15339,750,4596,4763,383,1774,2007,481,5766,138,35997,204,17515,15508,10912,16089
2022-07-08 09:00:00+00,15503,762,4594,4954,278,1948,2005,445,6406,358,37253,202,18237,16232,11638,16265
2022-07-08 09:30:00+00,15645,755,4595,4961,243,1932,2005,378,6951,202,37667,200,18755,16750,12155,16400
2022-07-08 10:00:00+00,15527,862,4595,4964,207,1686,2005,414,7513,254,38027,197,19284,17279,12684,16389
2022-07-08 10:30:00+00,15287,765,4594,5107,191,1686,2008,412,8010,70,38130,191,19910,17902,13308,16052
2022-07-08 11:00:00+00,15099,747,4594,5232,168,1982,2040,377,8293,10,38542,190,20327,18287,13693,15846
2022-07-08 11:30:00+00,15157,762,4590,5284,175,2002,1904,320,8213,96,38503,191,20166,18262,13672,15919
2022-07-08 12:00:00+00,14918,771,4590,5456,176,1910,1796,172,8628,222,38639,185,20646,18850,14260,15689
2022-07-08 12:30:00+00,14675,751,4589,5652,164,1898,1800,112,8576,46,38263,183,20781,18981,14392,15426
2022-07-08 13:00:00+00,13997,616,4584,5969,153,1840,1802,124,8430,0,37515,180,20938,19136,14552,14613
2022-07-08 13:30:00+00,13895,478,4584,6216,167,1810,1777,119,8057,0,37103,177,20801,19024,14440,14373
2022-07-08 14:00:00+00,13609,483,4582,6343,178,1846,1794,127,7490,0,36452,178,20387,18593,14011,14092
2022-07-08 14:30:00+00,14037,471,4577,6492,205,1860,1792,119,6786,0,36339,183,19852,18060,13483,14508
2022-07-08 15:00:00+00,14711,624,4580,6517,265,1580,1795,150,6218,0,36440,186,19375,17580,13000,15335
2022-07-08 15:30:00+00,14820,961,4582,6401,284,1586,1941,354,5367,44,36340,198,18575,16634,12052,15781
2022-07-08 16:00:00+00,15058,987,4585,6448,357,1504,2038,570,4325,0,35872,205,17754,15716,11130,16045
2022-07-08 16:30:00+00,15190,988,4598,6467,364,1570,2051,599,3446,206,35479,210,16926,14875,10277,16178
2022-07-08 17:00:00+00,15074,989,4597,6460,411,1552,2053,655,2844,432,35067,212,16365,14312,9715,16063
2022-07-08 17:30:00+00,15209,989,4586,6431,407,1624,2053,805,2032,714,34850,217,15509,13456,8870,16198
2022-07-08 18:00:00+00,15068,989,4586,6476,400,1598,2038,1065,1558,740,34518,221,15058,13020,8434,16057
2022-07-08 18:30:00+00,15195,991,4584,6284,406,1526,2046,981,1137,618,33768,226,14457,12411,7827,16186
2022-07-08 19:00:00+00,15314,990,4590,6028,380,1614,2032,878,585,594,33005,233,13615,11583,6993,16304
2022-07-08 19:30:00+00,15192,990,4589,5791,417,1542,2024,851,189,360,31945,238,13010,10986,6397,16182
2022-07-08 20:00:00+00,15280,991,4586,5662,407,1636,2019,587,12,238,31418,242,12686,10667,6081,16271
2022-07-08 20:30:00+00,15107,988,4582,5254,401,1554,2020,398,0,428,30732,241,12257,10237,5655,16095
2022-07-08 21:00:00+00,14998,973,4586,5278,375,1584,2006,473,0,162,30435,243,12245,10239,5653,15971
2022-07-08 21:30:00+00,14698,825,4586,5738,231,1460,2010,286,0,26,29860,234,12565,10555,5969,15523
2022-07-08 22:00:00+00,13633,494,4585,5969,227,1508,1903,336,0,118,28773,217,12684,10781,6196,14127
2022-07-08 22:30:00+00,12401,463,4590,6345,210,1646,1547,311,0,0,27513,208,12692,11145,6555,12864
2022-07-08 23:00:00+00,11884,460,4590,6714,138,1580,1395,227,0,0,26988,202,12837,11442,6852,12344
2022-07-08 23:30:00+00,11048,460,4592,7581,117,1436,1351,137,0,0,26722,188,13641,12290,7698,11508
2022-07-09 00:00:00+00,11096,432,4585,7884,95,1454,1410,137,0,0,27093,186,13974,12564,7979,11528
2022-07-09 00:30:00+00,10787,218,4587,8188,95,1554,1411,124,0,0,26964,176,14281,12870,8283,11005
2022-07-09 01:00:00+00,10579,0,4594,8730,93,1516,1407,109,0,0,27028,165,14824,13417,8823,10579
2022-07-09 01:30:00+00,10057,0,4593,8970,90,1414,1412,110,0,0,26646,157,15065,13653,9060,10057
2022-07-09 02:00:00+00,9875,0,4596,9071,76,1398,1412,111,0,0,26539,155,15155,13743,9147,9875
2022-07-09 02:30:00+00,9526,0,4601,9103,76,1434,1412,113,0,0,26265,152,15192,13780,9179,9526
2022-07-09 03:00:00+00,9358,0,4594,9325,76,1398,1278,121,0,0,26150,149,15273,13995,9401,9358
2022-07-09 03:30:00+00,9573,0,4590,8914,76,1392,1065,115,0,0,25725,153,14645,13580,8990,9573
2022-07-09 04:00:00+00,9678,0,4598,8917,76,1356,1063,109,8,0,25805,155,14662,13599,9001,9678
2022-07-09 04:30:00+00,9465,0,4599,8980,76,1382,1145,118,143,0,25908,152,14943,13798,9199,9465
2022-07-09 05:00:00+00,10001,0,4594,8496,95,1420,1398,123,474,0,26601,157,15057,13659,9065,10001
2022-07-09 05:30:00+00,10691,0,4594,8337,94,1412,1413,125,1086,0,27752,160,15524,14111,9517,10691
2022-07-09 06:00:00+00,10661,0,4590,8248,188,1398,1416,125,1548,0,28174,157,15990,14574,9984,10661
2022-07-09 06:30:00+00,11368,0,4587,7694,246,1396,1426,127,2156,326,29326,160,16109,14683,10096,11368
2022-07-09 07:00:00+00,11407,0,4594,7349,339,2208,1426,117,2713,262,30415,167,16421,14995,10401,11407
2022-07-09 07:30:00+00,11714,0,4593,6759,340,2372,1417,340,3470,50,31055,172,16579,15162,10569,11714
2022-07-09 08:00:00+00,11415,0,4592,6301,344,2262,1424,351,4289,358,31336,165,16950,15526,10934,11415
2022-07-09 08:30:00+00,11446,0,4596,5662,343,2256,1427,416,4949,576,31671,164,16977,15550,10954,11446
2022-07-09 09:00:00+00,11109,0,4599,5221,308,3198,1417,519,5652,254,32277,161,17197,15780,11181,11109
2022-07-09 09:30:00+00,11168,0,4596,4955,292,3250,1175,520,6579,154,32689,159,17597,16422,11826,11168
2022-07-09 10:00:00+00,11220,0,4592,4565,244,3318,1109,377,7426,166,33017,157,17936,16827,12235,11220
2022-07-09 10:30:00+00,11221,0,4594,4469,219,3322,1328,150,8090,156,33549,154,18700,17372,12778,11221
2022-07-09 11:00:00+00,11016,0,4594,4437,127,3398,1388,111,8625,146,33842,150,19171,17783,13189,11016
2022-07-09 11:30:00+00,10566,0,4591,4261,128,3400,1397,106,9045,150,33644,145,19422,18025,13434,10566
2022-07-09 12:00:00+00,10287,0,4586,4076,116,3400,1414,108,9163,0,33150,144,19355,17941,13355,10287
2022-07-09 12:30:00+00,10213,0,4585,4063,116,3402,1418,111,9129,0,33037,144,19311,17893,13308,10213
2022-07-09 13:00:00+00,9671,0,4585,4302,116,3458,1361,111,9011,0,32615,140,19375,18014,13429,9671
2022-07-09 13:30:00+00,9637,0,4579,4228,117,3458,1393,113,8677,0,32202,141,18994,17601,13022,9637
2022-07-09 14:00:00+00,9975,0,4576,4140,133,3460,1343,117,8199,0,31943,147,18391,17048,12472,9975
2022-07-09 14:30:00+00,10546,0,4578,3967,136,3458,1245,115,7538,0,31583,155,17464,16219,11641,10546
2022-07-09 15:00:00+00,11117,48,4572,3920,177,3422,1169,123,6839,0,31387,164,16677,15508,10936,11165
2022-07-09 15:30:00+00,12206,96,4569,3773,207,3420,1274,123,6016,0,31684,177,15839,14565,9996,12302
2022-07-09 16:00:00+00,13062,296,4569,3631,258,3414,1419,121,5065,0,31835,194,14942,13523,8954,13358
2022-07-09 16:30:00+00,14179,316,4577,3665,314,3406,1420,127,4160,110,32274,206,14136,12716,8139,14495
2022-07-09 17:00:00+00,15034,305,4581,3723,397,2824,1545,230,3283,126,32048,215,13529,11984,7403,15339
2022-07-09 17:30:00+00,15085,401,4582,3830,430,2792,1774,327,2455,208,31884,221,13071,11297,6715,15486
2022-07-09 18:00:00+00,15226,407,4584,3643,514,2102,2010,456,1714,604,31260,227,12465,10455,5871,15633
2022-07-09 18:30:00+00,15256,401,4583,3442,583,2058,2067,549,1044,522,30505,234,11719,9652,5069,15657
2022-07-09 19:00:00+00,15076,389,4580,3400,619,1748,2065,638,481,602,29598,233,11145,9080,4500,15465
2022-07-09 19:30:00+00,14954,385,4586,3560,619,1658,2066,572,134,386,28920,234,10965,8899,4313,15339
2022-07-09 20:00:00+00,14282,391,4585,3631,456,1952,2049,573,7,386,28312,238,10728,8679,4094,14673
2022-07-09 20:30:00+00,14102,392,4583,3735,420,2080,2047,561,0,50,27970,240,10785,8738,4155,14494
2022-07-09 21:00:00+00,14025,408,4578,3774,267,1580,2049,622,0,638,27941,233,10668,8619,4041,14433
2022-07-09 21:30:00+00,14000,398,4577,3840,247,1488,2044,534,0,298,27426,234,10708,8664,4087,14398
2022-07-09 22:00:00+00,14101,341,4578,3830,227,1610,2044,240,0,134,27105,231,10679,8635,4057,14442
2022-07-09 22:30:00+00,14097,32,4580,3994,202,1530,2044,271,0,0,26750,222,10820,8776,4196,14129
2022-07-09 23:00:00+00,13836,29,4582,3791,120,1756,2044,257,0,0,26414,223,10537,8493,3911,13865
2022-07-09 23:30:00+00,13328,26,4585,3859,106,1776,2103,150,0,0,25933,218,10653,8550,3965,13354
2022-07-10 00:00:00+00,12266,22,4573,3764,101,2086,2156,194,0,0,25162,212,10594,8438,3865,12288
2022-07-10 00:30:00+00,11959,19,4578,3681,100,2138,2167,192,0,0,24834,211,10526,8359,3781,11978
2022-07-10 01:00:00+00,11321,16,4582,3725,82,2326,2160,167,0,0,24379,203,10549,8389,3807,11337
2022-07-10 01:30:00+00,10947,13,4584,3807,78,2212,2161,127,0,0,23929,197,10630,8469,3885,10960
2022-07-10 02:00:00+00,10817,10,4583,3747,77,2005,2164,124,0,0,23527,197,10571,8407,3824,10827
2022-07-10 02:30:00+00,10781,6,4589,3682,74,1982,2165,113,0,0,23392,197,10510,8345,3756,10787
2022-07-10 03:00:00+00,10662,3,4588,3539,73,1962,2186,113,0,0,23126,197,10386,8200,3612,10665
2022-07-10 03:30:00+00,10352,0,4589,3496,73,1962,2183,113,0,0,22768,195,10341,8158,3569,10352
2022-07-10 04:00:00+00,10124,0,4589,3562,73,2032,2179,111,15,0,22685,196,10418,8239,3650,10124
2022-07-10 04:30:00+00,10042,0,4584,3527,73,2046,2188,113,183,0,22756,194,10555,8367,3783,10042
2022-07-10 05:00:00+00,10203,0,4588,3260,72,2634,2193,118,583,0,23651,200,10696,8503,3915,10203
2022-07-10 05:30:00+00,10726,0,4586,2975,97,2652,2192,116,1166,0,24510,202,11016,8824,4238,10726
2022-07-10 06:00:00+00,10410,0,4585,2745,230,3080,2187,113,1875,0,25225,196,11622,9435,4850,10410
2022-07-10 06:30:00+00,10748,0,4580,2551,257,3084,2194,120,2645,0,26179,194,12227,10033,5453,10748
2022-07-10 07:00:00+00,10630,0,4582,2415,272,3396,2187,115,3531,0,27128,186,12987,10800,6218,10630
2022-07-10 07:30:00+00,10390,0,4576,2387,275,3400,2194,112,4461,0,27795,178,13893,11699,7123,10390
2022-07-10 08:00:00+00,10225,0,4577,2193,260,3456,2193,124,5402,0,28430,173,14625,12432,7855,10225
2022-07-10 08:30:00+00,10414,0,4581,1933,234,3458,2192,113,6303,0,29228,171,15243,13051,8470,10414
2022-07-10 09:00:00+00,10083,0,4580,1782,169,3458,2192,111,7116,0,29491,165,15839,13647,9067,10083
2022-07-10 09:30:00+00,9881,0,4582,1872,164,3458,2189,112,7823,0,30081,159,16630,14441,9859,9881
2022-07-10 10:00:00+00,8848,0,4580,1787,124,4138,2041,112,8452,0,30082,145,16984,14943,10363,8848
2022-07-10 10:30:00+00,8786,0,4586,1647,123,4194,1940,110,8854,0,30240,143,17150,15210,10624,8786
2022-07-10 11:00:00+00,8444,0,4582,1661,107,4762,1884,115,9166,0,30721,136,17400,15516,10934,8444
2022-07-10 11:30:00+00,8448,0,4585,1742,107,4782,1576,120,9328,0,30688,135,17338,15762,11177,8448
2022-07-10 12:00:00+00,8432,0,4582,1803,92,5050,1641,110,9317,0,31027,134,17435,15794,11212,8432
2022-07-10 12:30:00+00,8283,0,4583,1856,93,5052,1872,112,9181,0,31032,133,17585,15713,11130,8283
2022-07-10 13:00:00+00,8156,0,4582,1852,78,4830,1933,111,9023,0,30565,134,17468,15535,10953,8156
2022-07-10 13:30:00+00,8234,0,4578,1813,82,4788,1910,119,8531,0,30055,138,16914,15004,10426,8234
2022-07-10 14:00:00+00,9044,0,4574,1739,82,4094,1856,114,7945,0,29448,150,16196,14340,9766,9044
2022-07-10 14:30:00+00,9781,0,4578,1640,86,4034,1858,112,7405,0,29494,160,15567,13709,9131,9781
2022-07-10 15:00:00+00,11013,0,4573,1600,114,3432,1857,123,6725,0,29437,175,14869,13012,8439,11013
2022-07-10 15:30:00+00,11410,91,4572,1672,136,3388,1737,479,5791,62,29338,187,13908,12171,7599,11501
2022-07-10 16:00:00+00,14134,236,4571,1635,225,2542,1785,619,5067,384,31198,214,13283,11498,6927,14370
2022-07-10 16:30:00+00,14858,405,4560,1541,216,2544,1753,714,4190,890,31671,225,12260,10507,5947,15263
2022-07-10 17:00:00+00,15791,762,4564,1432,411,1826,1822,750,3283,920,31561,239,11512,9690,5126,16553
2022-07-10 17:30:00+00,16039,958,4563,1439,471,1893,1833,757,2390,938,31281,252,10696,8863,4300,16997
2022-07-10 18:00:00+00,16224,979,4571,1392,620,1601,1838,800,1702,1348,31074,256,10123,8285,3714,17203
2022-07-10 18:30:00+00,16747,974,4574,1298,637,1587,1881,769,1059,1352,30878,265,9449,7568,2994,17721
2022-07-10 19:00:00+00,16814,979,4569,1188,648,1688,1892,838,508,1258,30382,273,8805,6913,2344,17793
2022-07-10 19:30:00+00,16535,979,4566,1144,660,1698,1898,800,146,1230,29656,274,8414,6516,1950,17514
2022-07-10 20:00:00+00,16467,958,4565,1156,575,1888,1904,747,7,606,28873,280,8207,6303,1738,17425
2022-07-10 20:30:00+00,16473,875,4566,1155,526,1974,1909,717,0,404,28599,281,8156,6247,1681,17348
2022-07-10 21:00:00+00,16591,982,4567,1141,560,1762,1911,705,0,806,29025,281,8179,6268,1701,17573
2022-07-10 21:30:00+00,16266,982,4570,1100,512,1762,1914,643,0,414,28163,285,8096,6182,1612,17248
2022-07-10 22:00:00+00,16157,985,4566,1137,468,1726,1963,576,0,438,28016,283,8134,6171,1605,17142
2022-07-10 22:30:00+00,15771,987,4567,1203,427,1564,1989,530,0,134,27172,283,8186,6197,1630,16758
2022-07-10 23:00:00+00,15686,988,4572,1267,231,1446,1955,390,0,24,26559,287,8025,6070,1498,16674
2022-07-10 23:30:00+00,15776,984,4567,1284,132,1492,1952,333,0,0,26520,290,7935,5983,1416,16760
2022-07-11 00:00:00+00,15957,985,4564,1183,112,1292,1947,356,0,0,26396,295,7806,5859,1295,16942
2022-07-11 00:30:00+00,16068,986,4568,1093,106,1256,1946,304,0,0,26327,297,7713,5767,1199,17054
2022-07-11 01:00:00+00,16101,987,4567,1037,109,894,1946,223,0,0,25864,302,7659,5713,1146,17088
2022-07-11 01:30:00+00,16139,988,4564,969,137,852,1951,174,0,0,25774,303,7621,5670,1106,17127
2022-07-11 02:00:00+00,16010,990,4570,962,96,832,1951,176,0,0,25587,303,7579,5628,1058,17000
2022-07-11 02:30:00+00,15689,989,4570,949,76,826,1950,191,0,0,25240,302,7545,5595,1025,16678
2022-07-11 03:00:00+00,15440,988,4575,931,76,786,2185,238,0,0,25219,300,7767,5582,1007,16428
2022-07-11 03:30:00+00,15367,990,4576,913,76,788,2259,225,0,0,25194,300,7824,5565,989,16357
2022-07-11 04:00:00+00,15453,989,4574,963,76,946,2331,148,15,0,25495,297,7959,5628,1054,16442
2022-07-11 04:30:00+00,15567,990,4573,1096,91,972,2473,151,192,0,26105,293,8425,5952,1379,16557
2022-07-11 05:00:00+00,15672,990,4573,1175,257,1080,2608,409,590,0,27354,285,9203,6595,2022,16662
2022-07-11 05:30:00+00,15898,986,4569,1170,474,1080,2734,721,1166,182,28980,276,10113,7379,2810,16884
2022-07-11 06:00:00+00,15547,915,4572,1118,657,1120,2772,821,1831,172,29525,266,10950,8178,3606,16462
2022-07-11 06:30:00+00,15764,787,4568,1121,631,1190,2779,800,2573,676,30889,254,11672,8893,4325,16551
2022-07-11 07:00:00+00,16037,719,4570,1247,574,1600,2831,694,3404,348,32024,250,12626,9795,5225,16756
2022-07-11 07:30:00+00,15964,781,4564,1268,593,1528,2816,693,4309,308,32824,243,13550,10734,6170,16745
2022-07-11 08:00:00+00,15955,835,4562,1415,575,1550,2809,722,5187,332,33942,239,14548,11739,7177,16790
2022-07-11 08:30:00+00,15970,726,4563,1523,562,1568,2814,561,6083,206,34576,230,15545,12731,8168,16696
2022-07-11 09:00:00+00,15707,598,4564,1711,524,1676,2820,481,6824,218,35123,220,16443,13623,9059,16305
2022-07-11 09:30:00+00,15410,524,4578,1996,511,1734,2614,485,7517,222,35591,211,17216,14602,10024,15934
2022-07-11 10:00:00+00,15621,641,4573,2461,394,1598,2170,425,8045,250,36178,210,17643,15473,10900,16262
2022-07-11 10:30:00+00,15373,524,4567,2821,217,1646,2174,366,8601,288,36577,202,18380,16206,11639,15897
2022-07-11 11:00:00+00,15841,520,4568,3212,168,1708,2116,464,8859,298,37754,203,18923,16807,12239,16361
2022-07-11 11:30:00+00,15869,518,4576,3595,167,1618,2070,323,8807,254,37797,202,19215,17145,12569,16387
2022-07-11 12:00:00+00,16290,812,4575,4049,134,1262,2050,289,8625,578,38664,207,19433,17383,12808,17102
2022-07-11 12:30:00+00,15777,963,4574,4591,174,1236,2229,189,8186,62,37981,208,19754,17525,12951,16740
2022-07-11 13:00:00+00,15758,917,4574,4966,192,940,2339,199,7816,454,38155,204,19887,17548,12974,16675
2022-07-11 13:30:00+00,15542,978,4574,5338,190,934,2422,272,7378,156,37784,207,19902,17480,12906,16520
2022-07-11 14:00:00+00,15317,978,4572,5677,190,984,2577,377,6517,204,37393,208,19533,16956,12384,16295
2022-07-11 14:30:00+00,15360,963,4566,6025,200,994,2463,439,5792,684,37486,207,19046,16583,12017,16323
2022-07-11 15:00:00+00,15475,844,4570,6336,264,1438,1990,622,5268,404,37211,209,18428,16438,11868,16319
2022-07-11 15:30:00+00,15585,850,4559,6507,246,1474,1876,706,4206,894,36903,211,17394,15518,10959,16435
2022-07-11 16:00:00+00,15803,832,4562,6711,348,1492,1777,718,3760,916,36919,212,17158,15381,10819,16635
2022-07-11 16:30:00+00,15781,799,4559,6686,375,1510,1816,714,3201,1248,36689,212,16637,14821,10262,16580
2022-07-11 17:00:00+00,15873,817,4557,6638,460,1192,1593,747,2529,1274,35680,216,15777,14184,9627,16690
2022-07-11 17:30:00+00,15970,831,4560,6898,466,1186,1448,739,1999,1092,35189,220,15371,13923,9363,16801
2022-07-11 18:00:00+00,15798,909,4559,7581,455,1033,1455,680,1230,854,34554,223,15280,13825,9266,16707
2022-07-11 18:30:00+00,15127,868,4568,8080,425,986,1460,728,779,886,33907,219,15312,13852,9284,15995
2022-07-11 19:00:00+00,14640,838,4567,8484,279,748,1459,629,399,1084,33127,218,15188,13729,9162,15478
2022-07-11 19:30:00+00,14833,808,4570,8742,257,674,1413,533,107,752,32689,222,15089,13676,9106,15641
2022-07-11 20:00:00+00,15014,953,4564,9127,216,624,1399,418,3,338,32656,227,15309,13910,9346,15967
2022-07-11 20:30:00+00,14901,980,4564,9349,181,520,1396,378,0,94,32363,227,15490,14094,9530,15881
2022-07-11 21:00:00+00,14671,977,4561,9336,120,488,1392,368,0,194,32107,225,15409,14017,9456,15648
2022-07-11 21:30:00+00,13706,822,4565,9578,118,538,1634,207,0,44,31212,215,15895,14261,9696,14528
2022-07-11 22:00:00+00,12941,798,4567,9763,118,449,1928,140,0,168,30872,205,16376,14448,9881,13739
2022-07-11 22:30:00+00,12291,726,4569,10031,118,250,1928,125,0,0,30038,197,16646,14718,10149,13017
2022-07-11 23:00:00+00,11952,594,4567,9876,118,200,1886,114,0,0,29307,192,16447,14561,9994,12546
2022-07-11 23:30:00+00,11566,281,4571,10227,104,100,1885,122,0,0,28856,178,16787,14902,10331,11847
2022-07-12 00:00:00+00,11497,7,4570,9994,103,58,1934,149,0,0,28312,171,16601,14667,10097,11504
2022-07-12 00:30:00+00,11468,0,4573,10031,104,120,1942,135,0,0,28373,171,16650,14708,10135,11468
2022-07-12 01:00:00+00,11489,0,4573,9835,104,138,1944,120,0,0,28203,172,16456,14512,9939,11489
2022-07-12 01:30:00+00,11476,0,4571,9675,103,244,2051,121,0,0,28241,174,16400,14349,9778,11476
2022-07-12 02:00:00+00,11417,0,4572,9559,101,252,2437,112,0,0,28450,174,16669,14232,9660,11417
2022-07-12 02:30:00+00,11179,0,4570,9715,100,224,2614,112,0,0,28514,170,16999,14385,9815,11179
2022-07-12 03:00:00+00,11265,0,4567,9591,99,210,2784,122,0,0,28638,172,17041,14257,9690,11265
2022-07-12 03:30:00+00,11369,0,4571,9602,99,136,2808,117,0,0,28702,171,17080,14272,9701,11369
2022-07-12 04:00:00+00,11730,0,4571,9641,101,194,2807,114,3,0,29161,174,17123,14316,9745,11730
2022-07-12 04:30:00+00,11966,0,4567,9528,116,162,2794,120,98,0,29351,176,17103,14309,9742,11966
2022-07-12 05:00:00+00,11776,0,4569,9507,149,24,2701,123,351,0,29200,172,17277,14576,10007,11776
2022-07-12 05:30:00+00,12383,141,4564,9460,174,22,2697,134,683,0,30258,178,17578,14881,10317,12524
2022-07-12 06:00:00+00,12524,374,4565,9265,286,202,2613,262,1143,110,31344,184,17872,15259,10694,12898
2022-07-12 06:30:00+00,13461,469,4564,9184,324,138,2588,434,1639,0,32801,190,18299,15711,11147,13930
2022-07-12 07:00:00+00,14279,631,4564,8710,370,926,2597,530,1974,140,34721,203,18215,15618,11054,14910
2022-07-12 07:30:00+00,14419,823,4569,8691,346,1060,2576,529,2621,92,35726,206,18803,16227,11658,15242
2022-07-12 08:00:00+00,14366,795,4564,8879,312,1128,2654,464,2991,30,36183,203,19400,16746,12182,15161
2022-07-12 08:30:00+00,14359,773,4563,8866,289,1156,2760,430,3193,0,36389,202,19671,16911,12348,15132
2022-07-12 09:00:00+00,13656,615,4560,8619,265,1566,2797,393,3784,0,36255,192,20025,17228,12668,14271
2022-07-12 09:30:00+00,14059,624,4561,8357,216,1572,2634,459,4206,42,36730,194,19974,17340,12779,14683
2022-07-12 10:00:00+00,14529,579,4563,8336,271,1306,2577,313,4139,112,36725,195,19886,17309,12746,15108
2022-07-12 10:30:00+00,14239,742,4561,8559,291,1322,2584,288,4088,14,36688,196,20083,17499,12938,14981
2022-07-12 11:00:00+00,14732,906,4564,8209,258,1322,2585,457,4200,572,37805,201,19816,17231,12667,15638
2022-07-12 11:30:00+00,14784,978,4566,7805,352,1320,2570,590,4368,462,37795,205,19661,17091,12525,15762
2022-07-12 12:00:00+00,14833,818,4568,7383,155,1872,2589,473,4226,92,37009,206,18921,16332,11764,15651
2022-07-12 12:30:00+00,14562,808,4573,6940,224,1892,2588,380,4346,498,36811,203,18671,16083,11510,15370
2022-07-12 13:00:00+00,14393,810,4560,6384,243,1964,2587,395,4274,400,36010,207,18048,15461,10901,15203
2022-07-12 13:30:00+00,14928,802,4571,6005,154,1952,2588,409,4085,58,35552,216,17403,14815,10244,15730
2022-07-12 14:00:00+00,15431,923,4578,5975,128,1612,2584,556,3817,486,36090,223,17082,14498,9920,16354
2022-07-12 14:30:00+00,15822,946,4572,5864,127,1648,2705,785,3362,574,36405,229,16630,13925,9353,16768
2022-07-12 15:00:00+00,16125,960,4567,5816,255,1938,2797,913,3127,284,36782,231,16562,13765,9198,17085
2022-07-12 15:30:00+00,16128,937,4566,5721,345,1984,2832,931,2772,786,37002,229,16236,13404,8838,17065
2022-07-12 16:00:00+00,16239,945,4567,5596,520,1962,2835,957,2449,1424,37494,226,15967,13132,8565,17184
2022-07-12 16:30:00+00,16421,937,4573,5662,535,1990,2836,934,2057,1464,37409,228,15663,12827,8254,17358
2022-07-12 17:00:00+00,16304,922,4574,5804,584,2090,2838,951,1600,1332,36999,229,15400,12562,7988,17226
2022-07-12 17:30:00+00,16388,929,4576,5780,582,2108,2839,953,1241,1046,36442,233,15018,12179,7603,17317
2022-07-12 18:00:00+00,16337,920,4576,5814,603,2112,2840,1054,882,970,36108,237,14715,11875,7299,17257
2022-07-12 18:30:00+00,15854,874,4572,6023,612,2154,2792,978,518,686,35063,237,14517,11725,7153,16728
2022-07-12 19:00:00+00,15760,907,4570,6156,517,2052,2646,869,255,646,34378,242,14144,11498,6928,16667
2022-07-12 19:30:00+00,15569,751,4577,5952,487,2128,2680,840,105,506,33595,241,13801,11121,6544,16320
2022-07-12 20:00:00+00,15918,769,4577,5690,415,2082,2680,801,4,250,33186,249,13366,10686,6109,16687
2022-07-12 20:30:00+00,15964,770,4573,5216,398,2084,2695,648,0,40,32388,254,12882,10187,5614,16734
2022-07-12 21:00:00+00,15657,760,4573,5273,307,1580,2692,420,0,0,31262,255,12845,10153,5580,16417
2022-07-12 21:30:00+00,14556,773,4575,5368,161,1440,2696,297,0,0,29866,249,12800,10104,5529,15329
2022-07-12 22:00:00+00,13872,945,4572,5469,160,514,2699,236,0,96,28563,248,12900,10201,5629,14817
2022-07-12 22:30:00+00,12946,978,4573,5464,142,540,2684,251,0,16,27594,245,12863,10179,5606,13924
2022-07-12 23:00:00+00,12057,978,4568,6175,127,504,2683,241,0,0,27333,231,13553,10870,6302,13035
2022-07-12 23:30:00+00,11640,947,4564,6477,125,504,2679,164,0,0,27100,225,13845,11166,6602,12587
2022-07-13 00:00:00+00,11763,936,4563,7014,108,504,2661,201,0,0,27750,222,14346,11685,7122,12699
2022-07-13 00:30:00+00,11534,894,4564,7255,108,504,2665,179,0,0,27703,217,14592,11927,7363,12428
2022-07-13 01:00:00+00,11182,800,4568,7544,108,504,2638,196,0,0,27540,210,14858,12220,7652,11982
2022-07-13 01:30:00+00,10966,797,4569,7730,108,504,2470,156,0,0,27300,207,14877,12407,7838,11763
2022-07-13 02:00:00+00,10504,788,4576,8766,79,504,2155,121,0,0,27493,197,15576,13421,8845,11292
2022-07-13 02:30:00+00,10233,637,4569,8916,79,504,2124,126,0,0,27188,190,15688,13564,8995,10870
2022-07-13 03:00:00+00,10754,660,4569,8391,79,504,2152,126,0,0,27235,198,15191,13039,8470,11414
2022-07-13 03:30:00+00,11108,699,4576,8002,79,504,2138,113,0,0,27219,205,14795,12657,8081,11807
2022-07-13 04:00:00+00,10932,776,4578,8041,79,504,2133,111,8,0,27162,205,14839,12706,8128,11708
2022-07-13 04:30:00+00,10944,645,4578,8389,80,504,2131,137,135,0,27543,198,15313,13182,8604,11589
2022-07-13 05:00:00+00,11037,610,4580,8279,109,440,2134,135,413,0,27737,196,15515,13381,8801,11647
2022-07-13 05:30:00+00,12017,788,4578,8256,201,306,2155,151,865,0,29317,202,16055,13900,9322,12805
2022-07-13 06:00:00+00,13034,808,4579,8103,223,602,2149,440,1412,0,31350,209,16466,14317,9738,13842
2022-07-13 06:30:00+00,14108,740,4580,7627,247,614,2150,621,2003,0,32690,212,16607,14457,9877,14848
2022-07-13 07:00:00+00,14361,765,4572,7022,311,1456,2151,811,2712,0,34161,215,16768,14617,10045,15126
2022-07-13 07:30:00+00,14595,895,4570,6662,360,1524,2144,847,3550,0,35147,215,17286,15142,10572,15490
2022-07-13 08:00:00+00,14817,977,4574,6121,355,1634,2148,693,4127,0,35446,217,17325,15177,10603,15794
2022-07-13 08:30:00+00,14940,901,4576,6022,314,1652,2152,639,4660,4,35860,213,17724,15572,10996,15841
2022-07-13 09:00:00+00,14842,985,4574,6134,281,1762,2151,459,5430,0,36618,208,18570,16419,11845,15827
2022-07-13 09:30:00+00,14805,988,4569,6078,276,1812,2154,423,5976,0,37081,205,19053,16899,12330,15793
2022-07-13 10:00:00+00,14797,986,4571,6177,213,2196,2159,445,6624,0,38168,200,19744,17585,13014,15783
2022-07-13 10:30:00+00,14612,987,4576,6287,211,2232,2156,422,7272,0,38755,195,20502,18346,13770,15599
2022-07-13 11:00:00+00,14783,988,4573,6437,211,2246,2153,390,7785,0,39566,193,21159,19006,14433,15771
2022-07-13 11:30:00+00,14800,987,4574,6474,189,2222,2154,392,8055,0,39847,191,21446,19292,14718,15787
2022-07-13 12:00:00+00,14395,988,4577,6289,127,2382,2153,224,8487,0,39622,188,21633,19480,14903,15383
2022-07-13 12:30:00+00,13934,987,4572,6381,126,2372,2152,144,8449,0,39117,185,21680,19528,14956,14921
2022-07-13 13:00:00+00,13439,848,4575,6523,126,2260,2150,152,8350,0,38423,180,21724,19574,14999,14287
2022-07-13 13:30:00+00,13267,844,4598,6521,126,2284,2152,155,7972,0,37919,180,21369,19217,14619,14111
2022-07-13 14:00:00+00,13565,818,4606,6389,126,2194,2152,150,7458,0,37458,182,20731,18579,13973,14383
2022-07-13 14:30:00+00,14169,884,4610,6353,127,2198,2167,190,6859,0,37557,190,20116,17949,13339,15053
2022-07-13 15:00:00+00,14748,972,4631,6263,158,2040,2191,486,6023,0,37512,197,19266,17075,12444,15720
2022-07-13 15:30:00+00,14987,987,4640,6057,334,2068,2182,508,5295,0,37058,203,18508,16326,11686,15974
2022-07-13 16:00:00+00,15092,987,4667,6009,448,3032,2195,584,4338,232,37584,209,17657,15462,10795,16079
2022-07-13 16:30:00+00,15544,989,4672,5973,475,3098,2196,755,3492,94,37288,218,16808,14612,9940,16533
2022-07-13 17:00:00+00,15687,929,4672,5978,357,3152,2195,858,2828,346,37002,222,16030,13835,9163,16616
2022-07-13 17:30:00+00,15950,986,4686,5822,404,3208,2197,871,2114,376,36614,229,15223,13026,8340,16936
2022-07-13 18:00:00+00,15638,989,4688,5373,539,3160,2199,922,1442,682,35632,232,14241,12042,7354,16627
2022-07-13 18:30:00+00,15741,988,4686,4971,554,3168,2197,973,881,678,34837,240,13289,11092,6406,16729
2022-07-13 19:00:00+00,15798,986,4682,4642,600,2860,2197,880,440,974,34059,244,12561,10364,5682,16784
2022-07-13 19:30:00+00,15514,984,4680,4328,647,2902,2197,856,149,718,32975,249,12001,9804,5124,16498
2022-07-13 20:00:00+00,15454,965,4687,4146,572,2712,2191,937,5,562,32231,253,11601,9410,4723,16419
2022-07-13 20:30:00+00,15415,983,4693,3880,483,2754,2192,897,0,528,31825,257,11248,9056,4363,16398
2022-07-13 21:00:00+00,15379,970,4701,3660,483,2788,2190,860,0,166,31197,262,11034,8844,4143,16349
2022-07-13 21:30:00+00,14909,748,4704,3451,332,2770,2190,627,0,0,29731,259,10677,8487,3783,15657
2022-07-13 22:00:00+00,13947,715,4701,3336,408,2172,2190,429,0,0,27898,245,10635,8445,3744,14662
2022-07-13 22:30:00+00,13235,583,4703,3441,340,2256,2191,359,0,0,27108,236,10675,8484,3781,13818
2022-07-13 23:00:00+00,13521,664,4704,3581,140,2006,2192,285,0,0,27093,242,10617,8425,3721,14185
2022-07-13 23:30:00+00,13250,702,4717,3562,114,1988,2192,193,0,0,26718,241,10585,8393,3676,13952
2022-07-14 00:00:00+00,13194,776,4795,3453,90,1902,2190,173,0,0,26573,244,10528,8338,3543,13970
2022-07-14 00:30:00+00,13544,708,4808,3154,88,1902,2174,180,0,0,26558,247,10224,8050,3242,14252
2022-07-14 01:00:00+00,13692,769,4812,2959,89,1902,2163,155,0,0,26541,251,10023,7860,3048,14461
2022-07-14 01:30:00+00,13525,824,4815,2891,89,1806,2168,152,0,0,26270,252,9963,7795,2980,14349
2022-07-14 02:00:00+00,13462,607,4822,2956,70,1830,2124,150,0,0,26021,246,9972,7848,3026,14069
2022-07-14 02:30:00+00,13535,531,4818,3024,69,1764,2121,154,0,0,26016,243,10032,7911,3093,14066
2022-07-14 03:00:00+00,13547,523,4825,3039,69,1860,2187,151,0,0,26201,243,10120,7933,3108,14070
2022-07-14 03:30:00+00,13327,581,4826,3129,71,1788,2199,152,0,0,26073,242,10225,8026,3200,13908
2022-07-14 04:00:00+00,13103,471,4824,2973,84,1878,2195,152,7,0,25687,239,10083,7888,3064,13574
2022-07-14 04:30:00+00,13074,460,4828,3003,83,1900,2198,153,128,0,25827,238,10240,8042,3214,13534
2022-07-14 05:00:00+00,13521,529,4829,3048,196,1908,2207,318,392,0,26947,238,10672,8465,3636,14050
2022-07-14 05:30:00+00,14107,594,4832,3111,268,1944,2221,562,883,0,28523,239,11316,9094,4262,14701
2022-07-14 06:00:00+00,15142,540,4831,3187,558,1934,2238,591,1568,154,30743,234,12382,10144,5313,15682
2022-07-14 06:30:00+00,16028,636,4830,3289,570,1808,2255,768,2184,0,32367,235,13127,10873,6043,16664
2022-07-14 07:00:00+00,16776,690,4832,3408,408,2370,2267,516,3151,0,34418,237,14066,11799,6967,17466
2022-07-14 07:30:00+00,17108,684,4835,3529,397,2392,2272,485,3950,0,35652,232,14983,12711,7876,17792
2022-07-14 08:00:00+00,17266,853,4833,3639,397,2556,2273,407,4601,20,36844,230,15742,13469,8637,18119
2022-07-14 08:30:00+00,17265,963,4829,3747,396,2558,2273,378,5268,0,37678,228,16513,14240,9411,18228
2022-07-14 09:00:00+00,17213,951,4816,3848,377,1948,2272,342,5897,0,37664,221,17209,14937,10122,18164
2022-07-14 09:30:00+00,17038,0,4801,3936,0,2043,2264,0,6161,0,36242,201,17162,14898,10097,17038
2022-07-14 10:00:00+00,16869,161,4800,4038,0,2597,2257,0,6681,0,37404,199,17777,15519,10719,17030
2022-07-14 10:30:00+00,16673,322,4804,4135,118,2786,2248,72,7208,0,38365,198,18512,16265,11461,16995
2022-07-14 11:00:00+00,16538,811,4814,4251,172,2397,2241,193,7335,58,38809,209,18813,16572,11758,17349
2022-07-14 11:30:00+00,16295,809,4820,4388,159,2401,2236,178,7469,0,38756,206,19073,16836,12016,17104
2022-07-14 12:00:00+00,16068,811,4824,4524,159,2402,2235,183,7974,0,39180,202,19716,17481,12657,16879
2022-07-14 12:30:00+00,15727,747,4825,4637,147,2403,2230,152,7646,0,38514,200,19485,17255,12430,16474
2022-07-14 13:00:00+00,15477,642,4825,4752,124,2461,2225,154,7624,0,38285,197,19550,17325,12500,16119
2022-07-14 13:30:00+00,15191,712,4824,4882,121,2462,2220,155,6907,0,37474,200,18954,16734,11910,15903
2022-07-14 14:00:00+00,15016,665,4823,5010,121,2369,2216,158,6455,6,36838,199,18624,16408,11586,15681
2022-07-14 14:30:00+00,14988,659,4823,5105,120,2369,2212,154,5889,0,36319,201,18149,15937,11114,15647
2022-07-14 15:00:00+00,15058,660,4823,5170,261,1682,2207,179,5239,0,35280,199,17701,15494,10670,15718
2022-07-14 15:30:00+00,15351,658,4824,5225,330,1646,2206,190,4671,94,35195,202,17256,15050,10226,16009
2022-07-14 16:00:00+00,15566,735,4823,5198,430,1502,2203,354,3971,0,34782,208,16625,14422,9599,16301
2022-07-14 16:30:00+00,15888,817,4817,5000,394,1531,2200,411,3568,90,34716,215,15979,13779,8962,16705
2022-07-14 17:00:00+00,15831,811,4816,4792,362,1600,2200,373,2759,402,33946,220,14929,12729,7913,16642
2022-07-14 17:30:00+00,16264,818,4818,4571,376,1588,2132,381,2096,592,33636,227,13993,11861,7043,17082
2022-07-14 18:00:00+00,16391,930,4888,4314,420,1268,2118,580,1438,764,33111,235,13178,11060,6172,17321
2022-07-14 18:30:00+00,16275,988,4900,4180,421,1292,2191,580,891,728,32446,241,12583,10392,5492,17263
2022-07-14 19:00:00+00,16171,990,4891,3711,421,1380,2205,537,467,780,31553,248,11695,9490,4599,17161
2022-07-14 19:30:00+00,16307,989,4894,3236,423,1432,2207,571,125,834,31018,255,10885,8678,3784,17296
2022-07-14 20:00:00+00,16636,989,4892,2720,366,1510,2206,609,3,782,30713,263,10187,7981,3089,17625
2022-07-14 20:30:00+00,16689,989,4890,2520,353,1574,2205,574,0,494,30288,268,9968,7763,2873,17678
2022-07-14 21:00:00+00,16442,989,4894,2372,284,1908,2208,422,0,362,29881,272,9758,7550,2656,17431
2022-07-14 21:30:00+00,15928,989,4908,2168,227,1962,2151,402,0,60,28795,275,9454,7303,2395,16917
2022-07-14 22:00:00+00,15627,827,4911,2213,199,1888,1975,393,0,36,28069,268,9298,7323,2412,16454
2022-07-14 22:30:00+00,15317,345,4901,2255,188,1902,1825,290,0,18,27041,255,9169,7344,2443,15662
2022-07-14 23:00:00+00,15093,410,4910,2292,125,1804,2016,211,0,0,26861,254,9343,7327,2417,15503
2022-07-14 23:30:00+00,14464,383,4906,2539,116,1648,2201,178,0,0,26435,246,9762,7561,2655,14847
2022-07-15 00:00:00+00,14586,237,4905,2683,116,1190,2204,158,0,0,26079,245,9908,7704,2799,14823
2022-07-15 00:30:00+00,14407,230,4907,2960,116,1140,2064,154,0,0,25978,242,10047,7983,3076,14637
2022-07-15 01:00:00+00,14739,230,4890,3061,100,806,1999,160,0,0,25985,248,10050,8051,3161,14969
2022-07-15 01:30:00+00,14750,234,4894,2997,99,746,2001,155,0,0,25876,249,9991,7990,3096,14984
2022-07-15 02:00:00+00,14858,232,4899,2923,97,656,1908,153,0,0,25726,253,9827,7919,3020,15090
2022-07-15 02:30:00+00,14868,233,4901,2945,95,626,1861,156,0,0,25685,253,9802,7941,3040,15101
2022-07-15 03:00:00+00,14930,230,4896,2990,95,466,1874,165,0,0,25646,255,9855,7981,3085,15160
2022-07-15 03:30:00+00,14773,230,4890,3114,95,428,1876,173,0,0,25579,253,9975,8099,3209,15003
2022-07-15 04:00:00+00,14315,230,4882,3141,94,593,1875,159,8,0,25298,247,10000,8125,3243,14545
2022-07-15 04:30:00+00,14495,230,4886,3304,94,713,1927,155,152,0,25956,245,10363,8436,3550,14725
2022-07-15 05:00:00+00,14528,380,4888,3338,148,1094,2078,236,459,0,27149,240,10911,8833,3945,14908
2022-07-15 05:30:00+00,14901,616,4897,3583,194,1018,2198,483,819,114,28823,240,11691,9493,4596,15517
2022-07-15 06:00:00+00,15167,657,4900,3905,388,1188,2110,768,1381,170,30634,231,12684,10574,5674,15824
2022-07-15 06:30:00+00,15566,709,4904,4234,410,1240,2023,851,2050,382,32369,226,13621,11598,6694,16275
2022-07-15 07:00:00+00,16191,693,4901,4273,404,1792,1995,597,2716,208,33770,227,14289,12294,7393,16884
2022-07-15 07:30:00+00,16148,612,4910,4381,402,1858,2026,460,3399,0,34196,221,15118,13092,8182,16760
2022-07-15 08:00:00+00,16491,695,4906,4504,300,2034,2087,219,4197,70,35503,219,15994,13907,9001,17186
2022-07-15 08:30:00+00,16087,699,4898,4709,308,2030,2162,175,5056,0,36124,211,17133,14971,10073,16786
2022-07-15 09:00:00+00,15903,884,4897,4786,251,1938,2011,194,5546,26,36436,210,17491,15480,10583,16787
2022-07-15 09:30:00+00,15670,824,4914,5083,210,1930,1712,177,6265,0,36785,203,18184,16472,11558,16494
2022-07-15 10:00:00+00,15735,689,5006,5286,162,2006,1420,152,6673,0,37129,199,18547,17127,12121,16424
2022-07-15 10:30:00+00,15443,467,5030,5866,163,1994,1342,153,6963,0,37421,189,19364,18022,12992,15910
2022-07-15 11:00:00+00,15589,459,5017,6124,150,1870,1456,166,6961,146,37938,188,19708,18252,13235,16048
2022-07-15 11:30:00+00,15584,462,5016,6167,152,1862,1591,153,6921,0,37908,189,19847,18256,13240,16046
2022-07-15 12:00:00+00,14970,474,5017,6286,132,1770,1739,166,6503,164,37221,184,19677,17938,12921,15444
2022-07-15 12:30:00+00,14684,500,5099,6415,133,1744,1760,156,6204,0,36695,184,19611,17851,12752,15184
2022-07-15 13:00:00+00,14828,459,5123,6660,135,1278,1731,151,5866,0,36231,185,19515,17784,12661,15287
2022-07-15 13:30:00+00,14865,464,5116,7107,131,1232,1552,152,5408,0,36027,185,19314,17762,12646,15329
2022-07-15 14:00:00+00,13743,468,5119,7383,129,1350,1446,151,5173,0,34962,185,19250,17804,12685,14211
2022-07-15 14:30:00+00,13760,460,5118,7730,129,1332,1451,145,5098,0,35223,184,19526,18075,12957,14220
2022-07-15 15:00:00+00,13124,463,5103,7990,164,1894,1295,165,4822,0,35020,180,19374,18079,12976,13587
2022-07-15 15:30:00+00,13701,478,5151,7803,178,1956,1286,207,4243,0,35003,187,18661,17375,12224,14179
2022-07-15 16:00:00+00,14159,281,5165,7341,210,2088,1352,197,3978,0,34771,185,18046,16694,11529,14440
2022-07-15 16:30:00+00,14510,262,5164,7146,205,2128,1400,248,3404,0,34467,191,17319,15919,10755,14772
2022-07-15 17:00:00+00,14405,302,5172,7415,221,2264,1375,239,2656,288,34337,193,16839,15464,10292,14707
2022-07-15 17:30:00+00,14640,249,5169,7327,273,2264,1371,323,1980,444,34040,197,16120,14749,9580,14889
2022-07-15 18:00:00+00,14652,275,5168,7421,438,1696,1288,450,1421,526,33335,196,15736,14448,9280,14927
2022-07-15 18:30:00+00,14624,277,5168,7247,412,1686,1176,438,901,644,32573,200,14904,13728,8560,14901
2022-07-15 19:00:00+00,14451,299,5166,6854,409,1572,1385,500,451,594,31681,204,14265,12880,7714,14750
2022-07-15 19:30:00+00,14673,304,5164,6441,406,1572,1309,391,120,594,30974,210,13440,12131,6967,14977
2022-07-15 20:00:00+00,15006,237,5166,6204,215,1569,1385,421,2,466,30671,215,12972,11587,6421,15243
2022-07-15 20:30:00+00,15754,229,5171,5260,172,1560,1323,328,0,530,30327,226,11926,10603,5432,15983
2022-07-15 21:00:00+00,16107,236,5167,4735,195,1521,1371,335,0,102,29769,234,11468,10097,4930,16343
2022-07-15 21:30:00+00,15398,231,5169,4368,235,1476,1469,336,0,0,28682,234,11241,9772,4603,15629
2022-07-15 22:00:00+00,15046,231,5178,4419,232,1096,1468,327,0,10,28007,234,11297,9829,4651,15277
2022-07-15 22:30:00+00,14699,231,5179,3819,172,1128,1494,268,0,24,27014,238,10664,9170,3991,14930
2022-07-15 23:00:00+00,15573,230,5176,2978,157,904,1220,235,0,40,26513,253,9531,8311,3135,15803
2022-07-15 23:30:00+00,15627,35,5175,2552,146,956,1383,175,0,36,26085,252,9256,7873,2698,15662
2022-07-16 00:00:00+00,15171,0,5184,2464,132,1004,1539,147,0,0,25640,247,9318,7780,2596,15171
2022-07-16 00:30:00+00,14857,0,5178,2290,132,1108,1473,157,0,0,25195,247,9073,7600,2422,14857
2022-07-16 01:00:00+00,14828,0,5178,2047,102,1260,1539,149,0,0,25103,247,8866,7327,2149,14828
2022-07-16 01:30:00+00,15019,0,5176,1749,88,1198,1548,153,0,0,24931,250,8561,7013,1837,15019
2022-07-16 02:00:00+00,15209,0,5181,1751,79,1304,1324,150,0,0,24998,254,8335,7011,1830,15209
2022-07-16 02:30:00+00,15126,0,5175,1458,100,1496,1312,154,0,0,24821,257,8045,6733,1558,15126
2022-07-16 03:00:00+00,15001,0,5178,1276,100,1832,1307,149,0,0,24843,255,7861,6554,1376,15001
2022-07-16 03:30:00+00,15166,0,5182,1196,99,1756,1276,147,0,0,24822,256,7753,6477,1295,15166
2022-07-16 04:00:00+00,14756,0,5178,1138,99,1760,1221,149,8,0,24309,254,7644,6423,1245,14756
2022-07-16 04:30:00+00,15159,0,5183,1066,105,1854,1093,145,169,0,24774,257,7616,6523,1340,15159
2022-07-16 05:00:00+00,14987,0,5185,1004,175,1738,1122,148,526,0,24885,251,8012,6890,1705,14987
2022-07-16 05:30:00+00,15244,0,5187,938,193,1606,1457,150,1030,0,25805,246,8805,7348,2161,15244
2022-07-16 06:00:00+00,14699,0,5187,841,236,2250,1643,157,1674,0,26687,240,9581,7938,2751,14699
2022-07-16 06:30:00+00,14891,0,5187,795,252,2418,1668,150,2455,0,27816,236,10357,8689,3502,14891
2022-07-16 07:00:00+00,14302,0,5190,782,268,3226,1829,155,3230,0,28982,222,11299,9470,4280,14302
2022-07-16 07:30:00+00,14189,0,5188,780,249,3272,2041,165,4041,0,29925,214,12299,10258,5070,14189
2022-07-16 08:00:00+00,14576,0,5187,801,234,3454,1965,156,4885,84,31342,210,13072,11107,5920,14576
2022-07-16 08:30:00+00,14237,0,5190,852,193,3456,1961,148,5702,0,31739,203,13898,11937,6747,14237
2022-07-16 09:00:00+00,14200,0,5187,886,99,3456,1946,147,6636,0,32557,198,14754,12808,7621,14200
2022-07-16 09:30:00+00,13907,0,5167,950,99,3456,1745,146,7431,0,32901,191,15392,13647,8480,13907
2022-07-16 10:00:00+00,13716,0,5149,988,101,3398,1632,154,7936,0,33074,187,15806,14174,9025,13716
2022-07-16 10:30:00+00,13379,0,5142,1055,97,3398,1710,145,8588,0,33514,181,16592,14882,9740,13379
2022-07-16 11:00:00+00,13103,0,5129,1131,87,3398,1763,148,9022,0,33781,176,17132,15369,10240,13103
2022-07-16 11:30:00+00,12794,0,5116,1252,85,3400,1619,150,9284,0,33700,173,17356,15737,10621,12794
2022-07-16 12:00:00+00,12200,0,5099,1421,83,3380,1594,162,9352,0,33291,168,17549,15955,10856,12200
2022-07-16 12:30:00+00,12002,0,5095,1544,82,3382,1688,156,9258,0,33207,166,17667,15979,10884,12002
2022-07-16 13:00:00+00,11614,0,5091,1687,82,3458,1749,149,9028,0,32858,164,17637,15888,10797,11614
2022-07-16 13:30:00+00,11445,0,5092,1917,81,3458,1663,149,8640,0,32445,164,17393,15730,10638,11445
2022-07-16 14:00:00+00,11820,0,5090,2219,82,3412,1590,158,8067,0,32438,168,17048,15458,10368,11820
2022-07-16 14:30:00+00,12125,0,5085,2490,97,3400,1725,155,7384,0,32461,172,16781,15056,9971,12125
2022-07-16 15:00:00+00,12755,0,5087,2788,97,2818,1832,150,6637,0,32164,180,16441,14609,9522,12755
2022-07-16 15:30:00+00,13528,37,5084,3054,102,2802,1894,153,5698,0,32353,189,15832,13938,8854,13566
2022-07-16 16:00:00+00,14660,75,5089,3344,134,2282,2054,155,4712,154,32659,200,15333,13279,8190,14735
2022-07-16 16:30:00+00,15322,327,5092,3586,154,2234,2125,153,3748,96,32837,214,14705,12580,7488,15649
2022-07-16 17:00:00+00,15538,485,5094,3751,243,1534,2064,233,2875,464,32281,216,14027,11963,6869,16023
2022-07-16 17:30:00+00,15299,450,5094,4051,260,1480,2034,467,2027,712,31874,216,13466,11432,6338,15749
2022-07-16 18:00:00+00,15229,265,5091,4287,303,1319,1779,795,1319,922,31309,215,12779,11000,5909,15494
2022-07-16 18:30:00+00,15315,235,5090,4580,302,1274,1870,745,787,746,30944,218,12629,10759,5669,15550
2022-07-16 19:00:00+00,15248,232,5093,4752,283,1390,1701,609,373,728,30409,221,12202,10501,5408,15480
2022-07-16 19:30:00+00,15118,236,5090,4943,222,1370,1770,434,95,524,29802,222,12120,10350,5260,15354
2022-07-16 20:00:00+00,14969,232,5098,5208,206,1542,1849,348,1,318,29771,222,12362,10513,5415,15201
2022-07-16 20:30:00+00,14929,255,5089,5138,197,1568,1842,295,0,304,29617,223,12266,10424,5335,15184
2022-07-16 21:00:00+00,15091,361,5092,5125,114,1492,1900,264,0,0,29439,232,12231,10331,5239,15452
2022-07-16 21:30:00+00,14659,364,5098,5407,111,1488,1597,184,0,0,28908,228,12213,10616,5518,15023
2022-07-16 22:00:00+00,14728,37,5097,5051,111,1102,1600,263,0,0,27989,227,11859,10259,5162,14765
2022-07-16 22:30:00+00,14321,0,5099,4916,111,918,1640,217,0,0,27222,223,11766,10126,5027,14321
2022-07-16 23:00:00+00,14206,0,5105,4693,84,360,1666,181,0,0,26295,227,11548,9882,4777,14206
2022-07-16 23:30:00+00,13959,0,5106,4557,83,182,1811,184,0,0,25882,225,11557,9746,4640,13959
2022-07-17 00:00:00+00,13998,0,5085,4554,83,70,1955,218,0,0,25963,227,11677,9722,4637,13998
2022-07-17 00:30:00+00,13891,0,5092,4576,83,56,1962,169,0,0,25829,225,11713,9751,4659,13891
2022-07-17 01:00:00+00,13983,0,5102,4653,48,14,1924,156,0,0,25880,225,11727,9803,4701,13983
2022-07-17 01:30:00+00,13878,0,5099,4530,48,7,1831,173,0,0,25566,226,11508,9677,4578,13878
2022-07-17 02:00:00+00,13060,0,5110,4669,48,0,1905,154,0,0,24946,219,11732,9827,4717,13060
2022-07-17 02:30:00+00,12731,0,5100,4564,48,0,1922,161,0,0,24526,217,11634,9712,4612,12731
2022-07-17 03:00:00+00,12335,0,5102,4577,48,68,1596,154,0,0,23880,216,11323,9727,4625,12335
2022-07-17 03:30:00+00,12173,0,5102,4779,48,4,1321,155,0,0,23582,214,11250,9929,4827,12173
2022-07-17 04:00:00+00,12158,0,5109,4830,48,0,1337,155,4,0,23641,213,11328,9991,4882,12158
2022-07-17 04:30:00+00,11978,0,5103,4868,64,0,1348,156,119,0,23636,210,11502,10154,5051,11978
2022-07-17 05:00:00+00,11945,0,5105,4751,88,0,1441,162,384,0,23876,208,11769,10328,5223,11945
2022-07-17 05:30:00+00,12200,0,5105,4535,96,0,1477,177,840,0,24430,208,12053,10576,5471,12200
2022-07-17 06:00:00+00,11660,0,5105,4349,159,152,1367,168,1385,0,24345,199,12365,10998,5893,11660
2022-07-17 06:30:00+00,12116,0,5106,4145,159,228,1479,182,2108,0,25523,197,12997,11518,6412,12116
2022-07-17 07:00:00+00,11747,0,5105,3915,159,922,1626,160,2751,0,26385,187,13556,11930,6825,11747
2022-07-17 07:30:00+00,12101,0,5105,3764,184,994,1675,156,3681,110,27770,183,14409,12734,7629,12101
2022-07-17 08:00:00+00,10843,0,5101,3610,193,2790,1699,165,4459,252,29112,173,15062,13363,8262,10843
2022-07-17 08:30:00+00,11107,0,5105,3408,189,3108,1671,149,5298,0,30035,174,15671,14000,8895,11107
2022-07-17 09:00:00+00,11324,0,5104,3120,122,3426,1713,145,5893,60,30907,173,15952,14239,9135,11324
2022-07-17 09:30:00+00,11205,0,5106,3158,112,3458,1792,144,6525,110,31610,168,16693,14901,9795,11205
2022-07-17 10:00:00+00,10958,0,5102,3252,74,3422,1937,150,6964,0,31859,163,17329,15392,10290,10958
2022-07-17 10:30:00+00,11214,0,5100,3193,63,3462,1790,150,7280,0,32252,164,17426,15636,10536,11214
2022-07-17 11:00:00+00,10513,0,5100,3303,63,3782,1683,152,7744,0,32340,155,17893,16210,11110,10513
2022-07-17 11:30:00+00,10210,0,5102,3368,63,3790,1777,147,7806,0,32263,152,18116,16339,11237,10210
2022-07-17 12:00:00+00,10152,0,5110,3566,63,3700,1747,144,7504,0,31986,152,17990,16243,11133,10152
2022-07-17 12:30:00+00,9688,0,5101,3913,63,3696,1674,144,7612,0,31891,146,18363,16689,11588,9688
2022-07-17 13:00:00+00,8710,0,5100,4388,63,3918,1562,144,7966,0,31851,135,19079,17517,12417,8710
2022-07-17 13:30:00+00,8427,0,5099,4686,63,3830,1437,145,7557,0,31244,133,18842,17405,12306,8427
2022-07-17 14:00:00+00,9666,0,5099,5052,63,2912,1678,148,7173,0,31791,146,19065,17387,12288,9666
2022-07-17 14:30:00+00,9779,0,5103,5409,63,2866,1776,152,6629,0,31777,148,18980,17204,12101,9779
2022-07-17 15:00:00+00,11967,0,5100,5618,87,1086,1777,166,5816,74,31691,165,18398,16621,11521,11967
2022-07-17 15:30:00+00,12998,0,5100,5609,91,1024,1792,171,5143,272,32200,175,17735,15943,10843,12998
2022-07-17 16:00:00+00,13759,16,5108,5835,136,666,1815,319,4492,412,32558,183,17386,15571,10463,13775
2022-07-17 16:30:00+00,14030,149,5106,6060,176,688,1813,527,3570,390,32509,193,16725,14912,9806,14179
2022-07-17 17:00:00+00,13655,247,5112,6432,307,1068,1508,743,2732,516,32320,193,16091,14583,9471,13902
2022-07-17 17:30:00+00,13689,229,5104,6645,359,1142,1507,770,1971,844,32260,194,15586,14079,8975,13918
2022-07-17 18:00:00+00,13882,229,5111,7022,417,1238,1408,847,1323,610,32087,198,15281,13873,8762,14111
2022-07-17 18:30:00+00,13900,230,5104,7390,330,1240,1355,780,742,588,31659,200,14921,13566,8462,14130
2022-07-17 19:00:00+00,14257,230,5107,7725,286,834,1375,701,378,442,31335,205,14871,13496,8389,14487
2022-07-17 19:30:00+00,14002,229,5100,8131,244,624,1389,573,108,474,30874,201,14972,13583,8483,14231
2022-07-17 20:00:00+00,14471,229,5109,8348,241,212,1372,369,0,172,30523,205,15070,13698,8589,14700
2022-07-17 20:30:00+00,14343,230,5098,8234,198,134,1404,290,0,170,30101,205,14934,13530,8432,14573
2022-07-17 21:00:00+00,14679,281,5081,8187,102,90,1542,219,0,132,30313,209,14912,13370,8289,14960
2022-07-17 21:30:00+00,13876,354,5072,8272,101,0,1636,152,0,56,29519,205,15081,13445,8373,14230
2022-07-17 22:00:00+00,14324,42,5077,8129,102,0,1629,145,0,0,29448,201,14937,13308,8231,14366
2022-07-17 22:30:00+00,13169,21,5078,8177,100,0,1737,165,0,0,28447,192,15092,13355,8277,13190
2022-07-17 23:00:00+00,13632,0,5054,7969,73,0,1970,147,0,0,28845,196,15066,13096,8042,13632
2022-07-17 23:30:00+00,13463,0,5061,7745,71,0,2165,146,0,0,28651,196,15042,12877,7816,13463
2022-07-18 00:00:00+00,13536,0,5056,7745,69,0,2064,144,0,0,28614,197,14934,12870,7814,13536
2022-07-18 00:30:00+00,13432,0,5052,7705,68,12,1891,149,0,0,28309,197,14716,12825,7773,13432
2022-07-18 01:00:00+00,13694,0,5034,7328,67,0,1899,149,0,0,28171,201,14328,12429,7395,13694
2022-07-18 01:30:00+00,13417,0,5032,7298,65,0,1881,149,0,0,27842,200,14276,12395,7363,13417
2022-07-18 02:00:00+00,13347,0,5015,6937,65,0,1916,172,0,0,27452,202,13933,12017,7002,13347
2022-07-18 02:30:00+00,13663,0,5015,6589,64,30,1897,149,0,0,27407,207,13565,11668,6653,13663
2022-07-18 03:00:00+00,13922,0,4999,6195,63,158,1930,152,0,0,27419,213,13187,11257,6258,13922
2022-07-18 03:30:00+00,14039,0,5001,5880,63,136,2053,153,0,0,27325,215,12997,10944,5943,14039
2022-07-18 04:00:00+00,13441,0,4988,5444,63,34,1985,149,2,0,26106,214,12482,10497,5509,13441
2022-07-18 04:30:00+00,14174,83,4987,4864,65,158,2110,152,142,0,26735,226,12168,10058,5071,14257
2022-07-18 05:00:00+00,14747,241,4986,4359,81,562,2221,152,483,0,27832,234,12130,9909,4923,14988
2022-07-18 05:30:00+00,15576,479,4985,3839,134,508,2423,187,977,0,29108,243,12358,9935,4950,16055
2022-07-18 06:00:00+00,15784,764,4982,3306,358,638,2587,314,1587,264,30584,244,12820,10233,5251,16548
2022-07-18 06:30:00+00,16550,902,4985,2704,515,644,2435,565,2300,702,32302,245,12939,10504,5519,17452
2022-07-18 07:00:00+00,16724,950,4988,2384,495,1762,2614,567,3121,254,33859,246,13602,10988,6000,17674
2022-07-18 07:30:00+00,17028,946,4989,2215,496,2022,2717,563,3929,230,35135,243,14346,11629,6640,17974
2022-07-18 08:00:00+00,17121,749,4990,2122,519,3114,2632,531,4825,12,36615,232,15088,12456,7466,17870
2022-07-18 08:30:00+00,17012,687,4988,2122,569,3162,2649,525,5679,176,37569,224,16007,13358,8370,17699
2022-07-18 09:00:00+00,17123,677,4988,2112,538,2610,2774,486,6465,48,37821,217,16877,14103,9115,17800
2022-07-18 09:30:00+00,17039,720,4989,2061,476,2594,2796,464,7162,0,38301,215,17484,14688,9699,17759
2022-07-18 10:00:00+00,16590,701,4988,2089,378,2926,2743,497,7743,0,38655,211,17941,15198,10210,17291
2022-07-18 10:30:00+00,16517,721,4980,2196,333,2952,2684,549,8256,0,39188,209,18449,15765,10785,17238
2022-07-18 11:00:00+00,16544,681,4972,2267,352,3146,2604,451,8548,138,39703,207,18743,16139,11167,17225
2022-07-18 11:30:00+00,16298,705,4969,2352,406,3148,2496,393,8691,12,39470,205,18914,16418,11449,17003
2022-07-18 12:00:00+00,16474,686,4963,2518,361,2596,2517,325,8709,0,39149,203,19068,16551,11588,17160
2022-07-18 12:30:00+00,16403,636,4955,2610,340,2580,2494,316,8582,0,38916,202,18981,16487,11532,17039
2022-07-18 13:00:00+00,16092,642,4946,3015,330,2766,2395,400,8333,0,38919,201,19019,16624,11678,16734
2022-07-18 13:30:00+00,16010,726,4931,3285,333,2766,2268,384,7813,0,38516,204,18630,16362,11431,16736
2022-07-18 14:00:00+00,16014,829,4921,3386,345,2480,2150,495,7271,90,37981,209,18073,15923,11002,16843
2022-07-18 14:30:00+00,16150,928,4915,3450,397,2478,2145,560,6369,128,37520,216,17276,15131,10216,17078
2022-07-18 15:00:00+00,15669,933,4914,3744,682,2882,2002,665,5839,62,37392,214,17181,15179,10265,16602
2022-07-18 15:30:00+00,15430,943,4907,4119,755,2888,1899,779,5095,644,37459,212,16775,14876,9969,16373
2022-07-18 16:00:00+00,15645,946,4906,4103,723,2906,1904,583,4282,1332,37330,214,15918,14014,9108,16591
2022-07-18 16:30:00+00,16257,944,4905,4095,722,2892,1911,580,3121,1176,36603,225,14754,12843,7938,17201
2022-07-18 17:00:00+00,15961,948,4908,4108,653,2636,1944,541,2470,1474,35643,225,14083,12139,7231,16909
2022-07-18 17:30:00+00,16411,954,4910,3994,565,2632,1897,576,1895,1514,35348,232,13261,11364,6454,17365
2022-07-18 18:00:00+00,16447,799,4913,4114,592,2584,1871,741,1336,1668,35065,234,12826,10955,6042,17246
2022-07-18 18:30:00+00,16134,757,4911,4226,602,2574,1788,623,759,1696,34070,234,12286,10498,5587,16891
2022-07-18 19:00:00+00,15932,604,4906,4415,729,2756,1807,527,340,1616,33632,231,12197,10390,5484,16536
2022-07-18 19:30:00+00,16078,599,4910,4600,662,2760,1841,531,70,1264,33315,235,12083,10242,5332,16677
2022-07-18 20:00:00+00,16532,781,4906,4663,613,2118,1988,459,0,1300,33360,238,12170,10182,5276,17313
2022-07-18 20:30:00+00,16476,687,4909,5022,512,2110,1963,399,0,886,32964,237,12406,10443,5534,17163
2022-07-18 21:00:00+00,15922,621,4908,5414,424,1866,2030,377,0,808,32370,229,12776,10746,5838,16543
2022-07-18 21:30:00+00,14959,570,4902,5455,371,1874,2044,366,0,822,31363,224,12772,10728,5826,15529
2022-07-18 22:00:00+00,15629,312,4906,5433,337,914,2179,329,0,438,30477,227,12855,10676,5770,15941
2022-07-18 22:30:00+00,15425,305,4900,5387,267,882,2255,211,0,0,29632,231,12809,10554,5654,15730
2022-07-18 23:00:00+00,15607,333,4902,5523,130,404,2237,179,0,0,29315,234,12792,10555,5653,15940
2022-07-18 23:30:00+00,15637,333,4903,5327,115,208,2164,167,0,0,28854,235,12509,10345,5442,15970
2022-07-19 00:00:00+00,15886,464,4904,5083,124,10,1951,185,0,0,28607,244,12062,10111,5207,16350
2022-07-19 00:30:00+00,15645,407,4911,5152,120,0,1949,290,0,0,28474,241,12132,10183,5272,16052
2022-07-19 01:00:00+00,15580,339,4913,5141,105,0,2148,315,0,0,28541,239,12307,10159,5246,15919
2022-07-19 01:30:00+00,15628,307,4903,5020,104,0,2301,288,0,0,28551,238,12328,10027,5124,15935
2022-07-19 02:00:00+00,15838,372,4902,4936,102,0,2304,265,0,0,28720,242,12244,9940,5038,16210
2022-07-19 02:30:00+00,15874,409,4905,4997,100,0,2304,169,0,0,28758,242,12306,10002,5097,16283
2022-07-19 03:00:00+00,16091,460,4899,4722,113,0,2300,293,0,0,28878,248,12034,9734,4835,16551
2022-07-19 03:30:00+00,16094,459,4905,4776,241,0,2286,303,0,0,29064,246,12208,9922,5017,16553
2022-07-19 04:00:00+00,16086,475,4900,4803,178,76,2340,297,2,0,29157,247,12223,9883,4983,16561
2022-07-19 04:30:00+00,16122,471,4905,4865,115,214,2351,302,162,0,29507,247,12398,10047,5142,16593
2022-07-19 05:00:00+00,16103,430,4907,4707,153,232,2347,292,492,48,29711,244,12606,10259,5352,16533
2022-07-19 05:30:00+00,16362,421,4905,4898,224,213,2345,411,894,654,31327,234,13266,10921,6016,16783
2022-07-19 06:00:00+00,15909,378,4903,5062,395,278,2344,468,1574,1104,32415,221,14278,11934,7031,16287
2022-07-19 06:30:00+00,16223,316,4905,5476,404,292,2333,661,2253,1328,34191,213,15371,13038,8133,16539
2022-07-19 07:00:00+00,16459,303,4901,6146,353,1332,2283,575,2920,746,36018,213,16603,14320,9419,16762
2022-07-19 07:30:00+00,16728,352,4902,6484,388,1488,2313,574,3716,484,37429,211,17803,15490,10588,17080
2022-07-19 08:00:00+00,16778,456,4906,6515,401,1318,2327,540,4623,458,38322,207,18772,16445,11539,17234
2022-07-19 08:30:00+00,16650,461,4909,6785,473,1318,2242,600,5347,284,39069,202,19756,17514,12605,17111
2022-07-19 09:00:00+00,16383,468,4906,6821,455,1290,2331,529,6006,104,39293,199,20519,18188,13282,16851
2022-07-19 09:30:00+00,16224,468,4905,6623,420,1308,2384,472,6647,476,39927,194,20979,18595,13690,16692
2022-07-19 10:00:00+00,15781,469,4905,6573,323,1914,2382,487,7045,656,40535,190,21228,18846,13941,16250
2022-07-19 10:30:00+00,15647,470,4914,6665,364,1926,2382,532,7464,482,40846,188,21789,19407,14493,16117
2022-07-19 11:00:00+00,15484,470,4904,6819,383,1942,2367,513,7715,194,40791,187,22188,19821,14917,15954
2022-07-19 11:30:00+00,15119,438,4906,6951,382,1942,2343,560,8027,124,40792,182,22609,20266,15360,15557
2022-07-19 12:00:00+00,14721,461,4907,7518,410,1238,2372,597,8064,290,40578,176,23271,20899,15992,15182
2022-07-19 12:30:00+00,14479,407,4903,7754,400,1264,2301,583,7737,322,40150,175,23095,20794,15891,14886
2022-07-19 13:00:00+00,14174,390,4905,8254,359,1218,2290,581,7382,112,39665,175,23190,20900,15995,14564
2022-07-19 13:30:00+00,13289,247,4903,8249,308,1330,2202,635,6929,102,38194,170,22591,20389,15486,13536
2022-07-19 14:00:00+00,13985,239,4896,7897,164,1706,2085,571,6485,154,38182,179,21527,19442,14546,14224
2022-07-19 14:30:00+00,14095,263,4894,7830,208,1762,2164,610,5872,226,37924,183,20968,18804,13910,14358
2022-07-19 15:00:00+00,14416,283,4889,7838,443,1706,2176,698,5326,132,37907,186,20672,18496,13607,14699
2022-07-19 15:30:00+00,15014,297,4893,8008,437,1682,2186,779,4529,202,38027,192,20053,17867,12974,15311
2022-07-19 16:00:00+00,15109,311,4897,8234,468,2049,2122,738,3774,866,38568,191,19495,17373,12476,15420
2022-07-19 16:30:00+00,15185,409,4903,8790,514,2116,2186,800,2954,1018,38875,193,19347,17161,12258,15594
2022-07-19 17:00:00+00,15126,465,4901,8965,594,2366,2208,812,2169,952,38558,195,18837,16629,11728,15591
2022-07-19 17:30:00+00,14935,474,4891,8599,594,2426,2179,779,1549,1414,37840,197,17812,15633,10742,15409
2022-07-19 18:00:00+00,14610,459,4902,8281,588,2892,2283,846,1006,984,36851,201,17060,14777,9875,15069
2022-07-19 18:30:00+00,14522,448,4895,7922,570,3010,2188,811,689,1002,36057,205,16264,14076,9181,14970
2022-07-19 19:00:00+00,14422,293,4902,7816,558,2542,2304,812,336,1172,35157,204,15916,13612,8710,14715
2022-07-19 19:30:00+00,14431,240,4899,7805,582,2478,2300,794,82,700,34311,208,15668,13368,8469,14671
2022-07-19 20:00:00+00,14719,238,4899,7597,541,1732,2359,791,0,842,33718,210,15396,13037,8138,14957
2022-07-19 20:30:00+00,14870,312,4903,8166,434,1688,2363,717,0,246,33699,213,15866,13503,8600,15182
2022-07-19 21:00:00+00,13637,283,4903,8694,279,2316,2326,672,0,0,33110,208,16202,13876,8973,13920
2022-07-19 21:30:00+00,12177,311,4892,8844,233,2256,2246,369,0,0,31328,198,16215,13969,9077,12488
2022-07-19 22:00:00+00,12089,340,4889,8433,209,1210,2234,294,0,0,29698,196,15765,13531,8642,12429
2022-07-19 22:30:00+00,12048,143,4889,8196,149,1180,2075,185,0,0,28865,193,15309,13234,8345,12191
2022-07-19 23:00:00+00,12967,0,4885,7848,69,1000,2194,149,0,0,29112,197,14996,12802,7917,12967
2022-07-19 23:30:00+00,12903,0,4883,7623,68,990,2153,151,0,0,28771,198,14727,12574,7691,12903
2022-07-20 00:00:00+00,13309,0,4885,7458,70,504,2182,157,0,0,28565,203,14595,12413,7528,13309
2022-07-20 00:30:00+00,13717,0,4895,6797,70,504,2218,156,0,0,28357,210,13980,11762,6867,13717
2022-07-20 01:00:00+00,14165,0,4892,5627,93,504,2323,141,0,0,27745,221,12935,10612,5720,14165
2022-07-20 01:30:00+00,14155,0,4898,5336,95,504,2268,140,0,0,27396,224,12597,10329,5431,14155
2022-07-20 02:00:00+00,14205,0,4894,5243,95,504,2235,142,0,0,27318,225,12467,10232,5338,14205
2022-07-20 02:30:00+00,13663,0,4896,5741,95,504,2225,140,0,0,27264,217,12957,10732,5836,13663
2022-07-20 03:00:00+00,13494,0,4888,5990,94,458,2241,147,0,0,27312,214,13213,10972,6084,13494
2022-07-20 03:30:00+00,13327,0,4883,6172,92,384,2219,140,0,0,27217,211,13366,11147,6264,13327
2022-07-20 04:00:00+00,12517,0,4880,6482,92,554,2154,142,0,0,26821,204,13608,11454,6574,12517
2022-07-20 04:30:00+00,12608,65,4888,7091,95,590,2137,145,50,0,27668,202,14261,12124,7236,12672
2022-07-20 05:00:00+00,12411,129,4894,7907,108,1446,2002,154,229,0,29280,192,15140,13138,8244,12540
2022-07-20 05:30:00+00,12481,267,4889,8727,129,1741,2042,204,528,0,31008,190,16315,14273,9384,12748
2022-07-20 06:00:00+00,12902,312,4893,8639,236,1850,1958,379,876,0,32045,192,16602,14644,9751,13214
2022-07-20 06:30:00+00,13483,233,4892,9462,253,1738,1839,404,1359,0,33663,186,17805,15966,11074,13716
2022-07-20 07:00:00+00,14763,230,4889,9585,257,872,1826,417,1783,138,34760,190,18340,16514,11625,14993
2022-07-20 07:30:00+00,15347,312,4890,9494,257,724,1823,411,2329,0,35587,193,18793,16970,12080,15659
2022-07-20 08:00:00+00,15236,489,4889,9282,268,916,1937,207,2821,106,36151,192,19197,17260,12371,15725
2022-07-20 08:30:00+00,15186,487,4893,9398,282,950,2079,199,3507,0,36981,188,20159,18080,13187,15673
2022-07-20 09:00:00+00,14178,407,4895,9666,292,1444,1971,196,3985,0,37034,176,20809,18838,13943,14585
2022-07-20 09:30:00+00,14346,365,4895,9178,288,1478,2118,163,4614,0,37445,175,21093,18975,14080,14711
2022-07-20 10:00:00+00,14455,303,4899,8922,205,1518,2455,154,4715,0,37626,175,21196,18741,13842,14758
2022-07-20 10:30:00+00,14609,360,4892,7970,168,1592,2550,157,5297,0,37595,178,20877,18327,13435,14969
2022-07-20 11:00:00+00,13822,361,4890,7415,122,2870,2517,174,5676,0,37847,175,20620,18103,13213,14183
2022-07-20 11:30:00+00,13800,370,4904,7173,99,2838,2478,218,5611,0,37491,177,20265,17787,12883,14170
2022-07-20 12:00:00+00,14567,438,4889,7540,89,1944,2521,266,5642,0,37896,181,20681,18160,13271,15005
2022-07-20 12:30:00+00,14563,406,4873,7903,82,1920,2506,210,5252,0,37715,181,20616,18110,13237,14969
2022-07-20 13:00:00+00,13883,363,4872,8439,92,2222,2475,214,4557,0,37117,180,20435,17960,13088,14246
2022-07-20 13:30:00+00,13724,242,4874,8685,104,2260,2522,256,3944,0,36611,179,20129,17607,12733,13966
2022-07-20 14:00:00+00,13635,266,4886,8660,105,1966,2504,406,4291,0,36719,179,20446,17942,13056,13901
2022-07-20 14:30:00+00,13748,289,4880,8575,125,1902,2532,488,4258,0,36797,180,20370,17838,12958,14037
2022-07-20 15:00:00+00,14738,292,4881,8138,260,1944,2529,517,3364,0,36663,190,19172,16643,11762,15030
2022-07-20 15:30:00+00,15349,347,4877,8021,308,1970,2574,525,2793,0,36764,198,18573,15999,11122,15696
2022-07-20 16:00:00+00,15578,370,4870,8048,255,1872,2672,620,2393,0,36678,202,18238,15566,10696,15948
2022-07-20 16:30:00+00,15099,331,4876,7948,264,1924,2689,658,1877,128,35794,200,17654,14965,10089,15430
2022-07-20 17:00:00+00,14175,296,4880,7892,308,2446,2722,624,1386,166,34895,195,17188,14466,9586,14471
2022-07-20 17:30:00+00,14061,290,4886,7932,307,2846,2722,646,969,148,34807,195,16816,14094,9208,14351
2022-07-20 18:00:00+00,13988,295,4881,7972,307,2452,2727,647,642,446,34357,191,16529,13802,8921,14283
2022-07-20 18:30:00+00,13964,263,4882,7691,305,2368,2730,577,379,456,33615,193,15987,13257,8375,14227
2022-07-20 19:00:00+00,14298,295,4880,7390,236,2288,2594,520,150,480,33131,200,15250,12656,7776,14593
2022-07-20 19:30:00+00,14382,317,4885,7292,226,2350,2398,489,29,118,32486,206,14830,12432,7547,14699
2022-07-20 20:00:00+00,14718,398,4888,7157,187,2132,2483,501,0,0,32464,214,14715,12232,7344,15116
2022-07-20 20:30:00+00,14560,326,4880,7165,184,1812,2566,432,0,0,31925,213,14795,12229,7349,14886
2022-07-20 21:00:00+00,13929,329,4879,7052,163,1366,2608,421,0,0,30747,211,14702,12094,7215,14258
2022-07-20 21:30:00+00,13651,318,4882,6774,163,1348,2373,244,0,0,29753,212,14192,11819,6937,13969
2022-07-20 22:00:00+00,14460,371,4890,6788,144,582,2362,159,0,0,29756,219,14184,11822,6932,14831
2022-07-20 22:30:00+00,13692,380,4883,7100,118,356,2142,148,0,0,28819,212,14243,12101,7218,14072
2022-07-20 23:00:00+00,13800,370,4880,7172,76,4,2335,148,0,0,28785,213,14463,12128,7248,14170
2022-07-20 23:30:00+00,13471,236,4877,7146,70,0,2248,149,0,0,28197,208,14341,12093,7216,13707
2022-07-21 00:00:00+00,13038,230,4866,7606,70,0,2293,154,0,0,28257,201,14835,12542,7676,13268
2022-07-21 00:30:00+00,12653,237,4845,7691,70,0,2283,161,0,0,27940,198,14889,12606,7761,12890
2022-07-21 01:00:00+00,12631,242,4831,7663,70,0,2373,161,0,0,27971,198,14937,12564,7733,12873
2022-07-21 01:30:00+00,12208,232,4823,8082,70,0,2376,155,0,0,27946,192,15351,12975,8152,12440
2022-07-21 02:00:00+00,12224,240,4801,7884,70,0,2388,171,0,0,27778,194,15143,12755,7954,12464
2022-07-21 02:30:00+00,12160,231,4795,7989,70,0,2383,149,0,0,27777,193,15237,12854,8059,12391
2022-07-21 03:00:00+00,12363,235,4796,7880,70,0,2382,152,0,0,27878,195,15128,12746,7950,12598
2022-07-21 03:30:00+00,12639,247,4790,7367,70,0,2390,156,0,0,27659,201,14617,12227,7437,12886
2022-07-21 04:00:00+00,12583,242,4788,6944,70,0,2390,156,0,0,27172,204,14192,11802,7014,12825
2022-07-21 04:30:00+00,13066,229,4797,6968,70,8,2359,148,28,0,27673,206,14222,11863,7066,13295
2022-07-21 05:00:00+00,12969,238,4794,7037,109,208,2110,181,183,0,27829,206,14233,12123,7329,13207
2022-07-21 05:30:00+00,13974,321,4797,6983,173,200,2442,204,425,0,29519,211,14820,12378,7581,14295
2022-07-21 06:00:00+00,14400,519,4797,6714,291,944,2100,233,782,0,30780,221,14684,12584,7787,14919
2022-07-21 06:30:00+00,14650,701,4789,6388,326,1206,2469,403,1311,68,32311,225,15283,12814,8025,15351
2022-07-21 07:00:00+00,15330,634,4773,6024,354,1754,2457,513,1899,22,33760,223,15507,13050,8277,15964
2022-07-21 07:30:00+00,15585,603,4755,5792,357,1816,2530,534,2529,40,34541,220,15963,13433,8678,16188
2022-07-21 08:00:00+00,16072,522,4742,5543,333,2318,2561,338,2872,28,35329,216,16051,13490,8748,16594
2022-07-21 08:30:00+00,16452,541,4725,5160,369,2340,2556,381,3174,0,35698,219,15984,13428,8703,16993
2022-07-21 09:00:00+00,16461,787,4727,4793,294,1904,2629,353,3563,0,35511,222,16006,13377,8650,17248
2022-07-21 09:30:00+00,16493,803,4727,4549,270,1900,2705,361,3690,0,35498,222,15941,13236,8509,17296
2022-07-21 10:00:00+00,16922,884,4722,4274,202,1608,2707,309,3994,406,36028,223,15899,13192,8470,17806
2022-07-21 10:30:00+00,17147,825,4726,3970,190,1618,2696,396,4250,484,36302,223,15832,13136,8410,17972
2022-07-21 11:00:00+00,17355,831,4720,3820,174,1646,2567,423,4267,468,36271,226,15548,12981,8261,18186
2022-07-21 11:30:00+00,17376,909,4728,3435,188,1648,2532,431,4097,794,36138,229,14980,12448,7720,18285
2022-07-21 12:00:00+00,17525,983,4733,3410,244,1396,2510,625,4216,234,35876,233,15113,12603,7870,18508
2022-07-21 12:30:00+00,17493,988,4723,3256,283,1481,2580,508,4062,294,35668,234,14904,12324,7601,18481
2022-07-21 13:00:00+00,17497,984,4726,3397,282,1646,2619,405,3966,162,35684,235,14990,12371,7645,18481
2022-07-21 13:30:00+00,17619,979,4726,3108,282,1731,2686,332,3769,154,35386,240,14571,11885,7159,18598
2022-07-21 14:00:00+00,17779,861,4717,2992,273,1834,2647,371,3623,170,35267,242,14252,11605,6888,18640
2022-07-21 14:30:00+00,17764,790,4723,3002,291,1862,2676,480,3359,106,35053,243,14051,11375,6652,18554
2022-07-21 15:00:00+00,17856,775,4731,3073,402,2302,2711,523,2901,0,35274,246,13818,11107,6376,18631
2022-07-21 15:30:00+00,18072,846,4731,2976,436,2308,2728,656,2705,108,35566,249,13576,10848,6117,18918
2022-07-21 16:00:00+00,17983,815,4732,2952,496,2670,2762,728,2359,562,36059,247,13301,10539,5807,18798
2022-07-21 16:30:00+00,18019,825,4730,3010,528,2674,2806,757,1958,596,35903,249,13032,10226,5496,18844
2022-07-21 17:00:00+00,17920,838,4729,3030,593,2712,2807,770,1355,668,35422,252,12514,9707,4978,18758
2022-07-21 17:30:00+00,17861,809,4728,3052,587,2674,2808,868,918,668,34973,254,12093,9285,4557,18670
2022-07-21 18:00:00+00,17853,801,4735,2965,615,1892,2806,1184,631,720,34202,257,11752,8946,4211,18654
2022-07-21 18:30:00+00,17566,826,4733,2812,613,1876,2803,1107,338,666,33340,260,11299,8496,3763,18392
2022-07-21 19:00:00+00,17492,985,4728,2596,568,1650,2792,924,128,714,32577,265,10812,8020,3292,18477
2022-07-21 19:30:00+00,17537,983,4731,2445,570,1650,2737,634,19,700,32006,267,10502,7765,3034,18520
2022-07-21 20:00:00+00,17341,983,4737,2467,507,1758,2715,550,0,18,31076,273,10426,7711,2974,18324
2022-07-21 20:30:00+00,16937,864,4732,2675,522,1816,2767,354,0,52,30719,265,10696,7929,3197,17801
2022-07-21 21:00:00+00,16705,514,4732,2551,441,1800,2771,238,0,0,29752,258,10495,7724,2992,17219
2022-07-21 21:30:00+00,16014,497,4729,2350,410,1622,2741,232,0,0,28595,257,10230,7489,2760,16511
2022-07-21 22:00:00+00,16545,496,4735,2221,284,928,2583,169,0,136,28097,264,9823,7240,2505,17041
2022-07-21 22:30:00+00,15835,499,4731,2098,298,1018,2425,192,0,0,27096,264,9552,7127,2396,16334
2022-07-21 23:00:00+00,15796,498,4740,1984,123,780,2456,166,0,0,26543,272,9303,6847,2107,16294
2022-07-21 23:30:00+00,15440,498,4737,1890,110,812,2459,147,0,0,26093,272,9196,6737,2000,15938
2022-07-22 00:00:00+00,15446,498,4736,1903,110,420,2443,147,0,0,25703,276,9192,6749,2013,15944
2022-07-22 00:30:00+00,15212,497,4731,1971,111,408,2452,147,0,0,25529,274,9265,6813,2082,15709
2022-07-22 01:00:00+00,15850,488,4739,1941,94,486,2450,148,0,0,26196,277,9224,6774,2035,16338
2022-07-22 01:30:00+00,15828,445,4734,1811,94,394,2457,155,0,0,25918,277,9096,6639,1905,16273
2022-07-22 02:00:00+00,15852,400,4742,1777,94,484,2631,153,0,0,26133,276,9244,6613,1871,16252
2022-07-22 02:30:00+00,15826,400,4741,1701,94,504,2750,151,0,0,26167,276,9286,6536,1795,16226
2022-07-22 03:00:00+00,15829,401,4752,1590,94,504,2724,149,0,0,26043,277,9160,6436,1684,16230
2022-07-22 03:30:00+00,15891,400,4742,1567,93,488,2731,151,0,0,26063,278,9133,6402,1660,16291
2022-07-22 04:00:00+00,15402,400,4753,1650,92,432,2753,144,0,0,25626,274,9248,6495,1742,15802
2022-07-22 04:30:00+00,15827,400,4748,1662,94,366,2700,157,16,0,25970,275,9220,6520,1772,16227
2022-07-22 05:00:00+00,16019,398,4745,1653,115,290,2703,187,108,14,26232,274,9324,6621,1876,16417
2022-07-22 05:30:00+00,16723,401,4745,1678,148,705,2726,403,293,116,27938,276,9590,6864,2119,17124
2022-07-22 06:00:00+00,16144,400,4744,1753,357,1456,2573,602,464,56,28549,269,9891,7318,2574,16544
2022-07-22 06:30:00+00,16352,400,4750,1945,468,1630,2650,803,713,220,29931,264,10526,7876,3126,16752
2022-07-22 07:00:00+00,17026,400,4743,2195,500,2356,2795,762,1080,168,32025,253,11313,8518,3775,17426
2022-07-22 07:30:00+00,17129,401,4747,2482,494,2474,2752,854,1452,158,32943,249,11927,9175,4428,17530
2022-07-22 08:00:00+00,17199,400,4740,2550,460,3358,2750,539,1930,296,34222,243,12430,9680,4940,17599
2022-07-22 08:30:00+00,17334,399,4738,2526,456,3374,2753,372,2236,486,34674,240,12709,9956,5218,17733
2022-07-22 09:00:00+00,17459,401,4742,2553,342,3034,2799,387,2598,482,34797,238,13034,10235,5493,17860
2022-07-22 09:30:00+00,17333,401,4741,2437,329,3034,2813,298,2806,346,34538,238,13126,10313,5572,17734
2022-07-22 10:00:00+00,17124,400,4744,2348,321,3377,2811,348,3218,312,35003,234,13442,10631,5887,17524
2022-07-22 10:30:00+00,17045,400,4743,2281,323,3406,2811,354,3650,358,35370,231,13808,10997,6254,17445
2022-07-22 11:00:00+00,17225,340,4748,2207,369,3408,2804,388,4090,298,35877,228,14218,11414,6666,17565
2022-07-22 11:30:00+00,17156,392,4752,2121,264,3405,2784,323,4060,292,35549,230,13981,11197,6445,17548
2022-07-22 12:00:00+00,17076,399,4742,1859,303,3110,2786,261,4409,336,35281,228,14099,11313,6571,17475
2022-07-22 12:30:00+00,16960,401,4750,1948,370,3063,2730,246,4518,176,35162,227,14316,11586,6836,17361
2022-07-22 13:00:00+00,17011,401,4746,2072,379,2483,2706,226,4145,184,34353,232,14048,11342,6596,17412
2022-07-22 13:30:00+00,16914,400,4743,2173,358,2404,2705,232,4085,210,34224,231,14064,11359,6616,17314
2022-07-22 14:00:00+00,17093,399,4740,2073,262,2044,2710,227,3873,182,33603,239,13658,10948,6208,17492
2022-07-22 14:30:00+00,17179,400,4739,2060,285,2035,2712,255,3758,0,33423,242,13554,10842,6103,17579
2022-07-22 15:00:00+00,17039,473,4740,2038,371,2165,2715,426,3344,228,33539,241,13208,10493,5753,17512
2022-07-22 15:30:00+00,17045,499,4739,2095,396,2186,2717,426,2979,374,33456,242,12926,10209,5470,17544
2022-07-22 16:00:00+00,16997,498,4740,2066,594,1722,2718,627,2721,792,33475,239,12839,10121,5381,17495
2022-07-22 16:30:00+00,17174,496,4743,2026,593,1744,2717,720,2265,912,33390,242,12344,9627,4884,17670
2022-07-22 17:00:00+00,17338,496,4741,1970,713,1902,2671,811,1907,834,33383,244,12002,9331,4590,17834
2022-07-22 17:30:00+00,17411,495,4744,1856,734,1902,2598,816,1312,730,32598,250,11244,8646,3902,17906
2022-07-22 18:00:00+00,17368,496,4745,1829,698,1476,2591,1126,852,764,31945,253,10715,8124,3379,17864
2022-07-22 18:30:00+00,17280,498,4743,1780,681,1456,2520,1158,539,986,31641,254,10263,7743,3000,17778
2022-07-22 19:00:00+00,17361,498,4743,1744,610,1580,2583,977,184,774,31054,258,9864,7281,2538,17859
2022-07-22 19:30:00+00,17171,499,4748,1689,602,1638,2544,610,30,762,30293,259,9613,7069,2321,17670
2022-07-22 20:00:00+00,17071,500,4741,1624,474,1318,2615,691,0,574,29608,263,9454,6839,2098,17571
2022-07-22 20:30:00+00,16846,498,4733,1536,467,1318,2624,692,0,428,29142,264,9360,6736,2003,17344
2022-07-22 21:00:00+00,16627,498,4725,1500,448,1366,2627,526,0,282,28599,265,9300,6673,1948,17125
2022-07-22 21:30:00+00,16316,497,4712,1515,414,1352,2633,250,0,86,27775,265,9274,6641,1929,16813
2022-07-22 22:00:00+00,16665,498,4707,1441,357,1048,2558,333,0,0,27607,275,9063,6505,1798,17163
2022-07-22 22:30:00+00,16344,498,4701,1421,336,998,2208,202,0,0,26708,277,8666,6458,1757,16842
2022-07-22 23:00:00+00,16399,496,4696,1362,264,466,2066,170,0,16,25935,282,8388,6322,1626,16895
2022-07-22 23:30:00+00,15958,497,4691,1263,232,422,2064,169,0,0,25296,282,8250,6186,1495,16455
2022-07-23 00:00:00+00,15170,498,4685,1188,230,440,2064,184,0,0,24459,284,8167,6103,1418,15668
2022-07-23 00:30:00+00,15023,499,4670,1206,225,412,2064,197,0,16,24312,283,8165,6101,1431,15522
2022-07-23 01:00:00+00,14706,500,4660,1145,181,372,2058,229,0,0,23851,283,8044,5986,1326,15206
2022-07-23 01:30:00+00,14574,499,4651,1128,179,424,2057,193,0,0,23705,283,8015,5958,1307,15073
2022-07-23 02:00:00+00,14336,499,4649,1160,130,502,2058,167,0,22,23523,282,7997,5939,1290,14835
2022-07-23 02:30:00+00,14418,500,4638,1172,156,504,1875,168,0,0,23431,284,7841,5966,1328,14918
2022-07-23 03:00:00+00,14451,500,4631,1279,158,504,1557,215,0,26,23321,285,7625,6068,1437,14951
2022-07-23 03:30:00+00,14233,500,4628,1446,157,504,1553,191,0,0,23212,282,7784,6231,1603,14733
2022-07-23 04:00:00+00,14098,501,4620,1668,146,504,1556,217,0,0,23310,279,7990,6434,1814,14599
2022-07-23 04:30:00+00,14032,501,4609,1874,153,504,1559,270,78,0,23580,276,8273,6714,2105,14533
2022-07-23 05:00:00+00,13528,500,4605,2175,227,566,1560,343,342,0,23846,265,8909,7349,2744,14028
2022-07-23 05:30:00+00,13620,502,4595,2379,252,622,1543,343,818,2,24676,258,9587,8044,3449,14122
2022-07-23 06:00:00+00,12835,500,4584,2593,338,994,1375,319,1292,58,24888,242,10182,8807,4223,13335
2022-07-23 06:30:00+00,12863,497,4576,2806,363,998,1356,354,1878,142,25833,234,10979,9623,5047,13360
2022-07-23 07:00:00+00,12812,497,4566,3052,350,1246,1383,313,2574,110,26903,226,11925,10542,5976,13309
2022-07-23 07:30:00+00,13276,498,4560,3154,350,1124,1356,313,3185,52,27868,223,12605,11249,6689,13774
2022-07-23 08:00:00+00,13304,500,4550,3457,340,1794,1387,266,3742,280,29620,216,13476,12089,7539,13804
2022-07-23 08:30:00+00,12987,499,4551,3800,302,1942,1382,249,4401,88,30201,209,14436,13054,8503,13486
2022-07-23 09:00:00+00,12121,497,4548,4523,233,2802,1345,182,4869,0,31120,194,15518,14173,9625,12618
2022-07-23 09:30:00+00,11455,498,4547,5403,234,2848,1379,165,5212,0,31741,181,16775,15396,10849,11953
2022-07-23 10:00:00+00,10462,499,4544,5783,147,3362,1309,168,5426,58,31758,170,17209,15900,11356,10961
2022-07-23 10:30:00+00,10018,499,4549,6566,146,3412,1223,150,5490,0,32053,163,17974,16751,12202,10517
2022-07-23 11:00:00+00,9431,368,4546,7258,114,3378,1211,149,5445,12,31912,153,18574,17363,12817,9799
2022-07-23 11:30:00+00,8859,308,4549,7983,104,3368,1200,145,5342,0,31858,144,19178,17978,13429,9167
2022-07-23 12:00:00+00,8327,486,4547,8661,105,2918,1236,149,4837,36,31302,146,19386,18150,13603,8813
2022-07-23 12:30:00+00,7862,494,4564,9441,115,2850,1240,145,4893,0,31604,138,20253,19013,14449,8356
2022-07-23 13:00:00+00,7313,439,4552,10141,79,2760,1246,145,4559,0,31234,134,20577,19331,14779,7752
2022-07-23 13:30:00+00,6946,422,4576,10573,74,2648,1246,145,4202,0,30832,130,20671,19425,14849,7368
2022-07-23 14:00:00+00,8101,429,4588,10739,75,1630,1271,149,3495,0,30477,143,20168,18897,14309,8530
2022-07-23 14:30:00+00,8701,492,4602,10643,67,1494,1276,148,3177,0,30600,151,19765,18489,13887,9193
2022-07-23 15:00:00+00,9870,497,4614,10773,84,452,1310,150,2941,0,30691,155,19722,18412,13798,10367
2022-07-23 15:30:00+00,10334,498,4624,10707,91,532,1319,179,2551,0,30835,162,19292,17973,13349,10832
2022-07-23 16:00:00+00,10611,498,4631,10772,324,670,1389,275,1884,0,31054,163,19000,17611,12980,11109
2022-07-23 16:30:00+00,10600,497,4642,10884,436,660,1548,300,1704,0,31271,162,19214,17666,13024,11097
2022-07-23 17:00:00+00,10602,494,4652,11260,482,620,1542,324,1326,18,31320,163,19262,17720,13068,11096
2022-07-23 17:30:00+00,10442,498,4662,11483,482,582,1551,362,855,184,31101,162,19033,17482,12820,10940
2022-07-23 18:00:00+00,10599,491,4672,11612,483,490,1540,379,672,90,31028,166,18979,17439,12767,11090
2022-07-23 18:30:00+00,10634,495,4671,11678,475,504,1552,265,390,162,30826,167,18766,17214,12543,11129
2022-07-23 19:00:00+00,10959,494,4672,11421,363,504,1548,228,160,408,30757,171,18164,16616,11944,11453
2022-07-23 19:30:00+00,10863,491,4676,11624,345,504,1542,179,20,140,30384,171,18207,16665,11989,11354
2022-07-23 20:00:00+00,10790,494,4674,11798,285,504,1552,164,0,84,30345,171,18309,16757,12083,11284
2022-07-23 20:30:00+00,10639,491,4678,11914,280,504,1543,157,0,64,30270,169,18415,16872,12194,11130
2022-07-23 21:00:00+00,9592,454,4679,12617,283,504,1511,156,0,94,29890,156,19090,17579,12900,10046
2022-07-23 21:30:00+00,8458,366,4680,13137,283,504,1419,154,0,0,29001,142,19519,18100,13420,8824
2022-07-23 22:00:00+00,7258,464,4692,13533,306,442,1214,198,0,0,28107,132,19745,18531,13839,7722
2022-07-23 22:30:00+00,6263,472,4685,13712,269,292,1005,210,0,0,26908,120,19671,18666,13981,6735
2022-07-23 23:00:00+00,5802,342,4684,13848,255,204,665,157,0,0,25957,109,19452,18787,14103,6144
2022-07-23 23:30:00+00,5232,308,4681,14101,236,204,565,146,0,0,25473,100,19583,19018,14337,5540
2022-07-24 00:00:00+00,4568,230,4691,14302,199,204,563,144,0,0,24901,89,19755,19192,14501,4798
2022-07-24 00:30:00+00,4439,231,4684,14234,174,228,565,155,0,0,24710,88,19657,19092,14408,4670
2022-07-24 01:00:00+00,4417,230,4682,14255,153,204,565,151,0,0,24657,88,19655,19090,14408,4647
2022-07-24 01:30:00+00,4152,231,4682,14353,167,204,565,145,0,0,24499,84,19767,19202,14520,4383
2022-07-24 02:00:00+00,4146,231,4674,14539,141,204,564,143,0,0,24642,83,19918,19354,14680,4377
2022-07-24 02:30:00+00,4038,234,4673,14247,151,204,562,150,0,0,24259,83,19633,19071,14398,4272
2022-07-24 03:00:00+00,4050,239,4674,14128,150,204,562,149,0,0,24156,84,19514,18952,14278,4289
2022-07-24 03:30:00+00,4003,237,4675,14020,149,204,562,155,0,0,24005,84,19406,18844,14169,4240
2022-07-24 04:00:00+00,4046,242,4667,13980,186,204,561,160,0,0,24046,84,19394,18833,14166,4288
2022-07-24 04:30:00+00,3979,239,4671,13955,185,204,563,156,36,0,23988,83,19410,18847,14176,4218
2022-07-24 05:00:00+00,4076,234,4679,13631,199,204,563,157,146,0,23889,85,19218,18655,13976,4310
2022-07-24 05:30:00+00,4133,259,4704,13727,206,186,563,161,398,0,24337,85,19598,19035,14331,4392
2022-07-24 06:00:00+00,3785,232,4707,13806,294,86,563,150,690,0,24313,77,20060,19497,14790,4017
2022-07-24 06:30:00+00,3780,232,4702,13813,309,182,563,154,1188,0,24923,76,20575,20012,15310,4012
2022-07-24 07:00:00+00,3451,230,4702,13683,320,952,566,151,1777,0,25832,75,21048,20482,15780,3681
2022-07-24 07:30:00+00,3443,232,4697,13794,309,1162,569,164,2446,0,26816,75,21815,21246,16549,3675
2022-07-24 08:00:00+00,3411,229,4711,13664,315,2694,567,150,3481,0,29222,76,22738,22171,17460,3640
2022-07-24 08:30:00+00,3375,230,4733,13878,323,2784,566,150,4191,0,30230,73,23691,23125,18392,3605
2022-07-24 09:00:00+00,3781,2,4736,13956,242,3124,341,148,4730,0,31060,69,24005,23664,18928,3783
2022-07-24 09:30:00+00,3688,1,4732,14043,225,3156,266,152,4962,0,31225,67,24228,23962,19230,3689
2022-07-24 10:00:00+00,3800,0,4734,13842,185,3100,264,148,5044,0,31117,68,24069,23805,19071,3800
2022-07-24 10:30:00+00,4042,0,4734,13486,182,3098,264,162,5631,72,31671,70,24297,24033,19299,4042
2022-07-24 11:00:00+00,4279,0,4740,12940,127,3123,263,156,6012,282,31922,73,24082,23819,19079,4279
2022-07-24 11:30:00+00,4241,0,4738,12903,127,3094,264,163,6119,272,31922,72,24151,23887,19149,4241
2022-07-24 12:00:00+00,4223,0,4755,12654,127,2960,263,168,6193,158,31500,71,23992,23729,18974,4223
2022-07-24 12:30:00+00,4242,0,4771,12543,127,2915,263,167,6450,70,31548,70,24154,23891,19120,4242
2022-07-24 13:00:00+00,4098,27,4786,12483,141,2854,262,149,6120,0,30919,70,23792,23530,18744,4125
2022-07-24 13:30:00+00,4272,54,4800,12224,139,2806,263,159,5884,128,30729,73,23310,23047,18247,4326
2022-07-24 14:00:00+00,4678,81,4822,12347,183,2632,293,148,5572,0,30757,78,23217,22924,18102,4759
2022-07-24 14:30:00+00,4918,245,4837,12581,213,2588,422,153,5079,0,31035,85,23132,22710,17873,5163
2022-07-24 15:00:00+00,5058,439,4843,12651,256,2663,534,156,4407,48,31056,92,22691,22157,17314,5497
2022-07-24 15:30:00+00,6214,671,4836,12671,290,2701,549,154,3610,158,31854,113,21956,21407,16571,6885
2022-07-24 16:00:00+00,8099,950,4837,12989,383,1487,910,221,2943,394,33212,138,22062,21152,16315,9049
2022-07-24 16:30:00+00,8495,978,4842,13079,450,1345,1218,230,2210,252,33098,143,21799,20581,15739,9473
2022-07-24 17:00:00+00,8760,952,4841,13069,632,1668,1424,412,1404,306,33468,147,21370,19946,15105,9712
2022-07-24 17:30:00+00,9070,894,4833,13067,645,1612,1446,469,1086,376,33498,148,21077,19631,14798,9964
2022-07-24 18:00:00+00,9944,913,4838,12718,665,1078,1450,534,738,370,33248,159,20409,18959,14121,10857
2022-07-24 18:30:00+00,10183,789,4834,12332,671,959,1362,384,457,640,32611,159,19656,18294,13460,10972
2022-07-24 19:00:00+00,10061,639,4841,12322,587,694,1354,283,194,532,31507,157,19298,17944,13103,10700
2022-07-24 19:30:00+00,10133,595,4834,12200,553,615,1355,274,33,712,31305,156,18975,17620,12786,10728
2022-07-24 20:00:00+00,10541,591,4831,11974,470,575,1356,306,0,328,30972,163,18631,17275,12444,11132
2022-07-24 20:30:00+00,10559,572,4841,11651,465,507,1356,263,0,302,30516,164,18313,16957,12116,11131
2022-07-24 21:00:00+00,10837,587,4836,11216,391,275,1356,275,0,368,30141,169,17799,16443,11607,11424
2022-07-24 21:30:00+00,9941,673,4835,10881,391,198,1356,268,0,280,28823,166,17463,16107,11272,10614
2022-07-24 22:00:00+00,9168,872,4839,10444,374,0,1286,219,0,374,27576,169,16943,15657,10818,10040
2022-07-24 22:30:00+00,8251,839,4842,10429,337,0,1250,168,0,296,26412,160,16858,15608,10766,9090
2022-07-24 23:00:00+00,8567,915,4836,10471,176,0,1215,174,0,56,26410,168,16698,15483,10647,9482
2022-07-24 23:30:00+00,8513,815,4840,10437,152,0,1250,173,0,0,26180,165,16679,15429,10589,9328
2022-07-25 00:00:00+00,8409,777,4838,10419,116,0,1296,159,0,0,26014,163,16669,15373,10535,9186
2022-07-25 00:30:00+00,8085,784,4836,10378,116,0,1235,155,0,0,25589,161,16565,15330,10494,8869
2022-07-25 01:00:00+00,8126,741,4838,10073,116,0,902,152,0,0,24948,162,15929,15027,10189,8867
2022-07-25 01:30:00+00,8072,797,4830,9785,116,0,857,153,0,0,24610,166,15588,14731,9901,8869
2022-07-25 02:00:00+00,7969,981,4817,9492,134,60,865,153,0,0,24471,173,15308,14443,9626,8950
2022-07-25 02:30:00+00,7736,903,4811,9513,141,174,870,155,0,0,24303,170,15335,14465,9654,8639
2022-07-25 03:00:00+00,7862,978,4801,9248,121,194,870,176,0,0,24250,176,15040,14170,9369,8840
2022-07-25 03:30:00+00,7683,978,4803,9676,122,194,871,189,0,0,24516,171,15472,14601,9798,8661
2022-07-25 04:00:00+00,7313,961,4797,10050,121,194,889,167,0,32,24524,164,15857,14968,10171,8274
2022-07-25 04:30:00+00,7281,836,4799,10522,122,194,1211,164,22,0,25151,156,16676,15465,10666,8117
2022-07-25 05:00:00+00,8169,681,4765,10834,136,194,1522,179,186,0,26666,157,17443,15921,11156,8850
2022-07-25 05:30:00+00,9400,717,4743,11024,163,194,1558,176,523,62,28560,165,18011,16453,11710,10117
2022-07-25 06:00:00+00,9914,704,4740,11279,346,194,1640,173,931,32,29953,164,18936,17296,12556,10618
2022-07-25 06:30:00+00,10507,624,4744,11520,363,194,1844,183,1399,0,31378,162,19870,18026,13282,11131
2022-07-25 07:00:00+00,10742,827,4741,11743,375,413,2033,166,1764,174,32977,166,20656,18623,13882,11569
2022-07-25 07:30:00+00,10950,981,4740,12080,365,631,2021,211,2217,32,34228,170,21423,19402,14662,11931
2022-07-25 08:00:00+00,10280,988,4737,12376,337,1040,2009,144,2394,14,34319,164,21853,19844,15107,11268
2022-07-25 08:30:00+00,9964,987,4734,12592,352,1126,2026,142,2895,0,34818,159,22599,20573,15839,10951
2022-07-25 09:00:00+00,9440,980,4734,12742,275,1534,1988,139,3612,0,35444,152,23351,21363,16629,10420
2022-07-25 09:30:00+00,9374,985,4736,12728,271,1588,1863,142,4144,0,35831,150,23742,21879,17143,10359
2022-07-25 10:00:00+00,9731,764,4737,12355,199,1868,1746,140,4211,0,35751,150,23248,21502,16765,10495
2022-07-25 10:30:00+00,9690,685,4735,12896,191,1814,1498,141,4407,0,36057,145,23727,22229,17494,10375
2022-07-25 11:00:00+00,9625,958,4734,13097,153,1996,1488,149,4564,0,36764,147,24036,22548,17814,10583
2022-07-25 11:30:00+00,9417,965,4743,13445,152,2002,1602,141,4504,0,36971,145,24446,22844,18101,10382
2022-07-25 12:00:00+00,9254,862,4741,13675,132,2002,1709,143,4326,0,36844,141,24583,22874,18133,10116
2022-07-25 12:30:00+00,9309,898,4743,13529,133,2004,1567,145,4209,0,36537,144,24181,22614,17871,10207
2022-07-25 13:00:00+00,9502,976,4741,13553,132,2058,1546,154,4635,0,37297,145,24607,23061,18320,10478
2022-07-25 13:30:00+00,9641,977,4738,13523,140,2058,1335,150,4326,0,36888,148,24062,22727,17989,10618
2022-07-25 14:00:00+00,9527,987,4741,13721,175,2030,1304,158,4296,0,36939,147,24237,22933,18192,10514
2022-07-25 14:30:00+00,9793,983,4737,12968,180,2030,1484,162,3936,0,36273,153,23305,21821,17084,10776
2022-07-25 15:00:00+00,9957,972,4751,12784,210,1772,1866,172,3485,0,35969,156,23096,21230,16479,10929
2022-07-25 15:30:00+00,10520,981,4745,12456,243,1750,2014,209,2876,220,36014,163,22334,20320,15575,11501
2022-07-25 16:00:00+00,11364,984,4740,12533,344,1348,2082,427,2278,38,36138,170,21977,19895,15155,12348
2022-07-25 16:30:00+00,11859,984,4739,12506,383,1342,2081,596,2006,0,36496,176,21715,19634,14895,12843
2022-07-25 17:00:00+00,12647,978,4732,12061,444,252,2058,685,1782,336,35975,182,21077,19019,14287,13625
2022-07-25 17:30:00+00,12745,941,4733,11935,445,374,1980,532,1210,140,35035,187,20303,18323,13590,13686
2022-07-25 18:00:00+00,12809,978,4730,11500,449,569,1953,232,777,676,34673,187,19409,17456,12726,13787
2022-07-25 18:30:00+00,12749,972,4731,10912,460,486,2032,331,464,728,33865,190,18599,16567,11836,13721
2022-07-25 19:00:00+00,13203,976,4728,10195,422,64,2002,596,197,890,33273,198,17544,15542,10814,14179
2022-07-25 19:30:00+00,12871,982,4732,10047,419,0,2002,657,23,722,32455,198,17223,15221,10489,13853
2022-07-25 20:00:00+00,12718,985,4732,9779,378,0,2001,647,0,462,31702,201,16890,14889,10157,13703
2022-07-25 20:30:00+00,12219,966,4738,10272,382,0,2032,571,0,30,31210,197,17424,15392,10654,13185
2022-07-25 21:00:00+00,11955,985,4730,10368,303,0,2007,450,0,508,31306,192,17408,15401,10671,12940
2022-07-25 21:30:00+00,11110,974,4737,11272,301,0,1784,315,0,0,30493,184,18094,16310,11573,12084
2022-07-25 22:00:00+00,9705,980,4733,11417,225,74,1492,236,0,0,28862,173,17867,16375,11642,10685
2022-07-25 22:30:00+00,9124,984,4732,11044,210,104,1169,208,0,0,27575,171,17155,15986,11254,10108
2022-07-25 23:00:00+00,9061,984,4727,10777,138,6,1152,198,0,0,27043,173,16794,15642,10915,10045
2022-07-25 23:30:00+00,9345,984,4717,10165,118,0,1163,198,0,0,26690,180,16163,15000,10283,10329
2022-07-26 00:00:00+00,9897,986,4709,9949,116,166,1160,199,0,0,27182,185,15934,14774,10065,10883
2022-07-26 00:30:00+00,9814,991,4699,9561,116,206,1226,207,0,0,26820,187,15602,14376,9677,10805
2022-07-26 01:00:00+00,9762,989,4692,8819,116,446,1383,202,0,0,26409,189,15010,13627,8935,10751
2022-07-26 01:30:00+00,9726,986,4690,8346,115,480,1508,195,0,0,26046,192,14659,13151,8461,10712
2022-07-26 02:00:00+00,9424,987,4674,7971,96,800,1566,204,0,0,25722,190,14307,12741,8067,10411
2022-07-26 02:30:00+00,9601,992,4667,7615,96,838,1448,203,0,0,25460,195,13826,12378,7711,10593
2022-07-26 03:00:00+00,9939,990,4649,7025,95,676,1491,209,0,0,25074,203,13260,11769,7120,10929
2022-07-26 03:30:00+00,10211,991,4642,6517,95,748,1693,202,0,0,25099,210,12947,11254,6612,11202
2022-07-26 04:00:00+00,10449,990,4633,6436,94,594,1742,216,0,0,25154,212,12905,11163,6530,11439
2022-07-26 04:30:00+00,11446,986,4630,6234,96,586,1499,220,53,0,25750,223,12512,11013,6383,12432
2022-07-26 05:00:00+00,12281,988,4618,5999,133,660,1434,219,234,0,26566,229,12418,10984,6366,13269
2022-07-26 05:30:00+00,13178,983,4620,5845,183,698,1884,308,530,0,28229,230,13062,11178,6558,14161
2022-07-26 06:00:00+00,13033,974,4620,5194,332,1128,2123,534,948,208,29094,223,13217,11094,6474,14007
2022-07-26 06:30:00+00,13603,981,4616,4833,487,1140,1917,622,1446,938,30583,220,13299,11382,6766,14584
2022-07-26 07:00:00+00,13948,987,4613,4572,514,1728,1898,454,1995,904,31613,219,13592,11694,7081,14935
2022-07-26 07:30:00+00,14462,976,4619,4249,589,1774,2249,367,2498,766,32549,219,14204,11955,7336,15438
2022-07-26 08:00:00+00,14547,966,4620,4084,604,2186,2231,618,2988,358,33202,222,14527,12296,7676,15513
2022-07-26 08:30:00+00,14161,982,4620,4176,608,2228,2240,583,3527,388,33513,216,15171,12931,8311,15143
2022-07-26 09:00:00+00,14194,989,4617,4091,582,2720,2248,577,3723,436,34177,217,15261,13013,8396,15183
2022-07-26 09:30:00+00,14421,988,4615,4037,536,2744,2242,597,4051,286,34517,217,15481,13239,8624,15409
2022-07-26 10:00:00+00,14533,986,4616,3763,433,3146,2251,527,4635,134,35024,219,15698,13447,8831,15519
2022-07-26 10:30:00+00,14574,985,4618,3682,424,3148,2246,499,4882,0,35058,219,15852,13606,8988,15559
2022-07-26 11:00:00+00,14543,978,4617,3653,398,3248,2247,505,4945,0,35134,218,15860,13613,8996,15521
2022-07-26 11:30:00+00,14474,987,4612,3543,273,3250,2258,416,4918,0,34731,219,15604,13346,8734,15461
2022-07-26 12:00:00+00,14431,983,4614,3571,329,3396,2254,341,4871,0,34790,218,15639,13385,8771,15414
2022-07-26 12:30:00+00,14708,987,4614,3472,234,3374,2255,241,5007,28,34920,220,15582,13327,8713,15695
2022-07-26 13:00:00+00,14714,977,4619,3495,256,2780,2251,290,5124,0,34506,217,15745,13494,8875,15691
2022-07-26 13:30:00+00,14669,989,4617,3489,254,2776,2251,283,4612,6,33946,221,15223,12972,8355,15658
2022-07-26 14:00:00+00,14795,978,4623,3469,122,2744,2254,299,4548,0,33832,222,15016,12762,8139,15773
2022-07-26 14:30:00+00,14763,977,4618,3515,171,2742,2208,355,4810,0,34159,219,15322,13114,8496,15740
2022-07-26 15:00:00+00,15088,975,4623,3656,318,2460,1964,486,4483,0,34053,221,15044,13080,8457,16063
2022-07-26 15:30:00+00,15294,981,4614,3773,322,2448,1967,694,3936,0,34029,226,14612,12645,8031,16275
2022-07-26 16:00:00+00,15939,978,4616,3741,349,2468,1978,804,3447,178,34498,235,14131,12153,7537,16917
2022-07-26 16:30:00+00,16276,987,4615,3566,365,2464,1976,817,2928,216,34210,241,13450,11474,6859,17263
2022-07-26 17:00:00+00,16512,975,4620,3482,550,2270,1977,982,2262,448,34078,243,12891,10914,6294,17487
2022-07-26 17:30:00+00,16703,984,4617,3424,548,2226,1986,1052,1642,498,33680,248,12217,10231,5614,17687
2022-07-26 18:00:00+00,17001,978,4617,3202,620,1446,1985,1103,1165,708,32825,254,11589,9604,4987,17979
2022-07-26 18:30:00+00,17068,986,4609,2997,698,1432,1995,1091,693,644,32213,259,10992,8997,4388,18054
2022-07-26 19:00:00+00,17066,982,4612,2816,602,1258,1998,1132,308,634,31408,264,10336,8338,3726,18048
2022-07-26 19:30:00+00,16860,982,4609,2495,609,1320,2011,965,48,624,30523,268,9772,7761,3152,17842
2022-07-26 20:00:00+00,16864,984,4617,2405,586,1542,2011,932,0,442,30383,273,9619,7608,2991,17848
2022-07-26 20:30:00+00,16588,988,4615,2356,573,1556,2014,929,0,140,29759,275,9558,7544,2929,17576
2022-07-26 21:00:00+00,16602,979,4619,2188,384,1832,2021,754,0,42,29421,280,9212,7191,2572,17581
2022-07-26 21:30:00+00,16269,984,4619,1949,365,1790,2021,469,0,0,28466,281,8954,6933,2314,17253
2022-07-26 22:00:00+00,16164,984,4617,1811,327,1568,1964,300,0,18,27753,278,8719,6755,2138,17148
2022-07-26 22:30:00+00,15508,989,4617,1696,223,1634,1838,288,0,0,26793,278,8374,6536,1919,16497
2022-07-26 23:00:00+00,15738,984,4613,1534,108,1592,1831,218,0,0,26618,282,8086,6254,1642,16722
2022-07-26 23:30:00+00,15578,986,4615,1405,108,1548,1834,190,0,0,26264,282,7962,6128,1513,16564
2022-07-27 00:00:00+00,15564,988,4613,1252,106,1598,1836,171,0,0,26128,284,7807,5971,1358,16552
2022-07-27 00:30:00+00,15501,987,4610,1175,107,1570,1836,163,0,0,25949,285,7728,5892,1282,16488
2022-07-27 01:00:00+00,15339,991,4615,1128,107,1512,1836,161,0,0,25689,284,7686,5850,1235,16330
2022-07-27 01:30:00+00,15131,987,4614,1031,107,1494,1791,157,0,0,25312,285,7543,5752,1138,16118
2022-07-27 02:00:00+00,14947,989,4612,931,107,1550,1827,157,0,0,25120,285,7477,5650,1038,15936
2022-07-27 02:30:00+00,14895,990,4617,931,105,1550,1834,155,0,0,25077,285,7487,5653,1036,15885
2022-07-27 03:00:00+00,14930,984,4614,950,103,1560,1828,157,0,0,25126,285,7495,5667,1053,15914
2022-07-27 03:30:00+00,14849,984,4614,944,104,1556,1959,161,0,0,25171,284,7621,5662,1048,15833
2022-07-27 04:00:00+00,15055,980,4614,936,104,1596,1942,163,0,0,25390,285,7596,5654,1040,16035
2022-07-27 04:30:00+00,15111,982,4615,871,103,1734,2142,166,62,0,25786,285,7793,5651,1036,16093
2022-07-27 05:00:00+00,14729,978,4618,767,122,1718,2258,172,363,0,25725,280,8128,5870,1252,15707
2022-07-27 05:30:00+00,15184,983,4617,660,192,1582,2564,171,842,0,26795,275,8875,6311,1694,16167
2022-07-27 06:00:00+00,15117,989,4619,615,381,1492,2533,305,1509,16,27576,266,9657,7124,2505,16106
2022-07-27 06:30:00+00,15945,976,4621,597,472,1490,2691,479,2075,0,29346,263,10456,7765,3144,16921
2022-07-27 07:00:00+00,15358,978,4618,588,539,2400,2684,429,2816,0,30410,258,11245,8561,3943,16336
2022-07-27 07:30:00+00,15562,988,4619,551,551,2558,2699,360,3650,12,31550,252,12070,9371,4752,16550
2022-07-27 08:00:00+00,15749,985,4619,521,597,2442,2698,416,4345,14,32386,244,12780,10082,5463,16734
2022-07-27 08:30:00+00,15449,988,4619,486,558,2458,2691,384,4805,66,32504,240,13159,10468,5849,16437
2022-07-27 09:00:00+00,14576,1051,4287,516,408,3188,2653,318,5021,0,32018,243,12885,10232,5945,15627
2022-07-27 09:30:00+00,14982,990,4613,566,352,3202,2667,333,5003,0,32708,241,13201,10534,5921,15972
2022-07-27 10:00:00+00,15291,987,4618,551,229,3048,2674,350,5511,134,33393,237,13583,10909,6291,16278
2022-07-27 10:30:00+00,15408,990,4629,576,227,3054,2667,346,6038,0,33935,234,14137,11470,6841,16398
2022-07-27 11:00:00+00,15305,990,4617,653,219,3206,2672,285,5901,6,33854,234,14062,11390,6773,16295
2022-07-27 11:30:00+00,15339,990,4624,717,205,3210,2671,283,5382,186,33607,237,13599,10928,6304,16329
2022-07-27 12:00:00+00,15447,987,4626,843,204,2762,2670,343,5047,32,32961,241,13390,10720,6094,16434
2022-07-27 12:30:00+00,15241,985,4610,1051,201,2758,2669,327,4834,32,32708,239,13365,10696,6086,16226
2022-07-27 13:00:00+00,15321,986,4612,1217,162,2856,2659,261,4983,140,33197,237,13633,10974,6362,16307
2022-07-27 13:30:00+00,15348,987,4613,1407,178,2836,2477,252,4944,0,33042,237,13619,11142,6529,16335
2022-07-27 14:00:00+00,15837,989,4616,1542,144,2314,2580,362,4370,44,32798,241,13252,10672,6056,16826
2022-07-27 14:30:00+00,15862,988,4610,1651,141,2312,2648,369,3503,214,32298,246,12553,9905,5295,16850
2022-07-27 15:00:00+00,15803,967,4613,1817,227,2824,2582,361,3221,264,32679,245,12460,9878,5265,16770
2022-07-27 15:30:00+00,15880,986,4614,2055,447,2832,2648,346,2663,170,32641,247,12427,9779,5165,16866
2022-07-27 16:00:00+00,16200,989,4616,2297,547,2700,2667,517,2200,196,32929,253,12327,9660,5044,17189
2022-07-27 16:30:00+00,16281,989,4608,2453,615,2712,2654,695,1773,456,33236,253,12103,9449,4841,17270
2022-07-27 17:00:00+00,16271,989,4617,2559,697,2732,2671,729,1366,466,33097,251,11910,9239,4622,17260
2022-07-27 17:30:00+00,16117,990,4614,2661,647,2710,2667,682,985,372,32445,254,11574,8907,4293,17107
2022-07-27 18:00:00+00,16417,987,4615,2817,658,1686,2622,741,641,396,31580,255,11353,8731,4116,17404
2022-07-27 18:30:00+00,15969,990,4617,3111,567,1672,2596,741,351,416,31030,253,11242,8646,4029,16959
2022-07-27 19:00:00+00,16092,989,4612,3147,594,1388,2595,535,138,328,30418,257,11086,8491,3879,17081
2022-07-27 19:30:00+00,15927,990,4611,3305,526,1496,2597,478,15,26,29971,260,11054,8457,3846,16917
2022-07-27 20:00:00+00,15877,991,4612,3448,395,1508,2597,396,0,0,29824,261,11052,8455,3843,16868
2022-07-27 20:30:00+00,15482,990,4608,3350,384,1522,2590,178,0,0,29104,259,10932,8342,3734,16472
2022-07-27 21:00:00+00,15294,989,4611,3256,292,1130,2440,225,0,0,28237,264,10599,8159,3548,16283
2022-07-27 21:30:00+00,14609,985,4606,3206,272,916,2194,215,0,0,27003,262,10278,8084,3478,15594
2022-07-27 22:00:00+00,15685,983,4611,3203,222,712,1904,274,0,0,27594,270,9940,8036,3425,16668
2022-07-27 22:30:00+00,14791,989,4608,3191,173,667,1746,258,0,0,26423,267,9718,7972,3364,15780
2022-07-27 23:00:00+00,14535,989,4605,3084,84,342,1824,241,0,26,25730,272,9597,7773,3168,15524
2022-07-27 23:30:00+00,14391,990,4610,2905,84,279,1826,245,0,0,25330,273,9425,7599,2989,15381
2022-07-28 00:00:00+00,14600,989,4611,2711,86,50,1697,237,0,0,24981,279,9105,7408,2797,15589
2022-07-28 00:30:00+00,14633,991,4608,2539,86,18,1648,245,0,0,24768,282,8881,7233,2625,15624
2022-07-28 01:00:00+00,14702,989,4607,2475,86,16,1654,229,0,0,24758,283,8822,7168,2561,15691
2022-07-28 01:30:00+00,14581,989,4608,2448,87,24,1649,227,0,0,24613,283,8792,7143,2535,15570
2022-07-28 02:00:00+00,14430,990,4615,2437,87,132,1666,173,0,0,24530,283,8805,7139,2524,15420
2022-07-28 02:30:00+00,14396,988,4613,2316,86,38,1851,167,0,0,24455,282,8866,7015,2402,15384
2022-07-28 03:00:00+00,14354,989,4620,2276,85,42,2022,171,0,0,24559,281,9003,6981,2361,15343
2022-07-28 03:30:00+00,14498,989,4614,2219,84,16,1997,158,0,0,24575,282,8914,6917,2303,15487
2022-07-28 04:00:00+00,15038,993,4612,2255,101,32,1975,153,0,0,25159,285,8943,6968,2356,16031
2022-07-28 04:30:00+00,15263,990,4611,2257,101,128,1987,172,19,0,25528,286,8975,6988,2377,16253
2022-07-28 05:00:00+00,15477,988,4614,2219,99,52,2185,172,144,0,25950,284,9261,7076,2462,16465
2022-07-28 05:30:00+00,15997,991,4615,2243,160,134,2402,205,382,0,27129,282,9802,7400,2785,16988
2022-07-28 06:00:00+00,16480,989,4614,2398,278,38,2412,358,781,2,28350,277,10483,8071,3457,17469
2022-07-28 06:30:00+00,17054,989,4617,2543,314,4,2597,427,1253,100,29898,271,11324,8727,4110,18043
2022-07-28 07:00:00+00,17129,991,4612,2553,389,406,2644,524,1704,292,31244,263,11902,9258,4646,18120
2022-07-28 07:30:00+00,17332,991,4616,2663,469,440,2673,872,2242,92,32390,260,12663,9990,5374,18323
2022-07-28 08:00:00+00,16946,989,4617,2844,449,1566,2672,771,2580,244,33678,255,13162,10490,5873,17935
2022-07-28 08:30:00+00,17192,986,4615,2977,394,1698,2672,543,2942,0,34019,255,13600,10928,6313,18178
2022-07-28 09:00:00+00,17259,986,4621,3150,317,1782,2657,405,3411,0,34588,252,14156,11499,6878,18245
2022-07-28 09:30:00+00,16910,988,4615,3439,318,1782,2491,408,3706,0,34657,247,14569,12078,7463,17898
2022-07-28 10:00:00+00,16824,986,4615,3614,251,1852,2465,364,4182,20,35173,242,15127,12662,8047,17810
2022-07-28 10:30:00+00,16939,989,4613,3867,201,1854,2340,336,4403,0,35542,240,15424,13084,8471,17928
2022-07-28 11:00:00+00,17208,987,4614,4088,194,1980,2335,292,4816,8,36522,237,16047,13712,9098,18195
2022-07-28 11:30:00+00,16802,988,4614,4564,183,1982,2336,281,4979,10,36739,231,16676,14340,9726,17790
2022-07-28 12:00:00+00,16660,990,4614,4968,122,1938,2327,270,4782,0,36671,230,16813,14486,9872,17650
2022-07-28 12:30:00+00,16523,990,4611,5027,121,1938,2341,218,4431,0,36200,231,16531,14190,9579,17513
2022-07-28 13:00:00+00,16803,988,4609,5000,121,1790,2335,192,4614,0,36452,232,16679,14344,9735,17791
2022-07-28 13:30:00+00,16737,990,4609,5148,122,1780,2248,176,4852,0,36662,229,16979,14731,10122,17727
2022-07-28 14:00:00+00,16913,990,4619,5390,137,948,2307,174,4133,0,35611,232,16586,14279,9660,17903
2022-07-28 14:30:00+00,16767,991,4612,5526,170,904,2172,185,3496,0,34823,234,15976,13804,9192,17758
2022-07-28 15:00:00+00,16649,991,4618,5574,275,814,2184,355,3102,0,34562,233,15753,13569,8951,17640
2022-07-28 15:30:00+00,17012,990,4611,5481,318,856,2395,448,2598,68,34777,237,15403,13008,8397,18002
2022-07-28 16:00:00+00,17084,989,4617,5465,337,1064,2593,549,1991,306,34995,238,15003,12410,7793,18073
2022-07-28 16:30:00+00,17277,989,4614,5320,339,1116,2611,750,1672,506,35194,241,14556,11945,7331,18266
2022-07-28 17:00:00+00,17297,990,4618,5202,395,1556,2668,775,1382,518,35401,241,14265,11597,6979,18287
2022-07-28 17:30:00+00,17387,989,4609,5099,384,1596,2672,730,1009,300,34775,247,13773,11101,6492,18376
2022-07-28 18:00:00+00,17292,990,4610,4855,352,1444,2673,780,726,590,34312,246,13216,10543,5933,18282
2022-07-28 18:30:00+00,17338,989,4611,4685,329,1446,2675,773,427,230,33503,252,12727,10052,5441,18327
2022-07-28 19:00:00+00,17387,991,4611,4397,330,1104,2677,708,187,252,32644,259,12202,9525,4914,18378
2022-07-28 19:30:00+00,17471,991,4609,4236,342,1030,2675,644,25,306,32329,261,11887,9212,4603,18462
2022-07-28 20:00:00+00,17624,988,4608,4210,326,580,2677,708,0,22,31743,267,11821,9144,4536,18612
2022-07-28 20:30:00+00,17247,991,4608,4046,339,540,2676,664,0,136,31247,266,11669,8993,4385,18238
2022-07-28 21:00:00+00,16583,988,4605,3932,297,176,2654,524,0,264,30023,265,11488,8834,4229,17571
2022-07-28 21:30:00+00,16412,989,4613,3801,262,154,2260,430,0,0,28921,270,10936,8676,4063,17401
2022-07-28 22:00:00+00,16665,988,4609,3632,229,58,1578,249,0,112,28120,277,10048,8470,3861,17653
2022-07-28 22:30:00+00,16250,990,4610,3445,225,80,1166,234,0,0,27000,281,9446,8280,3670,17240
2022-07-28 23:00:00+00,16190,990,4611,3394,117,340,1140,176,0,0,26958,284,9262,8122,3511,17180
2022-07-28 23:30:00+00,15788,989,4613,3376,136,284,1152,174,0,0,26512,282,9277,8125,3512,16777
2022-07-29 00:00:00+00,16326,989,4629,3265,123,338,1147,173,0,0,26990,285,9164,8017,3388,17315
2022-07-29 00:30:00+00,16478,989,4628,3111,121,312,1147,172,0,0,26958,288,9007,7860,3232,17467
2022-07-29 01:00:00+00,16512,990,4635,3027,126,220,1143,167,0,0,26820,288,8931,7788,3153,17502
2022-07-29 01:30:00+00,16285,991,4621,2909,144,242,1142,164,0,0,26498,288,8816,7674,3053,17276
2022-07-29 02:00:00+00,16532,991,4615,2783,131,178,1145,167,0,0,26542,291,8674,7529,2914,17523
2022-07-29 02:30:00+00,16480,991,4617,2633,121,194,1149,168,0,0,26353,292,8520,7371,2754,17471
2022-07-29 03:00:00+00,16489,988,4613,2486,127,230,1178,174,0,0,26285,294,8404,7226,2613,17477
2022-07-29 03:30:00+00,16613,991,4628,2357,152,250,1170,172,0,0,26333,295,8307,7137,2509,17604
2022-07-29 04:00:00+00,16773,990,4627,2236,152,304,1185,174,0,0,26441,298,8200,7015,2388,17763
2022-07-29 04:30:00+00,16973,989,4615,2194,163,466,1266,236,43,4,26949,299,8281,7015,2400,17962
2022-07-29 05:00:00+00,17221,991,4617,2174,195,448,1472,390,286,0,27794,295,8744,7272,2655,18212
2022-07-29 05:30:00+00,17543,990,4615,2134,197,335,1880,607,643,218,29162,289,9469,7589,2974,18533
2022-07-29 06:00:00+00,17355,991,4617,2111,361,304,2002,751,1145,322,29959,281,10236,8234,3617,18346
2022-07-29 06:30:00+00,17512,990,4613,2084,431,194,2014,809,1585,796,31028,272,10727,8713,4100,18502
2022-07-29 07:00:00+00,17438,992,4619,2037,464,638,2011,967,2286,324,31776,270,11417,9406,4787,18430
2022-07-29 07:30:00+00,17527,990,4616,1921,464,740,2013,1038,3063,214,32586,266,12077,10064,5448,18517
2022-07-29 08:00:00+00,17414,991,4617,1925,468,1948,2012,741,4153,276,34545,258,13175,11163,6546,18405
2022-07-29 08:30:00+00,17348,989,4615,2083,456,1988,2012,675,4920,248,35334,251,14086,12074,7459,18337
2022-07-29 09:00:00+00,17210,992,4619,2186,415,1668,2009,625,5564,146,35434,245,14793,12784,8165,18202
2022-07-29 09:30:00+00,16919,987,4619,2227,507,2002,2013,625,6330,142,36371,239,15696,13683,9064,17906
2022-07-29 10:00:00+00,16766,990,4614,2310,478,2002,2015,536,6903,142,36756,233,16320,14305,9691,17756
2022-07-29 10:30:00+00,16384,993,4619,2337,437,2002,2014,555,7633,142,37116,227,17040,15026,10407,17377
2022-07-29 11:00:00+00,16361,991,4608,2377,385,2002,2019,483,8143,164,37533,224,17532,15513,10905,17352
2022-07-29 11:30:00+00,16246,991,4615,2404,385,2002,2018,403,7994,144,37202,224,17416,15398,10783,17237
2022-07-29 12:00:00+00,15979,989,4615,2532,371,2002,2015,332,7888,206,36929,222,17421,15406,10791,16968
2022-07-29 12:30:00+00,15879,989,4610,2664,370,2000,2016,283,7498,148,36457,223,17158,15142,10532,16868
2022-07-29 13:00:00+00,15891,990,4610,2721,331,1998,2008,321,7237,108,36215,226,16907,14899,10289,16881
2022-07-29 13:30:00+00,16001,991,4610,2960,237,2094,1991,304,6514,6,35708,232,16312,14321,9711,16992
2022-07-29 14:00:00+00,15814,992,4609,3321,251,1804,1927,291,5826,20,34855,232,15934,14007,9398,16806
2022-07-29 14:30:00+00,15794,989,4606,3530,266,1856,1925,406,5287,12,34671,235,15614,13689,9083,16783
2022-07-29 15:00:00+00,15527,990,4609,3683,429,1642,1930,634,4404,0,33848,239,15055,13125,8516,16517
2022-07-29 15:30:00+00,15802,989,4611,3909,476,1654,1942,700,3521,156,33760,244,14459,12517,7906,16791
2022-07-29 16:00:00+00,16004,979,4608,4060,486,1418,1933,737,2949,596,33770,245,14036,12103,7495,16983
2022-07-29 16:30:00+00,15912,989,4599,4155,584,1430,1916,836,2474,758,33653,246,13728,11812,7213,16901
2022-07-29 17:00:00+00,15693,991,4591,4397,595,1708,1814,898,1804,864,33355,249,13201,11387,6796,16684
2022-07-29 17:30:00+00,15844,990,4592,4377,590,1772,1835,957,1255,768,32980,255,12649,10814,6222,16834
2022-07-29 18:00:00+00,16066,988,4587,4430,486,1430,1841,1011,794,718,32351,262,12138,10297,5710,17054
2022-07-29 18:30:00+00,16136,989,4594,4666,491,1472,1782,1009,434,282,31855,268,11967,10185,5591,17125
2022-07-29 19:00:00+00,15936,990,4592,4749,597,1532,1715,1014,144,278,31547,268,11797,10082,5490,16926
2022-07-29 19:30:00+00,15647,990,4592,4703,506,1490,1789,947,8,200,30872,269,11598,9809,5217,16637
2022-07-29 20:00:00+00,15455,991,4591,4814,542,1450,2012,976,0,0,30831,267,11959,9947,5356,16446
2022-07-29 20:30:00+00,15443,989,4592,5041,441,1458,1911,898,0,0,30773,267,11985,10074,5482,16432
2022-07-29 21:00:00+00,15285,988,4588,5218,251,1542,1806,725,0,0,30403,267,11863,10057,5469,16273
2022-07-29 21:30:00+00,14944,990,4590,5499,210,1434,1196,402,0,0,29265,265,11495,10299,5709,15934
2022-07-29 22:00:00+00,14972,988,4589,5775,177,712,1065,324,0,0,28602,258,11606,10541,5952,15960
2022-07-29 22:30:00+00,14388,989,4589,6005,176,712,1068,273,0,0,28200,253,11838,10770,6181,15377
2022-07-29 23:00:00+00,14245,991,4586,6243,140,712,678,217,0,0,27812,252,11647,10969,6383,15236
2022-07-29 23:30:00+00,13862,990,4586,6157,136,712,452,217,0,0,27112,252,11331,10879,6293,14852
2022-07-30 00:00:00+00,12975,989,4589,6447,135,712,453,204,0,0,26504,245,11624,11171,6582,13964
2022-07-30 00:30:00+00,12727,991,4591,6649,134,712,444,198,0,0,26446,241,11818,11374,6783,13718
2022-07-30 01:00:00+00,12547,989,4595,6920,132,682,435,192,0,0,26492,238,12082,11647,7052,13536
2022-07-30 01:30:00+00,12031,990,4595,7078,132,544,450,200,0,0,26020,232,12255,11805,7210,13021
2022-07-30 02:00:00+00,11693,990,4594,7269,111,472,452,202,0,0,25783,228,12426,11974,7380,12683
2022-07-30 02:30:00+00,11383,988,4592,7516,110,466,458,205,0,0,25718,223,12676,12218,7626,12371
2022-07-30 03:00:00+00,11330,991,4598,7445,110,490,459,195,0,0,25618,224,12612,12153,7555,12321
2022-07-30 03:30:00+00,11233,990,4595,7609,108,462,444,197,0,0,25638,221,12756,12312,7717,12223
2022-07-30 04:00:00+00,11250,990,4596,7634,127,534,443,196,0,0,25770,222,12800,12357,7761,12240
2022-07-30 04:30:00+00,11154,990,4585,7594,127,546,443,196,45,0,25680,221,12794,12351,7766,12144
2022-07-30 05:00:00+00,11105,990,4545,7600,159,434,438,199,205,0,25675,219,12947,12509,7964,12095
2022-07-30 05:30:00+00,11241,990,4538,7498,166,534,453,212,447,0,26079,219,13102,12649,8111,12231
2022-07-30 06:00:00+00,11548,990,4543,7475,273,670,431,219,783,0,26932,219,13505,13074,8531,12538
2022-07-30 06:30:00+00,11871,984,4539,7213,330,712,446,282,1205,78,27660,219,13733,13287,8748,12855
2022-07-30 07:00:00+00,11726,984,4547,6849,346,1038,490,375,1497,50,27902,222,13729,13239,8692,12710
2022-07-30 07:30:00+00,11683,986,4548,6826,368,926,690,516,1841,76,28460,218,14273,13583,9035,12669
2022-07-30 08:00:00+00,11463,984,4547,6670,380,1010,778,570,2325,34,28761,209,14700,13922,9375,12447
2022-07-30 08:30:00+00,11501,987,4541,6482,382,990,777,785,2850,250,29545,205,15032,14255,9714,12488
2022-07-30 09:00:00+00,11499,987,4547,6368,381,1406,778,856,3149,178,30149,208,15223,14445,9898,12486
2022-07-30 09:30:00+00,11764,987,4540,6613,358,1424,622,693,3476,180,30657,206,15609,14987,10447,12751
2022-07-30 10:00:00+00,11782,985,4547,6711,310,1992,514,245,3395,74,30555,207,15477,14963,10416,12767
2022-07-30 10:30:00+00,12393,984,4542,6635,274,2024,561,168,3771,0,31352,209,15783,15222,10680,13377
2022-07-30 11:00:00+00,12694,982,4545,6665,215,2328,435,151,4177,0,32192,207,16037,15602,11057,13676
2022-07-30 11:30:00+00,12483,982,4540,6872,215,2360,430,149,4253,0,32284,204,16310,15880,11340,13465
2022-07-30 12:00:00+00,12424,984,4534,6858,216,1914,433,152,4207,0,31722,203,16248,15815,11281,13408
2022-07-30 12:30:00+00,12351,977,4537,6762,218,1890,432,151,4306,0,31624,203,16254,15822,11286,13328
2022-07-30 13:00:00+00,12907,967,4539,6562,201,1062,432,160,3973,0,30803,209,15707,15275,10736,13874
2022-07-30 13:30:00+00,12830,981,4537,6591,201,974,483,163,3826,0,30586,209,15638,15155,10618,13811
2022-07-30 14:00:00+00,13314,985,4533,6625,222,0,667,168,3553,16,30083,210,15600,14933,10400,14299
2022-07-30 14:30:00+00,13517,985,4537,6573,243,0,742,203,3282,0,30082,213,15377,14635,10098,14502
2022-07-30 15:00:00+00,13979,982,4541,6357,342,204,686,275,3030,0,30396,220,14956,14270,9729,14961
2022-07-30 15:30:00+00,14711,988,4537,6183,476,204,712,395,2498,72,30776,228,14406,13694,9157,15699
2022-07-30 16:00:00+00,15719,985,4536,6101,557,102,774,537,2153,260,31724,234,14121,13347,8811,16704
2022-07-30 16:30:00+00,16047,986,4535,5808,550,0,776,766,1603,454,31525,240,13272,12496,7961,17033
2022-07-30 17:00:00+00,15652,986,4494,5561,672,0,770,856,1172,580,30743,242,12669,11899,7405,16638
2022-07-30 17:30:00+00,15545,989,4487,5422,601,48,708,858,883,696,30237,245,12101,11393,6906,16534
2022-07-30 18:00:00+00,16357,989,4489,4767,662,54,677,896,469,804,30164,257,11064,10387,5898,17346
2022-07-30 18:30:00+00,16672,989,4489,4212,723,70,777,882,247,704,29765,265,10448,9671,5182,17661
2022-07-30 19:00:00+00,16640,987,4494,3936,706,170,778,879,68,448,29106,272,9982,9204,4710,17627
2022-07-30 19:30:00+00,16529,990,4489,3681,630,196,777,882,2,442,28618,276,9579,8802,4313,17519
2022-07-30 20:00:00+00,16565,990,4487,3692,593,254,778,881,0,442,28682,277,9550,8772,4285,17555
2022-07-30 20:30:00+00,16506,990,4488,3607,594,180,778,771,0,570,28484,275,9467,8689,4201,17496
2022-07-30 21:00:00+00,16042,988,4509,3442,498,156,754,471,0,142,27002,280,9203,8449,3940,17030
2022-07-30 21:30:00+00,16007,990,4519,3270,347,26,487,432,0,102,26180,284,8623,8136,3617,16997
2022-07-30 22:00:00+00,15760,991,4541,3294,276,36,432,351,0,0,25681,285,8543,8111,3570,16751
2022-07-30 22:30:00+00,15197,991,4552,3130,246,26,432,245,0,0,24819,284,8360,7928,3376,16188
2022-07-30 23:00:00+00,16019,990,4572,2803,147,142,432,175,0,0,25280,293,7954,7522,2950,17009
2022-07-30 23:30:00+00,15784,991,4592,2750,142,153,432,152,0,54,25050,292,7916,7484,2892,16775
2022-07-31 00:00:00+00,15602,988,4597,2837,148,243,431,163,0,0,25009,291,8013,7582,2985,16590
2022-07-31 00:30:00+00,15079,985,4616,2971,148,264,435,171,0,0,24669,287,8170,7735,3119,16064
2022-07-31 01:00:00+00,15036,986,4624,2965,133,164,444,157,0,102,24611,286,8166,7722,3098,16022
2022-07-31 01:30:00+00,14858,988,4636,3114,116,37,434,146,0,0,24329,283,8300,7866,3230,15846
2022-07-31 02:00:00+00,14675,983,4659,3248,115,142,432,146,0,0,24400,281,8454,8022,3363,15658
2022-07-31 02:30:00+00,14519,985,4678,3285,114,168,437,149,0,0,24335,280,8514,8077,3399,15504
2022-07-31 03:00:00+00,14553,982,4693,3481,114,202,432,147,0,0,24604,278,8720,8288,3595,15535
2022-07-31 03:30:00+00,14449,976,4704,3664,112,108,432,148,0,0,24593,275,8912,8480,3776,15425
2022-07-31 04:00:00+00,14201,982,4710,3886,110,186,434,147,0,0,24656,272,9140,8706,3996,15183
2022-07-31 04:30:00+00,13697,977,4728,4417,133,148,433,147,0,0,24680,262,9711,9278,4550,14674
2022-07-31 05:00:00+00,13132,986,4732,4624,144,26,433,149,55,0,24281,256,9988,9555,4823,14118
2022-07-31 05:30:00+00,13086,978,4734,4958,150,16,429,146,207,0,24704,250,10478,10049,5315,14064
2022-07-31 06:00:00+00,12174,982,4733,5293,268,24,435,150,420,0,24479,238,11149,10714,5981,13156
2022-07-31 06:30:00+00,12003,989,4725,5507,340,76,443,160,748,0,24991,232,11763,11320,6595,12992
2022-07-31 07:00:00+00,11787,984,4733,5857,370,134,345,152,1149,0,25511,224,12454,12109,7376,12771
2022-07-31 07:30:00+00,12251,977,4733,6209,357,296,130,146,1532,0,26631,222,12961,12831,8098,13228
2022-07-31 08:00:00+00,12273,943,4730,5945,299,1308,130,154,1762,68,27612,223,12866,12736,8006,13216
2022-07-31 08:30:00+00,13045,985,4730,5623,308,1352,129,149,1997,0,28318,230,12787,12658,7928,14030
2022-07-31 09:00:00+00,12638,985,4681,5530,278,2618,130,158,2651,72,29741,219,13270,13140,8459,13623
2022-07-31 09:30:00+00,12747,987,4633,5472,239,2686,130,149,2996,14,30053,219,13470,13340,8707,13734
2022-07-31 10:00:00+00,12817,986,4633,5496,212,3084,131,153,3254,0,30766,215,13726,13595,8962,13803
2022-07-31 10:30:00+00,13017,987,4637,5161,193,3321,131,160,3596,0,31203,215,13718,13587,8950,14004
2022-07-31 11:00:00+00,12134,839,4645,5102,181,3434,131,147,3842,0,30455,203,13901,13770,9125,12973
2022-07-31 11:30:00+00,12079,929,4636,5123,180,3429,131,147,4277,0,30931,202,14347,14216,9580,13008
2022-07-31 12:00:00+00,11466,730,4637,5301,166,3491,128,147,4666,0,30732,188,14898,14770,10133,12196
2022-07-31 12:30:00+00,10774,714,4638,5609,167,3406,129,145,5320,0,30901,177,15863,15734,11096,11488
2022-07-31 13:00:00+00,10683,666,4639,5597,166,2822,128,157,5216,0,30074,178,15746,15618,10979,11349
2022-07-31 13:30:00+00,10580,858,4648,5610,163,2622,129,145,5272,0,30027,182,15822,15693,11045,11438
2022-07-31 14:00:00+00,11651,914,4645,5874,171,1607,131,152,4817,0,29962,196,15638,15507,10862,12565
2022-07-31 14:30:00+00,11873,734,4643,6126,172,1520,130,148,4784,0,30130,192,15855,15725,11082,12607
2022-07-31 15:00:00+00,12543,736,4642,6151,250,1062,130,166,4797,34,30511,196,15970,15840,11198,13279
2022-07-31 15:30:00+00,13679,848,4647,5696,316,1008,129,168,4218,44,30753,212,15006,14877,10230,14527
2022-07-31 16:00:00+00,15458,986,4652,5138,440,627,232,313,3591,278,31715,233,14053,13821,9169,16444
2022-07-31 16:30:00+00,15654,979,4654,4874,595,578,432,443,2737,44,30990,242,13292,12860,8206,16633
2022-07-31 17:00:00+00,15366,986,4650,4862,569,849,430,476,2316,486,30990,239,12827,12397,7747,16352
2022-07-31 17:30:00+00,15319,979,4652,4939,527,804,430,644,1781,544,30619,243,12329,11899,7247,16298
2022-07-31 18:00:00+00,15580,984,4648,5323,694,402,431,938,1111,704,30815,247,12207,11776,7128,16564
2022-07-31 18:30:00+00,15461,981,4648,5370,482,444,431,985,553,750,30105,252,11484,11053,6405,16442
2022-07-31 19:00:00+00,15741,989,4642,5246,434,464,431,959,163,762,29831,258,10916,10485,5843,16730
2022-07-31 19:30:00+00,16081,989,4599,4794,521,469,433,694,9,760,29349,264,10356,9923,5324,17070
2022-07-31 20:00:00+00,16308,992,4550,4476,416,574,435,740,0,536,29027,271,9877,9442,4892,17300
2022-07-31 20:30:00+00,16373,988,4549,3933,532,498,505,764,0,432,28574,275,9519,9014,4465,17361
2022-07-31 21:00:00+00,15755,990,4548,3690,485,702,488,642,0,22,27322,277,9211,8723,4175,16745
2022-07-31 21:30:00+00,15577,990,4552,3141,349,422,439,451,0,32,25953,283,8481,8042,3490,16567
2022-07-31 22:00:00+00,16227,989,4551,2550,324,84,455,404,0,238,25822,292,7880,7425,2874,17216
2022-07-31 22:30:00+00,16326,990,4556,2183,182,52,447,319,0,6,25061,301,7368,6921,2365,17316
2022-07-31 23:00:00+00,17047,990,4555,1916,124,16,461,259,0,48,25416,307,7056,6595,2040,18037
2022-07-31 23:30:00+00,17119,991,4551,1591,121,28,462,251,0,0,25114,312,6725,6263,1712,18110
2022-08-01 00:00:00+00,17149,989,4559,1443,121,162,459,229,0,0,25111,314,6582,6123,1564,18138
2022-08-01 00:30:00+00,17138,990,4555,1327,121,202,492,232,0,0,25057,316,6495,6003,1448,18128
2022-08-01 01:00:00+00,17034,989,4559,1119,121,170,507,191,0,0,24690,318,6306,5799,1240,18023
2022-08-01 01:30:00+00,17018,987,4561,949,102,180,485,172,0,0,24454,320,6097,5612,1051,18005
2022-08-01 02:00:00+00,17009,991,4561,841,99,170,439,169,0,0,24279,322,5940,5501,940,18000
2022-08-01 02:30:00+00,17010,989,4565,773,99,160,438,170,0,0,24204,323,5875,5437,872,17999
2022-08-01 03:00:00+00,17059,991,4565,719,98,144,517,171,0,0,24264,323,5899,5382,817,18050
2022-08-01 03:30:00+00,17042,990,4563,720,98,168,561,164,0,0,24306,322,5942,5381,818,18032
2022-08-01 04:00:00+00,16805,988,4566,695,98,224,740,152,0,0,24268,321,6099,5359,793,17793
2022-08-01 04:30:00+00,16895,992,4573,711,100,346,952,170,28,0,24767,320,6364,5412,839,17887
2022-08-01 05:00:00+00,16326,991,4573,723,152,508,1080,388,256,0,24997,314,6784,5704,1131,17317
2022-08-01 05:30:00+00,16205,989,4567,743,328,580,1024,642,529,404,26011,303,7191,6167,1600,17194
2022-08-01 06:00:00+00,15814,988,4566,720,585,1038,1007,633,973,726,27050,295,7851,6844,2278,16802
2022-08-01 06:30:00+00,16245,979,4565,677,686,1124,1131,623,1489,1016,28535,286,8548,7417,2852,17224
2022-08-01 07:00:00+00,16976,977,4561,648,554,1644,1292,533,1988,1042,30215,281,9043,7751,3190,17953
2022-08-01 07:30:00+00,16844,990,4524,760,540,1714,1332,598,2740,944,30986,274,9896,8564,4040,17834
2022-08-01 08:00:00+00,16597,992,4526,845,379,2138,1374,490,3522,796,31659,267,10646,9272,4746,17589
2022-08-01 08:30:00+00,16378,989,4538,1049,373,2168,1361,366,4174,934,32330,258,11495,10134,5596,17367
2022-08-01 09:00:00+00,16638,989,4386,1272,294,2156,1401,370,5410,730,33646,251,12763,11362,6976,17627
2022-08-01 09:30:00+00,16517,988,4377,1407,219,2066,1421,305,5862,544,33706,248,13286,11865,7488,17505
2022-08-01 10:00:00+00,16898,989,4384,1500,185,2068,1162,354,6193,160,33893,250,13424,12262,7878,17887
2022-08-01 10:30:00+00,16817,990,4374,1678,167,2118,1160,253,6686,0,34243,246,14065,12905,8531,17807
2022-08-01 11:00:00+00,16722,991,4386,1916,170,2340,1161,171,7386,34,35277,241,15019,13858,9472,17713
2022-08-01 11:30:00+00,16104,989,4388,2281,170,2354,1162,147,7747,0,35342,234,15748,14586,10198,17093
2022-08-01 12:00:00+00,16050,990,4391,2732,170,1590,1157,163,7525,0,34768,232,15975,14818,10427,17040
2022-08-01 12:30:00+00,15492,989,4382,3176,170,1504,1157,154,7495,0,34519,227,16380,15223,10841,16481
2022-08-01 13:00:00+00,15655,988,4392,3580,174,1436,1010,124,7463,28,34850,228,16619,15609,11217,16643
2022-08-01 13:30:00+00,15449,989,4397,4177,164,1442,912,124,7274,2,34930,224,16924,16012,11615,16438
2022-08-01 14:00:00+00,15531,987,4400,4798,147,1174,1060,123,6730,16,34966,222,17135,16075,11675,16518
2022-08-01 14:30:00+00,15466,991,4396,5357,144,1162,905,145,5964,0,34530,224,16766,15861,11465,16457
2022-08-01 15:00:00+00,16057,989,4398,6020,236,712,1050,153,5251,126,34992,222,16955,15905,11507,17046
2022-08-01 15:30:00+00,16164,989,4395,6909,259,712,1260,166,4434,0,35288,222,17257,15997,11602,17153
2022-08-01 16:00:00+00,15748,990,4400,7708,393,812,1304,229,3633,284,35501,218,17438,16134,11734,16738
2022-08-01 16:30:00+00,15685,987,4396,8145,486,826,1301,419,2697,652,35594,218,17025,15724,11328,16672
2022-08-01 17:00:00+00,15550,987,4397,8771,583,712,1145,531,1958,820,35454,216,16854,15709,11312,16537
2022-08-01 17:30:00+00,15617,986,4399,9118,478,712,1317,526,1094,746,34993,221,16406,15089,10690,16603
2022-08-01 18:00:00+00,15249,984,4390,9402,466,812,1325,607,563,950,34748,220,16146,14821,10431,16233
2022-08-01 18:30:00+00,14970,986,4389,9691,444,816,1294,635,265,352,33842,223,16083,14789,10400,15956
2022-08-01 19:00:00+00,14591,986,4386,10016,347,712,1304,610,61,482,33495,219,16114,14810,10424,15577
2022-08-01 19:30:00+00,14006,987,4383,10362,306,712,1371,457,1,22,32607,217,16423,15052,10669,14993
2022-08-01 20:00:00+00,13435,986,4379,10713,226,712,1366,339,0,94,32250,211,16684,15318,10939,14421
2022-08-01 20:30:00+00,12535,859,4381,11057,195,706,1363,251,0,0,31346,201,16996,15633,11252,13394
2022-08-01 21:00:00+00,11568,522,4380,11410,140,586,1124,146,0,0,29876,184,17054,15930,11550,12090
2022-08-01 21:30:00+00,10253,500,4380,11783,130,424,807,154,0,0,28432,170,17100,16293,11913,10753
2022-08-01 22:00:00+00,8980,365,4380,12140,111,418,814,171,0,12,27390,154,17445,16631,12251,9345
2022-08-01 22:30:00+00,7800,35,4381,12448,126,570,805,152,0,0,26317,133,17760,16955,12574,7835
2022-08-01 23:00:00+00,6890,0,4380,12743,131,674,821,156,0,0,25796,123,18076,17255,12874,6890
2022-08-01 23:30:00+00,6279,0,4380,13046,25,382,162,30,0,0,24304,110,17613,17451,13071,6279
2022-08-02 00:00:00+00,6094,0,4379,13344,0,638,0,0,0,0,24455,110,17723,17723,13344,6094
2022-08-02 00:30:00+00,6006,0,4381,13618,0,638,0,0,0,0,24644,108,18000,18000,13618,6006
2022-08-02 01:00:00+00,5756,0,4381,13863,0,638,0,0,0,0,24639,104,18245,18245,13863,5756
2022-08-02 01:30:00+00,5383,0,4386,14101,89,594,797,139,0,0,25489,99,19373,18576,14190,5383
2022-08-02 02:00:00+00,5141,0,4387,14347,89,638,801,142,0,0,25545,96,19624,18823,14436,5141
2022-08-02 02:30:00+00,4946,0,4389,14617,88,640,795,139,0,0,25615,93,19889,19094,14705,4946
2022-08-02 03:00:00+00,4787,0,4393,14885,86,640,808,146,0,0,25745,90,20171,19363,14971,4787
2022-08-02 03:30:00+00,4552,0,4396,15104,86,640,801,142,0,0,25721,87,20387,19586,15190,4552
2022-08-02 04:00:00+00,4614,0,4398,15291,86,640,818,152,0,0,25999,87,20593,19775,15377,4614
2022-08-02 04:30:00+00,4752,0,4403,15468,86,640,803,160,2,0,26314,88,20762,19959,15556,4752
2022-08-02 05:00:00+00,5346,0,4405,15640,86,580,811,148,92,0,27108,93,21034,20223,15818,5346
2022-08-02 05:30:00+00,6110,0,4408,15805,89,544,855,157,338,0,28306,99,21496,20641,16232,6110
2022-08-02 06:00:00+00,7298,0,4408,15979,235,450,1285,165,476,0,30296,108,22383,21098,16690,7298
2022-08-02 06:30:00+00,8336,0,4407,16192,282,654,1283,170,746,0,32070,118,22910,21627,17220,8336
2022-08-02 07:00:00+00,9255,0,4404,16420,300,656,1269,184,1045,0,33533,124,23438,22169,17765,9255
2022-08-02 07:30:00+00,9516,0,4396,16527,301,600,1342,228,1479,0,34389,124,24045,22703,18307,9516
2022-08-02 08:00:00+00,9223,0,4397,16647,302,1182,1336,201,1907,0,35195,122,24589,23253,18856,9223
2022-08-02 08:30:00+00,9063,0,4405,16926,318,1236,1336,167,2356,0,35806,119,25340,24004,19600,9063
2022-08-02 09:00:00+00,8562,0,4404,16867,335,1618,1343,156,2763,0,36048,114,25712,24369,19965,8562
2022-08-02 09:30:00+00,8536,0,4407,16945,276,1562,1183,148,3273,0,36330,112,26084,24901,20494,8536
2022-08-02 10:00:00+00,8514,0,4406,16991,256,1794,952,147,3509,0,36569,110,26114,25162,20756,8514
2022-08-02 10:30:00+00,8344,0,4406,17116,216,1756,865,149,3948,0,36800,107,26551,25686,21280,8344
2022-08-02 11:00:00+00,8445,0,4400,17217,189,2006,837,146,3964,0,37204,108,26607,25770,21370,8445
2022-08-02 11:30:00+00,8534,0,4406,17126,158,1976,852,147,4276,0,37475,107,26818,25966,21560,8534
2022-08-02 12:00:00+00,8138,0,4412,17277,141,1998,783,140,4960,0,37849,102,27573,26790,22378,8138
2022-08-02 12:30:00+00,7657,0,4407,17438,163,1960,790,140,4970,0,37525,98,27768,26978,22571,7657
2022-08-02 13:00:00+00,8019,0,4408,17253,155,1686,839,160,4810,0,37330,102,27465,26626,22218,8019
2022-08-02 13:30:00+00,7942,0,4404,17319,149,1636,866,146,5141,0,37603,100,27879,27013,22609,7942
2022-08-02 14:00:00+00,8251,0,4402,17200,226,1176,929,164,4730,32,37110,103,27487,26558,22156,8251
2022-08-02 14:30:00+00,8482,0,4407,17221,258,1106,1034,157,4160,18,36843,105,27080,26046,21639,8482
2022-08-02 15:00:00+00,9860,0,4410,17187,299,466,1120,142,3481,76,37041,113,26497,25377,20967,9860
2022-08-02 15:30:00+00,10331,0,4408,16935,345,696,1224,139,3337,44,37459,119,26249,25025,20617,10331
2022-08-02 16:00:00+00,12327,0,4409,16656,352,406,1332,153,2787,92,38514,136,25536,24204,19795,12327
2022-08-02 16:30:00+00,12623,0,4413,16537,384,552,1402,253,2242,0,38406,143,24978,23576,19163,12623
2022-08-02 17:00:00+00,12727,0,4413,16343,451,560,1432,258,1729,302,38215,145,24368,22936,18523,12727
2022-08-02 17:30:00+00,12926,0,4411,16053,445,558,1454,230,1212,454,37743,149,23575,22121,17710,12926
2022-08-02 18:00:00+00,12885,0,4415,15666,392,648,1545,179,740,466,36936,153,22758,21213,16798,12885
2022-08-02 18:30:00+00,12959,0,4413,15466,381,556,1765,176,392,178,36286,156,22417,20652,16239,12959
2022-08-02 19:00:00+00,12973,0,4413,15336,320,632,1950,162,106,58,35950,159,22125,20175,15762,12973
2022-08-02 19:30:00+00,12534,0,4413,15474,318,584,1701,163,3,48,35238,156,21909,20208,15795,12534
2022-08-02 20:00:00+00,12700,0,4428,15152,299,578,1481,182,0,194,35014,158,21360,19879,15451,12700
2022-08-02 20:30:00+00,12286,0,4444,15100,275,362,1482,248,0,0,34197,154,21301,19819,15375,12286
2022-08-02 21:00:00+00,11230,0,4475,15206,207,288,1369,205,0,0,32980,145,21257,19888,15413,11230
2022-08-02 21:30:00+00,10238,0,4502,15295,192,98,1191,157,0,0,31673,135,21180,19989,15487,10238
2022-08-02 22:00:00+00,8261,0,4526,15356,162,96,1160,157,0,0,29718,117,21204,20044,15518,8261
2022-08-02 22:30:00+00,7416,0,4534,14672,149,338,1161,151,0,0,28421,115,20516,19355,14821,7416
2022-08-02 23:00:00+00,6507,0,4562,14429,103,508,1156,145,0,0,27410,109,20250,19094,14532,6507
2022-08-02 23:30:00+00,6024,0,4575,14613,84,656,1156,141,0,0,27249,105,20428,19272,14697,6024
2022-08-03 00:00:00+00,5855,0,4569,14018,76,710,1167,153,0,0,26548,106,19830,18663,14094,5855
2022-08-03 00:30:00+00,6120,0,4575,13676,76,710,1180,141,0,0,26478,110,19507,18327,13752,6120
2022-08-03 01:00:00+00,5848,0,4598,13564,76,710,1126,144,0,0,26066,108,19364,18238,13640,5848
2022-08-03 01:30:00+00,5770,0,4605,13289,76,710,1123,145,0,0,25718,108,19093,17970,13365,5770
2022-08-03 02:00:00+00,5462,0,4613,13497,73,710,1132,139,0,0,25626,104,19315,18183,13570,5462
2022-08-03 02:30:00+00,5270,0,4607,13492,73,710,1145,140,0,0,25437,102,19317,18172,13565,5270
2022-08-03 03:00:00+00,5587,0,4619,13352,73,710,1146,139,0,0,25626,106,19190,18044,13425,5587
2022-08-03 03:30:00+00,5655,0,4619,13364,73,704,1148,143,0,0,25706,106,19204,18056,13437,5655
2022-08-03 04:00:00+00,6320,0,4619,13480,73,570,1150,146,0,0,26358,111,19322,18172,13553,6320
2022-08-03 04:30:00+00,6773,0,4619,13628,74,432,1149,217,19,0,26911,114,19489,18340,13721,6773
2022-08-03 05:00:00+00,8028,0,4617,13802,134,240,1248,189,195,0,28453,122,19996,18748,14131,8028
2022-08-03 05:30:00+00,8880,0,4620,13936,185,264,1196,155,472,0,29708,128,20409,19213,14593,8880
2022-08-03 06:00:00+00,9223,0,4645,14189,303,304,1266,151,890,16,30987,128,21293,20027,15382,9223
2022-08-03 06:30:00+00,9845,0,4650,14568,345,520,1424,167,1418,6,32943,132,22405,20981,16331,9845
2022-08-03 07:00:00+00,10183,0,4656,14304,377,458,1418,178,1984,48,33606,131,22739,21321,16665,10183
2022-08-03 07:30:00+00,10687,0,4652,14062,359,775,1473,174,2403,50,34635,136,22949,21476,16824,10687
2022-08-03 08:00:00+00,10979,0,4655,13957,357,698,1562,158,2800,78,35244,138,23331,21769,17114,10979
2022-08-03 08:30:00+00,10635,0,4660,14180,358,698,1783,141,3357,0,35812,133,24338,22555,17895,10635
2022-08-03 09:00:00+00,10413,0,4649,13937,318,1002,1943,153,4037,16,36468,132,24884,22941,18292,10413
2022-08-03 09:30:00+00,10459,0,4659,13733,235,1387,1935,145,4575,4,37132,131,25137,23202,18543,10459
2022-08-03 10:00:00+00,9883,0,4664,13449,188,1772,1804,142,4713,0,36615,128,24818,23014,18350,9883
2022-08-03 10:30:00+00,9953,0,4661,13112,187,1806,1741,151,5431,20,37062,127,25132,23391,18730,9953
2022-08-03 11:00:00+00,10214,0,4653,12707,176,1796,1727,149,5921,0,37343,129,25184,23457,18804,10214
2022-08-03 11:30:00+00,10445,0,4652,12247,169,1798,1789,153,5878,0,37131,133,24735,22946,18294,10445
2022-08-03 12:00:00+00,10739,0,4662,11410,154,1890,1788,162,5795,42,36642,137,23809,22021,17359,10739
2022-08-03 12:30:00+00,11039,0,4669,10913,150,1920,1781,143,5910,34,36559,140,23423,21642,16973,11039
2022-08-03 13:00:00+00,11343,0,4670,10278,149,1584,1862,215,6384,84,36569,142,23343,21481,16811,11343
2022-08-03 13:30:00+00,11892,0,4668,9299,163,1582,1992,352,5917,20,35885,153,22039,20047,15379,11892
2022-08-03 14:00:00+00,12780,0,4669,8674,243,604,1995,499,5998,272,35734,158,21579,19584,14915,12780
2022-08-03 14:30:00+00,13782,0,4662,8192,321,536,2002,552,5508,0,35555,170,20685,18683,14021,13782
2022-08-03 15:00:00+00,14113,0,4665,7967,274,1026,1923,435,4932,0,35335,177,19761,17838,13173,14113
2022-08-03 15:30:00+00,15129,14,4634,7432,335,1048,1825,530,4264,0,35211,190,18490,16665,12031,15143
2022-08-03 16:00:00+00,15492,148,4608,6839,472,1146,1772,692,3590,356,35115,200,17281,15509,10901,15640
2022-08-03 16:30:00+00,15661,336,4571,6442,534,1182,1815,657,2967,574,34739,209,16329,14514,9943,15997
2022-08-03 17:00:00+00,16685,451,4543,5822,597,386,1910,751,2340,908,34393,219,15212,13302,8759,17136
2022-08-03 17:30:00+00,17196,475,4539,5186,587,428,2064,756,1644,912,33787,231,14020,11956,7417,17671
2022-08-03 18:00:00+00,17173,492,4579,4506,605,824,1884,821,948,1108,32940,240,12522,10638,6059,17665
2022-08-03 18:30:00+00,17452,494,4617,3777,608,944,1839,752,478,1154,32115,250,11319,9480,4863,17946
2022-08-03 19:00:00+00,17582,495,4667,3413,616,1158,1731,599,133,1134,31528,256,10560,8829,4162,18077
2022-08-03 19:30:00+00,17424,471,4676,3275,604,1198,1815,502,4,1010,30979,258,10374,8559,3883,17895
2022-08-03 20:00:00+00,16807,420,4676,2974,637,1462,2116,458,0,922,30472,256,10403,8287,3611,17227
2022-08-03 20:30:00+00,16417,418,4678,2887,560,1408,2141,714,0,676,29899,258,10266,8125,3447,16835
2022-08-03 21:00:00+00,15479,393,4676,2937,445,1696,2145,687,0,32,28490,261,10203,8058,3382,15872
2022-08-03 21:30:00+00,15203,247,4672,2696,418,1338,2145,623,0,0,27342,259,9931,7786,3114,15450
2022-08-03 22:00:00+00,17378,0,4677,2681,351,88,2147,565,0,492,28379,259,9856,7709,3032,17378
2022-08-03 22:30:00+00,17569,0,4678,2727,263,144,2100,461,0,222,28164,262,9768,7668,2990,17569
2022-08-03 23:00:00+00,17725,0,4675,2731,138,262,1853,358,0,36,27778,268,9397,7544,2869,17725
2022-08-03 23:30:00+00,17715,0,4678,2311,138,244,1634,316,0,0,27036,273,8761,7127,2449,17715
2022-08-04 00:00:00+00,17835,0,4679,2011,136,354,1463,283,0,120,26881,277,8289,6826,2147,17835
2022-08-04 00:30:00+00,17835,0,4687,2193,134,320,1454,247,0,0,26870,276,8468,7014,2327,17835
2022-08-04 01:00:00+00,17471,0,4688,2469,133,258,1453,246,0,0,26718,271,8743,7290,2602,17471
2022-08-04 01:30:00+00,17084,0,4682,2538,122,244,1458,247,0,0,26375,269,8800,7342,2660,17084
2022-08-04 02:00:00+00,16716,0,4686,2629,115,364,1454,248,0,0,26212,267,8884,7430,2744,16716
2022-08-04 02:30:00+00,16438,0,4690,2883,115,416,1448,248,0,0,26238,264,9136,7688,2998,16438
2022-08-04 03:00:00+00,16174,0,4692,3175,115,370,1447,246,0,0,26219,259,9429,7982,3290,16174
2022-08-04 03:30:00+00,15881,0,4699,3412,115,324,1454,246,0,0,26131,255,9680,8226,3527,15881
2022-08-04 04:00:00+00,16128,0,4698,3479,118,254,1452,245,0,0,26374,255,9747,8295,3597,16128
2022-08-04 04:30:00+00,16286,0,4696,3633,123,262,1475,261,17,0,26753,254,9944,8469,3773,16286
2022-08-04 05:00:00+00,17038,0,4698,3907,215,324,1708,256,220,0,28366,252,10748,9040,4342,17038
2022-08-04 05:30:00+00,17357,0,4695,3954,265,292,2008,333,601,74,29580,248,11524,9516,4820,17357
2022-08-04 06:00:00+00,17668,0,4699,4013,387,24,2146,377,1053,212,30579,240,12298,10152,5453,17668
2022-08-04 06:30:00+00,17974,0,4697,4212,475,0,2146,676,1712,326,32218,235,13242,11096,6399,17974
2022-08-04 07:00:00+00,17847,0,4702,4317,492,0,2144,673,2655,252,33082,227,14310,12166,7464,17847
2022-08-04 07:30:00+00,17632,0,4700,4770,490,0,2148,690,3474,128,34032,219,15582,13434,8734,17632
2022-08-04 08:00:00+00,17180,0,4701,5057,355,368,2119,641,4394,108,34923,213,16626,14507,9806,17180
2022-08-04 08:30:00+00,16894,0,4694,5263,334,404,2136,661,5326,140,35852,204,17753,15617,10923,16894
2022-08-04 09:00:00+00,17158,0,4693,5299,264,476,2145,284,5917,0,36236,203,18318,16173,11480,17158
2022-08-04 09:30:00+00,17154,0,4693,5180,198,440,2145,155,6211,0,36176,201,18427,16282,11589,17154
2022-08-04 10:00:00+00,17163,0,4696,5199,155,0,2146,155,6509,0,36023,196,18705,16559,11863,17163
2022-08-04 10:30:00+00,17061,0,4692,5074,155,0,2144,165,7078,0,36369,193,19143,16999,12307,17061
2022-08-04 11:00:00+00,16786,0,4691,5158,141,0,2145,162,7152,0,36235,191,19287,17142,12451,16786
2022-08-04 11:30:00+00,16521,0,4726,5427,136,105,2141,164,7565,0,36785,187,19995,17854,13128,16521
2022-08-04 12:00:00+00,16615,0,4747,5514,137,210,1797,158,7332,0,36510,189,19527,17730,12983,16615
2022-08-04 12:30:00+00,16566,0,4743,5401,138,220,1826,159,7188,0,36241,190,19296,17470,12727,16566
2022-08-04 13:00:00+00,16825,0,4723,5443,138,0,2132,156,7025,0,36442,190,19461,17329,12606,16825
2022-08-04 13:30:00+00,16842,0,4708,5448,137,20,2123,145,6611,0,36034,193,19027,16904,12196,16842
2022-08-04 14:00:00+00,17201,0,4706,5409,133,146,2108,157,6246,0,36106,198,18602,16494,11788,17201
2022-08-04 14:30:00+00,17287,0,4708,5639,137,214,2107,157,5720,18,35987,200,18311,16204,11496,17287
2022-08-04 15:00:00+00,17205,0,4711,5554,223,378,2106,265,5262,0,35704,204,17856,15750,11039,17205
2022-08-04 15:30:00+00,17500,0,4708,5539,295,362,2114,482,4560,54,35614,210,17216,15102,10394,17500
2022-08-04 16:00:00+00,17347,0,4717,5622,371,316,2083,568,3923,364,35311,210,16716,14633,9916,17347
2022-08-04 16:30:00+00,17384,0,4727,5846,411,428,2035,726,3144,538,35239,214,16163,14128,9401,17384
2022-08-04 17:00:00+00,17575,0,4724,5647,422,432,2076,717,2533,898,35024,217,15402,13326,8602,17575
2022-08-04 17:30:00+00,17889,0,4721,5402,547,432,2116,678,1855,934,34574,224,14641,12525,7804,17889
2022-08-04 18:00:00+00,18071,0,4725,5126,521,512,2118,636,1181,818,33708,232,13671,11553,6828,18071
2022-08-04 18:30:00+00,18385,0,4720,4468,561,528,2126,544,643,852,32827,242,12518,10392,5672,18385
2022-08-04 19:00:00+00,18457,0,4725,3906,518,600,2131,735,192,520,31784,254,11472,9342,4616,18457
2022-08-04 19:30:00+00,18482,0,4717,3560,422,558,2134,678,7,854,31412,256,10840,8706,3989,18482
2022-08-04 20:00:00+00,18575,0,4719,3262,544,620,2134,569,0,944,31367,257,10659,8525,3806,18575
2022-08-04 20:30:00+00,18542,0,4741,3055,481,504,2135,699,0,430,30587,262,10412,8277,3536,18542
2022-08-04 21:00:00+00,18576,0,4742,2984,362,522,2135,672,0,130,30123,267,10223,8088,3346,18576
2022-08-04 21:30:00+00,18186,0,4743,2831,267,396,2132,602,0,428,29585,263,9973,7841,3098,18186
2022-08-04 22:00:00+00,17793,0,4748,2772,238,300,2053,391,0,220,28515,264,9811,7758,3010,17793
2022-08-04 22:30:00+00,17188,0,4756,2966,193,174,2121,233,0,0,27631,260,10036,7915,3159,17188
2022-08-04 23:00:00+00,16614,0,4746,2973,129,138,2114,158,0,0,26872,257,9962,7848,3102,16614
2022-08-04 23:30:00+00,16329,0,4753,2838,111,32,2115,155,0,0,26333,256,9817,7702,2949,16329
2022-08-05 00:00:00+00,16173,0,4747,2756,111,134,2120,146,0,0,26187,257,9734,7614,2867,16173
2022-08-05 00:30:00+00,15995,0,4748,2957,113,194,2124,147,0,0,26278,255,9942,7818,3070,15995
2022-08-05 01:00:00+00,15505,0,4747,3163,116,208,2123,153,0,0,26015,250,10149,8026,3279,15505
2022-08-05 01:30:00+00,15232,0,4754,3239,116,208,2126,148,0,0,25823,248,10235,8109,3355,15232
2022-08-05 02:00:00+00,15149,0,4753,3414,97,200,2119,156,0,0,25888,246,10383,8264,3511,15149
2022-08-05 02:30:00+00,14933,0,4762,3542,97,198,2123,144,0,0,25799,243,10524,8401,3639,14933
2022-08-05 03:00:00+00,14957,0,4754,3775,95,166,1897,148,0,0,25792,242,10521,8624,3870,14957
2022-08-05 03:30:00+00,14924,0,4760,3903,95,170,1821,148,0,0,25821,241,10579,8758,3998,14924
2022-08-05 04:00:00+00,14983,0,4767,3897,95,148,1996,151,0,0,26037,240,10755,8759,3992,14983
2022-08-05 04:30:00+00,15063,0,4781,4002,112,192,2119,146,7,0,26422,239,11021,8902,4121,15063
2022-08-05 05:00:00+00,15637,0,4770,4368,145,102,2118,145,175,0,27460,237,11576,9458,4688,15637
2022-08-05 05:30:00+00,15744,0,4765,4604,275,164,2117,244,611,150,28674,231,12372,10255,5490,15744
2022-08-05 06:00:00+00,15880,0,4767,4880,437,68,2124,647,1237,148,30188,224,13444,11320,6554,15880
2022-08-05 06:30:00+00,15780,0,4763,4920,452,134,2128,696,2091,524,31488,215,14354,12226,7463,15780
2022-08-05 07:00:00+00,15574,0,4769,4850,468,0,2130,649,2856,124,31420,210,15073,12943,8174,15574
2022-08-05 07:30:00+00,15661,0,4766,4759,416,0,2132,533,3844,184,32295,204,15917,13785,9019,15661
2022-08-05 08:00:00+00,15373,0,4768,4926,413,0,2131,591,4965,104,33271,195,17203,15072,10304,15373
2022-08-05 08:30:00+00,15080,0,4777,5194,365,0,2123,556,5823,0,33918,188,18282,16159,11382,15080
2022-08-05 09:00:00+00,15039,0,4768,5449,226,2,2117,353,6273,0,34227,184,18833,16716,11948,15039
2022-08-05 09:30:00+00,14895,0,4773,5881,188,0,2114,297,6602,0,34750,179,19558,17444,12671,14895
2022-08-05 10:00:00+00,14546,0,4766,6234,170,0,2113,232,7219,0,35280,172,20502,18389,13623,14546
2022-08-05 10:30:00+00,14592,0,4767,6207,149,0,2116,200,7521,68,35620,170,20760,18644,13877,14592
2022-08-05 11:00:00+00,14862,0,4728,6154,129,0,2115,166,7476,20,35650,173,20602,18487,13759,14862
2022-08-05 11:30:00+00,14756,0,4611,6463,114,0,2117,185,7746,0,35992,170,21051,18934,14323,14756
2022-08-05 12:00:00+00,14413,0,4620,6384,108,272,2116,190,7447,0,35550,173,20675,18559,13939,14413
2022-08-05 12:30:00+00,14137,0,4612,6424,104,308,2114,189,7268,0,35156,172,20522,18408,13796,14137
2022-08-05 13:00:00+00,13403,0,4593,6288,115,1162,1988,198,6972,0,34719,175,19956,17968,13375,13403
2022-08-05 13:30:00+00,13463,0,4589,6232,106,1184,1908,195,6925,0,34602,176,19760,17852,13263,13463
2022-08-05 14:00:00+00,13095,0,4595,6345,105,1190,1783,172,6590,0,33875,176,19418,17635,13040,13095
2022-08-05 14:30:00+00,13449,0,4569,6086,109,1190,1786,146,5734,0,33069,184,18284,16498,11929,13449
2022-08-05 15:00:00+00,14174,0,4642,5916,183,1042,1784,170,5133,0,33044,192,17658,15874,11232,14174
2022-08-05 15:30:00+00,14898,0,4770,6066,193,898,1874,150,4591,0,33440,196,17494,15620,10850,14898
2022-08-05 16:00:00+00,15856,0,4787,6108,228,4,2009,158,4363,42,33555,195,17495,15486,10699,15856
2022-08-05 16:30:00+00,16390,0,4791,5784,248,40,2125,151,3492,84,33104,204,16440,14315,9524,16390
2022-08-05 17:00:00+00,16690,0,4790,5778,380,396,2119,221,2636,52,33062,209,15703,13584,8794,16690
2022-08-05 17:30:00+00,16853,0,4787,5605,372,464,2121,461,1918,174,32755,215,14803,12682,7895,16853
2022-08-05 18:00:00+00,16924,0,4787,5085,379,810,2120,585,1196,148,32033,222,13567,11447,6660,16924
2022-08-05 18:30:00+00,16839,0,4786,4814,402,846,2130,417,581,154,30968,227,12713,10583,5797,16839
2022-08-05 19:00:00+00,16635,0,4784,4597,387,836,2130,275,157,120,29921,231,12055,9925,5141,16635
2022-08-05 19:30:00+00,16249,0,4788,4431,383,822,2130,491,3,162,29459,231,11735,9605,4817,16249
2022-08-05 20:00:00+00,15864,0,4790,4261,369,702,2131,552,0,538,29207,229,11551,9420,4630,15864
2022-08-05 20:30:00+00,15148,0,4785,4079,326,648,2129,534,0,460,28109,227,11319,9190,4405,15148
2022-08-05 21:00:00+00,14375,0,4788,3844,213,276,2130,431,0,414,26471,229,10975,8845,4057,14375
2022-08-05 21:30:00+00,13248,0,4789,3621,183,248,2130,301,0,336,24856,224,10723,8593,3804,13248
2022-08-05 22:00:00+00,12158,0,4794,3528,178,648,2127,179,0,20,23632,216,10627,8500,3706,12158
2022-08-05 22:30:00+00,11175,0,4790,3505,170,722,2128,161,0,0,22651,208,10593,8465,3675,11175
2022-08-05 23:00:00+00,10426,0,4794,3447,115,1088,2014,153,0,0,22038,200,10370,8356,3562,10426
2022-08-05 23:30:00+00,9980,0,4790,3258,112,1132,2035,162,0,18,21487,197,10195,8160,3370,9980
2022-08-06 00:00:00+00,9955,0,4797,3171,110,1088,1993,149,0,0,21263,198,10071,8078,3281,9955
2022-08-06 00:30:00+00,10032,0,4795,3027,108,1078,1852,157,0,0,21049,201,9782,7930,3135,10032
2022-08-06 01:00:00+00,9947,0,4798,3177,106,944,1844,145,0,0,20961,200,9925,8081,3283,9947
2022-08-06 01:30:00+00,9742,0,4788,3298,104,936,1750,152,0,0,20770,197,9940,8190,3402,9742
2022-08-06 02:00:00+00,9670,0,4792,3040,83,1052,1761,145,0,0,20543,199,9676,7915,3123,9670
2022-08-06 02:30:00+00,9644,0,4799,3114,81,1046,1602,145,0,0,20430,198,9596,7994,3195,9644
2022-08-06 03:00:00+00,9663,0,4800,3139,81,864,1485,156,0,0,20188,200,9505,8020,3220,9663
2022-08-06 03:30:00+00,9567,0,4804,3096,80,852,1493,388,0,0,20280,201,9473,7980,3176,9567
2022-08-06 04:00:00+00,9764,0,4808,3108,98,788,1484,211,0,0,20261,203,9498,8014,3206,9764
2022-08-06 04:30:00+00,9727,0,4802,3006,100,832,1457,149,11,0,20084,204,9376,7919,3117,9727
2022-08-06 05:00:00+00,9570,0,4810,2893,167,1040,1419,160,215,6,20280,200,9504,8085,3275,9570
2022-08-06 05:30:00+00,10022,0,4810,2701,205,1094,1416,158,681,130,21217,200,9813,8397,3587,10022
2022-08-06 06:00:00+00,9949,0,4812,2722,232,2020,1402,146,1298,0,22581,195,10466,9064,4252,9949
2022-08-06 06:30:00+00,10091,0,4810,2853,221,2069,1432,159,2068,0,23703,189,11384,9952,5142,10091
2022-08-06 07:00:00+00,8967,0,4818,3205,193,3419,1414,145,2982,0,25144,173,12612,11198,6380,8967
2022-08-06 07:30:00+00,8655,0,4818,3401,180,3486,1469,152,3871,0,26032,163,13739,12270,7452,8655
2022-08-06 08:00:00+00,8098,0,4821,3353,167,4282,1352,150,4759,0,26982,150,14452,13100,8279,8098
2022-08-06 08:30:00+00,7928,0,4819,3431,169,4320,1242,151,5641,0,27701,143,15302,14060,9241,7928
2022-08-06 09:00:00+00,7552,0,4837,3598,152,4604,1025,153,6199,0,28120,135,15811,14786,9949,7552
2022-08-06 09:30:00+00,7098,0,4822,3798,152,4628,955,156,6699,0,28308,128,16426,15471,10649,7098
2022-08-06 10:00:00+00,6741,0,4717,3976,122,4878,980,168,7279,0,28861,121,17074,16094,11377,6741
2022-08-06 10:30:00+00,6593,0,4660,4097,120,4916,924,146,7479,0,28935,118,17280,16356,11696,6593
2022-08-06 11:00:00+00,6118,0,4657,4176,78,5434,816,148,7736,0,29163,112,17463,16647,11990,6118
2022-08-06 11:30:00+00,6216,0,4657,4142,75,5450,802,145,7914,0,29401,112,17590,16788,12131,6216
2022-08-06 12:00:00+00,5925,0,4667,4375,75,5260,799,144,8430,0,29675,107,18346,17547,12880,5925
2022-08-06 12:30:00+00,5322,0,4661,4623,75,5222,795,144,8199,0,29041,101,18353,17558,12897,5322
2022-08-06 13:00:00+00,5223,0,4655,5115,56,4342,812,151,8003,0,28357,100,18641,17829,13174,5223
2022-08-06 13:30:00+00,5404,0,4648,4981,55,4286,850,171,7744,0,28139,103,18278,17428,12780,5404
2022-08-06 14:00:00+00,5458,0,4650,5340,55,4460,798,146,7336,0,28243,104,18179,17381,12731,5458
2022-08-06 14:30:00+00,5629,0,4634,5634,58,4248,811,152,6799,0,27965,108,17936,17125,12491,5629
2022-08-06 15:00:00+00,8597,0,4666,5553,142,1114,1014,170,6046,0,27302,144,17421,16407,11741,8597
2022-08-06 15:30:00+00,9747,0,4709,5528,165,996,1151,165,5228,0,27689,158,16781,15630,10921,9747
2022-08-06 16:00:00+00,12080,0,4749,5565,266,550,1329,183,4361,162,29245,172,16270,14941,10192,12080
2022-08-06 16:30:00+00,12534,0,4801,5612,282,564,1328,170,3541,38,28870,181,15564,14236,9435,12534
2022-08-06 17:00:00+00,12693,0,4832,5500,438,677,1449,239,2733,480,29042,182,14952,13503,8671,12693
2022-08-06 17:30:00+00,12772,0,4842,5451,472,657,1676,438,1886,332,28526,189,14327,12651,7809,12772
2022-08-06 18:00:00+00,12737,0,4847,5323,461,630,1751,492,1191,710,28142,192,13573,11822,6975,12737
2022-08-06 18:30:00+00,12573,0,4846,5151,402,610,1848,490,556,916,27392,196,12803,10955,6109,12573
2022-08-06 19:00:00+00,12275,0,4850,5186,402,326,1852,577,139,846,26453,201,12429,10577,5727,12275
2022-08-06 19:30:00+00,11835,0,4839,5210,400,258,1850,583,1,638,25614,200,12300,10450,5611,11835
2022-08-06 20:00:00+00,11379,0,4839,5481,354,250,1848,581,0,412,25144,196,12522,10674,5835,11379
2022-08-06 20:30:00+00,10541,0,4844,5526,310,172,1850,524,0,224,23991,190,12530,10680,5836,10541
2022-08-06 21:00:00+00,9696,0,4851,5554,221,24,1844,385,0,84,22660,185,12470,10626,5775,9696
2022-08-06 21:30:00+00,8516,0,4847,5754,217,0,1577,314,0,34,21260,172,12395,10818,5971,8516
2022-08-06 22:00:00+00,7393,0,4849,6073,216,118,1377,219,0,0,20244,156,12515,11138,6289,7393
2022-08-06 22:30:00+00,6376,0,4854,6412,208,314,1344,285,0,0,19792,144,12818,11474,6620,6376
2022-08-06 23:00:00+00,5624,0,4849,6685,151,204,1346,344,0,0,19203,133,13031,11685,6836,5624
2022-08-06 23:30:00+00,5193,0,4849,6705,151,190,1393,180,0,0,18662,125,13098,11705,6856,5193
2022-08-07 00:00:00+00,5184,0,4843,6552,149,1197,1207,141,0,0,19272,129,12751,11544,6701,5184
2022-08-07 00:30:00+00,5280,0,4842,6565,149,1318,1203,153,0,0,19510,132,12759,11556,6714,5280
2022-08-07 01:00:00+00,5223,0,4856,6818,149,2052,1181,137,0,0,20416,128,13004,11823,6967,5223
2022-08-07 01:30:00+00,5044,0,4847,6785,148,2031,1182,137,0,0,20174,125,12962,11780,6933,5044
2022-08-07 02:00:00+00,5000,0,4857,6697,118,2204,1186,140,0,0,20202,122,12858,11672,6815,5000
2022-08-07 02:30:00+00,5008,0,4851,6431,113,2212,1211,150,0,0,19976,124,12606,11395,6544,5008
2022-08-07 03:00:00+00,5025,0,4848,6285,113,1772,1243,162,0,0,19448,123,12489,11246,6398,5025
2022-08-07 03:30:00+00,5077,0,4864,6144,85,1764,1164,152,0,0,19250,125,12257,11093,6229,5077
2022-08-07 04:00:00+00,5520,0,4862,6030,100,1474,891,146,0,0,19023,129,11883,10992,6130,5520
2022-08-07 04:30:00+00,5358,0,4872,5965,102,1494,895,142,7,0,18835,127,11841,10946,6074,5358
2022-08-07 05:00:00+00,5012,0,4865,5976,115,2250,895,141,168,0,19422,122,12018,11124,6258,5012
2022-08-07 05:30:00+00,5097,0,4872,5980,115,2272,1068,146,615,0,20165,120,12650,11582,6710,5097
2022-08-07 06:00:00+00,4926,0,4869,6009,96,2912,1230,152,1308,0,21502,118,13512,12282,7413,4926
2022-08-07 06:30:00+00,5122,0,4873,5824,120,2992,1227,144,2091,0,22393,117,14135,12908,8035,5122
2022-08-07 07:00:00+00,4599,0,4873,5663,132,3972,1226,140,2948,0,23553,112,14842,13616,8743,4599
2022-08-07 07:30:00+00,4230,0,4870,5939,132,4000,1227,144,3759,0,24301,103,15927,14700,9830,4230
2022-08-07 08:00:00+00,4367,0,4873,6018,128,4026,1225,147,4684,0,25468,100,16928,15703,10830,4367
2022-08-07 08:30:00+00,4622,0,4870,5949,130,4054,1190,149,5399,0,26363,101,17538,16348,11478,4622
2022-08-07 09:00:00+00,4294,0,4877,6099,110,4390,958,147,6181,0,27056,92,18225,17267,12390,4294
2022-08-07 09:30:00+00,4223,0,4871,6183,102,4456,920,146,6720,0,27621,89,18796,17876,13005,4223
2022-08-07 10:00:00+00,4240,0,4871,5869,93,4716,935,151,7568,0,28443,87,19336,18401,13530,4240
2022-08-07 10:30:00+00,4336,0,4869,5742,99,4734,969,147,8124,0,29020,87,19803,18834,13965,4336
2022-08-07 11:00:00+00,4667,0,4870,5492,102,4358,1184,161,8519,0,29353,91,20167,18983,14113,4667
2022-08-07 11:30:00+00,4663,0,4879,5465,100,4332,1225,151,8824,0,29639,90,20493,19268,14389,4663
2022-08-07 12:00:00+00,4443,0,4916,5643,74,4256,1074,150,8847,0,29403,88,20554,19480,14564,4443
2022-08-07 12:30:00+00,4426,0,4964,5585,76,4230,891,154,8602,0,28928,88,20118,19227,14263,4426
2022-08-07 13:00:00+00,4714,0,5007,5395,76,3894,894,151,8458,0,28589,93,19830,18936,13929,4714
2022-08-07 13:30:00+00,5140,0,5016,5182,76,3850,931,154,8219,0,28568,99,19424,18493,13477,5140
2022-08-07 14:00:00+00,5627,0,5010,5034,75,4022,1086,169,7623,0,28646,106,18828,17742,12732,5627
2022-08-07 14:30:00+00,6150,0,5003,5041,76,3982,1101,165,6793,0,28311,115,18014,16913,11910,6150
2022-08-07 15:00:00+00,7460,0,5006,5008,147,3458,1114,173,5980,0,28346,131,17255,16141,11135,7460
2022-08-07 15:30:00+00,9190,0,5009,4781,160,3170,1086,165,5275,0,28836,150,16311,15225,10216,9190
2022-08-07 16:00:00+00,12903,0,5014,4569,256,154,1329,185,4450,156,29016,183,15618,14289,9275,12903
2022-08-07 16:30:00+00,14174,0,5023,4491,321,158,1495,152,3553,306,29673,197,14883,13388,8365,14174
2022-08-07 17:00:00+00,15114,0,5028,4590,405,174,1479,409,2677,584,30460,208,14179,12700,7672,15114
2022-08-07 17:30:00+00,15235,0,5034,4541,397,238,1501,707,1873,598,30124,216,13346,11845,6811,15235
2022-08-07 18:00:00+00,15308,0,5031,4398,367,384,1504,766,1107,918,29783,222,12407,10903,5872,15308
2022-08-07 18:30:00+00,15419,0,5031,4125,345,406,1499,980,489,770,29064,232,11489,9990,4959,15419
2022-08-07 19:00:00+00,15555,0,5033,3735,295,528,1496,973,111,802,28528,239,10670,9174,4141,15555
2022-08-07 19:30:00+00,15610,0,5029,3172,294,554,1489,965,0,964,28077,244,9984,8495,3466,15610
2022-08-07 20:00:00+00,15724,0,5028,2953,326,492,1585,956,0,964,28028,247,9892,8307,3279,15724
2022-08-07 20:30:00+00,15548,0,5042,2843,331,386,1793,832,0,696,27471,247,10009,8216,3174,15548
2022-08-07 21:00:00+00,15498,0,5034,2796,224,280,2085,624,0,304,26845,250,10139,8054,3020,15498
2022-08-07 21:30:00+00,15234,0,5032,2753,216,154,2137,246,0,206,25978,247,10138,8001,2969,15234
2022-08-07 22:00:00+00,14847,0,5033,2821,223,180,2135,229,0,66,25534,245,10212,8077,3044,14847
2022-08-07 22:30:00+00,14161,0,5035,2867,210,16,2134,155,0,146,24724,238,10246,8112,3077,14161
2022-08-07 23:00:00+00,14399,0,5034,2895,112,8,2132,144,0,148,24872,240,10173,8041,3007,14399
2022-08-07 23:30:00+00,14394,0,5031,2942,110,0,2130,141,0,0,24748,241,10213,8083,3052,14394
2022-08-08 00:00:00+00,14382,0,5032,3015,96,52,2130,142,0,0,24849,241,10273,8143,3111,14382
2022-08-08 00:30:00+00,14427,0,5025,2903,95,0,2130,150,0,0,24730,242,10153,8023,2998,14427
2022-08-08 01:00:00+00,14097,0,5034,3003,76,0,2090,146,0,0,24446,239,10203,8113,3079,14097
2022-08-08 01:30:00+00,13836,0,5033,3027,76,0,2075,145,0,0,24192,238,10211,8136,3103,13836
2022-08-08 02:00:00+00,14219,0,5034,3050,76,0,2077,146,0,0,24602,240,10237,8160,3126,14219
2022-08-08 02:30:00+00,14194,0,5035,3060,76,0,2076,143,0,0,24584,240,10247,8171,3136,14194
2022-08-08 03:00:00+00,14658,0,5033,3020,86,76,2168,215,0,0,25256,243,10307,8139,3106,14658
2022-08-08 03:30:00+00,14710,0,5030,2921,105,142,2236,348,0,0,25492,245,10292,8056,3026,14710
2022-08-08 04:00:00+00,14800,0,5028,2886,105,266,2264,345,0,0,25694,247,10283,8019,2991,14800
2022-08-08 04:30:00+00,15127,0,5030,2617,108,280,2420,197,4,114,25897,249,10179,7759,2729,15127
2022-08-08 05:00:00+00,15433,0,5036,2536,161,420,2564,318,162,446,27076,247,10459,7895,2859,15433
2022-08-08 05:30:00+00,16515,0,5036,2577,184,486,2390,500,617,392,28697,251,10804,8414,3378,16515
2022-08-08 06:00:00+00,17335,0,5035,2439,249,248,2127,370,1320,18,29141,251,11170,9043,4008,17335
2022-08-08 06:30:00+00,17594,0,5032,2359,249,184,2107,835,2032,144,30536,247,11779,9672,4640,17594
2022-08-08 07:00:00+00,17193,0,5030,2414,242,302,2137,464,2865,696,31343,233,12688,10551,5521,17193
2022-08-08 07:30:00+00,17510,0,5039,2524,231,288,2135,712,3668,316,32423,231,13597,11462,6423,17510
2022-08-08 08:00:00+00,17531,0,5030,2589,244,1016,2136,694,4635,146,34021,227,14634,12498,7468,17531
2022-08-08 08:30:00+00,17327,0,5036,2830,248,1066,2081,608,5652,0,34848,219,15847,13766,8730,17327
2022-08-08 09:00:00+00,17154,0,5038,2923,215,1474,2056,420,6439,126,35845,212,16671,14615,9577,17154
2022-08-08 09:30:00+00,16983,0,5052,2901,198,1482,2084,341,7164,84,36289,207,17399,15315,10263,16983
2022-08-08 10:00:00+00,16276,0,5053,2844,140,1646,2040,278,7540,148,35965,201,17617,15577,10524,16276
2022-08-08 10:30:00+00,16189,0,5058,2912,132,1648,2066,151,7852,110,36118,198,18020,15954,10896,16189
2022-08-08 11:00:00+00,15907,0,5058,2935,129,1606,2081,156,8242,190,36304,195,18445,16364,11306,15907
2022-08-08 11:30:00+00,15800,0,5058,2997,111,1606,2076,151,8153,122,36074,195,18395,16319,11261,15800
2022-08-08 12:00:00+00,16173,0,5026,2916,111,1558,2076,152,8367,302,36681,195,18496,16420,11394,16173
2022-08-08 12:30:00+00,16248,0,4989,2904,111,1556,2074,144,8372,52,36450,197,18450,16376,11387,16248
2022-08-08 13:00:00+00,16721,3,4982,2883,104,1148,2070,156,8098,0,36165,202,18137,16067,11085,16724
2022-08-08 13:30:00+00,16845,6,4986,2974,92,1140,2048,147,7437,0,35675,206,17537,15489,10503,16851
2022-08-08 14:00:00+00,16985,9,4986,3013,90,740,2062,146,6940,0,34971,207,17091,15029,10043,16994
2022-08-08 14:30:00+00,17078,32,4977,3010,125,720,2075,196,6286,0,34499,212,16473,14398,9421,17110
2022-08-08 15:00:00+00,17192,92,4990,3058,331,444,2076,399,5593,0,34175,217,16048,13972,8982,17284
2022-08-08 15:30:00+00,17388,252,4984,3007,341,448,2085,675,4855,178,34213,226,15272,13187,8203,17640
2022-08-08 16:00:00+00,17163,326,4981,3037,443,894,2104,784,4282,928,34942,225,14847,12743,7762,17489
2022-08-08 16:30:00+00,17429,417,4981,3018,443,916,2112,845,3329,1106,34596,233,13883,11771,6790,17846
2022-08-08 17:00:00+00,17548,492,4985,3058,568,780,2099,940,2534,1188,34192,238,13244,11145,6160,18040
2022-08-08 17:30:00+00,17666,494,4985,3130,552,798,2065,999,1816,1188,33693,244,12548,10483,5498,18160
2022-08-08 18:00:00+00,17496,493,4989,3141,503,820,2081,933,1065,1188,32709,249,11779,9698,4709,17989
2022-08-08 18:30:00+00,17497,492,4990,3088,467,784,2085,951,446,1188,31988,254,11076,8991,4001,17989
2022-08-08 19:00:00+00,17419,492,4996,2845,445,552,2084,868,93,1016,30810,260,10463,8379,3383,17911
2022-08-08 19:30:00+00,17429,477,4992,2799,444,558,2084,858,0,900,30541,262,10319,8235,3243,17906
2022-08-08 20:00:00+00,17451,493,4988,2791,387,754,2081,768,0,716,30429,265,10247,8166,3178,17944
2022-08-08 20:30:00+00,17401,384,4991,2870,362,722,2081,614,0,260,29685,265,10304,8223,3232,17785
2022-08-08 21:00:00+00,17568,33,4991,2811,262,538,2073,703,0,116,29095,264,10137,8064,3073,17601
2022-08-08 21:30:00+00,17248,0,4988,2772,144,518,2032,258,0,26,27986,263,9936,7904,2916,17248
2022-08-08 22:00:00+00,17309,0,4991,2670,136,192,2094,159,0,132,27683,260,9891,7797,2806,17309
2022-08-08 22:30:00+00,16950,0,4990,2619,150,96,1802,152,0,0,26759,261,9561,7759,2769,16950
2022-08-08 23:00:00+00,17027,0,4990,2460,133,228,1689,155,0,0,26682,265,9272,7583,2593,17027
2022-08-08 23:30:00+00,16686,0,4988,2410,107,116,2086,148,0,0,26541,261,9591,7505,2517,16686
2022-08-09 00:00:00+00,16564,0,4990,2453,85,354,2085,158,0,0,26689,262,9613,7528,2538,16564
2022-08-09 00:30:00+00,16493,0,4989,2147,84,418,2082,304,0,0,26517,265,9302,7220,2231,16493
2022-08-09 01:00:00+00,16540,0,4989,2095,68,348,2088,399,0,0,26527,266,9240,7152,2163,16540
2022-08-09 01:30:00+00,16398,0,4987,1976,68,226,2115,361,0,0,26131,265,9146,7031,2044,16398
2022-08-09 02:00:00+00,16288,0,4899,1988,66,224,2114,488,0,0,26067,267,9067,6953,2054,16288
2022-08-09 02:30:00+00,16350,0,4834,2151,66,160,2118,479,0,0,26158,265,9169,7051,2217,16350
2022-08-09 03:00:00+00,16360,0,4847,2116,70,314,2120,471,0,0,26298,267,9153,7033,2186,16360
2022-08-09 03:30:00+00,16368,0,4845,2266,95,226,2121,459,0,0,26380,264,9327,7206,2361,16368
2022-08-09 04:00:00+00,16339,0,4845,2489,114,226,2120,402,0,0,26535,262,9568,7448,2603,16339
2022-08-09 04:30:00+00,16369,0,4785,2771,114,346,2120,368,3,0,26876,261,9793,7673,2888,16369
2022-08-09 05:00:00+00,15177,0,4720,2827,185,946,1681,468,158,0,26162,251,9571,7890,3170,15177
2022-08-09 05:30:00+00,15762,0,4620,2819,208,888,1534,508,576,136,27051,250,9757,8223,3603,15762
2022-08-09 06:00:00+00,16178,0,4598,2908,264,156,1595,464,1231,330,27724,244,10596,9001,4403,16178
2022-08-09 06:30:00+00,16708,0,4599,2850,371,124,2030,545,1984,20,29231,240,11834,9804,5205,16708
2022-08-09 07:00:00+00,16570,0,4600,2890,366,1222,2130,521,2830,8,31137,234,12816,10686,6086,16570
2022-08-09 07:30:00+00,16479,0,4593,3025,356,1344,2126,569,3778,100,32370,225,13878,11752,7159,16479
2022-08-09 08:00:00+00,16373,0,4600,3036,204,1914,2123,464,4776,0,33490,221,14739,12616,8016,16373
2022-08-09 08:30:00+00,16085,0,4594,3075,204,1908,2128,379,5733,0,34106,213,15734,13606,9012,16085
2022-08-09 09:00:00+00,16140,0,4588,3084,190,2002,2001,334,6554,0,34893,209,16417,14416,9828,16140
2022-08-09 09:30:00+00,15932,0,4594,3136,181,2002,1993,300,7290,0,35428,203,17194,15201,10607,15932
2022-08-09 10:00:00+00,15516,0,4599,3225,117,1804,2094,195,7913,0,35463,197,17948,15854,11255,15516
2022-08-09 10:30:00+00,15192,0,4602,3345,117,1836,2041,193,8361,0,35687,192,18466,16425,11823,15192
2022-08-09 11:00:00+00,15924,0,4598,3468,117,1998,2128,202,8635,0,37070,194,18946,16818,12220,15924
2022-08-09 11:30:00+00,15773,0,4605,3589,121,2002,2143,200,8724,0,37157,192,19182,17039,12434,15773
2022-08-09 12:00:00+00,15150,0,4603,3524,116,2298,1998,180,8534,42,36445,188,18775,16777,12174,15150
2022-08-09 12:30:00+00,14897,0,4607,3625,110,2320,1896,143,8400,62,36060,187,18638,16742,12135,14897
2022-08-09 13:00:00+00,14893,5,4598,3787,96,2048,1905,161,8428,102,36022,187,18814,16909,12311,14898
2022-08-09 13:30:00+00,15095,9,4601,3945,99,2044,1910,144,7822,108,35777,190,18377,16467,11866,15104
2022-08-09 14:00:00+00,15744,14,4594,4091,134,1462,2026,195,7051,64,35374,199,17896,15870,11276,15758
2022-08-09 14:30:00+00,15933,18,4590,4202,153,1438,2172,313,6705,34,35558,202,17822,15650,11060,15951
2022-08-09 15:00:00+00,15998,160,4590,4353,211,1552,2175,288,5965,74,35366,205,17294,15119,10529,16158
2022-08-09 15:30:00+00,16180,397,4688,4410,303,1578,2159,490,5097,2,35304,215,16657,14498,9810,16577
2022-08-09 16:00:00+00,15995,477,4762,4441,370,1282,2108,601,4229,144,34409,217,15910,13802,9040,16472
2022-08-09 16:30:00+00,16199,478,4757,4452,393,1266,2063,696,3257,722,34283,221,14922,12859,8102,16677
2022-08-09 17:00:00+00,16315,492,4767,4487,467,1300,2060,784,2501,826,33999,221,14282,12222,7455,16807
2022-08-09 17:30:00+00,16329,489,4785,4428,519,1340,2062,805,1840,810,33407,225,13634,11572,6787,16818
2022-08-09 18:00:00+00,16015,474,4788,4253,500,1578,2064,861,1133,828,32494,227,12738,10674,5886,16489
2022-08-09 18:30:00+00,15995,457,4793,4088,497,1570,2081,886,489,828,31684,233,11948,9867,5074,16452
2022-08-09 19:00:00+00,16426,490,4794,3975,465,870,2099,756,101,1002,30978,241,11434,9335,4541,16916
2022-08-09 19:30:00+00,16663,490,4805,4125,463,838,2133,727,0,726,30970,245,11526,9393,4588,17153
2022-08-09 20:00:00+00,16781,489,4799,4135,446,920,2135,717,0,476,30898,250,11515,9380,4581,17270
2022-08-09 20:30:00+00,16708,406,4760,4019,435,954,2132,708,0,152,30274,253,11346,9214,4454,17114
2022-08-09 21:00:00+00,16668,57,4638,3812,351,608,2117,494,0,172,28917,248,10918,8801,4163,16725
2022-08-09 21:30:00+00,16550,0,4610,3697,304,600,1890,237,0,0,27888,249,10501,8611,4001,16550
2022-08-09 22:00:00+00,16010,0,4336,3768,240,220,2038,200,0,0,26812,248,10382,8344,4008,16010
2022-08-09 22:30:00+00,15162,0,4328,3892,141,206,1828,160,0,0,25718,243,10190,8362,4034,15162
2022-08-09 23:00:00+00,15719,0,4331,3935,114,0,1910,150,0,0,26159,247,10290,8380,4049,15719
2022-08-09 23:30:00+00,15414,0,4331,3813,113,0,1951,150,0,0,25772,247,10208,8257,3926,15414
2022-08-10 00:00:00+00,15513,0,4333,3682,112,0,1993,152,0,0,25785,248,10120,8127,3794,15513
2022-08-10 00:30:00+00,15301,0,4335,3578,110,0,1919,219,0,0,25462,249,9942,8023,3688,15301
2022-08-10 01:00:00+00,15500,0,4336,3359,92,0,2017,359,0,0,25663,252,9804,7787,3451,15500
2022-08-10 01:30:00+00,15557,0,4335,3360,91,0,2032,293,0,0,25668,252,9818,7786,3451,15557
2022-08-10 02:00:00+00,15682,0,4333,3338,92,0,2041,319,0,0,25805,254,9804,7763,3430,15682
2022-08-10 02:30:00+00,15618,0,4332,3195,94,0,2055,248,0,0,25542,254,9676,7621,3289,15618
2022-08-10 03:00:00+00,15588,0,4331,3251,111,0,2104,175,0,0,25560,252,9797,7693,3362,15588
2022-08-10 03:30:00+00,15623,0,4328,3127,111,0,2182,158,0,0,25529,253,9748,7566,3238,15623
2022-08-10 04:00:00+00,15732,0,4340,3022,126,66,2187,143,0,0,25616,254,9675,7488,3148,15732
2022-08-10 04:30:00+00,15770,0,4346,3243,133,68,2160,148,2,0,25870,252,9884,7724,3378,15770
2022-08-10 05:00:00+00,16130,0,4355,3255,199,188,1791,302,139,160,26519,252,9739,7948,3593,16130
2022-08-10 05:30:00+00,16494,0,4356,3095,221,192,1877,378,582,410,27605,248,10131,8254,3898,16494
2022-08-10 06:00:00+00,15869,0,4357,3003,241,512,1916,394,1269,198,27759,241,10786,8870,4513,15869
2022-08-10 06:30:00+00,16496,0,4359,3037,240,1020,1716,625,2081,8,29582,243,11433,9717,5358,16496
2022-08-10 07:00:00+00,16406,0,4359,3109,219,1992,1559,550,2982,0,31176,235,12228,10669,6310,16406
2022-08-10 07:30:00+00,16456,0,4365,3161,217,2022,1656,486,3900,0,32263,228,13299,11643,7278,16456
2022-08-10 08:00:00+00,16372,0,4362,3240,199,2466,1751,210,4856,0,33456,216,14408,12657,8295,16372
2022-08-10 08:30:00+00,15869,0,4366,3584,195,2434,1718,149,5759,0,34074,206,15622,13904,9538,15869
2022-08-10 09:00:00+00,16013,0,4363,3857,173,1870,1738,150,6619,0,34783,203,16750,15012,10649,16013
2022-08-10 09:30:00+00,15785,0,4362,3938,163,1856,1402,169,7369,0,35044,198,17234,15832,11470,15785
2022-08-10 10:00:00+00,15873,0,4371,4067,113,2020,1424,175,8042,0,36085,193,18017,16593,12222,15873
2022-08-10 10:30:00+00,15729,0,4367,4067,111,2014,1353,163,8546,0,36350,189,18444,17091,12724,15729
2022-08-10 11:00:00+00,15679,0,4367,4010,109,1894,1341,177,8892,0,36469,188,18719,17378,13011,15679
2022-08-10 11:30:00+00,15259,0,4371,4087,109,1872,1546,153,9076,78,36551,184,19189,17643,13272,15259
2022-08-10 12:00:00+00,15158,0,4368,4169,128,1684,1867,157,9107,94,36732,182,19639,17772,13404,15158
2022-08-10 12:30:00+00,15156,0,4369,4169,124,1684,1961,149,8992,0,36604,183,19615,17654,13285,15156
2022-08-10 13:00:00+00,15140,0,4361,4164,161,1460,2018,154,8736,0,36194,183,19440,17422,13061,15140
2022-08-10 13:30:00+00,15044,0,4363,4369,263,1454,2052,278,8333,0,36156,183,19380,17328,12965,15044
2022-08-10 14:00:00+00,15856,0,4362,4391,252,1036,2169,357,7784,196,36403,188,18958,16789,12427,15856
2022-08-10 14:30:00+00,16168,9,4356,4524,263,1026,2273,471,7111,0,36201,194,18527,16254,11898,16177
2022-08-10 15:00:00+00,16381,121,4372,4513,266,774,2233,578,6304,0,35542,205,17688,15455,11083,16502
2022-08-10 15:30:00+00,16460,351,4411,4675,281,766,2182,623,5441,184,35374,213,16990,14808,10397,16811
2022-08-10 16:00:00+00,16150,488,4460,4633,349,1282,2174,596,4516,230,34878,218,16132,13958,9498,16638
2022-08-10 16:30:00+00,16351,483,4487,4555,427,1308,2151,743,3580,308,34393,224,15200,13049,8562,16834
2022-08-10 17:00:00+00,16309,399,4493,4291,549,1364,2135,892,2687,842,33961,222,14155,12020,7527,16708
2022-08-10 17:30:00+00,16313,348,4483,4054,555,1384,2160,984,1860,1140,33280,226,13112,10952,6468,16661
2022-08-10 18:00:00+00,16377,410,4486,3864,660,1420,2219,962,1059,1654,33111,229,12288,10069,5583,16787
2022-08-10 18:30:00+00,16234,456,4479,3521,695,1290,2248,965,418,1604,31910,236,11361,9113,4634,16690
2022-08-10 19:00:00+00,16331,490,4486,3226,648,1192,2249,927,68,1250,30867,247,10677,8428,3942,16821
2022-08-10 19:30:00+00,16020,490,4486,3140,589,1180,2092,929,0,1410,30336,246,10307,8215,3729,16510
2022-08-10 20:00:00+00,16355,473,4490,2960,392,1526,2113,903,0,988,30200,253,9955,7842,3352,16828
2022-08-10 20:30:00+00,16551,412,4490,2871,350,1542,2119,787,0,372,29494,258,9830,7711,3221,16963
2022-08-10 21:00:00+00,16703,287,4491,2924,331,1278,2127,460,0,32,28633,259,9873,7746,3255,16990
2022-08-10 21:30:00+00,16266,230,4488,2951,284,1190,1796,404,0,66,27675,257,9519,7723,3235,16496
2022-08-10 22:00:00+00,17270,229,4488,2929,237,336,2198,332,0,212,28231,263,9852,7654,3166,17499
2022-08-10 22:30:00+00,16894,231,4495,2761,234,468,1934,196,0,0,27213,267,9424,7490,2995,17125
2022-08-10 23:00:00+00,16785,230,4494,2665,171,214,2078,160,0,0,26797,270,9408,7330,2836,17015
2022-08-10 23:30:00+00,16725,230,4497,2602,151,208,2121,164,0,0,26698,271,9371,7250,2753,16955
2022-08-11 00:00:00+00,17022,229,4493,2418,135,208,2242,184,0,0,26931,273,9288,7046,2553,17251
2022-08-11 00:30:00+00,16941,229,4494,2272,135,208,2197,186,0,0,26662,275,9098,6901,2407,17170
2022-08-11 01:00:00+00,17145,229,4494,2253,117,208,2179,180,0,0,26805,276,9043,6864,2370,17374
2022-08-11 01:30:00+00,17030,229,4491,2302,118,208,2020,181,0,0,26579,276,8931,6911,2420,17259
2022-08-11 02:00:00+00,17345,230,4494,2248,119,208,1941,183,0,0,26768,278,8802,6861,2367,17575
2022-08-11 02:30:00+00,17341,230,4491,2119,136,208,2076,179,0,0,26780,279,8822,6746,2255,17571
2022-08-11 03:00:00+00,17438,231,4488,2001,135,208,2240,180,0,0,26921,280,8864,6624,2136,17669
2022-08-11 03:30:00+00,17462,235,4490,1907,135,208,2275,207,0,0,26919,280,8807,6532,2042,17697
2022-08-11 04:00:00+00,17256,231,4498,1836,150,208,2274,254,0,0,26707,280,8758,6484,1986,17487
2022-08-11 04:30:00+00,17567,233,4500,1745,177,208,2269,265,1,0,26965,282,8692,6423,1923,17800
2022-08-11 05:00:00+00,16822,238,4498,1648,234,594,2195,307,119,0,26655,275,8694,6499,2001,17060
2022-08-11 05:30:00+00,17363,339,4496,1510,251,540,2243,448,552,130,27872,274,9052,6809,2313,17702
2022-08-11 06:00:00+00,16636,352,4501,1442,317,1058,2007,509,1239,2,28063,268,9506,7499,2998,16988
2022-08-11 06:30:00+00,17265,380,4505,1286,409,1090,1891,677,2049,176,29728,264,10140,8249,3744,17645
2022-08-11 07:00:00+00,16568,385,4499,1224,494,2002,1929,553,2923,286,30863,252,11069,9140,4641,16953
2022-08-11 07:30:00+00,16589,372,4498,1189,456,2090,1932,483,3854,274,31737,244,11929,9997,5499,16961
2022-08-11 08:00:00+00,16156,318,4502,1151,369,2998,1931,385,4801,136,32747,228,12754,10823,6321,16474
2022-08-11 08:30:00+00,15829,291,4505,1210,241,3042,2009,268,5703,140,33238,220,13668,11659,7154,16120
2022-08-11 09:00:00+00,15760,235,4499,1257,226,3040,2193,213,6553,36,34012,215,14728,12535,8036,15995
2022-08-11 09:30:00+00,15487,238,4503,1397,203,3004,2305,175,7288,0,34600,209,15696,13391,8888,15725
2022-08-11 10:00:00+00,15983,286,4498,1542,162,2240,2311,171,7916,0,35109,211,16429,14118,9620,16269
2022-08-11 10:30:00+00,15942,234,4504,1663,143,2216,2308,170,8414,0,35594,206,17032,14724,10220,16176
2022-08-11 11:00:00+00,16763,249,4511,1742,145,1944,2308,201,8746,0,36609,211,17452,15144,10633,17012
2022-08-11 11:30:00+00,16441,296,4513,1806,145,1948,2303,226,8933,0,36611,209,17700,15397,10884,16737
2022-08-11 12:00:00+00,15704,254,4514,1924,133,2292,2287,224,8973,0,36305,202,17831,15544,11030,15958
2022-08-11 12:30:00+00,15285,248,4514,2108,135,2340,2290,215,8847,0,35982,199,17894,15604,11090,15533
2022-08-11 13:00:00+00,14904,247,4516,2307,134,2302,2289,254,8604,0,35557,197,17850,15561,11045,15151
2022-08-11 13:30:00+00,14708,324,4510,2447,134,2268,2288,296,8203,0,35178,198,17582,15294,10784,15032
2022-08-11 14:00:00+00,14462,407,4513,2551,156,2653,2280,365,7682,92,35161,194,17182,14902,10389,14869
2022-08-11 14:30:00+00,14591,405,4508,2657,178,2240,2247,408,7013,102,34349,194,16603,14356,9848,14996
2022-08-11 15:00:00+00,14426,403,4509,2664,186,2896,2221,465,6216,122,34108,194,15796,13575,9066,14829
2022-08-11 15:30:00+00,14778,408,4522,2713,208,2938,2238,475,5371,220,33871,200,15052,12814,8292,15186
2022-08-11 16:00:00+00,15662,403,4558,2961,256,2096,2272,517,4445,976,34146,213,14492,12220,7662,16065
2022-08-11 16:30:00+00,16128,407,4545,3139,368,2042,2276,552,3524,1168,34149,219,13852,11576,7031,16535
2022-08-11 17:00:00+00,17068,409,4543,3163,587,1662,2267,851,2635,1386,34571,229,13195,10928,6385,17477
2022-08-11 17:30:00+00,17321,411,4546,3143,610,1670,2276,1005,1812,1544,34338,235,12387,10111,5565,17732
2022-08-11 18:00:00+00,16726,399,4544,3217,580,2220,2269,1034,1012,1204,33205,237,11622,9353,4809,17125
2022-08-11 18:30:00+00,16462,403,4540,3232,568,2276,2274,1017,390,1130,32292,241,11004,8730,4190,16865
2022-08-11 19:00:00+00,16648,423,4534,2986,419,2164,2279,928,57,1204,31642,253,10275,7996,3462,17071
2022-08-11 19:30:00+00,17063,404,4541,2875,325,2116,2296,872,0,884,31376,260,10037,7741,3200,17467
2022-08-11 20:00:00+00,17679,476,4544,2891,342,1539,2323,952,0,612,31358,264,10100,7777,3233,18155
2022-08-11 20:30:00+00,17030,307,4552,3069,243,1482,2337,973,0,492,30485,257,10201,7864,3312,17337
2022-08-11 21:00:00+00,17356,8,4551,3073,198,1175,2333,853,0,264,29811,260,10155,7822,3271,17364
2022-08-11 21:30:00+00,17093,0,4554,2858,191,1054,2279,397,0,0,28426,262,9882,7603,3049,17093
2022-08-11 22:00:00+00,17376,0,4551,2696,181,456,2305,196,0,0,27761,261,9733,7428,2877,17376
2022-08-11 22:30:00+00,16818,0,4554,2463,194,696,2310,191,0,0,27226,262,9521,7211,2657,16818
2022-08-11 23:00:00+00,17378,0,4552,2327,129,816,2311,232,0,0,27745,267,9319,7008,2456,17378
2022-08-11 23:30:00+00,17308,0,4553,2267,108,918,2296,192,0,0,27642,268,9224,6928,2375,17308
2022-08-12 00:00:00+00,17472,0,4540,2213,108,972,2313,211,0,0,27829,270,9174,6861,2321,17472
2022-08-12 00:30:00+00,17432,0,4530,2146,109,848,2312,178,0,0,27555,270,9097,6785,2255,17432
2022-08-12 01:00:00+00,17177,0,4529,2043,110,626,2291,166,0,0,26942,274,8973,6682,2153,17177
2022-08-12 01:30:00+00,17242,0,4516,1914,109,564,2279,168,0,0,26792,275,8818,6539,2023,17242
2022-08-12 02:00:00+00,17528,0,4507,1837,90,676,2243,164,0,0,27045,279,8677,6434,1927,17528
2022-08-12 02:30:00+00,17445,0,4491,1748,92,656,2221,185,0,0,26838,279,8552,6331,1840,17445
2022-08-12 03:00:00+00,17401,0,4482,1599,92,578,2220,172,0,0,26544,280,8393,6173,1691,17401
2022-08-12 03:30:00+00,17640,0,4471,1457,92,560,2215,152,0,0,26587,283,8235,6020,1549,17640
2022-08-12 04:00:00+00,17864,0,4464,1347,92,634,2236,152,0,0,26789,283,8139,5903,1439,17864
2022-08-12 04:30:00+00,17785,0,4453,1369,119,682,2243,151,0,0,26802,282,8184,5941,1488,17785
2022-08-12 05:00:00+00,17400,0,4448,1395,204,1168,2244,154,113,0,27126,274,8404,6160,1712,17400
2022-08-12 05:30:00+00,17402,0,4435,1496,212,1080,2246,401,535,0,27807,267,8924,6678,2243,17402
2022-08-12 06:00:00+00,16788,0,4427,1605,223,1234,2237,557,1218,152,28441,252,9710,7473,3046,16788
2022-08-12 06:30:00+00,17635,0,4425,1690,223,1204,2150,644,2011,164,30146,248,10499,8349,3924,17635
2022-08-12 07:00:00+00,17431,0,4419,1675,223,1806,2205,482,2881,172,31294,239,11403,9198,4779,17431
2022-08-12 07:30:00+00,17718,0,4424,1690,222,1876,2233,423,3787,22,32395,235,12356,10123,5699,17718
2022-08-12 08:00:00+00,17805,0,4425,1724,178,2224,2241,295,4726,64,33682,228,13294,11053,6628,17805
2022-08-12 08:30:00+00,17702,0,4369,1794,175,2198,2237,267,5641,30,34413,222,14216,11979,7610,17702
2022-08-12 09:00:00+00,17696,0,4317,1791,218,2764,2237,393,6478,116,36010,215,15041,12804,8487,17696
2022-08-12 09:30:00+00,17512,0,4314,1863,210,2800,2233,400,7206,0,36538,210,15826,13593,9279,17512
2022-08-12 10:00:00+00,17313,0,4310,1987,189,3152,2227,220,7853,0,37251,205,16566,14339,10029,17313
2022-08-12 10:30:00+00,17198,0,4312,2073,171,3154,2226,205,8340,0,37679,202,17122,14896,10584,17198
2022-08-12 11:00:00+00,17143,0,4312,2276,160,3390,2224,183,8646,0,38334,200,17618,15394,11082,17143
2022-08-12 11:30:00+00,16949,0,4320,2511,132,3390,2139,142,8804,0,38387,197,17906,15767,11447,16949
2022-08-12 12:00:00+00,17143,0,4332,2681,115,3154,2148,152,8854,0,38579,197,18130,15982,11650,17143
2022-08-12 12:30:00+00,16929,0,4342,2793,104,3124,1957,151,8759,0,38159,196,17955,15998,11656,16929
2022-08-12 13:00:00+00,16704,0,4348,2947,103,2522,1985,159,8498,0,37266,195,17881,15896,11548,16704
2022-08-12 13:30:00+00,16665,0,4391,3025,103,2494,2104,151,8087,0,37020,196,17710,15606,11215,16665
2022-08-12 14:00:00+00,16433,0,4422,2998,106,2184,2045,165,7548,36,35937,199,17119,15074,10652,16433
2022-08-12 14:30:00+00,16566,0,4437,2993,112,2164,2101,200,6869,96,35538,203,16512,14411,9974,16566
2022-08-12 15:00:00+00,16240,0,4441,2977,115,2064,2130,227,6070,4,34268,206,15733,13603,9162,16240
2022-08-12 15:30:00+00,16469,0,4449,3006,140,2080,2113,525,5199,206,34187,211,14907,12794,8345,16469
2022-08-12 16:00:00+00,16151,0,4454,3089,224,2374,2075,627,4276,684,33954,208,14118,12043,7589,16151
2022-08-12 16:30:00+00,16466,0,4463,3009,218,2428,2096,774,3361,776,33591,215,13147,11051,6588,16466
2022-08-12 17:00:00+00,16258,0,4452,3034,397,2076,2089,905,2476,1074,32761,218,12448,10359,5907,16258
2022-08-12 17:30:00+00,16173,0,4447,3147,364,2050,2116,975,1678,1432,32382,220,11752,9636,5189,16173
2022-08-12 18:00:00+00,16608,0,4453,3171,376,2347,2105,974,965,1448,32447,227,11070,8965,4512,16608
2022-08-12 18:30:00+00,16682,0,4448,3150,351,2340,2105,982,382,1142,31582,234,10436,8331,3883,16682
2022-08-12 19:00:00+00,16778,0,4442,3337,289,1519,2116,899,52,898,30329,237,10236,8120,3678,16778
2022-08-12 19:30:00+00,16833,0,4449,3517,274,1507,2095,752,0,500,29927,239,10335,8240,3791,16833
2022-08-12 20:00:00+00,17066,0,4443,3668,238,1660,2088,751,0,332,30246,241,10437,8349,3906,17066
2022-08-12 20:30:00+00,16725,0,4454,3840,250,1645,2091,599,0,0,29604,241,10635,8544,4090,16725
2022-08-12 21:00:00+00,16677,0,4457,3942,204,1456,2093,456,0,0,29285,242,10696,8603,4146,16677
2022-08-12 21:30:00+00,16095,0,4483,3950,204,1460,1970,201,0,0,28363,239,10607,8637,4154,16095
2022-08-12 22:00:00+00,15974,0,4512,3910,202,974,1556,182,0,22,27332,242,10180,8624,4112,15974
2022-08-12 22:30:00+00,16108,0,4540,3795,186,1148,1441,162,0,0,27380,248,9962,8521,3981,16108
2022-08-12 23:00:00+00,16238,0,4556,3665,169,896,1497,162,0,30,27213,254,9887,8390,3834,16238
2022-08-12 23:30:00+00,16059,0,4569,3556,151,818,1518,149,0,0,26820,255,9794,8276,3707,16059
2022-08-13 00:00:00+00,15867,0,4568,3388,132,448,1528,157,0,0,26088,257,9616,8088,3520,15867
2022-08-13 00:30:00+00,15669,0,4570,3215,130,476,1530,146,0,0,25736,257,9445,7915,3345,15669
2022-08-13 01:00:00+00,15728,0,4569,2913,124,348,1527,158,0,0,25367,260,9133,7606,3037,15728
2022-08-13 01:30:00+00,15723,0,4567,2778,124,224,1525,152,0,0,25093,260,8994,7469,2902,15723
2022-08-13 02:00:00+00,16000,0,4570,2671,123,288,1527,152,0,0,25331,263,8891,7364,2794,16000
2022-08-13 02:30:00+00,15830,0,4589,2646,113,290,1530,149,0,0,25147,263,8878,7348,2759,15830
2022-08-13 03:00:00+00,15836,0,4605,2600,113,362,1530,147,0,0,25193,264,8848,7318,2713,15836
2022-08-13 03:30:00+00,15521,0,4614,2587,113,326,1530,161,0,0,24852,262,8844,7314,2700,15521
2022-08-13 04:00:00+00,15706,0,4626,2572,131,372,1531,159,0,0,25097,263,8860,7329,2703,15706
2022-08-13 04:30:00+00,15812,0,4651,2487,152,368,1531,152,0,0,25153,264,8821,7290,2639,15812
2022-08-13 05:00:00+00,15724,0,4668,2408,184,284,1528,153,101,0,25050,262,8889,7361,2693,15724
2022-08-13 05:30:00+00,16017,0,4676,2276,204,506,1528,154,496,0,25857,261,9180,7652,2976,16017
2022-08-13 06:00:00+00,14820,0,4672,2146,217,434,1494,189,1126,24,25122,248,9655,8161,3489,14820
2022-08-13 06:30:00+00,15104,0,4674,2051,217,478,1526,178,1869,0,26097,243,10337,8811,4137,15104
2022-08-13 07:00:00+00,14565,0,4675,1963,217,1208,1522,152,2705,0,27007,233,11082,9560,4885,14565
2022-08-13 07:30:00+00,14637,0,4681,1906,216,1178,1522,152,3608,0,27900,226,11933,10411,5730,14637
2022-08-13 08:00:00+00,14231,0,4675,1830,203,2062,1524,154,4541,0,29220,218,12773,11249,6574,14231
2022-08-13 08:30:00+00,14153,0,4674,1771,202,2154,1527,165,5454,0,30100,212,13628,12101,7427,14153
2022-08-13 09:00:00+00,14511,0,4681,1593,167,2716,1524,148,6311,0,31651,205,14276,12752,8071,14511
2022-08-13 09:30:00+00,14376,0,4684,1472,140,2792,1526,161,7062,0,32213,200,14884,13358,8674,14376
2022-08-13 10:00:00+00,13588,0,4701,1459,97,3312,1525,147,7695,0,32524,190,15477,13952,9251,13588
2022-08-13 10:30:00+00,13349,0,4689,1500,97,3370,1525,147,8205,0,32882,185,16016,14491,9802,13349
2022-08-13 11:00:00+00,13314,0,4686,1475,83,3496,1386,152,8562,0,33154,184,16192,14806,10120,13314
2022-08-13 11:30:00+00,13534,0,4679,1384,83,3502,1106,162,8755,0,33205,185,16007,14901,10222,13534
2022-08-13 12:00:00+00,13462,0,4686,1345,83,3676,1021,153,8779,0,33205,184,15914,14893,10207,13462
2022-08-13 12:30:00+00,13198,0,4685,1308,83,3618,1197,145,8654,0,32888,183,15927,14730,10045,13198
2022-08-13 13:00:00+00,13707,0,4691,1264,83,2828,1397,147,8366,0,32483,191,15801,14404,9713,13707
2022-08-13 13:30:00+00,13925,0,4693,1288,83,2780,1456,148,7978,0,32351,195,15498,14042,9349,13925
2022-08-13 14:00:00+00,14058,0,4691,1347,82,2100,1552,184,7429,0,31443,201,15101,13549,8858,14058
2022-08-13 14:30:00+00,14075,0,4694,1407,169,2052,1537,360,6709,0,31003,206,14516,12979,8285,14075
2022-08-13 15:00:00+00,14321,0,4692,1561,262,1108,1535,338,5872,0,29689,211,13922,12387,7695,14321
2022-08-13 15:30:00+00,14772,0,4689,1730,280,1044,1537,464,5071,0,29587,218,13307,11770,7081,14772
2022-08-13 16:00:00+00,15701,0,4691,1941,311,1566,1537,635,4099,264,30745,226,12579,11042,6351,15701
2022-08-13 16:30:00+00,15655,0,4691,2161,323,1630,1536,674,3162,688,30520,227,11873,10337,5646,15655
2022-08-13 17:00:00+00,15633,0,4696,2407,380,1388,1655,762,2343,990,30254,227,11481,9826,5130,15633
2022-08-13 17:30:00+00,15603,0,4686,2626,410,1404,1869,775,1579,1160,30112,228,11170,9301,4615,15603
2022-08-13 18:00:00+00,15685,0,4686,2792,421,1374,2139,805,907,1008,29817,229,10945,8806,4120,15685
2022-08-13 18:30:00+00,15742,0,4681,2922,408,1376,2177,768,342,962,29378,233,10530,8353,3672,15742
2022-08-13 19:00:00+00,15820,0,4680,3192,373,1236,2180,686,38,954,29159,236,10463,8283,3603,15820
2022-08-13 19:30:00+00,15841,0,4677,3636,306,1232,2188,564,0,646,29090,235,10807,8619,3942,15841
2022-08-13 20:00:00+00,16270,0,4680,3969,285,1098,2172,472,0,608,29554,236,11106,8934,4254,16270
2022-08-13 20:30:00+00,16374,0,4678,4330,263,1026,2137,363,0,0,29171,239,11408,9271,4593,16374
2022-08-13 21:00:00+00,16464,0,4681,4405,221,326,2118,353,0,410,28978,241,11425,9307,4626,16464
2022-08-13 21:30:00+00,16470,0,4686,4199,192,312,2152,209,0,114,28334,245,11229,9077,4391,16470
2022-08-13 22:00:00+00,14907,0,4691,4066,170,606,2166,195,0,0,26801,236,11093,8927,4236,14907
2022-08-13 22:30:00+00,14018,0,4691,3827,169,642,2156,191,0,16,25710,232,10843,8687,3996,14018
2022-08-13 23:00:00+00,12447,0,4689,3484,143,906,2117,190,0,56,24032,225,10433,8316,3627,12447
2022-08-13 23:30:00+00,12077,0,4685,3077,113,1076,2238,186,0,0,23452,228,10113,7875,3190,12077
2022-08-14 00:00:00+00,12015,0,4685,2519,113,942,2254,189,0,0,22717,234,9571,7317,2632,12015
2022-08-14 00:30:00+00,11874,0,4699,2221,114,870,2254,184,0,122,22338,234,9288,7034,2335,11874
2022-08-14 01:00:00+00,11339,0,4705,2007,114,936,2258,186,0,18,21563,233,9084,6826,2121,11339
2022-08-14 01:30:00+00,11322,0,4701,1740,113,784,2260,190,0,0,21110,235,8814,6554,1853,11322
2022-08-14 02:00:00+00,11087,0,4706,1604,113,856,2258,184,0,0,20808,237,8681,6423,1717,11087
2022-08-14 02:30:00+00,10810,0,4696,1568,113,866,2259,183,0,0,20495,236,8636,6377,1681,10810
2022-08-14 03:00:00+00,10534,0,4714,1503,113,948,2230,185,0,0,20227,230,8560,6330,1616,10534
2022-08-14 03:30:00+00,10500,0,4726,1444,113,956,2244,189,0,0,20172,230,8527,6283,1557,10500
2022-08-14 04:00:00+00,10696,0,4726,1472,112,1008,2264,188,0,0,20466,230,8574,6310,1584,10696
2022-08-14 04:30:00+00,10488,0,4739,1448,132,982,2245,185,0,0,20219,228,8564,6319,1580,10488
2022-08-14 05:00:00+00,10689,0,4737,1364,170,1086,2263,187,88,0,20584,231,8622,6359,1622,10689
2022-08-14 05:30:00+00,10890,0,4748,1267,191,1184,2262,193,466,8,21209,230,8934,6672,1924,10890
2022-08-14 06:00:00+00,10309,0,4740,1114,202,2104,2262,215,1014,10,21970,218,9332,7070,2330,10309
2022-08-14 06:30:00+00,10125,0,4735,1011,222,2328,2261,385,1736,128,22931,211,9965,7704,2969,10125
2022-08-14 07:00:00+00,9957,0,4729,934,211,2940,2247,455,2517,94,24084,204,10638,8391,3662,9957
2022-08-14 07:30:00+00,10197,0,4720,896,218,2946,2260,472,3383,14,25106,199,11477,9217,4497,10197
2022-08-14 08:00:00+00,9946,0,4718,900,184,4262,2256,215,4248,98,26827,182,12306,10050,5332,9946
2022-08-14 08:30:00+00,9944,0,4722,835,185,4330,2249,149,5169,0,27583,177,13160,10911,6189,9944
2022-08-14 09:00:00+00,9863,0,4710,718,129,4590,2200,478,6081,0,28769,172,13838,11638,6928,9863
2022-08-14 09:30:00+00,9914,0,4703,692,104,4604,2165,641,6838,0,29661,169,14502,12337,7634,9914
2022-08-14 10:00:00+00,9991,0,4689,696,69,4556,2212,773,7460,0,30446,167,15126,12914,8225,9991
2022-08-14 10:30:00+00,9973,0,4700,718,59,4554,2121,749,7934,0,30808,164,15532,13411,8711,9973
2022-08-14 11:00:00+00,10017,0,4684,718,59,5542,2148,328,8263,0,31759,158,15872,13724,9040,10017
2022-08-14 11:30:00+00,10129,0,4667,821,59,5592,2128,167,8353,0,31916,157,16028,13900,9233,10129
2022-08-14 12:00:00+00,9849,0,4669,926,58,5840,2112,146,8324,0,31924,154,16089,13977,9308,9849
2022-08-14 12:30:00+00,9862,0,4673,1191,57,5854,2140,142,8004,0,31923,154,16065,13925,9252,9862
2022-08-14 13:00:00+00,9578,0,4666,1408,57,5890,2096,142,7512,0,31349,152,15739,13643,8977,9578
2022-08-14 13:30:00+00,9688,0,4659,1707,58,5834,2114,146,7018,0,31224,154,15556,13442,8783,9688
2022-08-14 14:00:00+00,10360,0,4646,1730,58,5018,2169,152,6358,0,30491,166,14961,12792,8146,10360
2022-08-14 14:30:00+00,10885,0,4636,1695,58,4950,2192,233,5735,0,30384,174,14316,12124,7488,10885
2022-08-14 15:00:00+00,12647,0,4635,1761,106,2404,2246,681,5108,0,29588,200,13856,11610,6975,12647
2022-08-14 15:30:00+00,13797,0,4644,1741,115,2280,2221,723,4140,42,29703,215,12861,10640,5996,13797
2022-08-14 16:00:00+00,15017,0,4634,1673,162,1922,2230,446,3435,452,29971,219,12134,9904,5270,15017
2022-08-14 16:30:00+00,15612,0,4631,1499,233,2075,2234,581,2585,360,29810,230,11182,8948,4317,15612
2022-08-14 17:00:00+00,15788,0,4627,1409,277,1798,2212,821,1887,588,29407,233,10412,8200,3573,15788
2022-08-14 17:30:00+00,15901,0,4620,1386,344,1822,2212,920,1274,994,29473,236,9836,7624,3004,15901
2022-08-14 18:00:00+00,16222,0,4606,1447,576,1542,2201,1030,740,1058,29422,242,9570,7369,2763,16222
2022-08-14 18:30:00+00,16306,0,4599,1486,577,1550,2206,1025,296,896,28941,247,9164,6958,2359,16306
2022-08-14 19:00:00+00,16182,0,4585,1475,424,1550,2221,965,36,890,28328,251,8741,6520,1935,16182
2022-08-14 19:30:00+00,16291,0,4573,1444,368,1530,2218,830,0,928,28182,253,8603,6385,1812,16291
2022-08-14 20:00:00+00,16400,0,4557,1332,263,1746,2223,821,0,788,28130,260,8374,6152,1594,16400
2022-08-14 20:30:00+00,16358,0,4559,1352,236,1668,2229,685,0,288,27375,265,8376,6147,1588,16358
2022-08-14 21:00:00+00,16447,0,4553,1448,417,1110,2227,743,0,140,27085,270,8645,6418,1865,16447
2022-08-14 21:30:00+00,16223,0,4542,1402,255,836,2227,426,0,124,26035,269,8426,6199,1657,16223
2022-08-14 22:00:00+00,15533,0,4537,1358,197,856,2224,270,0,0,24975,262,8316,6092,1555,15533
2022-08-14 22:30:00+00,14858,0,4527,1354,169,922,2225,169,0,0,24224,258,8275,6050,1523,14858
2022-08-14 23:00:00+00,14969,0,4346,1129,118,714,2194,153,0,0,23623,268,7787,5593,1247,14969
2022-08-14 23:30:00+00,14849,0,4347,1219,76,678,2188,145,0,0,23502,267,7830,5642,1295,14849
2022-08-15 00:00:00+00,14935,0,4345,1197,63,518,2155,148,0,0,23361,272,7760,5605,1260,14935
2022-08-15 00:30:00+00,14991,0,4360,1017,64,486,2163,146,0,0,23227,274,7604,5441,1081,14991
2022-08-15 01:00:00+00,14998,0,4362,1219,65,296,2191,145,0,0,23276,273,7837,5646,1284,14998
2022-08-15 01:30:00+00,14976,0,4362,1036,65,262,2191,153,0,0,23045,275,7654,5463,1101,14976
2022-08-15 02:00:00+00,14980,0,4361,985,65,266,2196,148,0,0,23001,275,7607,5411,1050,14980
2022-08-15 02:30:00+00,14903,0,4365,1256,65,262,2171,149,0,0,23171,272,7857,5686,1321,14903
2022-08-15 03:00:00+00,14928,2,4362,1379,65,206,2208,152,0,0,23302,270,8014,5806,1444,14930
2022-08-15 03:30:00+00,14988,4,4365,1471,65,258,2274,146,0,0,23571,269,8175,5901,1536,14992
2022-08-15 04:00:00+00,14951,6,4362,1888,75,278,2304,150,0,0,24014,264,8629,6325,1963,14957
2022-08-15 04:30:00+00,14877,30,4357,1962,102,254,2457,162,0,0,24201,262,8878,6421,2064,14907
2022-08-15 05:00:00+00,14261,101,4369,1871,133,1294,2619,195,56,0,24899,253,9048,6429,2060,14362
2022-08-15 05:30:00+00,14893,243,4366,1913,135,1438,2755,193,279,0,26215,257,9448,6693,2327,15136
2022-08-15 06:00:00+00,14826,366,4369,2078,178,2106,2815,230,593,0,27561,246,10033,7218,2849,15192
2022-08-15 06:30:00+00,15668,417,4365,1915,183,2300,2730,249,1047,48,28922,249,10240,7510,3145,16085
2022-08-15 07:00:00+00,16339,446,4363,1563,203,2666,2721,374,1484,194,30353,250,10334,7613,3250,16785
2022-08-15 07:30:00+00,16529,468,4368,1304,212,2758,2724,717,2021,56,31157,250,10629,7905,3537,16997
2022-08-15 08:00:00+00,16164,429,4371,1162,177,4282,2714,336,2828,12,32475,239,11252,8538,4167,16593
2022-08-15 08:30:00+00,16133,420,4365,1206,165,4332,2737,330,3331,0,33019,234,11804,9067,4702,16553
2022-08-15 09:00:00+00,16047,357,4373,1309,118,4362,2779,326,3912,0,33583,230,12491,9712,5339,16404
2022-08-15 09:30:00+00,16048,380,4367,1594,113,4346,2782,350,4337,22,34339,226,13193,10411,6044,16428
2022-08-15 10:00:00+00,15869,405,4371,1773,82,4668,2782,339,4302,0,34591,225,13310,10528,6157,16274
2022-08-15 10:30:00+00,16075,419,4371,1719,76,4648,2834,313,4167,24,34646,228,13167,10333,5962,16494
2022-08-15 11:00:00+00,15929,485,4379,1665,75,4558,2844,567,4225,4,34731,230,13188,10344,5965,16414
2022-08-15 11:30:00+00,15846,492,4383,1869,75,4546,2826,631,4139,0,34807,229,13292,10466,6083,16338
2022-08-15 12:00:00+00,15864,495,4375,2074,75,3972,2820,635,4181,14,34505,230,13525,10705,6330,16359
2022-08-15 12:30:00+00,15820,494,4374,2263,87,3936,2776,641,4265,0,34656,228,13765,10989,6615,16314
2022-08-15 13:00:00+00,15549,481,4375,2482,101,3660,2806,604,3978,0,34036,228,13742,10936,6561,16030
2022-08-15 13:30:00+00,15534,438,4371,2669,75,3674,2781,428,4293,0,34263,224,14189,11408,7037,15972
2022-08-15 14:00:00+00,15753,494,4377,2637,55,3742,2751,314,4079,0,34202,227,13899,11148,6771,16247
2022-08-15 14:30:00+00,15779,491,4377,2628,58,3800,2760,328,3310,0,33531,233,13133,10373,5996,16270
2022-08-15 15:00:00+00,15826,489,4373,2506,125,3658,2751,468,3217,0,33413,232,12972,10221,5848,16315
2022-08-15 15:30:00+00,15783,450,4377,2725,149,3824,2720,597,2610,0,33235,235,12581,9861,5484,16233
2022-08-15 16:00:00+00,15961,458,4381,3199,197,3824,2709,720,2264,0,33713,235,12750,10041,5660,16419
2022-08-15 16:30:00+00,16111,445,4393,2975,266,3826,2693,807,1571,162,33249,240,11898,9205,4812,16556
2022-08-15 17:00:00+00,16361,449,4394,2767,405,3148,2729,861,1193,550,32857,242,11488,8759,4365,16810
2022-08-15 17:30:00+00,16415,445,4394,2488,411,3146,2675,879,702,438,31993,249,10670,7995,3601,16860
2022-08-15 18:00:00+00,16503,414,4395,2610,370,2336,2655,912,486,720,31401,252,10516,7861,3466,16917
2022-08-15 18:30:00+00,16401,382,4398,2848,343,2358,2641,872,194,430,30867,254,10424,7783,3385,16783
2022-08-15 19:00:00+00,16541,398,4390,2976,325,2138,2611,835,20,482,30716,257,10322,7711,3321,16939
2022-08-15 19:30:00+00,16666,368,4390,2766,353,2116,2637,731,0,1134,31161,253,10146,7509,3119,17034
2022-08-15 20:00:00+00,16966,401,4389,2571,305,2314,2737,666,0,740,31089,259,10002,7265,2876,17367
2022-08-15 20:30:00+00,16793,469,4385,2527,223,2158,2745,752,0,0,30052,268,9880,7135,2750,17262
2022-08-15 21:00:00+00,16194,394,4385,2628,164,1724,2751,633,0,58,28931,265,9928,7177,2792,16588
2022-08-15 21:30:00+00,15788,358,4388,2609,144,1704,2600,406,0,0,27997,264,9741,7141,2753,16146
2022-08-15 22:00:00+00,16365,40,4385,2431,131,1400,2658,301,0,0,27711,264,9605,6947,2562,16405
2022-08-15 22:30:00+00,16130,0,4390,2682,117,1220,2410,170,0,0,27119,260,9599,7189,2799,16130
2022-08-15 23:00:00+00,16668,0,4392,2857,85,1212,2408,152,0,0,27774,262,9742,7334,2942,16668
2022-08-15 23:30:00+00,16265,0,4395,2730,87,1136,2409,158,0,0,27180,260,9621,7212,2817,16265
2022-08-16 00:00:00+00,16695,0,4403,2587,87,846,2540,220,0,0,27378,265,9617,7077,2674,16695
2022-08-16 00:30:00+00,16482,0,4399,2526,85,774,2516,391,0,0,27173,265,9526,7010,2611,16482
2022-08-16 01:00:00+00,16511,0,4408,2595,66,600,2572,659,0,0,27411,266,9641,7069,2661,16511
2022-08-16 01:30:00+00,16447,0,4408,2729,66,566,2598,645,0,0,27459,264,9801,7203,2795,16447
2022-08-16 02:00:00+00,16467,0,4413,2860,65,486,2525,539,0,0,27355,262,9863,7338,2925,16467
2022-08-16 02:30:00+00,16378,0,4413,3085,64,568,2520,239,0,0,27267,260,10082,7562,3149,16378
2022-08-16 03:00:00+00,16195,0,4417,3250,62,550,2537,148,0,0,27159,257,10266,7729,3312,16195
2022-08-16 03:30:00+00,15889,0,4417,3391,61,536,2508,156,0,0,26958,254,10377,7869,3452,15889
2022-08-16 04:00:00+00,16026,0,4414,3619,60,638,2491,148,0,0,27396,254,10584,8093,3679,16026
2022-08-16 04:30:00+00,16016,0,4415,3885,60,728,2529,158,0,0,27791,252,10889,8360,3945,16016
2022-08-16 05:00:00+00,15474,123,4413,3893,90,1220,2439,158,32,0,27842,249,10867,8428,4015,15597
2022-08-16 05:30:00+00,15681,349,4411,3825,111,1302,2707,228,195,0,28809,254,11249,8542,4131,16030
2022-08-16 06:00:00+00,15387,486,4412,3725,118,2016,2681,431,394,8,29658,256,11330,8649,4237,15873
2022-08-16 06:30:00+00,15647,489,4414,3513,144,2078,2812,728,635,0,30460,256,11518,8706,4292,16136
2022-08-16 07:00:00+00,14896,377,4407,3572,190,3248,2729,367,1030,176,30992,240,11928,9199,4792,15273
2022-08-16 07:30:00+00,15221,321,4413,3680,180,3458,2716,253,1295,150,31687,237,12284,9568,5155,15542
2022-08-16 08:00:00+00,15262,282,4405,3765,166,4160,2703,283,1641,64,32731,235,12680,9977,5572,15544
2022-08-16 08:30:00+00,15448,408,4408,3828,165,4176,2478,268,2265,88,33532,234,13144,10666,6258,15856
2022-08-16 09:00:00+00,15302,458,4405,3931,114,4402,2360,252,2710,98,34032,231,13520,11160,6755,15760
2022-08-16 09:30:00+00,15150,402,4411,4072,91,4422,2462,188,3120,42,34360,225,14156,11694,7283,15552
2022-08-16 10:00:00+00,15392,435,4410,4142,74,4442,2236,206,3214,0,34551,227,14076,11840,7430,15827
2022-08-16 10:30:00+00,15393,390,4404,4219,73,4446,2081,268,3557,0,34831,224,14334,12253,7849,15783
2022-08-16 11:00:00+00,15243,351,4407,4208,76,4522,2328,308,3351,0,34794,223,14370,12042,7635,15594
2022-08-16 11:30:00+00,15094,457,4416,4261,76,4518,2124,314,3182,0,34442,226,14059,11935,7519,15551
2022-08-16 12:00:00+00,15131,500,4410,4349,79,4110,2136,286,3457,0,34458,227,14431,12295,7885,15631
2022-08-16 12:30:00+00,14991,499,4414,4574,91,4110,2230,312,3099,0,34320,227,14408,12178,7764,15490
2022-08-16 13:00:00+00,15182,498,4419,4600,92,3548,2205,365,3119,0,34028,230,14435,12230,7811,15680
2022-08-16 13:30:00+00,15170,499,4414,4510,92,3544,2163,367,3349,0,34108,229,14528,12365,7951,15669
2022-08-16 14:00:00+00,14996,457,4405,4416,105,3804,2161,371,2862,0,33577,228,13949,11788,7383,15453
2022-08-16 14:30:00+00,15047,452,4404,4325,119,3826,2321,334,2285,134,33247,231,13454,11133,6729,15499
2022-08-16 15:00:00+00,15613,364,4408,4305,157,2880,2850,748,1956,138,33419,237,13676,10826,6418,15977
2022-08-16 15:30:00+00,15797,345,4412,4464,228,2918,2908,791,1997,306,34166,234,14009,11101,6689,16142
2022-08-16 16:00:00+00,16240,356,4408,4537,274,2650,2909,869,1598,780,34621,236,13726,10817,6409,16596
2022-08-16 16:30:00+00,16092,359,4412,4534,451,2650,2906,898,1139,1366,34807,233,13442,10536,6124,16451
2022-08-16 17:00:00+00,16596,372,4416,4611,574,2170,2914,990,770,1244,34657,234,13285,10371,5955,16968
2022-08-16 17:30:00+00,16675,476,4420,4602,579,2122,2912,927,380,1098,34191,240,12893,9981,5561,17151
2022-08-16 18:00:00+00,16165,373,4418,4787,519,1946,2886,939,196,1342,33571,234,12806,9920,5502,16538
2022-08-16 18:30:00+00,15666,321,4422,5025,380,1834,2865,889,70,1104,32576,231,12762,9897,5475,15987
2022-08-16 19:00:00+00,15815,326,4416,5222,289,2006,2868,639,2,1040,32623,232,12797,9929,5513,16141
2022-08-16 19:30:00+00,15790,348,4419,5661,259,1992,2791,588,0,856,32704,231,13130,10339,5920,16138
2022-08-16 20:00:00+00,15939,348,4416,5897,191,1812,2762,546,0,668,32579,231,13266,10504,6088,16287
2022-08-16 20:30:00+00,15852,344,4416,5856,189,1798,2776,452,0,130,31813,234,13237,10461,6045,16196
2022-08-16 21:00:00+00,15818,353,4415,5723,159,1034,2684,304,0,108,30598,240,12981,10297,5882,16171
2022-08-16 21:30:00+00,15531,210,4414,5829,156,950,2198,247,0,34,29569,236,12597,10399,5985,15741
2022-08-16 22:00:00+00,15355,0,4410,5848,112,736,2253,259,0,6,28979,233,12623,10370,5960,15355
2022-08-16 22:30:00+00,14630,0,4413,5757,103,734,2266,169,0,0,28072,229,12539,10273,5860,14630
2022-08-16 23:00:00+00,15200,0,4410,5640,64,606,2268,167,0,0,28355,233,12382,10114,5704,15200
2022-08-16 23:30:00+00,15208,0,4413,5801,64,496,2268,257,0,0,28507,231,12546,10278,5865,15208
2022-08-17 00:00:00+00,15315,0,4414,5744,64,448,2268,180,0,0,28433,231,12490,10222,5808,15315
2022-08-17 00:30:00+00,15318,0,4416,5610,63,448,2269,193,0,0,28317,232,12358,10089,5673,15318
2022-08-17 01:00:00+00,14979,0,4422,5818,61,376,2269,220,0,0,28145,228,12570,10301,5879,14979
2022-08-17 01:30:00+00,14743,0,4413,5968,59,244,2117,155,0,0,27699,225,12557,10440,6027,14743
2022-08-17 02:00:00+00,14800,0,4415,5951,59,236,1933,144,0,0,27538,226,12358,10425,6010,14800
2022-08-17 02:30:00+00,14773,0,4417,5915,59,206,1926,147,0,0,27443,226,12317,10391,5974,14773
2022-08-17 03:00:00+00,14216,0,4414,5981,57,205,1923,145,0,0,26941,222,12375,10452,6038,14216
2022-08-17 03:30:00+00,14074,0,4415,6147,57,204,1911,148,0,0,26956,220,12530,10619,6204,14074
2022-08-17 04:00:00+00,14684,0,4417,6391,57,221,1810,142,0,0,27722,222,12675,10865,6448,14684
2022-08-17 04:30:00+00,14956,70,4412,6739,59,239,1706,146,0,0,28326,223,12916,11210,6798,15026
2022-08-17 05:00:00+00,15207,139,4408,7051,116,256,1721,154,5,0,29057,224,13301,11580,7172,15346
2022-08-17 05:30:00+00,15276,366,4405,7251,141,392,2060,164,89,20,30164,227,13946,11886,7481,15642
2022-08-17 06:00:00+00,15600,462,4405,7326,158,422,2248,235,307,52,31215,228,14444,12196,7791,16062
2022-08-17 06:30:00+00,16461,475,4400,7420,164,472,2250,287,604,28,32561,231,14838,12588,8188,16936
2022-08-17 07:00:00+00,15569,385,4404,7553,159,1054,1948,321,938,0,32331,224,15002,13054,8650,15954
2022-08-17 07:30:00+00,15978,376,4400,7577,209,1070,1765,355,1238,0,32968,223,15189,13424,9024,16354
2022-08-17 08:00:00+00,16680,398,4403,7345,108,1348,1697,369,1554,12,33914,223,15107,13410,9007,17078
2022-08-17 08:30:00+00,16770,475,4404,7176,108,1372,1657,420,1982,0,34364,223,15327,13670,9266,17245
2022-08-17 09:00:00+00,16535,359,4404,6904,94,1618,1674,341,2523,0,34452,217,15599,13925,9521,16894
2022-08-17 09:30:00+00,16439,338,4407,6502,89,1612,1747,307,3078,0,34519,215,15823,14076,9669,16777
2022-08-17 10:00:00+00,16631,403,4416,6190,89,1098,2087,409,3480,40,34843,216,16262,14175,9759,17034
2022-08-17 10:30:00+00,16395,369,4417,5807,89,1086,2558,565,3794,78,35158,213,16665,14107,9690,16764
2022-08-17 11:00:00+00,16327,384,4418,5544,89,914,2887,673,4083,138,35457,209,17021,14134,9716,16711
2022-08-17 11:30:00+00,16566,379,4417,5397,90,920,2918,679,4551,0,35917,209,17373,14455,10038,16945
2022-08-17 12:00:00+00,16668,484,4412,5270,103,590,2857,871,4815,966,37036,206,17457,14600,10188,17152
2022-08-17 12:30:00+00,16526,495,4417,5140,150,733,2910,873,4382,798,36424,211,16999,14089,9672,17021
2022-08-17 13:00:00+00,16563,493,4415,5081,138,1064,2892,903,4379,116,36044,216,16905,14013,9598,17056
2022-08-17 13:30:00+00,16559,495,4412,5131,91,1088,2902,939,3877,14,35508,220,16413,13511,9099,17054
2022-08-17 14:00:00+00,15379,306,4411,5013,109,1318,2897,1010,3313,314,34070,209,15743,12846,8435,15685
2022-08-17 14:30:00+00,15890,231,4413,4860,143,1374,2905,920,2990,278,34004,213,15311,12406,7993,16121
2022-08-17 15:00:00+00,15929,235,4419,4622,237,1271,2916,926,2699,532,33787,215,14893,11977,7558,16164
2022-08-17 15:30:00+00,16693,259,4423,4427,248,1253,2935,865,2236,780,34119,222,14269,11334,6911,16952
2022-08-17 16:00:00+00,17533,379,4424,4088,265,1050,2890,908,1888,1330,34755,232,13555,10665,6241,17912
2022-08-17 16:30:00+00,17984,458,4426,3725,206,1034,2869,1010,1424,1380,34516,242,12650,9781,5355,18442
2022-08-17 17:00:00+00,18359,494,4420,3543,229,726,2909,1077,910,1382,34049,248,12011,9102,4682,18853
2022-08-17 17:30:00+00,18262,492,4421,3581,229,716,2914,1065,552,1330,33562,250,11697,8783,4362,18754
2022-08-17 18:00:00+00,17541,359,4419,3900,431,908,2929,1085,306,1110,32988,243,11985,9056,4637,17900
2022-08-17 18:30:00+00,17593,238,4427,4090,287,932,2917,1027,111,1130,32752,241,11832,8915,4488,17831
2022-08-17 19:00:00+00,17403,252,4426,4369,215,996,2790,1010,5,880,32346,243,11805,9015,4589,17655
2022-08-17 19:30:00+00,17340,324,4423,4517,211,1014,2760,1013,0,640,32242,246,11911,9151,4728,17664
2022-08-17 20:00:00+00,17315,288,4425,4597,211,969,2758,997,0,432,31992,247,11991,9233,4808,17603
2022-08-17 20:30:00+00,16712,325,4423,4537,184,882,2600,803,0,108,30574,248,11744,9144,4721,17037
2022-08-17 21:00:00+00,16794,475,4423,4363,115,516,2447,297,0,146,29576,256,11348,8901,4478,17269
2022-08-17 21:30:00+00,16507,389,4417,4263,114,560,2097,185,0,16,28548,257,10891,8794,4377,16896
2022-08-17 22:00:00+00,16080,33,4414,4302,95,644,1623,244,0,64,27499,252,10434,8811,4397,16113
2022-08-17 22:30:00+00,15216,0,4414,4162,94,816,1671,198,0,10,26581,250,10341,8670,4256,15216
2022-08-17 23:00:00+00,15709,0,4416,3957,74,580,2107,168,0,16,27027,251,10554,8447,4031,15709
2022-08-17 23:30:00+00,16033,0,4415,3585,73,374,2202,248,0,0,26930,254,10275,8073,3658,16033
2022-08-18 00:00:00+00,16006,0,4416,3338,72,472,2204,538,0,0,27046,257,10030,7826,3410,16006
2022-08-18 00:30:00+00,16025,0,4419,3309,72,622,2224,646,0,0,27317,259,10024,7800,3381,16025
2022-08-18 01:00:00+00,16018,0,4421,3495,58,660,2122,497,0,0,27271,258,10096,7974,3553,16018
2022-08-18 01:30:00+00,15969,0,4426,3652,56,510,2072,160,0,0,26845,255,10206,8134,3708,15969
2022-08-18 02:00:00+00,15915,0,4424,3838,56,554,2053,157,0,0,26997,253,10371,8318,3894,15915
2022-08-18 02:30:00+00,15746,0,4425,3898,56,520,2082,154,0,0,26881,251,10461,8379,3954,15746
2022-08-18 03:00:00+00,15820,0,4430,4261,56,442,1925,158,0,0,27092,248,10672,8747,4317,15820
2022-08-18 03:30:00+00,15765,0,4429,4419,56,474,1813,153,0,0,27109,247,10717,8904,4475,15765
2022-08-18 04:00:00+00,15901,0,4430,4735,56,540,1950,156,0,0,27768,245,11171,9221,4791,15901
2022-08-18 04:30:00+00,15907,0,4428,4950,57,406,2034,159,0,0,27941,242,11469,9435,5007,15907
2022-08-18 05:00:00+00,15118,0,4429,5057,98,512,1906,157,14,32,27323,237,11504,9598,5169,15118
2022-08-18 05:30:00+00,15648,0,4423,5089,128,754,1984,192,124,202,28544,239,11748,9764,5341,15648
2022-08-18 06:00:00+00,14614,0,4426,5282,157,1166,1961,351,413,190,28560,232,12239,10278,5852,14614
2022-08-18 06:30:00+00,15204,0,4420,5382,145,1230,2061,654,726,68,29890,234,12734,10673,6253,15204
2022-08-18 07:00:00+00,15586,0,4417,5589,148,1413,2094,829,1100,234,31410,232,13348,11254,6837,15586
2022-08-18 07:30:00+00,15678,0,4418,5952,182,1410,2150,884,1477,166,32317,227,14179,12029,7611,15678
2022-08-18 08:00:00+00,15520,0,4419,6470,249,1402,2356,978,2048,316,33758,218,15542,13186,8767,15520
2022-08-18 08:30:00+00,15560,0,4423,6851,239,1396,2554,907,2329,0,34259,215,16396,13842,9419,15560
2022-08-18 09:00:00+00,15283,0,4421,7375,150,1158,2826,692,2657,0,34562,205,17429,14603,10182,15283
2022-08-18 09:30:00+00,15389,0,4422,7714,135,1076,2887,388,3657,0,35668,196,18815,15928,11506,15389
2022-08-18 10:00:00+00,15404,0,4426,7884,120,1592,2887,377,4136,86,36912,192,19453,16566,12140,15404
2022-08-18 10:30:00+00,15312,0,4429,8280,119,1604,2890,406,4416,0,37456,188,20134,17244,12815,15312
2022-08-18 11:00:00+00,15148,0,4430,8463,119,1258,2663,355,4477,0,36913,187,20152,17489,13059,15148
2022-08-18 11:30:00+00,15414,0,4440,8108,119,1278,2617,175,4784,0,36935,189,20068,17451,13011,15414
2022-08-18 12:00:00+00,15722,0,4440,7842,120,896,2717,231,5062,40,37070,189,20181,17464,13024,15722
2022-08-18 12:30:00+00,15643,0,4439,7975,120,896,2728,280,5417,0,37498,186,20679,17951,13512,15643
2022-08-18 13:00:00+00,15505,0,4443,8144,141,1314,2649,276,4986,0,37458,187,20363,17714,13271,15505
2022-08-18 13:30:00+00,15404,0,4446,8134,144,1358,2660,283,4460,0,36889,189,19844,17184,12738,15404
2022-08-18 14:00:00+00,15120,0,4442,8131,157,1566,2724,289,4223,0,36652,193,19677,16953,12511,15120
2022-08-18 14:30:00+00,15082,0,4443,8394,154,1598,2758,262,3985,0,36676,193,19734,16976,12533,15082
2022-08-18 15:00:00+00,15073,61,4437,8663,210,1112,2753,444,3288,0,36041,193,19351,16598,12161,15134
2022-08-18 15:30:00+00,15212,274,4441,8801,231,1104,2777,489,2637,8,35974,201,18887,16110,11669,15486
2022-08-18 16:00:00+00,14860,380,4445,9291,369,1372,2754,477,2229,198,36375,196,19088,16334,11889,15240
2022-08-18 16:30:00+00,15178,249,4448,9515,377,1418,2513,426,1678,290,36092,196,18531,16018,11570,15427
2022-08-18 17:00:00+00,14730,233,4445,9740,365,1400,2487,430,1121,704,35655,191,18158,15671,11226,14963
2022-08-18 17:30:00+00,14628,232,4443,9968,378,1440,2187,416,579,726,34997,192,17555,15368,10925,14860
2022-08-18 18:00:00+00,14097,230,4447,10264,381,1404,2065,442,285,612,34227,190,17442,15377,10930,14327
2022-08-18 18:30:00+00,13829,230,4446,10657,343,1361,1915,382,76,668,33907,186,17437,15522,11076,14059
2022-08-18 19:00:00+00,13839,232,4449,11039,230,1038,2056,231,1,324,33439,189,17775,15719,11270,14071
2022-08-18 19:30:00+00,13807,247,4446,10986,214,1020,1877,244,0,442,33283,190,17523,15646,11200,14054
2022-08-18 20:00:00+00,14687,297,4448,10780,160,750,1992,316,0,122,33552,201,17380,15388,10940,14984
2022-08-18 20:30:00+00,14023,229,4447,10636,153,742,1901,316,0,6,32453,197,17137,15236,10789,14252
2022-08-18 21:00:00+00,12652,3,4444,10739,138,763,1547,250,0,56,30592,183,16868,15321,10877,12655
2022-08-18 21:30:00+00,11576,0,4445,10613,138,759,1556,224,0,12,29322,176,16752,15196,10751,11576
2022-08-18 22:00:00+00,11493,0,4443,10166,137,734,1568,159,0,0,28700,178,16314,14746,10303,11493
2022-08-18 22:30:00+00,11139,0,4438,9603,135,740,1430,149,0,0,27634,179,15606,14176,9738,11139
2022-08-18 23:00:00+00,11254,0,4434,10077,73,618,1615,142,0,0,28213,176,16199,14584,10150,11254
2022-08-18 23:30:00+00,10873,0,4428,10528,104,518,1394,154,0,0,27999,169,16454,15060,10632,10873
2022-08-19 00:00:00+00,11306,0,4422,10603,105,616,1400,155,0,0,28607,173,16530,15130,10708,11306
2022-08-19 00:30:00+00,11351,0,4427,10706,87,520,1529,148,0,0,28768,172,16749,15220,10793,11351
2022-08-19 01:00:00+00,11227,0,4430,10963,67,420,1620,150,0,0,28877,168,17080,15460,11030,11227
2022-08-19 01:30:00+00,10928,0,4431,11163,67,452,1453,152,0,0,28646,165,17114,15661,11230,10928
2022-08-19 02:00:00+00,11052,0,4433,10956,66,522,1401,158,0,0,28588,168,16856,15455,11022,11052
2022-08-19 02:30:00+00,11240,0,4430,10525,65,476,1469,156,0,0,28361,172,16489,15020,10590,11240
2022-08-19 03:00:00+00,11475,0,4435,10022,65,504,1729,145,0,0,28375,176,16251,14522,10087,11475
2022-08-19 03:30:00+00,11540,0,4433,9556,65,596,1802,151,0,0,28143,181,15856,14054,9621,11540
2022-08-19 04:00:00+00,11620,0,4432,8905,65,724,1805,145,0,0,27696,187,15207,13402,8970,11620
2022-08-19 04:30:00+00,12208,0,4439,8369,65,840,1869,149,0,0,27939,194,14742,12873,8434,12208
2022-08-19 05:00:00+00,11889,0,4440,7710,96,931,1725,160,36,0,26987,196,14007,12282,7842,11889
2022-08-19 05:30:00+00,12845,0,4438,7119,141,1008,1951,208,324,0,28034,204,13973,12022,7584,12845
2022-08-19 06:00:00+00,13170,0,4438,6781,202,994,1680,401,870,306,28842,202,13971,12291,7853,13170
2022-08-19 06:30:00+00,14082,0,4432,6496,300,972,1628,784,1624,170,30488,206,14480,12852,8420,14082
2022-08-19 07:00:00+00,14268,0,4435,6314,288,926,1896,888,2390,136,31541,204,15323,13427,8992,14268
2022-08-19 07:30:00+00,13867,0,4430,6621,282,910,2061,874,3287,206,32538,193,16681,14620,10190,13867
2022-08-19 08:00:00+00,13932,0,4431,6938,314,938,2065,809,3946,140,33513,191,17694,15629,11198,13932
2022-08-19 08:30:00+00,13637,0,4432,7573,290,964,1960,781,4718,140,34495,182,18973,17013,12581,13637
2022-08-19 09:00:00+00,13941,0,4425,7868,219,874,1989,558,5254,144,35272,179,19755,17766,13341,13941
2022-08-19 09:30:00+00,13883,0,4433,8147,216,920,1854,317,5684,168,35622,175,20334,18480,14047,13883
2022-08-19 10:00:00+00,14089,0,4424,8347,173,746,2064,178,6226,244,36491,170,21234,19170,14746,14089
2022-08-19 10:30:00+00,14049,0,4428,8439,169,772,1972,152,6636,26,36643,169,21644,19672,15244,14049
2022-08-19 11:00:00+00,13763,0,4432,8575,156,840,1946,149,6564,6,36431,167,21673,19727,15295,13763
2022-08-19 11:30:00+00,13017,0,4455,9136,172,842,1876,140,6638,0,36276,160,22277,20401,15946,13017
2022-08-19 12:00:00+00,13166,0,4435,9302,167,990,1903,146,6876,96,37081,160,22683,20780,16345,13166
2022-08-19 12:30:00+00,13180,0,4438,9246,163,974,1709,142,6886,0,36738,161,22442,20733,16295,13180
2022-08-19 13:00:00+00,13059,0,4439,9411,149,626,1524,145,6718,0,36071,157,22241,20717,16278,13059
2022-08-19 13:30:00+00,13255,0,4439,9116,147,630,1511,161,6292,0,35551,162,21505,19994,15555,13255
2022-08-19 14:00:00+00,12899,0,4442,9201,159,798,1489,146,6003,0,35137,160,21294,19805,15363,12899
2022-08-19 14:30:00+00,13119,0,4439,9402,167,730,1354,147,5519,0,34876,162,20880,19526,15088,13119
2022-08-19 15:00:00+00,13387,0,4432,9383,187,556,1367,154,4815,40,34321,167,20184,18817,14385,13387
2022-08-19 15:30:00+00,14009,0,4437,9245,218,548,1519,171,4335,226,34708,173,19754,18235,13798,14009
2022-08-19 16:00:00+00,14035,0,4445,8745,346,966,1589,200,3554,490,34370,181,18679,17090,12645,14035
2022-08-19 16:30:00+00,14171,0,4487,8289,365,1114,1824,391,2855,742,34238,187,17820,15996,11509,14171
2022-08-19 17:00:00+00,13971,0,4500,8065,329,1316,1543,270,2175,908,33077,189,16612,15069,10569,13971
2022-08-19 17:30:00+00,14224,0,4506,7780,370,1270,1616,266,1268,994,32294,196,15540,13924,9418,14224
2022-08-19 18:00:00+00,14149,0,4504,7395,402,766,1888,402,709,964,31179,200,14898,13010,8506,14149
2022-08-19 18:30:00+00,13932,0,4506,7160,373,876,2050,463,198,892,30450,205,14287,12237,7731,13932
2022-08-19 19:00:00+00,14063,0,4509,6716,353,716,2175,484,7,1012,30035,209,13760,11585,7076,14063
2022-08-19 19:30:00+00,14219,0,4507,6487,413,712,2155,509,0,888,29890,212,13562,11407,6900,14219
2022-08-19 20:00:00+00,14286,0,4516,6052,339,880,2002,587,0,476,29138,221,12909,10907,6391,14286
2022-08-19 20:30:00+00,13984,0,4514,5744,304,879,1832,627,0,416,28300,222,12394,10562,6048,13984
2022-08-19 21:00:00+00,13707,0,4523,5684,260,772,2072,585,0,174,27777,221,12539,10467,5944,13707
2022-08-19 21:30:00+00,13459,0,4517,5462,237,828,1673,276,0,140,26592,223,11889,10216,5699,13459
2022-08-19 22:00:00+00,12720,0,4520,5074,203,822,1307,294,0,208,25148,224,11104,9797,5277,12720
2022-08-19 22:30:00+00,12262,0,4514,4867,182,776,1320,188,0,142,24251,223,10883,9563,5049,12262
2022-08-19 23:00:00+00,13198,0,4514,4754,157,744,1501,183,0,346,25397,228,10926,9425,4911,13198
2022-08-19 23:30:00+00,13205,0,4515,4738,124,748,1365,169,0,86,24950,232,10742,9377,4862,13205
2022-08-20 00:00:00+00,12979,0,4514,5195,120,718,1390,220,0,0,25136,227,11219,9829,5315,12979
2022-08-20 00:30:00+00,12657,0,4511,5463,118,748,1332,176,0,110,25115,221,11424,10092,5581,12657
2022-08-20 01:00:00+00,12553,0,4517,5774,97,748,1281,140,0,64,25174,218,11669,10388,5871,12553
2022-08-20 01:30:00+00,11721,0,4515,6545,96,748,1118,141,0,0,24884,207,12274,11156,6641,11721
2022-08-20 02:00:00+00,11276,0,4515,6932,94,748,1131,149,0,0,24845,200,12672,11541,7026,11276
2022-08-20 02:30:00+00,10902,0,4519,7536,95,748,932,150,0,0,24882,193,13082,12150,7631,10902
2022-08-20 03:00:00+00,10868,0,4523,7973,94,748,933,149,0,0,25288,189,13523,12590,8067,10868
2022-08-20 03:30:00+00,10243,0,4529,8842,95,748,923,143,0,0,25523,178,14389,13466,8937,10243
2022-08-20 04:00:00+00,10082,0,4523,9354,95,748,955,155,0,0,25912,173,14927,13972,9449,10082
2022-08-20 04:30:00+00,9753,0,4532,9858,95,748,918,140,0,0,26044,167,15403,14485,9953,9753
2022-08-20 05:00:00+00,8939,0,4529,10084,117,726,915,139,39,0,25488,157,15684,14769,10240,8939
2022-08-20 05:30:00+00,9047,0,4531,10396,126,746,915,140,324,0,26225,155,16292,15377,10846,9047
2022-08-20 06:00:00+00,9466,0,4531,10590,173,672,922,144,846,0,27344,153,17062,16140,11609,9466
2022-08-20 06:30:00+00,9715,0,4526,10892,192,716,940,153,1522,0,28656,151,18072,17132,12606,9715
2022-08-20 07:00:00+00,10212,0,4526,11032,228,732,958,155,2226,0,30069,151,18970,18012,13486,10212
2022-08-20 07:30:00+00,10270,0,4522,11157,242,638,1178,153,2963,0,31123,146,20062,18884,14362,10270
2022-08-20 08:00:00+00,9818,0,4519,11482,282,730,951,147,3495,0,31424,139,20729,19778,15259,9818
2022-08-20 08:30:00+00,9405,0,4523,11770,278,742,938,151,4171,0,31978,131,21680,20742,16219,9405
2022-08-20 09:00:00+00,9134,0,4523,12048,251,702,929,145,4589,0,32321,125,22340,21411,16888,9134
2022-08-20 09:30:00+00,8607,0,4520,12475,235,568,926,144,5044,0,32519,116,23200,22274,17754,8607
2022-08-20 10:00:00+00,8274,0,4519,12815,198,921,951,145,5399,0,33222,110,23882,22931,18412,8274
2022-08-20 10:30:00+00,8166,0,4520,12917,138,1010,927,140,5812,0,33630,108,24314,23387,18867,8166
2022-08-20 11:00:00+00,8123,0,4521,13122,146,928,936,142,5821,0,33739,107,24546,23610,19089,8123
2022-08-20 11:30:00+00,7913,0,4527,13153,143,878,914,139,6065,0,33732,104,24802,23888,19361,7913
2022-08-20 12:00:00+00,7218,0,4527,13080,157,612,921,139,6436,0,33090,96,25121,24200,19673,7218
2022-08-20 12:30:00+00,7041,0,4530,13009,156,524,911,139,6498,0,32808,93,25104,24193,19663,7041
2022-08-20 13:00:00+00,7489,0,4526,13155,138,384,914,140,6722,0,33468,98,25455,24541,20015,7489
2022-08-20 13:30:00+00,7034,0,4528,13586,139,264,915,140,6664,0,33270,92,25832,24917,20389,7034
2022-08-20 14:00:00+00,7101,0,4529,13429,153,460,936,149,6147,0,32904,96,25194,24258,19729,7101
2022-08-20 14:30:00+00,7821,0,4526,13374,153,432,934,148,5778,0,33166,104,24765,23831,19305,7821
2022-08-20 15:00:00+00,7913,0,4525,13198,153,536,938,151,5101,0,32515,108,23915,22977,18452,7913
2022-08-20 15:30:00+00,8841,0,4523,13229,155,594,915,141,4150,0,32548,120,22972,22057,17534,8841
2022-08-20 16:00:00+00,10213,0,4521,12779,268,446,939,149,3414,0,32729,134,21921,20982,16461,10213
2022-08-20 16:30:00+00,11266,0,4519,12450,260,418,996,155,2658,0,32722,148,20883,19887,15368,11266
2022-08-20 17:00:00+00,10949,0,4523,12220,248,562,1022,141,1987,332,31984,150,20000,18978,14455,10949
2022-08-20 17:30:00+00,11118,0,4516,11962,250,552,1150,148,1270,482,31448,155,19148,17998,13482,11118
2022-08-20 18:00:00+00,11697,0,4520,11682,260,228,1530,216,667,478,31278,161,18659,17129,12609,11697
2022-08-20 18:30:00+00,11902,0,4520,11633,260,226,1588,317,163,246,30855,166,18164,16576,12056,11902
2022-08-20 19:00:00+00,11894,0,4521,11554,261,208,1596,607,3,194,30838,167,17935,16339,11818,11894
2022-08-20 19:30:00+00,11838,0,4524,11693,302,72,1605,642,0,302,30978,164,18124,16519,11995,11838
2022-08-20 20:00:00+00,11551,0,4524,11636,243,0,1605,469,0,6,30034,163,18008,16403,11879,11551
2022-08-20 20:30:00+00,11311,0,4526,11590,213,0,1591,289,0,0,29520,160,17920,16329,11803,11311
2022-08-20 21:00:00+00,11841,0,4524,11577,143,0,1363,196,0,40,29684,165,17607,16244,11720,11841
2022-08-20 21:30:00+00,11711,0,4524,11683,153,0,961,143,0,34,29209,163,17321,16360,11836,11711
2022-08-20 22:00:00+00,11398,0,4524,10969,132,0,985,141,0,122,28271,165,16610,15625,11101,11398
2022-08-20 22:30:00+00,10666,0,4528,10844,130,0,969,155,0,0,27292,160,16471,15502,10974,10666
2022-08-20 23:00:00+00,10369,0,4515,10643,99,0,1186,145,0,0,26957,158,16443,15257,10742,10369
2022-08-20 23:30:00+00,10422,0,4519,10349,97,21,1226,146,0,0,26780,161,16191,14965,10446,10422
2022-08-21 00:00:00+00,10199,0,4526,10194,93,42,1038,140,0,0,26232,160,15851,14813,10287,10199
2022-08-21 00:30:00+00,10077,0,4523,10143,79,158,923,141,0,0,26044,161,15668,14745,10222,10077
2022-08-21 01:00:00+00,9481,0,4526,10010,82,132,929,140,0,0,25300,156,15547,14618,10092,9481
2022-08-21 01:30:00+00,9131,0,4530,10210,81,22,912,139,0,0,25025,150,15733,14821,10291,9131
2022-08-21 02:00:00+00,9051,0,4524,10113,82,106,914,139,0,0,24929,151,15633,14719,10195,9051
2022-08-21 02:30:00+00,8739,0,4527,10311,84,98,913,139,0,0,24811,147,15835,14922,10395,8739
2022-08-21 03:00:00+00,8248,0,4528,10125,82,60,943,147,0,0,24133,142,15678,14735,10207,8248
2022-08-21 03:30:00+00,8327,0,4533,10076,82,66,917,141,0,0,24142,143,15608,14691,10158,8327
2022-08-21 04:00:00+00,8566,0,4534,9760,82,146,939,147,0,0,24174,149,15315,14376,9842,8566
2022-08-21 04:30:00+00,8895,0,4538,9051,83,165,935,145,0,0,23813,157,14607,13672,9134,8895
2022-08-21 05:00:00+00,9412,0,4539,8280,110,179,930,143,33,0,23626,167,13892,12962,8423,9412
2022-08-21 05:30:00+00,9868,0,4533,7542,125,366,935,145,269,0,23783,176,13404,12469,7936,9868
2022-08-21 06:00:00+00,9469,0,4536,7019,148,298,928,144,656,0,23198,172,13287,12359,7823,9469
2022-08-21 06:30:00+00,10062,0,4532,6444,160,374,960,155,1190,14,23891,177,13286,12326,7794,10062
2022-08-21 07:00:00+00,8544,0,4541,6180,204,1862,914,140,1865,0,24250,165,13704,12790,8249,8544
2022-08-21 07:30:00+00,8887,0,4533,5884,198,2030,918,142,2663,0,25255,166,14196,13278,8745,8887
2022-08-21 08:00:00+00,8221,0,4532,5719,161,3216,920,144,3515,0,26428,150,14847,13927,9395,8221
2022-08-21 08:30:00+00,8676,0,4530,5447,119,3322,926,149,4124,0,27293,152,15146,14220,9690,8676
2022-08-21 09:00:00+00,8544,0,4535,5405,114,3798,916,140,4710,0,28162,146,15680,14764,10229,8544
2022-08-21 09:30:00+00,8717,0,4533,5196,126,3808,916,139,4973,0,28408,147,15744,14828,10295,8717
2022-08-21 10:00:00+00,8892,0,4534,4943,136,3822,940,147,5624,0,29038,146,16177,15237,10703,8892
2022-08-21 10:30:00+00,9246,0,4535,4531,132,3822,1009,147,6092,0,29514,149,16299,15290,10755,9246
2022-08-21 11:00:00+00,8423,0,4539,4515,119,5260,914,139,5802,0,29711,139,15889,14975,10436,8423
2022-08-21 11:30:00+00,8662,0,4543,4480,119,5322,919,139,5979,0,30163,140,16040,15121,10578,8662
2022-08-21 12:00:00+00,8244,0,4544,4502,106,5244,915,139,6062,0,29756,136,16129,15214,10670,8244
2022-08-21 12:30:00+00,8806,0,4542,4028,105,5254,934,144,5661,0,29474,145,15270,14336,9794,8806
2022-08-21 13:00:00+00,8732,0,4547,3851,105,5550,909,139,5822,0,29655,143,15234,14325,9778,8732
2022-08-21 13:30:00+00,9172,0,4542,3449,106,5534,921,141,5816,0,29681,149,14834,13913,9371,9172
2022-08-21 14:00:00+00,9938,0,4544,3290,136,4936,913,139,5096,0,28992,162,13979,13066,8522,9938
2022-08-21 14:30:00+00,10539,0,4542,2979,144,4910,912,139,4891,0,29056,170,13468,12556,8014,10539
2022-08-21 15:00:00+00,11987,0,4540,2772,154,3768,984,148,4271,0,28624,191,12721,11737,7197,11987
2022-08-21 15:30:00+00,12422,0,4537,2508,222,3684,1427,144,3503,0,28447,201,12197,10770,6233,12422
2022-08-21 16:00:00+00,12818,0,4535,2428,315,2974,1591,736,3044,152,28593,211,11913,10322,5787,12818
2022-08-21 16:30:00+00,13361,0,4526,2161,292,2948,1601,887,2346,252,28374,222,10926,9325,4799,13361
2022-08-21 17:00:00+00,13762,0,4530,2030,367,2480,1603,1101,1797,718,28388,222,10327,8724,4194,13762
2022-08-21 17:30:00+00,14193,0,4535,1842,451,2434,1592,1303,1180,690,28220,231,9600,8008,3473,14193
2022-08-21 18:00:00+00,13828,0,4532,1689,450,2512,1601,1232,478,1008,27330,238,8750,7149,2617,13828
2022-08-21 18:30:00+00,13699,0,4531,1500,483,2532,1602,1099,115,1078,26639,241,8231,6629,2098,13699
2022-08-21 19:00:00+00,13715,0,4534,1250,576,2502,1608,1088,1,1152,26426,239,7969,6361,1827,13715
2022-08-21 19:30:00+00,13960,0,4536,1175,489,2598,1605,1099,0,1152,26614,242,7805,6200,1664,13960
2022-08-21 20:00:00+00,13896,0,4542,1114,458,3016,1603,932,0,1114,26674,246,7716,6114,1572,13896
2022-08-21 20:30:00+00,13683,0,4547,1025,361,3008,1598,830,0,782,25834,249,7531,5933,1386,13683
2022-08-21 21:00:00+00,13935,0,4549,1017,307,2008,1604,875,0,578,24873,253,7477,5873,1324,13935
2022-08-21 21:30:00+00,13362,0,4550,1027,250,1972,1521,869,0,158,23709,256,7348,5827,1277,13362
2022-08-21 22:00:00+00,13842,0,4546,1043,211,790,1591,704,0,204,22931,261,7391,5800,1254,13842
2022-08-21 22:30:00+00,13583,0,4546,1055,198,874,1537,455,0,0,22248,264,7336,5799,1253,13583
2022-08-21 23:00:00+00,13543,0,4548,1054,145,890,1602,419,0,0,22201,270,7349,5747,1199,13543
2022-08-21 23:30:00+00,13344,0,4546,1049,144,1016,1601,242,0,0,21942,270,7340,5739,1193,13344
2022-08-22 00:00:00+00,13195,0,4551,1103,144,1044,1601,240,0,0,21878,266,7399,5798,1247,13195
2022-08-22 00:30:00+00,13021,0,4543,1264,143,1060,1475,228,0,0,21734,264,7425,5950,1407,13021
2022-08-22 01:00:00+00,13114,0,4546,1300,125,1302,1256,136,0,0,21779,263,7227,5971,1425,13114
2022-08-22 01:30:00+00,13082,0,4541,1324,125,1302,1122,138,0,0,21634,264,7112,5990,1449,13082
2022-08-22 02:00:00+00,13452,0,4541,1316,122,1044,1328,138,0,0,21941,267,7307,5979,1438,13452
2022-08-22 02:30:00+00,13441,0,4545,1427,120,1034,1350,137,0,0,22054,266,7442,6092,1547,13441
2022-08-22 03:00:00+00,13304,0,4543,1607,120,950,1272,149,0,0,21945,264,7542,6270,1727,13304
2022-08-22 03:30:00+00,12928,4,4548,1860,118,914,1346,142,0,0,21860,259,7872,6526,1978,12932
2022-08-22 04:00:00+00,13356,7,4543,2106,136,748,1314,145,0,0,22356,260,8099,6785,2242,13363
2022-08-22 04:30:00+00,13383,11,4554,2353,140,782,1441,208,0,0,22872,256,8488,7047,2493,13394
2022-08-22 05:00:00+00,13460,32,4555,2649,183,1150,1600,371,20,0,24020,249,9007,7407,2852,13492
2022-08-22 05:30:00+00,13722,93,4552,3233,278,1194,1599,491,244,368,25774,241,9906,8307,3755,13815
2022-08-22 06:00:00+00,13349,239,4557,3825,256,1812,1526,542,673,218,26997,238,10837,9311,4754,13588
2022-08-22 06:30:00+00,13660,314,4561,4113,322,1716,1587,537,1239,322,28371,232,11822,10235,5674,13974
2022-08-22 07:00:00+00,14501,360,4555,4201,263,1550,1594,604,1708,214,29550,234,12321,10727,6172,14861
2022-08-22 07:30:00+00,14904,319,4559,4313,249,1484,1686,730,2481,188,30913,227,13288,11602,7043,15223
2022-08-22 08:00:00+00,14899,415,4554,4599,235,1906,1713,630,3209,168,32328,218,14310,12597,8043,15314
2022-08-22 08:30:00+00,14528,553,4550,4868,232,1964,1826,463,3830,0,32814,213,15306,13480,8930,15081
2022-08-22 09:00:00+00,13660,510,4552,4941,191,2964,1882,372,4142,0,33214,203,15708,13826,9274,14170
2022-08-22 09:30:00+00,13357,524,4549,4987,184,2986,2084,275,4049,0,32995,201,15853,13769,9220,13881
2022-08-22 10:00:00+00,13175,515,4552,4839,172,3304,2100,214,4301,22,33194,200,15964,13864,9312,13690
2022-08-22 10:30:00+00,13550,260,4557,4931,172,3294,2098,169,4449,0,33480,196,16207,14109,9552,13810
2022-08-22 11:00:00+00,13998,230,4562,4996,179,2946,2098,174,4578,0,33761,193,16413,14315,9753,14228
2022-08-22 11:30:00+00,14188,230,4556,5027,180,2918,2100,220,4440,0,33859,195,16303,14203,9647,14418
2022-08-22 12:00:00+00,14102,230,4563,5404,250,2352,2098,184,4064,144,33391,195,16379,14281,9718,14332
2022-08-22 12:30:00+00,14125,229,4559,5918,171,2310,2132,179,3899,0,33522,195,16679,14547,9988,14354
2022-08-22 13:00:00+00,14542,229,4559,6081,150,1800,2195,186,3268,70,33080,199,16253,14058,9499,14771
2022-08-22 13:30:00+00,14405,229,4565,6259,158,1838,2241,183,2925,0,32803,200,16148,13907,9342,14634
2022-08-22 14:00:00+00,14422,229,4561,6298,185,1626,2252,320,2594,156,32643,202,15890,13638,9077,14651
2022-08-22 14:30:00+00,14572,230,4560,6303,222,1670,2249,510,2342,0,32658,206,15676,13427,8867,14802
2022-08-22 15:00:00+00,14596,229,4564,6371,348,1496,2243,641,2083,44,32615,205,15609,13366,8802,14825
2022-08-22 15:30:00+00,14589,247,4562,6423,487,1468,2242,869,1760,76,32723,207,15474,13232,8670,14836
2022-08-22 16:00:00+00,14390,253,4558,6523,451,1774,2245,962,1320,810,33286,206,15097,12852,8294,14643
2022-08-22 16:30:00+00,14567,328,4555,6604,570,1786,2245,1176,987,730,33548,211,14961,12716,8161,14895
2022-08-22 17:00:00+00,14528,445,4552,6525,543,1548,2246,1233,700,832,33152,214,14566,12320,7768,14973
2022-08-22 17:30:00+00,14993,456,4546,6317,499,1532,2208,1210,515,896,33172,221,14085,11877,7331,15449
2022-08-22 18:00:00+00,15232,444,4551,6179,523,1114,2120,1182,255,848,32448,224,13628,11508,6957,15676
2022-08-22 18:30:00+00,14981,445,4552,6131,525,1116,2157,1093,59,426,31485,227,13424,11267,6715,15426
2022-08-22 19:00:00+00,14889,451,4549,5838,480,972,2160,1024,0,636,30999,228,13027,10867,6318,15340
2022-08-22 19:30:00+00,14843,444,4555,5541,407,1026,2158,1065,0,564,30603,232,12661,10503,5948,15287
2022-08-22 20:00:00+00,14974,438,4552,5296,276,1178,2152,1003,0,82,29951,239,12276,10124,5572,15412
2022-08-22 20:30:00+00,14621,483,4552,5254,245,1202,2151,648,0,0,29156,237,12202,10051,5499,15104
2022-08-22 21:00:00+00,14550,491,4556,5308,207,920,2151,520,0,0,28703,241,12222,10071,5515,15041
2022-08-22 21:30:00+00,13619,487,4569,5437,195,964,2038,292,0,0,27601,235,12239,10201,5632,14106
2022-08-22 22:00:00+00,12914,492,4566,5389,172,620,1794,508,0,0,26455,234,11921,10127,5561,13406
2022-08-22 22:30:00+00,12657,494,4568,5315,161,386,1653,517,0,0,25751,232,11697,10044,5476,13151
2022-08-22 23:00:00+00,12883,491,4573,5030,126,336,1864,442,0,0,25745,235,11593,9729,5156,13374
2022-08-22 23:30:00+00,12938,491,4572,4827,124,276,1892,257,0,0,25377,236,11415,9523,4951,13429
2022-08-23 00:00:00+00,13419,488,4563,4764,105,358,1944,206,0,0,25847,240,11376,9432,4869,13907
2022-08-23 00:30:00+00,13584,488,4563,4455,104,264,2092,196,0,0,25746,242,11214,9122,4559,14072
2022-08-23 01:00:00+00,14382,489,4559,4047,102,254,1894,192,0,0,25919,252,10602,8708,4149,14871
2022-08-23 01:30:00+00,14917,489,4555,3683,101,126,1702,161,0,0,25734,258,10041,8339,3784,15406
2022-08-23 02:00:00+00,14917,491,4558,3488,101,218,1760,169,0,0,25702,261,9907,8147,3589,15408
2022-08-23 02:30:00+00,14964,492,4550,3252,100,170,1696,246,0,0,25470,264,9598,7902,3352,15456
2022-08-23 03:00:00+00,14954,492,4554,3064,100,240,1638,255,0,0,25297,266,9356,7718,3164,15446
2022-08-23 03:30:00+00,14833,491,4558,3090,100,246,1794,228,0,0,25340,265,9542,7748,3190,15324
2022-08-23 04:00:00+00,14151,483,4553,3121,100,104,2006,211,0,0,24729,258,9780,7774,3221,14634
2022-08-23 04:30:00+00,14160,482,4557,3189,100,212,2173,230,0,0,25103,257,10019,7846,3289,14642
2022-08-23 05:00:00+00,14219,490,4559,3158,148,302,1986,493,4,0,25359,260,9855,7869,3310,14709
2022-08-23 05:30:00+00,14731,490,4540,3370,220,723,1938,873,123,0,27008,262,10191,8253,3713,15221
2022-08-23 06:00:00+00,14803,577,4327,3582,386,1232,2050,992,379,0,28328,257,10724,8674,4347,15380
2022-08-23 06:30:00+00,15154,716,4265,3703,426,1150,2203,952,776,316,29661,253,11373,9170,4905,15870
2022-08-23 07:00:00+00,15042,718,4261,3772,429,2413,2223,996,1275,28,31157,247,11960,9737,5476,15760
2022-08-23 07:30:00+00,15424,719,4260,3790,419,2452,2219,1019,1912,56,32270,244,12600,10381,6121,16143
2022-08-23 08:00:00+00,15246,722,4260,3801,331,2786,2184,988,2470,0,32788,239,13046,10862,6602,15968
2022-08-23 08:30:00+00,15279,719,4258,3641,421,2808,2218,933,2854,0,33131,236,13392,11174,6916,15998
2022-08-23 09:00:00+00,14967,719,4255,3692,404,2974,2153,768,3422,0,33354,229,13926,11773,7518,15686
2022-08-23 09:30:00+00,14958,726,4250,3686,304,3006,2085,644,3817,0,33476,227,14142,12057,7807,15684
2022-08-23 10:00:00+00,14657,727,4251,3768,167,3606,1988,481,4454,0,34099,219,14628,12640,8389,15384
2022-08-23 10:30:00+00,14509,730,4249,3782,156,3626,1956,459,4950,0,34417,215,15093,13137,8888,15239
2022-08-23 11:00:00+00,14833,732,4252,3707,143,3636,1921,415,5330,0,34969,215,15353,13432,9180,15565
2022-08-23 11:30:00+00,14565,730,4258,3629,145,3602,1968,356,5587,0,34840,213,15587,13619,9361,15295
2022-08-23 12:00:00+00,14933,735,4256,3759,132,2774,2165,455,5120,236,34565,219,15432,13267,9011,15668
2022-08-23 12:30:00+00,14757,727,4259,4036,132,2774,2105,509,5462,0,34761,216,15994,13889,9630,15484
2022-08-23 13:00:00+00,14445,732,4258,4151,135,2718,2118,520,4770,0,33847,218,15432,13314,9056,15177
2022-08-23 13:30:00+00,14692,736,4256,4031,136,2716,2122,440,5130,0,34259,217,15675,13553,9297,15428
2022-08-23 14:00:00+00,14796,734,4264,4172,289,2714,2105,566,4897,0,34537,218,15727,13622,9358,15530
2022-08-23 14:30:00+00,14910,754,4260,4344,295,2680,2113,707,4335,18,34416,221,15347,13234,8974,15664
2022-08-23 15:00:00+00,14999,897,4266,4497,325,2308,2125,897,3470,122,33906,228,14683,12558,8292,15896
2022-08-23 15:30:00+00,15161,985,4263,4738,419,2308,2102,1118,2576,246,33916,234,14098,11996,7733,16146
2022-08-23 16:00:00+00,15092,989,4271,4651,557,2422,2052,1132,1871,460,33497,238,13402,11350,7079,16081
2022-08-23 16:30:00+00,15145,988,4265,4582,583,2444,2086,1148,1284,858,33383,240,12800,10714,6449,16133
2022-08-23 17:00:00+00,15161,986,4258,4454,636,2432,1956,1330,945,892,33050,245,12249,10293,6035,16147
2022-08-23 17:30:00+00,14985,990,4258,4202,614,2366,1941,1381,616,1192,32545,247,11631,9690,5432,15975
2022-08-23 18:00:00+00,15260,954,4256,3979,625,1983,2237,1425,268,1196,32183,251,11365,9128,4872,16214
2022-08-23 18:30:00+00,15309,927,4256,3588,621,2001,1997,1430,47,1170,31346,257,10509,8512,4256,16236
2022-08-23 19:00:00+00,15672,994,4255,3448,558,1332,2305,1192,0,1134,30890,258,10566,8261,4006,16666
2022-08-23 19:30:00+00,15794,995,4254,3217,557,1324,2545,1169,0,1048,30903,260,10573,8028,3774,16789
2022-08-23 20:00:00+00,15769,993,4257,3131,572,1352,2671,1181,0,236,30162,268,10631,7960,3703,16762
2022-08-23 20:30:00+00,15483,843,4256,3049,250,1360,2825,853,0,0,28919,267,10380,7555,3299,16326
2022-08-23 21:00:00+00,15222,501,4253,2887,248,2512,2496,371,0,18,28508,262,9884,7388,3135,15723
2022-08-23 21:30:00+00,15122,496,4258,2662,170,2622,2196,144,0,0,27670,267,9286,7090,2832,15618
2022-08-23 22:00:00+00,15027,496,4266,2654,140,1006,2451,181,0,0,26221,268,9511,7060,2794,15523
2022-08-23 22:30:00+00,14576,495,4266,2750,139,774,2417,217,0,0,25634,264,9572,7155,2889,15071
2022-08-23 23:00:00+00,14724,494,4271,2578,139,550,2602,201,0,0,25559,269,9590,6988,2717,15218
2022-08-23 23:30:00+00,14650,495,4268,2336,139,416,2634,201,0,0,25139,271,9377,6743,2475,15145
2022-08-24 00:00:00+00,14757,495,4273,2372,139,282,2618,200,0,0,25136,270,9402,6784,2511,15252
2022-08-24 00:30:00+00,14670,493,4273,2383,139,178,2634,185,0,0,24955,269,9429,6795,2522,15163
2022-08-24 01:00:00+00,14644,488,4271,2487,120,298,2590,196,0,0,25094,269,9468,6878,2607,15132
2022-08-24 01:30:00+00,14632,486,4267,2457,120,162,2533,199,0,0,24856,268,9377,6844,2577,15118
2022-08-24 02:00:00+00,14543,488,4261,2696,121,132,2589,166,0,0,24996,265,9667,7078,2817,15031
2022-08-24 02:30:00+00,14469,489,4259,3070,120,80,2357,149,0,0,24993,261,9806,7449,3190,14958
2022-08-24 03:00:00+00,14339,493,4257,3554,120,138,2170,148,0,0,25219,257,10101,7931,3674,14832
2022-08-24 03:30:00+00,14492,496,4260,3814,120,152,1959,147,0,0,25440,257,10153,8194,3934,14988
2022-08-24 04:00:00+00,14025,496,4259,4419,133,214,2186,152,0,0,25884,247,10997,8811,4552,14521
2022-08-24 04:30:00+00,14070,496,4257,4573,133,306,2316,153,0,0,26304,246,11279,8963,4706,14566
2022-08-24 05:00:00+00,14120,495,4260,4878,141,348,2518,142,5,0,26907,243,11802,9284,5024,14615
2022-08-24 05:30:00+00,14552,496,4263,5375,169,656,2607,139,98,0,28355,241,12512,9905,5642,15048
2022-08-24 06:00:00+00,14617,495,4261,5615,281,1152,2689,470,302,0,29882,236,13148,10459,6198,15112
2022-08-24 06:30:00+00,14593,492,4270,5746,304,1232,2788,936,581,52,30994,232,13689,10901,6631,15085
2022-08-24 07:00:00+00,14661,491,4272,6316,289,1137,2783,932,1015,0,31896,223,14675,11892,7620,15152
2022-08-24 07:30:00+00,14714,492,4268,6270,275,1052,2775,968,1620,200,32634,216,15208,12433,8165,15206
2022-08-24 08:00:00+00,14533,491,4273,6100,261,2118,2772,820,2022,206,33596,215,15428,12656,8383,15024
2022-08-24 08:30:00+00,14542,492,4271,6098,254,2172,2757,791,2298,50,33725,214,15678,12921,8650,15034
2022-08-24 09:00:00+00,14546,492,4258,6277,227,2146,2713,658,3077,0,34394,208,16552,13839,9581,15038
2022-08-24 09:30:00+00,14515,491,4228,6114,227,2202,2670,572,3557,120,34696,206,16796,14126,9898,15006
2022-08-24 10:00:00+00,14407,493,4239,5628,188,3104,2222,567,3914,4,34766,211,16191,13969,9730,14900
2022-08-24 10:30:00+00,14647,493,4259,5253,183,3196,2235,596,4153,4,35019,214,16083,13848,9589,15140
2022-08-24 11:00:00+00,14559,495,4257,5402,176,2984,2414,529,4078,0,34894,211,16327,13913,9656,15054
2022-08-24 11:30:00+00,14634,494,4258,5415,166,2968,2337,394,4352,0,35018,210,16528,14191,9933,15128
2022-08-24 12:00:00+00,14693,495,4261,5170,165,2834,2483,466,4901,0,35468,210,16980,14497,10236,15188
2022-08-24 12:30:00+00,14748,496,4260,5216,164,2808,2433,398,5069,0,35592,210,17142,14709,10449,15244
2022-08-24 13:00:00+00,14385,495,4262,5176,162,2450,2374,318,4684,0,34306,211,16658,14284,10022,14880
2022-08-24 13:30:00+00,14332,494,4258,5231,170,2448,2350,401,4544,0,34228,211,16553,14203,9945,14826
2022-08-24 14:00:00+00,14230,495,4268,5481,221,2116,2315,481,4178,20,33805,205,16463,14148,9880,14725
2022-08-24 14:30:00+00,13969,507,4266,5845,237,2140,2287,513,3643,0,33407,204,16278,13991,9725,14476
2022-08-24 15:00:00+00,14002,665,4267,5927,275,2792,2302,714,3419,194,34557,207,16190,13888,9621,14667
2022-08-24 15:30:00+00,14710,730,4273,5818,287,2856,2490,742,3101,0,35007,216,15969,13479,9206,15440
2022-08-24 16:00:00+00,14823,725,4268,5396,358,2874,2606,847,2552,556,35005,220,15180,12574,8306,15548
2022-08-24 16:30:00+00,15275,738,4263,4926,485,2898,2625,902,1950,936,34998,227,14249,11624,7361,16013
2022-08-24 17:00:00+00,16023,735,4270,4604,610,2696,2614,942,1286,664,34444,238,13384,10770,6500,16758
2022-08-24 17:30:00+00,16083,729,4265,4482,646,2824,2602,978,751,616,33976,244,12746,10144,5879,16812
2022-08-24 18:00:00+00,16209,732,4264,4257,666,2566,2603,1093,350,512,33252,252,12140,9537,5273,16941
2022-08-24 18:30:00+00,16126,731,4264,4273,625,2544,2617,1001,66,604,32851,253,11845,9228,4964,16857
2022-08-24 19:00:00+00,16067,732,4259,4479,550,2510,2620,841,0,652,32710,254,11908,9288,5029,16799
2022-08-24 19:30:00+00,16197,725,4264,4374,539,2368,2621,846,0,432,32366,257,11798,9177,4913,16922
2022-08-24 20:00:00+00,16331,723,4260,4357,444,1790,2622,850,0,298,31675,257,11683,9061,4801,17054
2022-08-24 20:30:00+00,15991,633,4264,4380,417,1680,2583,636,0,0,30584,255,11644,9061,4797,16624
2022-08-24 21:00:00+00,16070,499,4262,4398,308,1802,2617,454,0,0,30410,255,11585,8968,4706,16569
2022-08-24 21:30:00+00,15378,498,4263,4171,236,1652,2623,432,0,0,29253,253,11293,8670,4407,15876
2022-08-24 22:00:00+00,14804,489,4257,4345,127,996,2625,371,0,0,28014,256,11354,8729,4472,15293
2022-08-24 22:30:00+00,14043,492,4268,4666,125,1016,2564,254,0,0,27428,249,11623,9059,4791,14535
2022-08-24 23:00:00+00,14202,494,4265,4728,94,556,2625,207,0,0,27171,246,11712,9087,4822,14696
2022-08-24 23:30:00+00,13749,490,4278,4907,83,572,2713,170,0,0,26962,242,11981,9268,4990,14239
2022-08-25 00:00:00+00,14138,476,4276,4800,83,626,2401,169,0,0,26969,246,11560,9159,4883,14614
2022-08-25 00:30:00+00,14500,492,4280,4588,82,584,2290,157,0,0,26973,251,11240,8950,4670,14992
2022-08-25 01:00:00+00,14458,496,4289,4585,69,542,2079,145,0,0,26663,251,11022,8943,4654,14954
2022-08-25 01:30:00+00,14463,496,4281,4287,75,504,2076,143,0,0,26325,254,10719,8643,4362,14959
2022-08-25 02:00:00+00,14861,497,4284,4038,75,676,2080,142,0,0,26653,259,10477,8397,4113,15358
2022-08-25 02:30:00+00,14944,497,4281,3928,75,642,2083,145,0,0,26595,261,10367,8284,4003,15441
2022-08-25 03:00:00+00,14844,498,4280,3841,73,550,2118,142,0,0,26346,261,10312,8194,3914,15342
2022-08-25 03:30:00+00,14859,499,4276,3470,57,618,2188,171,0,0,26138,265,9991,7803,3527,15358
2022-08-25 04:00:00+00,14663,499,4280,3320,67,736,2293,185,0,0,26043,266,9960,7667,3387,15162
2022-08-25 04:30:00+00,15012,500,4274,3094,86,750,2496,214,0,0,26426,269,9950,7454,3180,15512
2022-08-25 05:00:00+00,15064,498,4279,3091,120,1290,2268,530,0,0,27140,272,9758,7490,3211,15562
2022-08-25 05:30:00+00,15756,500,4274,2874,190,1408,2484,741,20,210,28457,272,9842,7358,3084,16256
2022-08-25 06:00:00+00,15913,499,4275,2946,242,1100,2664,827,79,558,29103,259,10206,7542,3267,16412
2022-08-25 06:30:00+00,16217,500,4278,3044,418,1062,2704,983,176,920,30302,253,10620,7916,3638,16717
2022-08-25 07:00:00+00,16089,500,4280,3016,441,2374,2781,1187,360,350,31378,253,10878,8097,3817,16589
2022-08-25 07:30:00+00,16162,500,4283,3238,433,2548,2784,1191,615,256,32010,250,11353,8569,4286,16662
2022-08-25 08:00:00+00,15977,500,4287,3729,418,3378,2671,1077,884,302,33223,240,11989,9318,5031,16477
2022-08-25 08:30:00+00,15955,498,4289,4246,239,3472,2696,1029,1109,204,33737,237,12579,9883,5594,16453
2022-08-25 09:00:00+00,16194,498,4291,4012,217,3500,2739,986,1467,268,34172,236,12726,9987,5696,16692
2022-08-25 09:30:00+00,16172,495,4287,3897,198,3542,2716,871,1734,166,34078,236,12832,10116,5829,16667
2022-08-25 10:00:00+00,16086,496,4284,3831,266,3406,2717,882,2061,336,34365,232,13159,10442,6158,16582
2022-08-25 10:30:00+00,16279,497,4282,3748,341,3394,2715,896,2304,0,34456,234,13390,10675,6393,16776
2022-08-25 11:00:00+00,16336,497,4279,3761,228,3414,2705,797,2448,132,34597,233,13421,10716,6437,16833
2022-08-25 11:30:00+00,16316,500,4277,3712,237,3412,2712,663,2843,76,34748,230,13781,11069,6792,16816
2022-08-25 12:00:00+00,16310,500,4220,3658,351,3480,2721,779,3019,0,35038,230,13969,11248,7028,16810
2022-08-25 12:30:00+00,16183,499,4157,3230,352,3460,2727,771,3102,18,34499,232,13568,10841,6684,16682
2022-08-25 13:00:00+00,16337,500,4152,3121,271,3306,2684,556,3391,0,34318,234,13619,10935,6783,16837
2022-08-25 13:30:00+00,16063,500,4155,3269,179,3326,2653,477,3105,0,33727,235,13361,10708,6553,16563
2022-08-25 14:00:00+00,15751,501,4153,3363,156,3018,2522,400,3240,0,33104,235,13434,10912,6759,16252
2022-08-25 14:30:00+00,15539,576,4151,3325,154,2950,2449,418,3446,0,33008,234,13525,11076,6925,16115
2022-08-25 15:00:00+00,14631,711,4152,3639,165,2736,2335,477,3075,0,31921,234,13366,11031,6879,15342
2022-08-25 15:30:00+00,14549,744,4151,4061,191,2772,2315,597,2448,0,31828,236,13166,10851,6700,15293
2022-08-25 16:00:00+00,15311,816,4153,4340,253,2886,2597,769,2494,64,33683,236,13837,11240,7087,16127
2022-08-25 16:30:00+00,15632,818,4165,4370,259,2932,2528,884,2405,122,34115,237,13727,11199,7034,16450
2022-08-25 17:00:00+00,15713,822,4165,4601,265,2344,2540,860,1845,232,33387,239,13416,10876,6711,16535
2022-08-25 17:30:00+00,15943,848,4168,4426,266,2342,2694,657,1018,580,32942,244,12572,9878,5710,16791
2022-08-25 18:00:00+00,15914,879,4159,4142,374,1948,2731,583,422,650,31802,249,11828,9097,4938,16793
2022-08-25 18:30:00+00,15889,819,4146,4154,313,1938,2641,739,63,592,31294,252,11317,8676,4530,16708
2022-08-25 19:00:00+00,16168,870,4143,4028,444,2032,2727,814,0,394,31620,255,11342,8615,4472,17038
2022-08-25 19:30:00+00,16045,972,4145,4090,370,1978,2740,813,0,370,31523,258,11345,8605,4460,17017
2022-08-25 20:00:00+00,15783,928,4146,3813,198,2330,2655,874,0,158,30885,264,10812,8157,4011,16711
2022-08-25 20:30:00+00,15473,819,4147,3625,183,2302,2612,377,0,36,29574,263,10567,7955,3808,16292
2022-08-25 21:00:00+00,15426,507,4149,3419,155,2150,2602,263,0,0,28671,262,10325,7723,3574,15933
2022-08-25 21:30:00+00,15005,497,4148,3187,153,2216,2596,228,0,0,28030,263,10084,7488,3340,15502
2022-08-25 22:00:00+00,15353,499,4152,2685,118,996,2723,203,0,0,26729,275,9678,6955,2803,15852
2022-08-25 22:30:00+00,15038,499,4166,2350,114,870,2745,210,0,0,25992,277,9375,6630,2464,15537
2022-08-25 23:00:00+00,15708,498,4149,2103,79,666,2756,203,0,0,26162,282,9087,6331,2182,16206
2022-08-25 23:30:00+00,15472,497,4149,1888,80,622,2784,171,0,0,25663,282,8901,6117,1968,15969
2022-08-26 00:00:00+00,16003,494,4150,1651,96,726,2808,183,0,0,26111,287,8705,5897,1747,16497
2022-08-26 00:30:00+00,16036,495,4159,1665,96,714,2702,185,0,0,26052,288,8622,5920,1761,16531
2022-08-26 01:00:00+00,16020,490,4171,1619,80,728,2601,186,0,0,25895,289,8471,5870,1699,16510
2022-08-26 01:30:00+00,15773,491,4178,1500,71,666,2609,169,0,0,25457,289,8358,5749,1571,16264
2022-08-26 02:00:00+00,15723,497,4188,1429,62,678,2595,160,0,0,25332,290,8274,5679,1491,16220
2022-08-26 02:30:00+00,15641,498,4192,1405,62,646,2596,157,0,0,25197,289,8255,5659,1467,16139
2022-08-26 03:00:00+00,15536,499,4200,1456,62,648,2591,187,0,0,25179,288,8309,5718,1518,16035
2022-08-26 03:30:00+00,15651,499,4204,1427,62,612,2594,165,0,0,25214,289,8287,5693,1489,16150
2022-08-26 04:00:00+00,15386,500,4213,1576,81,592,2598,207,0,0,25153,285,8468,5870,1657,15886
2022-08-26 04:30:00+00,15576,501,4226,1641,81,722,2616,220,0,0,25583,286,8564,5948,1722,16077
2022-08-26 05:00:00+00,14949,499,4229,1635,126,944,2609,404,5,0,25400,281,8604,5995,1766,15448
2022-08-26 05:30:00+00,15657,498,4231,1489,135,1002,2685,622,201,0,26520,282,8741,6056,1825,16155
2022-08-26 06:00:00+00,15077,500,4240,1309,186,1702,2753,765,610,0,27142,274,9098,6345,2105,15577
2022-08-26 06:30:00+00,15769,501,4244,1172,192,1682,2845,866,1224,8,28503,271,9677,6832,2588,16270
2022-08-26 07:00:00+00,15536,500,4247,1047,192,2192,2879,872,2103,0,29568,260,10468,7589,3342,16036
2022-08-26 07:30:00+00,15571,499,4248,994,186,2088,2892,921,2985,0,30384,253,11305,8413,4165,16070
2022-08-26 08:00:00+00,15570,500,4258,989,189,2078,2879,793,3924,0,31180,247,12239,9360,5102,16070
2022-08-26 08:30:00+00,15955,501,4262,945,201,2070,2784,280,4914,0,31912,241,13106,10322,6060,16456
2022-08-26 09:00:00+00,16153,500,4272,916,183,2296,2551,172,5832,62,32937,233,13754,11203,6931,16653
2022-08-26 09:30:00+00,15849,498,4269,870,167,2350,2434,214,6445,0,33096,228,14185,11751,7482,16347
2022-08-26 10:00:00+00,15655,498,4271,869,105,2142,2716,225,6813,0,33294,225,14774,12058,7787,16153
2022-08-26 10:30:00+00,15722,501,4262,827,105,2112,2585,171,7271,90,33646,222,15050,12465,8203,16223
2022-08-26 11:00:00+00,15685,500,4263,813,105,2824,2283,120,7393,294,34280,217,14857,12574,8311,16185
2022-08-26 11:30:00+00,15484,500,4266,840,104,2798,2471,122,7161,148,33894,218,14842,12371,8105,15984
2022-08-26 12:00:00+00,15881,496,4265,836,103,2750,2864,282,6689,216,34382,224,14757,11893,7628,16377
2022-08-26 12:30:00+00,15806,499,4267,860,102,2720,2847,355,6164,260,33880,227,14240,11393,7126,16305
2022-08-26 13:00:00+00,15965,497,4265,867,101,2538,2819,378,5719,158,33307,233,13771,10952,6687,16462
2022-08-26 13:30:00+00,15967,498,4266,889,95,2514,2822,472,4868,4,32395,240,12940,10118,5852,16465
2022-08-26 14:00:00+00,15863,499,4269,878,105,2366,2762,525,4287,60,31614,243,12301,9539,5270,16362
2022-08-26 14:30:00+00,15898,497,4268,837,110,2362,2788,579,3818,0,31157,248,11821,9033,4765,16395
2022-08-26 15:00:00+00,15892,495,4266,854,152,2654,2733,692,3466,18,31222,250,11471,8738,4472,16387
2022-08-26 15:30:00+00,16283,496,4266,840,153,2696,2787,746,2781,178,31226,257,10827,8040,3774,16779
2022-08-26 16:00:00+00,16405,496,4265,857,214,2588,2790,672,2184,642,31113,256,10310,7520,3255,16901
2022-08-26 16:30:00+00,16643,495,4272,899,235,2646,2875,719,1758,838,31380,258,10039,7164,2892,17138
2022-08-26 17:00:00+00,16518,495,4271,936,240,3014,2725,815,1272,830,31116,260,9444,6719,2448,17013
2022-08-26 17:30:00+00,16510,494,4269,984,237,2996,2686,872,707,866,30621,264,8883,6197,1928,17004
2022-08-26 18:00:00+00,16759,496,4267,995,236,2146,2802,895,327,810,29734,270,8627,5825,1558,17255
2022-08-26 18:30:00+00,16647,494,4272,1016,207,2111,2871,903,50,782,29353,272,8416,5545,1273,17141
2022-08-26 19:00:00+00,16918,491,4264,1070,205,1838,2882,875,0,704,29246,274,8421,5539,1275,17409
2022-08-26 19:30:00+00,16823,492,4264,1191,188,1826,2884,772,0,666,29106,272,8527,5643,1379,17315
2022-08-26 20:00:00+00,16161,493,4261,1187,148,2712,2810,625,0,68,28465,274,8406,5596,1335,16654
2022-08-26 20:30:00+00,15602,489,4256,1139,148,2750,2438,515,0,82,27419,274,7981,5543,1287,16091
2022-08-26 21:00:00+00,15896,491,4258,964,119,2528,2334,563,0,196,27349,280,7675,5341,1083,16387
2022-08-26 21:30:00+00,15561,491,4262,825,101,2386,2176,260,0,80,26142,283,7364,5188,926,16052
2022-08-26 22:00:00+00,15402,491,4261,766,42,984,1887,184,0,2,24019,290,6956,5069,808,15893
2022-08-26 22:30:00+00,14754,491,4261,732,39,1030,1748,201,0,0,23256,291,6780,5032,771,15245
2022-08-26 23:00:00+00,14906,494,4262,677,39,578,1713,215,0,4,22888,300,6691,4978,716,15400
2022-08-26 23:30:00+00,14678,493,4260,586,39,498,1682,203,0,0,22439,301,6567,4885,625,15171
2022-08-27 00:00:00+00,15416,494,4268,492,39,614,1509,187,0,0,23019,307,6308,4799,531,15910
2022-08-27 00:30:00+00,15467,495,4269,464,39,564,1539,229,0,0,23066,307,6311,4772,503,15962
2022-08-27 01:00:00+00,15878,494,4271,493,39,662,1532,212,0,0,23581,309,6335,4803,532,16372
2022-08-27 01:30:00+00,15894,481,4276,550,39,566,1569,178,0,0,23553,307,6434,4865,589,16375
2022-08-27 02:00:00+00,15870,490,4272,651,39,608,1576,195,0,0,23701,306,6538,4962,690,16360
2022-08-27 02:30:00+00,15884,498,4277,690,39,520,1509,203,0,0,23620,306,6515,5006,729,16382
2022-08-27 03:00:00+00,16077,498,4266,685,39,580,1514,206,0,0,23865,307,6504,4990,724,16575
2022-08-27 03:30:00+00,16038,500,4267,793,39,548,1515,183,0,0,23883,305,6614,5099,832,16538
2022-08-27 04:00:00+00,16057,499,4264,817,39,570,1516,202,0,0,23964,305,6636,5120,856,16556
2022-08-27 04:30:00+00,16058,499,4267,810,44,666,1510,234,0,0,24088,306,6631,5121,854,16557
2022-08-27 05:00:00+00,15863,500,4262,846,83,636,1423,273,4,0,23890,305,6618,5195,933,16363
2022-08-27 05:30:00+00,15984,498,4267,874,86,620,1455,383,162,0,24329,302,6844,5389,1122,16482
2022-08-27 06:00:00+00,15324,499,4269,966,134,380,1646,428,585,0,24231,289,7600,5954,1685,15823
2022-08-27 06:30:00+00,15355,498,4271,1012,135,228,1659,603,1217,0,24978,280,8294,6635,2364,15853
2022-08-27 07:00:00+00,15066,500,4267,1018,135,652,1521,630,1923,0,25712,274,8864,7343,3076,15566
2022-08-27 07:30:00+00,15385,500,4265,1014,136,638,1482,493,2813,34,26760,266,9710,8228,3963,15885
2022-08-27 08:00:00+00,15695,498,4271,1039,152,960,1475,377,3815,0,28282,256,10752,9277,5006,16193
2022-08-27 08:30:00+00,15723,501,4272,993,141,974,1483,328,4847,0,29262,248,11736,10253,5981,16224
2022-08-27 09:00:00+00,15895,497,4281,974,99,1394,1498,208,5599,94,30539,240,12451,10953,6672,16392
2022-08-27 09:30:00+00,15448,497,4283,986,94,1400,1470,159,6530,36,30903,230,13363,11893,7610,15945
2022-08-27 10:00:00+00,15140,498,4285,964,61,1264,1488,149,6807,12,30668,222,13605,12117,7832,15638
2022-08-27 10:30:00+00,15403,495,4281,880,61,1310,1390,145,6705,160,30830,224,13317,11927,7646,15898
2022-08-27 11:00:00+00,15764,497,4283,896,46,1314,1269,133,6828,0,31030,227,13322,12053,7770,16261
2022-08-27 11:30:00+00,15624,495,4284,980,43,1340,1434,149,7261,0,31610,221,14002,12568,8284,16119
2022-08-27 12:00:00+00,15792,496,4278,1006,43,1622,1480,192,6843,0,31752,225,13650,12170,7892,16288
2022-08-27 12:30:00+00,15828,494,4276,1028,43,1630,1409,198,6438,0,31344,228,13194,11785,7509,16322
2022-08-27 13:00:00+00,15855,495,4275,1073,42,1728,1285,152,6315,0,31220,230,12990,11705,7430,16350
2022-08-27 13:30:00+00,15720,495,4277,1176,42,1732,1376,128,5990,0,30936,231,12861,11485,7208,16215
2022-08-27 14:00:00+00,15798,494,4272,1247,42,1314,1507,145,5961,0,30780,228,13029,11522,7250,16292
2022-08-27 14:30:00+00,15679,497,4278,1342,43,1300,1591,232,5091,0,30053,233,12345,10754,6476,16176
2022-08-27 15:00:00+00,15549,496,4276,1396,119,684,1537,298,4492,98,28945,238,11820,10283,6007,16045
2022-08-27 15:30:00+00,15681,495,4275,1449,148,662,1591,556,3854,10,28721,244,11317,9726,5451,16176
2022-08-27 16:00:00+00,15587,495,4273,1569,187,1292,1566,828,3028,20,28845,248,10623,9057,4784,16082
2022-08-27 16:30:00+00,15841,496,4272,1595,228,1346,1547,935,2263,326,28849,252,9905,8358,4086,16337
2022-08-27 17:00:00+00,15816,496,4277,1617,202,1946,1540,942,1622,490,28948,253,9258,7718,3441,16312
2022-08-27 17:30:00+00,15913,494,4276,1698,206,1966,1565,949,983,694,28744,256,8728,7163,2887,16407
2022-08-27 18:00:00+00,15933,491,4281,1808,198,1882,1585,902,373,702,28155,262,8245,6660,2379,16424
2022-08-27 18:30:00+00,15906,491,4277,1843,167,1880,1570,832,47,650,27663,265,7904,6334,2057,16397
2022-08-27 19:00:00+00,15872,492,4280,1874,146,2530,1500,838,0,308,27840,269,7800,6300,2020,16364
2022-08-27 19:30:00+00,15881,494,4276,1941,131,2558,1563,796,0,264,27904,268,7911,6348,2072,16375
2022-08-27 20:00:00+00,15904,496,4274,1948,118,1952,1557,852,0,0,27101,271,7897,6340,2066,16400
2022-08-27 20:30:00+00,15756,498,4273,1986,101,1892,1560,492,0,0,26558,271,7920,6360,2087,16254
2022-08-27 21:00:00+00,15998,498,4273,1922,69,1768,1502,456,0,192,26678,275,7766,6264,1991,16496
2022-08-27 21:30:00+00,15835,498,4279,1841,69,1796,1394,302,0,0,26014,280,7583,6189,1910,16333
2022-08-27 22:00:00+00,15737,500,4275,1817,69,930,1312,394,0,54,25088,288,7473,6161,1886,16237
2022-08-27 22:30:00+00,15225,499,4275,1799,65,806,1236,387,0,114,24406,287,7375,6139,1864,15724
2022-08-27 23:00:00+00,15127,499,4275,1694,40,602,1243,214,0,0,23694,288,7252,6009,1734,15626
2022-08-27 23:30:00+00,14933,499,4275,1640,40,478,1254,193,0,0,23312,287,7209,5955,1680,15432
2022-08-28 00:00:00+00,14943,493,4267,1641,40,192,1426,227,0,0,23229,285,7374,5948,1681,15436
2022-08-28 00:30:00+00,14771,495,4278,1564,40,212,1439,161,0,0,22960,286,7321,5882,1604,15266
2022-08-28 01:00:00+00,14489,497,4283,1452,40,788,1214,110,0,0,22873,285,6989,5775,1492,14986
2022-08-28 01:30:00+00,14435,498,4276,1378,40,814,948,134,0,0,22523,288,6642,5694,1418,14933
2022-08-28 02:00:00+00,13776,500,4282,1311,40,1066,692,117,0,0,21784,286,6325,5633,1351,14276
2022-08-28 02:30:00+00,13588,500,4279,1268,40,1074,686,111,0,0,21546,286,6273,5587,1308,14088
2022-08-28 03:00:00+00,13618,499,4278,1200,40,1424,619,111,0,0,21789,289,6137,5518,1240,14117
2022-08-28 03:30:00+00,13497,500,4281,1170,39,1432,590,121,0,0,21630,289,6080,5490,1209,13997
2022-08-28 04:00:00+00,13671,500,4273,1267,39,1452,657,130,0,0,21989,290,6236,5579,1306,14171
2022-08-28 04:30:00+00,13673,498,4277,1350,39,1432,675,122,0,0,22066,288,6341,5666,1389,14171
2022-08-28 05:00:00+00,13803,501,4268,1349,39,864,686,137,5,0,21652,290,6347,5661,1393,14304
2022-08-28 05:30:00+00,13810,501,4275,1421,39,940,724,137,245,0,22092,286,6704,5980,1705,14311
2022-08-28 06:00:00+00,13386,501,4271,1436,134,1496,528,130,753,0,22635,277,7122,6594,2323,13887
2022-08-28 06:30:00+00,13652,497,4274,1398,134,1626,519,179,1470,0,23749,271,7795,7276,3002,14149
2022-08-28 07:00:00+00,13663,498,4273,1376,116,2138,512,184,2185,0,24945,255,8462,7950,3677,14161
2022-08-28 07:30:00+00,13596,499,4269,1368,115,2186,516,205,2956,0,25710,247,9224,8708,4439,14095
2022-08-28 08:00:00+00,12815,492,4278,1373,101,2688,520,158,3967,0,26392,229,10239,9719,5441,13307
2022-08-28 08:30:00+00,12795,498,4275,1371,101,2780,511,150,4639,0,27120,223,10897,10386,6111,13293
2022-08-28 09:00:00+00,12941,496,4280,1429,96,3137,515,164,5110,0,28168,218,11430,10915,6635,13437
2022-08-28 09:30:00+00,12964,497,4282,1418,92,3094,500,156,5841,0,28844,213,12133,11633,7351,13461
2022-08-28 10:00:00+00,13364,497,4270,1451,55,3386,503,193,6282,0,30001,211,12561,12058,7788,13861
2022-08-28 10:30:00+00,13364,494,4288,1517,55,3398,499,183,6354,0,30152,209,12713,12214,7926,13858
2022-08-28 11:00:00+00,13251,495,4282,1538,41,3456,507,167,6648,0,30385,207,13016,12509,8227,13746
2022-08-28 11:30:00+00,13126,493,4283,1639,39,3438,501,162,6795,0,30476,205,13257,12756,8473,13619
2022-08-28 12:00:00+00,12764,451,4284,1645,39,3282,504,149,6648,0,29766,203,13120,12616,8332,13215
2022-08-28 12:30:00+00,12749,476,4278,1602,39,3260,509,153,6118,0,29184,208,12546,12037,7759,13225
2022-08-28 13:00:00+00,12935,495,4278,1649,39,2956,510,154,5417,0,28433,216,11893,11383,7105,13430
2022-08-28 13:30:00+00,13192,494,4281,1699,39,2920,516,155,5050,0,28346,220,11585,11069,6788,13686
2022-08-28 14:00:00+00,13904,497,4272,1779,47,2696,537,163,4092,0,27987,233,10727,10190,5918,14401
2022-08-28 14:30:00+00,14277,499,4275,1808,49,2670,557,203,3849,0,28187,238,10538,9981,5706,14776
2022-08-28 15:00:00+00,14382,491,4278,1902,102,2540,635,364,3599,0,28293,240,10516,9881,5603,14873
2022-08-28 15:30:00+00,14980,499,4279,2078,105,2598,642,546,2747,0,28474,250,9851,9209,4930,15479
2022-08-28 16:00:00+00,15291,498,4282,2125,137,2554,766,653,2076,290,28672,254,9386,8620,4338,15789
2022-08-28 16:30:00+00,15615,498,4274,2223,160,2550,850,657,1579,372,28778,258,9086,8236,3962,16113
2022-08-28 17:00:00+00,15730,492,4276,2260,210,1960,899,968,1026,808,28629,259,8671,7772,3496,16222
2022-08-28 17:30:00+00,15633,494,4278,2317,211,2008,1091,1084,571,716,28403,263,8468,7377,3099,16127
2022-08-28 18:00:00+00,15890,493,4278,2413,211,1530,1376,1076,238,704,28209,270,8516,7140,2862,16383
2022-08-28 18:30:00+00,16273,499,4275,2407,182,1544,1428,885,25,594,28112,276,8317,6889,2614,16772
2022-08-28 19:00:00+00,16389,498,4278,2283,148,1064,1475,905,0,770,27810,275,8184,6709,2431,16887
2022-08-28 19:30:00+00,16206,492,4283,2369,145,968,1494,928,0,534,27419,276,8291,6797,2514,16698
2022-08-28 20:00:00+00,16440,492,4275,2456,106,1068,1497,938,0,210,27482,278,8334,6837,2562,16932
2022-08-28 20:30:00+00,16278,500,4272,2569,103,966,1485,810,0,0,26983,278,8429,6944,2672,16778
2022-08-28 21:00:00+00,15797,501,4267,2796,68,736,1490,643,0,166,26464,277,8621,7131,2864,16298
2022-08-28 21:30:00+00,15666,499,4269,2995,68,664,1302,352,0,0,25815,276,8634,7332,3063,16165
2022-08-28 22:00:00+00,15657,498,4272,3030,68,490,1207,273,0,0,25495,278,8577,7370,3098,16155
2022-08-28 22:30:00+00,15326,498,4269,2969,65,276,944,272,0,0,24619,277,8247,7303,3034,15824
2022-08-28 23:00:00+00,14785,497,4269,2981,40,352,889,194,0,0,24007,276,8179,7290,3021,15282
2022-08-28 23:30:00+00,14325,499,4267,3041,40,286,894,165,0,0,23517,272,8242,7348,3081,14824
2022-08-29 00:00:00+00,14335,500,4271,3027,40,318,900,173,0,0,23564,273,8238,7338,3067,14835
2022-08-29 00:30:00+00,14064,500,4266,3117,40,276,902,177,0,0,23342,270,8325,7423,3157,14564
2022-08-29 01:00:00+00,14059,500,4270,3044,40,398,911,189,0,0,23411,272,8265,7354,3084,14559
2022-08-29 01:30:00+00,13907,501,4274,2781,40,330,920,153,0,0,22906,273,8015,7095,2821,14408
2022-08-29 02:00:00+00,14702,500,4278,2763,40,400,903,156,0,0,23742,279,7984,7081,2803,15202
2022-08-29 02:30:00+00,14820,500,4279,2845,40,292,892,159,0,0,23827,277,8056,7164,2885,15320
2022-08-29 03:00:00+00,15199,502,4272,2894,40,368,920,187,0,0,24382,279,8126,7206,2934,15701
2022-08-29 03:30:00+00,15229,500,4275,2877,40,372,915,210,0,0,24418,280,8107,7192,2917,15729
2022-08-29 04:00:00+00,15389,501,4276,3108,40,548,994,198,0,0,25054,279,8418,7424,3148,15890
2022-08-29 04:30:00+00,15408,500,4272,3312,40,572,1006,200,0,0,25310,276,8630,7624,3352,15908
2022-08-29 05:00:00+00,15777,499,4266,3497,40,504,1140,266,0,62,26051,274,8943,7803,3537,16276
2022-08-29 05:30:00+00,15831,500,4264,3706,40,624,1295,311,85,18,26674,272,9390,8095,3831,16331
2022-08-29 06:00:00+00,16294,499,4270,3672,135,506,1519,403,515,138,27951,266,10111,8592,4322,16793
2022-08-29 06:30:00+00,16257,501,4267,3535,135,458,1686,394,1123,220,28576,259,10746,9060,4793,16758
2022-08-29 07:00:00+00,16209,500,4271,3397,135,262,1694,502,1866,146,28982,253,11363,9669,5398,16709
2022-08-29 07:30:00+00,15977,499,4269,3545,134,328,1764,625,2537,12,29690,246,12249,10485,6216,16476
2022-08-29 08:00:00+00,15647,499,4271,3406,120,370,1770,514,3159,0,29756,241,12726,10956,6685,16146
2022-08-29 08:30:00+00,15802,498,4268,3377,122,350,1755,460,3670,0,30302,238,13192,11437,7169,16300
2022-08-29 09:00:00+00,15763,499,4271,3387,105,350,1750,322,4060,72,30579,234,13573,11823,7552,16262
2022-08-29 09:30:00+00,15657,497,4275,3590,103,367,1754,254,4520,0,31017,228,14242,12488,8213,16154
2022-08-29 10:00:00+00,15493,499,4274,3594,70,476,1755,239,4662,82,31143,226,14355,12600,8326,15992
2022-08-29 10:30:00+00,15541,498,4284,3696,67,318,1774,218,5355,52,31803,219,15176,13402,9118,16039
2022-08-29 11:00:00+00,15520,501,4281,3839,51,262,1756,237,5342,0,31789,220,15269,13513,9232,16021
2022-08-29 11:30:00+00,15651,500,4277,3777,50,237,1748,214,4870,0,31324,224,14722,12974,8697,16151
2022-08-29 12:00:00+00,15318,500,4278,3673,50,230,1747,171,4915,94,30976,222,14663,12916,8638,15818
2022-08-29 12:30:00+00,15185,498,4285,3557,50,177,1746,161,4913,0,30572,222,14551,12805,8520,15683
2022-08-29 13:00:00+00,14647,496,4277,3812,50,148,1754,162,4829,0,30175,217,14722,12968,8691,15143
2022-08-29 13:30:00+00,14276,499,4280,4133,49,148,1751,165,4417,0,29719,216,14630,12879,8599,14775
2022-08-29 14:00:00+00,14938,499,4296,4335,49,296,1753,235,4372,96,30869,219,14805,13052,8756,15437
2022-08-29 14:30:00+00,15194,499,4328,4355,49,363,1753,237,3842,110,30730,224,14327,12574,8246,15693
2022-08-29 15:00:00+00,15660,498,4334,4402,61,920,1774,207,3243,150,31250,229,13814,12040,7706,16158
2022-08-29 15:30:00+00,16118,500,4333,4371,69,952,1874,635,2850,154,31856,235,13497,11623,7290,16618
2022-08-29 16:00:00+00,16202,500,4332,4196,190,905,1879,925,2388,708,32225,234,12985,11106,6774,16702
2022-08-29 16:30:00+00,16482,499,4325,4169,205,973,2041,904,1779,892,32269,237,12519,10478,6153,16981
2022-08-29 17:00:00+00,16151,500,4340,4374,239,1224,2255,1075,1190,614,31962,238,12398,10142,5802,16651
2022-08-29 17:30:00+00,16222,501,4381,4557,250,1242,2334,1037,652,690,31865,240,12174,9840,5459,16723
2022-08-29 18:00:00+00,16020,499,4385,4805,219,1304,2335,597,236,1064,31464,237,11980,9645,5260,16519
2022-08-29 18:30:00+00,16150,498,4388,4862,219,1341,2319,584,24,1010,31395,240,11812,9493,5105,16648
2022-08-29 19:00:00+00,16647,500,4385,5086,202,1054,2359,746,0,684,31663,245,12032,9673,5288,17147
2022-08-29 19:30:00+00,16567,502,4392,5298,159,904,2369,785,0,668,31644,243,12218,9849,5457,17069
2022-08-29 20:00:00+00,16475,501,4385,5600,146,560,2369,827,0,80,30943,246,12500,10131,5746,16976
2022-08-29 20:30:00+00,15689,501,4386,5649,143,534,2361,616,0,0,29879,241,12539,10178,5792,16190
2022-08-29 21:00:00+00,15426,500,4388,5786,120,380,2279,255,0,0,29134,240,12573,10294,5906,15926
2022-08-29 21:30:00+00,14501,499,4381,5756,105,306,2091,231,0,0,27870,237,12333,10242,5861,15000
2022-08-29 22:00:00+00,15183,499,4380,5622,88,216,1823,241,0,0,28052,244,11913,10090,5710,15682
2022-08-29 22:30:00+00,14670,500,4381,5589,83,150,1628,232,0,0,27233,242,11681,10053,5672,15170
2022-08-29 23:00:00+00,14876,499,4382,5605,63,236,1596,224,0,0,27481,244,11646,10050,5668,15375
2022-08-29 23:30:00+00,14658,496,4382,5661,63,270,1506,170,0,0,27206,243,11612,10106,5724,15154
2022-08-30 00:00:00+00,14762,497,4383,5668,63,398,1505,158,0,0,27434,244,11619,10114,5731,15259
2022-08-30 00:30:00+00,14572,500,4382,5514,63,492,1526,153,0,0,27202,245,11485,9959,5577,15072
2022-08-30 01:00:00+00,14322,497,4392,5697,63,408,1488,142,0,0,27009,241,11640,10152,5760,14819
2022-08-30 01:30:00+00,14077,498,4385,5606,63,428,1494,143,0,0,26694,241,11548,10054,5669,14575
2022-08-30 02:00:00+00,13961,500,4390,5442,63,440,1531,153,0,0,26480,242,11426,9895,5505,14461
2022-08-30 02:30:00+00,14280,501,4405,5083,63,424,1523,154,0,0,26433,247,11074,9551,5146,14781
2022-08-30 03:00:00+00,14269,501,4437,5214,63,418,1509,152,0,0,26563,245,11223,9714,5277,14770
2022-08-30 03:30:00+00,14319,495,4450,5318,63,398,1505,147,0,0,26695,244,11336,9831,5381,14814
2022-08-30 04:00:00+00,14511,500,4460,5272,65,380,1528,153,0,0,26869,245,11325,9797,5337,15011
2022-08-30 04:30:00+00,15178,500,4463,5215,66,362,1691,155,0,0,27630,249,11435,9744,5281,15678
2022-08-30 05:00:00+00,15813,500,4457,5279,83,522,2122,242,0,0,29018,251,11941,9819,5362,16313
2022-08-30 05:30:00+00,16226,500,4457,5378,83,724,2416,295,161,0,30240,251,12495,10079,5622,16726
2022-08-30 06:00:00+00,16163,500,4448,5360,97,700,2444,344,662,18,30736,247,13011,10567,6119,16663
2022-08-30 06:30:00+00,16997,499,4453,5351,95,580,2632,496,1403,14,32520,244,13934,11302,6849,17496
2022-08-30 07:00:00+00,16602,510,4446,5520,95,886,2585,433,2269,0,33346,234,14915,12330,7884,17112
2022-08-30 07:30:00+00,16091,534,4455,5951,97,936,2692,490,2965,0,34211,224,16160,13468,9013,16625
2022-08-30 08:00:00+00,15058,549,4453,6098,84,1976,2163,332,3420,108,34241,215,16218,14055,9602,15607
2022-08-30 08:30:00+00,15232,583,4454,6087,84,2016,1603,201,4177,110,34547,213,16405,14802,10348,15815
2022-08-30 09:00:00+00,15507,599,4453,5977,84,1902,1626,165,4720,0,35033,213,16860,15234,10781,16106
2022-08-30 09:30:00+00,15409,635,4449,5554,80,1810,1611,177,5257,142,35124,211,16951,15340,10891,16044
2022-08-30 10:00:00+00,15367,649,4456,5038,67,1988,1802,158,5519,248,35292,211,16882,15080,10624,16016
2022-08-30 10:30:00+00,15526,687,4461,4966,66,1980,2100,158,5457,0,35401,214,17050,14950,10489,16213
2022-08-30 11:00:00+00,15917,716,4460,4781,49,2054,2120,190,5418,0,35705,218,16828,14708,10248,16633
2022-08-30 11:30:00+00,16194,719,4467,4695,51,1994,2121,162,5256,0,35659,221,16590,14469,10002,16913
2022-08-30 12:00:00+00,16291,719,4483,4602,61,1858,2124,184,5274,54,35650,223,16544,14420,9937,17010
2022-08-30 12:30:00+00,16287,722,4510,4555,61,1810,2118,159,5392,0,35614,222,16636,14518,10008,17009
2022-08-30 13:00:00+00,16066,699,4497,4557,60,2236,2118,182,4929,32,35376,224,16161,14043,9546,16765
2022-08-30 13:30:00+00,16257,714,4494,4472,60,2292,2122,193,4748,0,35352,227,15896,13774,9280,16971
2022-08-30 14:00:00+00,16738,719,4492,4492,61,2224,1998,195,4627,26,35572,231,15670,13672,9180,17457
2022-08-30 14:30:00+00,16819,719,4488,4627,61,2338,1986,202,4113,0,35353,235,15275,13289,8801,17538
2022-08-30 15:00:00+00,17053,714,4491,4789,78,1388,2100,332,3400,0,34345,239,14858,12758,8267,17767
2022-08-30 15:30:00+00,17253,718,4485,4808,79,1364,2125,498,3196,354,34880,239,14693,12568,8083,17971
2022-08-30 16:00:00+00,17409,717,4493,5006,147,1822,2115,668,2676,410,35463,240,14437,12322,7829,18126
2022-08-30 16:30:00+00,17538,716,4489,5211,157,1844,1909,692,2136,592,35284,242,13902,11993,7504,18254
2022-08-30 17:00:00+00,17718,728,4490,5581,230,1554,1845,765,1543,758,35212,246,13689,11844,7354,18446
2022-08-30 17:30:00+00,17631,728,4492,5900,228,1552,1776,814,873,606,34600,249,13269,11493,7001,18359
2022-08-30 18:00:00+00,17669,724,4484,6097,205,1548,1711,821,294,764,34317,252,12791,11080,6596,18393
2022-08-30 18:30:00+00,17743,723,4495,6219,195,1566,1659,735,22,682,34039,255,12590,10931,6436,18466
2022-08-30 19:00:00+00,17849,723,4494,6379,136,1600,1855,568,0,446,34050,254,12864,11009,6515,18572
2022-08-30 19:30:00+00,17516,725,4508,6633,131,1514,1917,562,0,20,33526,253,13189,11272,6764,18241
2022-08-30 20:00:00+00,17521,752,4509,6577,88,674,2006,538,0,6,32671,255,13180,11174,6665,18273
2022-08-30 20:30:00+00,16758,798,4504,6596,89,534,1692,227,0,138,31336,251,12881,11189,6685,17556
2022-08-30 21:00:00+00,17030,796,4508,6465,70,379,1574,172,0,72,31066,254,12617,11043,6535,17826
2022-08-30 21:30:00+00,16235,795,4507,6443,68,284,1437,153,0,0,29922,251,12455,11018,6511,17030
2022-08-30 22:00:00+00,16212,797,4499,6260,68,226,1657,201,0,0,29920,252,12484,10827,6328,17009
2022-08-30 22:30:00+00,15396,799,4495,6132,68,306,1765,185,0,0,29146,249,12460,10695,6200,16195
2022-08-30 23:00:00+00,14989,795,4505,6057,49,380,1404,157,0,0,28336,250,12015,10611,6106,15784
2022-08-30 23:30:00+00,14986,800,4499,5860,49,320,1231,156,0,0,27901,252,11639,10408,5909,15786
2022-08-31 00:00:00+00,15019,799,4502,5765,49,372,1236,159,0,0,27901,253,11552,10316,5814,15818
2022-08-31 00:30:00+00,15066,797,4505,5815,49,402,1189,147,0,0,27970,253,11558,10369,5864,15863
2022-08-31 01:00:00+00,15021,798,4503,5828,49,220,1189,146,0,0,27754,252,11569,10380,5877,15819
2022-08-31 01:30:00+00,14191,780,4510,6173,49,186,1188,147,0,0,27224,243,11920,10732,6222,14971
2022-08-31 02:00:00+00,13903,769,4506,6384,49,230,1228,149,0,0,27218,240,12167,10939,6433,14672
2022-08-31 02:30:00+00,13831,746,4508,6439,49,216,1093,150,0,0,27032,239,12089,10996,6488,14577
2022-08-31 03:00:00+00,13884,792,4512,6399,49,188,1093,150,0,0,27067,241,12053,10960,6448,14676
2022-08-31 03:30:00+00,13959,797,4508,6504,49,158,1097,160,0,0,27232,240,12158,11061,6553,14756
2022-08-31 04:00:00+00,13989,798,4521,6597,49,204,1127,166,0,0,27451,239,12294,11167,6646,14787
2022-08-31 04:30:00+00,14779,797,4526,6503,65,216,1124,161,0,0,28171,244,12218,11094,6568,15576
2022-08-31 05:00:00+00,15859,799,4522,6361,64,270,1299,168,0,0,29342,251,12246,10947,6425,16658
2022-08-31 05:30:00+00,16704,845,4524,6334,72,374,1963,171,136,0,31123,253,13029,11066,6542,17549
2022-08-31 06:00:00+00,17568,847,4518,6433,155,290,2053,275,672,0,32811,250,13831,11778,7260,18415
2022-08-31 06:30:00+00,17914,850,4517,6414,165,168,2022,616,1457,94,34217,245,14575,12553,8036,18764
2022-08-31 07:00:00+00,17743,850,4517,6481,158,478,2013,631,2300,106,35277,239,15469,13456,8939,18593
2022-08-31 07:30:00+00,17630,847,4517,6705,155,518,1880,589,3072,108,36021,232,16329,14449,9932,18477
2022-08-31 08:00:00+00,17609,850,4516,6894,119,892,1499,247,3655,0,36281,226,16683,15184,10668,18459
2022-08-31 08:30:00+00,17281,850,4518,7127,114,926,1271,160,4306,0,36553,220,17336,16065,11547,18131
2022-08-31 09:00:00+00,16912,849,4519,7193,86,610,1550,157,5284,0,37160,212,18632,17082,12563,17761
2022-08-31 09:30:00+00,16525,850,4523,7105,82,624,1926,145,5887,0,37667,206,19523,17597,13074,17375
2022-08-31 10:00:00+00,16070,848,4529,6990,90,1128,2028,143,6146,0,37972,203,19783,17755,13226,16918
2022-08-31 10:30:00+00,16119,849,4528,6994,92,1146,2045,153,6280,0,38206,202,19939,17894,13366,16968
2022-08-31 11:00:00+00,15837,847,4536,6978,75,1944,2092,146,6309,0,38764,202,19990,17898,13362,16684
2022-08-31 11:30:00+00,15763,845,4534,6699,75,1960,2110,156,6390,0,38532,203,19808,17698,13164,16608
2022-08-31 12:00:00+00,15552,846,4538,6489,76,1960,2057,148,6342,0,38008,203,19502,17445,12907,16398
2022-08-31 12:30:00+00,15293,842,4533,6501,76,1972,2015,155,6330,0,37717,202,19455,17440,12907,16135
2022-08-31 13:00:00+00,15417,844,4541,6681,76,1764,1965,144,6161,0,37593,204,19424,17459,12918,16261
2022-08-31 13:30:00+00,15213,842,4542,6716,71,1786,2018,148,5711,30,37077,205,19058,17040,12498,16055
2022-08-31 14:00:00+00,16217,840,4555,6775,75,854,2112,148,5543,0,37119,210,19060,16948,12393,17057
2022-08-31 14:30:00+00,16398,832,4596,6617,75,808,2119,157,5225,80,36907,212,18632,16513,11917,17230
2022-08-31 15:00:00+00,16983,840,4593,6563,91,208,2119,268,4526,30,36221,218,17892,15773,11180,17823
2022-08-31 15:30:00+00,17113,846,4591,6624,96,72,2106,634,3815,26,35923,223,17232,15126,10535,17959
2022-08-31 16:00:00+00,17316,891,4587,6980,177,122,2102,935,3055,342,36507,226,16901,14799,10212,18207
2022-08-31 16:30:00+00,17240,891,4601,7426,167,104,2116,973,2299,564,36381,226,16609,14493,9892,18131
2022-08-31 17:00:00+00,16991,897,4632,7660,212,170,2092,1042,1655,574,35925,227,16251,14159,9527,17888
2022-08-31 17:30:00+00,17125,894,4655,7926,213,166,2066,918,891,664,35518,230,15751,13685,9030,18019
2022-08-31 18:00:00+00,17492,895,4648,7976,212,60,2072,982,293,662,35292,236,15201,13129,8481,18387
2022-08-31 18:30:00+00,17432,893,4654,8292,212,144,2056,952,21,630,35286,236,15235,13179,8525,18325
2022-08-31 19:00:00+00,17406,892,4650,8580,184,204,2071,748,0,676,35411,233,15485,13414,8764,18298
2022-08-31 19:30:00+00,17508,897,4657,8690,182,232,2061,660,0,522,35409,235,15590,13529,8872,18405
2022-08-31 20:00:00+00,17419,812,4655,8828,125,224,2060,578,0,48,34749,235,15668,13608,8953,18231
2022-08-31 20:30:00+00,17040,566,4664,9006,119,84,2062,204,0,0,33745,225,15851,13789,9125,17606
2022-08-31 21:00:00+00,16723,523,4668,9166,82,0,2061,171,0,26,33420,221,15977,13916,9248,17246
2022-08-31 21:30:00+00,15643,488,4685,8765,92,0,2059,172,0,40,31944,217,15601,13542,8857,16131
2022-08-31 22:00:00+00,14022,759,4689,8624,92,58,2061,158,0,0,30463,215,15466,13405,8716,14781
2022-08-31 22:30:00+00,13149,839,4686,8431,92,82,2062,156,0,0,29497,214,15271,13209,8523,13988
2022-08-31 23:00:00+00,12840,880,4686,8300,92,9,2061,184,0,0,29052,213,15139,13078,8392,13720
2022-08-31 23:30:00+00,12620,895,4698,8254,92,2,2058,167,0,0,28786,212,15102,13044,8346,13515
2022-09-01 00:00:00+00,12426,823,4700,8138,92,0,2057,148,0,0,28384,210,14987,12930,8230,13249
2022-09-01 00:30:00+00,12341,735,4698,8027,92,14,2060,145,0,0,28112,208,14877,12817,8119,13076
2022-09-01 01:00:00+00,12187,619,4698,7876,91,52,2066,141,0,0,27730,205,14731,12665,7967,12806
2022-09-01 01:30:00+00,12080,492,4690,7654,91,16,2064,150,0,0,27237,203,14499,12435,7745,12572
2022-09-01 02:00:00+00,12166,503,4692,7445,91,16,2064,170,0,0,27147,205,14292,12228,7536,12669
2022-09-01 02:30:00+00,12260,557,4696,7238,91,22,2062,157,0,0,27083,209,14087,12025,7329,12817
2022-09-01 03:00:00+00,12361,761,4705,6905,91,120,2060,144,0,0,27147,218,13761,11701,6996,13122
2022-09-01 03:30:00+00,12665,898,4710,6530,91,150,2029,152,0,0,27225,227,13360,11331,6621,13563
2022-09-01 04:00:00+00,12702,849,4710,6198,91,238,1888,157,0,0,26833,230,12887,10999,6289,13551
2022-09-01 04:30:00+00,13861,829,4715,6063,91,194,1860,144,0,0,27757,238,12729,10869,6154,14690
2022-09-01 05:00:00+00,14912,897,4708,5989,128,412,1860,146,0,0,29052,247,12685,10825,6117,15809
2022-09-01 05:30:00+00,15965,899,4711,5897,126,552,1856,371,101,0,30478,253,12691,10835,6124,16864
2022-09-01 06:00:00+00,16497,900,4715,5927,156,846,1908,590,469,0,32008,254,13175,11267,6552,17397
2022-09-01 06:30:00+00,16624,898,4711,5872,171,764,2047,858,1018,174,33137,248,13819,11772,7061,17522
2022-09-01 07:00:00+00,16741,899,4701,5792,171,1094,2056,796,1625,230,34105,245,14345,12289,7588,17640
2022-09-01 07:30:00+00,16995,900,4702,5739,166,1062,2052,857,2204,232,34909,241,14863,12811,8109,17895
2022-09-01 08:00:00+00,16906,901,4707,5684,141,1154,2050,628,2791,0,34962,236,15373,13323,8616,17807
2022-09-01 08:30:00+00,16858,901,4711,5509,140,1160,2057,472,3539,0,35347,232,15956,13899,9188,17759
2022-09-01 09:00:00+00,16968,900,4729,5451,113,1412,2051,337,4301,0,36262,228,16645,14594,9865,17868
2022-09-01 09:30:00+00,16924,902,4730,5471,94,1414,2054,271,4922,0,36782,223,17271,15217,10487,17826
2022-09-01 10:00:00+00,16931,895,4732,5512,94,1352,2047,267,5381,0,37211,221,17766,15719,10987,17826
2022-09-01 10:30:00+00,16585,905,4728,5682,93,1352,2041,361,5911,0,37658,216,18455,16414,11686,17490
2022-09-01 11:00:00+00,16586,899,4734,5624,93,1774,2054,378,6140,0,38282,215,18645,16591,11857,17485
2022-09-01 11:30:00+00,16607,907,4731,5536,93,1778,2055,350,6286,16,38359,215,18701,16646,11915,17514
2022-09-01 12:00:00+00,16790,900,4764,5525,93,1462,2048,243,6245,0,38070,216,18675,16627,11863,17690
2022-09-01 12:30:00+00,16527,918,4775,5638,93,1454,2049,191,5850,0,37495,217,18405,16356,11581,17445
2022-09-01 13:00:00+00,16275,918,4774,5667,93,1262,2051,192,5617,0,36849,217,18202,16151,11377,17193
2022-09-01 13:30:00+00,16372,918,4776,5694,93,1262,2054,239,4997,0,36405,221,17614,15560,10784,17290
2022-09-01 14:00:00+00,16459,918,4780,5689,93,1404,2056,345,4507,100,36351,223,17125,15069,10289,17377
2022-09-01 14:30:00+00,16620,913,4799,5747,100,1408,2056,489,4019,230,36381,225,16721,14665,9866,17533
2022-09-01 15:00:00+00,17053,872,4807,5854,120,790,2055,735,3432,254,35972,231,16268,14213,9406,17925
2022-09-01 15:30:00+00,17280,843,4806,5798,137,776,2052,913,2796,656,36057,233,15589,13537,8731,18123
2022-09-01 16:00:00+00,17644,866,4814,5825,168,754,2052,1030,2280,882,36315,238,15139,13087,8273,18510
2022-09-01 16:30:00+00,17620,768,4806,5781,198,770,2052,1157,1664,1312,36128,238,14501,12449,7643,18388
2022-09-01 17:00:00+00,17755,764,4808,5675,236,636,2050,1059,980,1302,35265,244,13749,11699,6891,18519
2022-09-01 17:30:00+00,17768,794,4801,5594,254,626,2055,1091,551,1262,34796,249,13255,11200,6399,18562
2022-09-01 18:00:00+00,17761,908,4806,5683,261,436,2059,1114,191,1224,34443,251,13000,10941,6135,18669
2022-09-01 18:30:00+00,17605,915,4801,6159,260,464,2057,1003,6,1196,34466,249,13283,11226,6425,18520
2022-09-01 19:00:00+00,16879,919,4805,6605,223,804,2060,1179,0,1236,34710,244,13693,11633,6828,17798
2022-09-01 19:30:00+00,16630,920,4804,6930,182,826,2061,978,0,962,34293,242,13977,11916,7112,17550
2022-09-01 20:00:00+00,16620,920,4806,7018,166,722,2062,587,0,554,33455,242,14052,11990,7184,17540
2022-09-01 20:30:00+00,16415,920,4809,6878,164,716,2062,496,0,90,32550,245,13913,11851,7042,17335
2022-09-01 21:00:00+00,16466,919,4814,6666,153,444,2062,240,0,202,31966,244,13695,11633,6819,17385
2022-09-01 21:30:00+00,15908,753,4816,6362,142,552,2062,157,0,128,30880,241,13382,11320,6504,16661
2022-09-01 22:00:00+00,16480,506,4821,6052,128,188,2061,167,0,94,30497,242,13062,11001,6180,16986
2022-09-01 22:30:00+00,16429,398,4831,5801,126,82,2062,150,0,0,29879,240,12820,10758,5927,16827
2022-09-01 23:00:00+00,16140,479,4828,5393,114,0,2062,150,0,0,29166,244,12397,10335,5507,16619
2022-09-01 23:30:00+00,15955,459,4829,5172,113,0,2060,173,0,0,28761,244,12174,10114,5285,16414
2022-09-02 00:00:00+00,15647,393,4844,4903,113,0,2059,161,0,0,28120,243,11919,9860,5016,16040
2022-09-02 00:30:00+00,15791,238,4848,4583,113,0,2060,157,0,0,27790,243,11604,9544,4696,16029
2022-09-02 01:00:00+00,15807,230,4854,4236,94,0,2062,161,0,0,27444,246,11246,9184,4330,16037
2022-09-02 01:30:00+00,15771,229,4854,4020,94,0,2060,145,0,0,27173,248,11028,8968,4114,16000
2022-09-02 02:00:00+00,15964,229,4863,3880,94,16,2064,141,0,0,27251,250,10901,8837,3974,16193
2022-09-02 02:30:00+00,15986,229,4871,3751,94,16,2061,152,0,0,27160,251,10777,8716,3845,16215
2022-09-02 03:00:00+00,16034,231,4878,3575,94,16,2063,168,0,0,27059,253,10610,8547,3669,16265
2022-09-02 03:30:00+00,16109,231,4884,3487,94,16,2064,168,0,0,27053,254,10529,8465,3581,16340
2022-09-02 04:00:00+00,16009,233,4897,3474,108,128,2064,390,0,0,27303,255,10543,8479,3582,16242
2022-09-02 04:30:00+00,16067,367,4898,3507,108,278,2061,448,0,0,27734,259,10574,8513,3615,16434
2022-09-02 05:00:00+00,16396,498,4904,3598,114,558,2063,525,0,0,28656,265,10679,8616,3712,16894
2022-09-02 05:30:00+00,17087,497,4911,3629,113,848,2062,672,67,36,29922,269,10782,8720,3809,17584
2022-09-02 06:00:00+00,17176,491,4907,3625,175,818,2059,764,344,396,30755,263,11110,9051,4144,17667
2022-09-02 06:30:00+00,17742,491,4907,3688,177,670,2062,1115,734,390,31976,263,11568,9506,4599,18233
2022-09-02 07:00:00+00,17687,489,4907,3818,177,1364,2060,954,1245,344,33045,260,12207,10147,5240,18176
2022-09-02 07:30:00+00,17911,489,4897,3947,160,1368,2060,1000,1765,342,33939,256,12829,10769,5872,18400
2022-09-02 08:00:00+00,18271,494,4901,4083,149,1702,2060,1055,2323,66,35104,252,13516,11456,6555,18765
2022-09-02 08:30:00+00,18277,498,4901,4282,150,1710,2058,991,2929,0,35796,247,14320,12262,7361,18775
2022-09-02 09:00:00+00,18063,493,4906,4484,115,1918,2057,518,3417,0,35971,239,14979,12922,8016,18556
2022-09-02 09:30:00+00,17960,496,4910,4549,113,1920,2056,572,3897,16,36489,235,15525,13469,8559,18456
2022-09-02 10:00:00+00,17614,499,4920,4872,80,2002,2055,676,4249,0,36967,229,16176,14121,9201,18113
2022-09-02 10:30:00+00,17392,498,4922,5080,79,2002,2056,649,4644,52,37374,224,16781,14725,9803,17890
2022-09-02 11:00:00+00,17420,501,4929,5439,79,1904,2056,651,4847,0,37826,222,17350,15294,10365,17921
2022-09-02 11:30:00+00,17460,496,4920,5658,79,1902,2055,503,4875,90,38038,220,17587,15532,10612,17956
2022-09-02 12:00:00+00,17306,495,4928,5816,79,1740,2077,527,4766,68,37802,220,17666,15589,10661,17801
2022-09-02 12:30:00+00,16795,483,4931,6183,79,1734,2120,604,4579,0,37508,217,17892,15772,10841,17278
2022-09-02 13:00:00+00,16796,488,4933,6504,80,1182,2144,379,4756,0,37262,212,18417,16273,11340,17284
2022-09-02 13:30:00+00,16877,497,4930,6474,79,1204,2169,153,5026,0,37409,211,18678,16509,11579,17374
2022-09-02 14:00:00+00,17133,484,4930,6247,78,1200,2245,154,4235,246,36952,218,17735,15490,10560,17617
2022-09-02 14:30:00+00,17275,494,4934,6119,80,1254,2472,149,3333,0,36110,226,16938,14466,9532,17769
2022-09-02 15:00:00+00,17371,494,4942,6337,97,1192,2653,265,2788,0,36139,228,16817,14164,9222,17865
2022-09-02 15:30:00+00,17481,487,4951,6631,99,1178,2698,459,2245,88,36317,230,16624,13926,8975,17968
2022-09-02 16:00:00+00,16923,460,4995,6855,155,1044,2697,648,1986,310,36073,225,16688,13991,8996,17383
2022-09-02 16:30:00+00,16968,394,5016,7057,206,1028,2696,819,1530,588,36302,224,16505,13809,8793,17362
2022-09-02 17:00:00+00,17616,390,5027,7283,240,872,2698,1003,981,542,36652,228,16229,13531,8504,18006
2022-09-02 17:30:00+00,17269,397,5024,7511,211,870,2691,934,536,726,36169,227,15973,13282,8258,17666
2022-09-02 18:00:00+00,17806,407,5023,7864,208,638,2691,570,117,716,36040,228,15903,13212,8189,18213
2022-09-02 18:30:00+00,17619,483,5021,8362,195,556,2658,545,1,414,35854,228,16237,13579,8558,18102
2022-09-02 19:00:00+00,17301,481,5019,8993,164,354,2624,389,0,400,35725,220,16800,14176,9157,17782
2022-09-02 19:30:00+00,16739,411,5024,9293,145,336,2658,224,0,160,34990,215,17120,14462,9438,17150
2022-09-02 20:00:00+00,16275,394,5027,9795,118,70,2661,154,0,98,34592,208,17601,14940,9913,16669
2022-09-02 20:30:00+00,15202,342,5039,9823,85,50,2663,150,0,92,33446,200,17610,14947,9908,15544
2022-09-02 21:00:00+00,14561,347,5046,9921,81,25,2624,140,0,0,32745,196,17672,15048,10002,14908
2022-09-02 21:30:00+00,13537,462,5053,10243,81,0,2379,182,0,0,31937,191,17756,15377,10324,13999
2022-09-02 22:00:00+00,10952,262,5096,10304,81,232,2023,228,0,0,29178,170,17504,15481,10385,11214
2022-09-02 22:30:00+00,9456,281,5099,10370,81,294,2021,213,0,0,27815,159,17571,15550,10451,9737
2022-09-02 23:00:00+00,8936,330,5103,10284,81,100,2020,199,0,0,27053,154,17488,15468,10365,9266
2022-09-02 23:30:00+00,8941,234,5101,10050,81,32,2020,228,0,0,26687,152,17252,15232,10131,9175
2022-09-03 00:00:00+00,8481,156,5094,10021,81,148,2021,229,0,0,26231,147,17217,15196,10102,8637
2022-09-03 00:30:00+00,8126,78,5096,10168,81,214,2018,229,0,0,26010,142,17363,15345,10249,8204
2022-09-03 01:00:00+00,7969,0,5106,10187,81,76,2018,243,0,0,25680,136,17392,15374,10268,7969
2022-09-03 01:30:00+00,7883,0,5110,9915,81,16,2020,258,0,0,25283,136,17126,15106,9996,7883
2022-09-03 02:00:00+00,8088,0,5115,9800,81,0,2002,258,0,0,25344,138,16998,14996,9881,8088
2022-09-03 02:30:00+00,8147,30,5125,9806,81,0,1796,363,0,0,25348,141,16808,15012,9887,8176
2022-09-03 03:00:00+00,8129,59,5201,9744,81,52,1442,489,0,0,25197,143,16468,15026,9825,8188
2022-09-03 03:30:00+00,7866,206,5218,9802,81,80,1441,543,0,0,25237,145,16542,15101,9883,8072
2022-09-03 04:00:00+00,8045,230,5219,9555,81,284,1442,481,0,0,25337,151,16297,14855,9636,8275
2022-09-03 04:30:00+00,8306,343,5217,9145,81,346,1426,473,0,0,25337,161,15869,14443,9226,8649
2022-09-03 05:00:00+00,8518,428,5229,8783,81,194,1327,564,0,66,25190,166,15420,14093,8864,8946
2022-09-03 05:30:00+00,9260,336,5236,8545,89,358,1388,716,89,10,26027,174,15347,13959,8723,9596
2022-09-03 06:00:00+00,9943,300,5245,8245,170,274,1439,627,397,146,26786,176,15496,14057,8812,10243
2022-09-03 06:30:00+00,10204,299,5255,8012,212,326,1440,773,843,182,27546,178,15762,14322,9067,10503
2022-09-03 07:00:00+00,10123,301,5255,7945,316,1022,1459,771,1313,20,28525,183,16288,14829,9574,10424
2022-09-03 07:30:00+00,10423,300,5252,8056,264,1182,1460,782,1876,0,29595,182,16908,15448,10196,10723
2022-09-03 08:00:00+00,10356,300,5250,8256,157,1876,1461,735,2320,76,30787,175,17444,15983,10733,10656
2022-09-03 08:30:00+00,10501,299,5245,8502,151,1914,1459,777,2765,22,31635,172,18122,16663,11418,10800
2022-09-03 09:00:00+00,10363,299,5247,8671,85,2036,1398,762,3312,0,32173,167,18713,17315,12068,10662
2022-09-03 09:30:00+00,10331,299,5247,8924,84,2034,1407,452,3940,0,32718,160,19602,18195,12948,10630
2022-09-03 10:00:00+00,9985,299,5255,9020,84,2286,1301,495,3993,0,32718,156,19653,18352,13097,10284
2022-09-03 10:30:00+00,9904,300,5248,9103,83,2292,1218,387,4210,0,32745,154,19862,18644,13396,10204
2022-09-03 11:00:00+00,9625,300,5259,9221,81,2360,1160,276,4331,0,32613,151,20052,18892,13633,9925
2022-09-03 11:30:00+00,9495,300,5267,9296,80,2340,1020,315,4232,58,32403,150,19895,18875,13608,9795
2022-09-03 12:00:00+00,9612,301,5270,9233,80,2186,971,377,4114,0,32144,153,19668,18697,13427,9913
2022-09-03 12:30:00+00,9629,299,5277,9231,80,2170,1015,381,3576,0,31658,156,19179,18164,12887,9928
2022-09-03 13:00:00+00,10022,298,5279,9572,80,1568,993,288,3445,0,31545,158,19369,18376,13097,10320
2022-09-03 13:30:00+00,9620,253,5280,9810,80,1578,1031,278,3202,0,31132,154,19403,18372,13092,9873
2022-09-03 14:00:00+00,10555,325,5290,9970,80,650,1058,306,3027,0,31261,157,19425,18367,13077,10880
2022-09-03 14:30:00+00,10779,445,5290,10020,80,602,1230,307,2712,0,31465,163,19332,18102,12812,11224
2022-09-03 15:00:00+00,12036,705,5296,10208,115,360,1429,322,2043,0,32514,180,19091,17662,12366,12741
2022-09-03 15:30:00+00,12900,777,5301,10715,115,252,1445,332,1670,0,33507,188,19246,17801,12500,13677
2022-09-03 16:00:00+00,13859,791,5300,11142,150,236,1431,416,1199,0,34524,192,19222,17791,12491,14650
2022-09-03 16:30:00+00,14001,793,5298,11371,163,302,1412,437,839,0,34616,194,19083,17671,12373,14794
2022-09-03 17:00:00+00,13697,793,5316,11385,217,364,1398,481,559,0,34210,194,18875,17477,12161,14490
2022-09-03 17:30:00+00,13652,794,5366,11540,230,398,1348,361,238,0,33927,194,18722,17374,12008,14446
2022-09-03 18:00:00+00,13506,796,5372,11373,239,292,1295,396,45,0,33314,195,18324,17029,11657,14302
2022-09-03 18:30:00+00,13712,796,5368,11007,246,334,1296,421,0,0,33180,199,17917,16621,11253,14508
2022-09-03 19:00:00+00,13576,878,5351,10810,205,432,1296,424,0,44,33016,202,17662,16366,11015,14454
2022-09-03 19:30:00+00,13589,926,5356,10361,204,298,1299,349,0,0,32382,204,17220,15921,10565,14515
2022-09-03 20:00:00+00,13543,926,5353,9781,105,322,1241,280,0,0,31551,209,16480,15239,9886,14469
2022-09-03 20:30:00+00,13138,928,5358,9345,101,284,1217,297,0,0,30668,209,16021,14804,9446,14066
2022-09-03 21:00:00+00,12929,860,5258,8915,101,396,1219,312,0,72,30062,212,15493,14274,9016,13789
2022-09-03 21:30:00+00,12559,690,5207,8745,102,448,1219,239,0,0,29209,207,15273,14054,8847,13249
2022-09-03 22:00:00+00,12356,581,5208,8642,119,196,1218,405,0,40,28765,201,15187,13969,8761,12937
2022-09-03 22:30:00+00,12048,607,5246,8446,118,58,1213,459,0,8,28203,200,15023,13810,8564,12655
2022-09-03 23:00:00+00,10759,508,5289,8403,99,22,1199,474,0,0,26753,188,14990,13791,8502,11267
2022-09-03 23:30:00+00,9950,631,5340,8232,98,74,1212,437,0,64,26038,185,14882,13670,8330,10581
2022-09-04 00:00:00+00,9284,488,5352,7997,80,0,1215,390,0,28,24834,176,14644,13429,8077,9772
2022-09-04 00:30:00+00,9134,495,5382,7909,80,0,1212,195,0,0,24407,175,14583,13371,7989,9629
2022-09-04 01:00:00+00,9043,479,5384,7870,80,0,1078,176,0,0,24110,174,14412,13334,7950,9522
2022-09-04 01:30:00+00,8759,586,5391,8207,80,0,576,197,0,0,23796,174,14254,13678,8287,9345
2022-09-04 02:00:00+00,8160,550,5390,8471,80,56,545,218,0,0,23470,166,14486,13941,8551,8710
2022-09-04 02:30:00+00,7714,458,5392,8703,80,16,543,157,0,0,23063,156,14718,14175,8783,8172
2022-09-04 03:00:00+00,7175,459,5387,8999,80,76,542,150,0,0,22868,149,15008,14466,9079,7634
2022-09-04 03:30:00+00,6999,460,5388,9271,80,24,544,148,0,0,22914,144,15283,14739,9351,7459
2022-09-04 04:00:00+00,7448,461,5384,9568,80,64,542,169,0,0,23716,148,15574,15032,9648,7909
2022-09-04 04:30:00+00,7436,603,5413,9839,81,16,645,153,0,0,24186,150,15978,15333,9920,8039
2022-09-04 05:00:00+00,8125,660,5430,9945,115,70,789,218,0,0,25352,158,16279,15490,10060,8785
2022-09-04 05:30:00+00,8370,659,5434,9872,116,92,1066,180,30,0,25819,160,16518,15452,10018,9029
2022-09-04 06:00:00+00,8639,660,5439,9944,132,74,1181,157,207,0,26433,161,16903,15722,10283,9299
2022-09-04 06:30:00+00,8831,660,5434,9853,152,56,1188,298,549,0,27021,161,17176,15988,10554,9491
2022-09-04 07:00:00+00,8387,658,5435,9493,220,562,1104,300,876,30,27065,164,17128,16024,10589,9045
2022-09-04 07:30:00+00,9163,746,5435,9422,220,668,1172,240,1246,18,28330,172,17495,16323,10888,9909
2022-09-04 08:00:00+00,8499,649,5439,8611,185,1820,1148,167,1855,70,28443,166,17238,16090,10651,9148
2022-09-04 08:30:00+00,9609,430,5431,7921,156,1892,1190,160,2308,0,29097,171,17006,15816,10385,10039
2022-09-04 09:00:00+00,10093,430,5416,7646,115,2044,1182,230,2730,50,29936,174,17089,15907,10491,10523
2022-09-04 09:30:00+00,10315,430,5412,7320,111,2020,1187,535,3108,0,30438,177,17138,15951,10539,10745
2022-09-04 10:00:00+00,11075,430,5424,7059,111,2050,1300,664,3526,202,31841,182,17420,16120,10696,11505
2022-09-04 10:30:00+00,11147,429,5436,7118,111,2098,1291,597,4076,186,32489,180,18032,16741,11305,11576
2022-09-04 11:00:00+00,10645,429,5437,7068,111,2370,1226,483,4090,0,31859,179,17932,16706,11269,11074
2022-09-04 11:30:00+00,10795,427,5444,6981,113,2530,1192,416,4324,0,32222,179,18054,16862,11418,11222
2022-09-04 12:00:00+00,10261,428,5446,6961,114,2494,1123,421,4345,0,31593,175,17989,16866,11420,10689
2022-09-04 12:30:00+00,10143,430,5447,6780,114,2536,1181,388,4567,0,31586,175,18089,16908,11461,10573
2022-09-04 13:00:00+00,10470,430,5452,6773,114,2608,1202,360,3868,0,31277,181,17409,16207,10755,10900
2022-09-04 13:30:00+00,10352,430,5452,6620,114,2732,1200,298,3472,0,30670,185,16858,15658,10206,10782
2022-09-04 14:00:00+00,11728,436,5457,6522,114,2332,1289,233,3528,30,31669,193,16910,15621,10164,12164
2022-09-04 14:30:00+00,12037,602,5466,6529,130,2266,1340,235,3488,0,32093,200,16953,15613,10147,12639
2022-09-04 15:00:00+00,13785,907,5464,6572,132,748,1345,803,2882,164,32802,215,16395,15050,9586,14692
2022-09-04 15:30:00+00,14278,977,5463,6711,173,748,1347,859,2275,404,33235,221,15969,14622,9159,15255
2022-09-04 16:00:00+00,14716,979,5464,6919,219,748,1351,836,1778,664,33674,224,15731,14380,8916,15695
2022-09-04 16:30:00+00,15005,976,5461,7395,229,748,1363,835,1305,746,34063,225,15753,14390,8929,15981
2022-09-04 17:00:00+00,14493,978,5468,7483,269,750,1348,826,815,1066,33496,223,15383,14035,8567,15471
2022-09-04 17:30:00+00,14194,976,5470,7835,286,748,1365,796,347,1080,33097,221,15303,13938,8468,15170
2022-09-04 18:00:00+00,13993,975,5472,8554,256,748,1364,785,70,858,33075,218,15716,14352,8880,14968
2022-09-04 18:30:00+00,13731,909,5468,8964,255,748,1365,798,0,814,33052,213,16052,14687,9219,14640
2022-09-04 19:00:00+00,13586,867,5475,9507,189,748,1366,742,0,780,33260,208,16537,15171,9696,14453
2022-09-04 19:30:00+00,13276,805,5476,10006,188,736,1364,552,0,300,32703,204,17034,15670,10194,14081
2022-09-04 20:00:00+00,12947,722,5474,10485,172,600,1365,455,0,14,32234,197,17496,16131,10657,13669
2022-09-04 20:30:00+00,11841,361,5475,11029,172,356,1320,413,0,0,30967,176,17996,16676,11201,12202
2022-09-04 21:00:00+00,11139,230,5470,11230,130,400,1220,289,0,0,30108,167,18050,16830,11360,11369
2022-09-04 21:30:00+00,10271,211,5474,11261,120,388,1177,223,0,0,29125,159,18032,16855,11381,10482
2022-09-04 22:00:00+00,9648,1,5474,11202,102,430,1172,216,0,0,28245,149,17950,16778,11304,9649
2022-09-04 22:30:00+00,8813,0,5475,11136,102,374,1300,219,0,0,27419,141,18013,16713,11238,8813
2022-09-04 23:00:00+00,8161,0,5474,11360,101,384,1264,192,0,0,26936,134,18199,16935,11461,8161
2022-09-04 23:30:00+00,7727,0,5474,11658,82,290,1214,170,0,0,26614,127,18428,17214,11740,7727
2022-09-05 00:00:00+00,7288,0,5480,12341,80,254,1184,167,0,0,26794,119,19085,17901,12421,7288
2022-09-05 00:30:00+00,6775,0,5475,12902,80,256,1006,158,0,0,26652,111,19463,18457,12982,6775
2022-09-05 01:00:00+00,6232,0,5471,13219,80,258,1051,168,0,0,26479,104,19821,18770,13299,6232
2022-09-05 01:30:00+00,5896,0,5470,13477,80,244,1069,146,0,0,26382,99,20096,19027,13557,5896
2022-09-05 02:00:00+00,5813,0,5467,13852,80,278,1094,138,0,0,26722,97,20493,19399,13932,5813
2022-09-05 02:30:00+00,5805,0,5462,13898,80,242,1171,147,0,0,26805,96,20611,19440,13978,5805
2022-09-05 03:00:00+00,6647,0,5474,12916,80,152,1395,153,0,0,26817,109,19865,18470,12996,6647
2022-09-05 03:30:00+00,7702,2,5487,11877,122,132,1389,146,0,0,26857,123,18875,17486,11999,7704
2022-09-05 04:00:00+00,8599,143,5479,11311,138,46,1461,153,0,0,27330,138,18389,16928,11449,8742
2022-09-05 04:30:00+00,9380,267,5472,11264,143,198,1457,179,0,0,28360,151,18336,16879,11407,9647
2022-09-05 05:00:00+00,10918,579,5462,10724,193,218,1677,204,0,84,30059,173,18056,16379,10917,11497
2022-09-05 05:30:00+00,12532,766,5466,9969,196,194,1918,348,53,40,31482,193,17602,15684,10218,13298
2022-09-05 06:00:00+00,13878,798,5471,9436,269,42,2020,537,438,0,32889,203,17634,15614,10143,14676
2022-09-05 06:30:00+00,14543,799,5472,8873,282,146,2020,662,1116,218,34131,206,17763,15743,10271,15342
2022-09-05 07:00:00+00,14757,669,5473,7944,289,422,1929,630,1924,50,34087,207,17559,15630,10157,15426
2022-09-05 07:30:00+00,14796,780,5478,7566,297,514,2023,579,2680,0,34713,208,18044,16021,10543,15576
2022-09-05 08:00:00+00,14708,794,5474,7690,227,926,2021,526,3434,0,35800,204,18846,16825,11351,15502
2022-09-05 08:30:00+00,14631,760,5475,7683,208,1102,1852,504,4108,0,36323,201,19326,17474,11999,15391
2022-09-05 09:00:00+00,14830,799,5468,7331,200,946,1831,435,4517,220,36577,202,19347,17516,12048,15629
2022-09-05 09:30:00+00,14975,798,5472,6966,183,1084,1833,399,5092,174,36976,203,19546,17713,12241,15773
2022-09-05 10:00:00+00,14914,800,5462,7071,165,1524,1831,374,5247,200,37588,204,19776,17945,12483,15714
2022-09-05 10:30:00+00,14960,799,5449,6958,167,1606,1831,301,5159,300,37530,205,19564,17733,12284,15759
2022-09-05 11:00:00+00,15153,800,5451,6382,207,1878,1834,266,4667,380,37018,213,18541,16707,11256,15953
2022-09-05 11:30:00+00,15232,800,5452,6034,183,1912,1834,378,4387,374,36586,217,17890,16056,10604,16032
2022-09-05 12:00:00+00,15426,900,5454,5892,178,2070,1829,356,4446,312,36863,222,17799,15970,10516,16326
2022-09-05 12:30:00+00,15251,937,5453,6151,137,2010,1830,310,4628,152,36859,220,18199,16369,10916,16188
2022-09-05 13:00:00+00,15118,992,5456,6394,161,1652,1829,351,4429,298,36680,218,18269,16440,10984,16110
2022-09-05 13:30:00+00,15110,1016,5451,6260,152,1574,1934,394,3857,382,36130,221,17654,15720,10269,16126
2022-09-05 14:00:00+00,15757,1089,5455,6139,169,984,1994,527,3244,332,35690,227,17001,15007,9552,16846
2022-09-05 14:30:00+00,16044,1237,5458,6091,196,896,1971,572,3062,344,35871,232,16778,14807,9349,17281
2022-09-05 15:00:00+00,16376,1388,5452,5725,254,746,1984,778,2576,328,35607,242,15991,14007,8555,17764
2022-09-05 15:30:00+00,16534,1469,5449,5874,306,596,1984,1020,2031,336,35599,247,15644,13660,8211,18003
2022-09-05 16:00:00+00,16646,1447,5468,6489,355,520,1978,1027,1841,648,36419,241,16131,14153,8685,18093
2022-09-05 16:30:00+00,16784,1447,5466,6874,330,520,2003,1091,1270,836,36621,241,15943,13940,8474,18231
2022-09-05 17:00:00+00,17126,1460,5463,6729,303,580,2012,1081,840,886,36480,247,15347,13335,7872,18586
2022-09-05 17:30:00+00,16980,1424,5465,6933,305,726,2006,1025,401,732,35997,249,15110,13104,7639,18404
2022-09-05 18:00:00+00,17044,1455,5461,7222,308,748,2011,901,98,776,36024,249,15100,13089,7628,18499
2022-09-05 18:30:00+00,17032,1438,5463,7538,251,748,2012,886,0,718,36086,248,15264,13252,7789,18470
2022-09-05 19:00:00+00,17001,1308,5461,7831,232,748,2011,795,0,738,36125,244,15535,13524,8063,18309
2022-09-05 19:30:00+00,16988,991,5463,7784,220,732,2014,586,0,420,35198,239,15481,13467,8004,17979
2022-09-05 20:00:00+00,16921,980,5462,7720,193,734,1526,339,0,334,34209,240,14901,13375,7913,17901
2022-09-05 20:30:00+00,16351,867,5467,8066,167,640,1379,214,0,0,33151,235,15079,13700,8233,17218
2022-09-05 21:00:00+00,15130,721,5468,8881,111,726,1382,174,0,0,32593,221,15842,14460,8992,15851
2022-09-05 21:30:00+00,13919,500,5471,9212,110,748,1367,185,0,0,31512,207,16160,14793,9322,14419
2022-09-05 22:00:00+00,11536,500,5467,10111,95,676,1288,180,0,0,29853,185,16961,15673,10206,12036
2022-09-05 22:30:00+00,10799,496,5470,10077,96,592,1211,163,0,0,28904,179,16854,15643,10173,11295
2022-09-05 23:00:00+00,9581,494,5472,10450,91,482,1339,166,0,0,28075,166,17352,16013,10541,10075
2022-09-05 23:30:00+00,8956,400,5470,10392,92,542,1424,165,0,0,27441,159,17378,15954,10484,9356
2022-09-06 00:00:00+00,8826,245,5461,9719,92,572,1489,179,0,0,26583,157,16761,15272,9811,9071
2022-09-06 00:30:00+00,9382,292,5467,9043,92,648,1387,166,0,0,26477,168,15989,14602,9135,9674
2022-09-06 01:00:00+00,8863,336,5466,9076,91,570,1408,164,0,0,25974,164,16041,14633,9167,9199
2022-09-06 01:30:00+00,9094,333,5462,8460,91,518,1412,179,0,0,25549,170,15425,14013,8551,9427
2022-09-06 02:00:00+00,10402,428,5455,6997,90,586,1410,165,0,0,25533,195,13952,12542,7087,10830
2022-09-06 02:30:00+00,10676,500,5448,6608,86,512,1383,279,0,0,25492,203,13525,12142,6694,11176
2022-09-06 03:00:00+00,10977,500,5444,6650,84,606,1382,417,0,0,26060,206,13560,12178,6734,11477
2022-09-06 03:30:00+00,11416,501,5445,5993,84,578,1396,368,0,0,25781,214,12918,11522,6077,11917
2022-09-06 04:00:00+00,12456,640,5444,5809,84,408,1401,256,0,92,26590,224,12738,11337,5893,13096
2022-09-06 04:30:00+00,13315,858,5450,5627,83,496,1404,190,0,8,27431,237,12564,11160,5710,14173
2022-09-06 05:00:00+00,14582,1090,5448,5808,147,390,1406,329,0,264,29464,246,12809,11403,5955,15672
2022-09-06 05:30:00+00,15850,1360,5450,6168,155,406,1430,344,73,290,31526,255,13276,11846,6396,17210
2022-09-06 06:00:00+00,16363,1465,5447,6054,212,630,1433,605,337,700,33246,256,13483,12050,6603,17828
2022-09-06 06:30:00+00,16747,1477,5453,6394,213,610,1425,945,839,322,34425,254,14324,12899,7446,18224
2022-09-06 07:00:00+00,16455,1473,5454,6999,181,520,1434,779,1230,398,34923,244,15298,13864,8410,17928
2022-09-06 07:30:00+00,16450,1477,5454,7247,160,520,1424,760,1380,380,35252,241,15665,14241,8787,17927
2022-09-06 08:00:00+00,16370,1476,5462,7635,92,918,1430,585,1731,196,35895,236,16350,14920,9458,17846
2022-09-06 08:30:00+00,16304,1476,5461,8017,90,1036,1424,487,2008,4,36307,233,17000,15576,10115,17780
2022-09-06 09:00:00+00,16022,1237,5449,7961,58,2056,1307,193,2449,168,36900,227,17224,15917,10468,17259
2022-09-06 09:30:00+00,16355,1105,5446,7976,55,2178,1260,117,2723,70,37285,226,17460,16200,10754,17460
2022-09-06 10:00:00+00,16104,864,5446,7891,55,2668,1273,118,3405,0,37824,221,18070,16797,11351,16968
2022-09-06 10:30:00+00,16246,716,5445,7768,55,2668,1204,114,3907,0,38123,217,18379,17175,11730,16962
2022-09-06 11:00:00+00,15670,755,5447,7743,55,2714,1158,115,4168,0,37825,213,18571,17413,11966,16425
2022-09-06 11:30:00+00,15293,783,5440,7997,55,2596,1180,116,3756,0,37216,212,18428,17248,11808,16076
2022-09-06 12:00:00+00,15532,725,5442,8031,55,1924,1282,115,4307,0,37413,207,19117,17835,12393,16257
2022-09-06 12:30:00+00,15458,695,5444,7886,58,1784,1191,113,4500,0,37129,205,19079,17888,12444,16153
2022-09-06 13:00:00+00,16210,706,5435,7602,55,1148,1228,119,4654,0,37157,209,18974,17746,12311,16916
2022-09-06 13:30:00+00,15991,791,5439,7626,56,1152,1282,112,4710,0,37159,210,19113,17831,12392,16782
2022-09-06 14:00:00+00,16614,967,5432,7357,74,804,1281,123,4407,104,37163,216,18551,17270,11838,17581
2022-09-06 14:30:00+00,17016,1026,5440,7614,75,804,1310,120,3598,28,37031,222,18037,16727,11287,18042
2022-09-06 15:00:00+00,17271,1116,5441,7559,91,804,1313,551,2838,222,37206,230,17242,15929,10488,18387
2022-09-06 15:30:00+00,17357,1235,5449,7573,109,816,1311,795,2478,452,37575,235,16920,15609,10160,18592
2022-09-06 16:00:00+00,16730,1413,5449,8690,176,724,1341,909,1429,740,37601,233,17085,15744,10295,18143
2022-09-06 16:30:00+00,17151,1340,5446,8585,162,594,1341,953,902,1218,37692,234,16436,15095,9649,18491
2022-09-06 17:00:00+00,17050,1190,5455,8829,176,580,1341,911,569,1230,37331,231,16370,15029,9574,18240
2022-09-06 17:30:00+00,16668,1040,5447,9585,176,714,1328,820,259,1126,37163,225,16795,15467,10020,17708
2022-09-06 18:00:00+00,17471,1115,5447,9420,159,614,1331,787,59,1278,37681,229,16416,15085,9638,18586
2022-09-06 18:30:00+00,17501,1324,5437,9287,149,468,1331,762,0,1000,37259,235,16204,14873,9436,18825
2022-09-06 19:00:00+00,17143,1293,5434,9192,133,458,1326,725,0,1144,36848,233,16085,14759,9325,18436
2022-09-06 19:30:00+00,17013,1101,5434,9179,80,218,1324,688,0,824,35861,230,16017,14693,9259,18114
2022-09-06 20:00:00+00,16438,972,5439,8792,73,264,1326,558,0,626,34488,228,15630,14304,8865,17410
2022-09-06 20:30:00+00,15563,979,5436,8648,93,36,1333,399,0,354,32841,224,15510,14177,8741,16542
2022-09-06 21:00:00+00,15327,844,5445,8959,78,0,1388,296,0,320,32657,217,15870,14482,9037,16171
2022-09-06 21:30:00+00,14642,523,5445,9595,74,0,1393,177,0,0,31849,203,16507,15114,9669,15165
2022-09-06 22:00:00+00,13719,367,5445,9231,74,0,1390,167,0,0,30393,196,16140,14750,9305,14086
2022-09-06 22:30:00+00,12834,300,5445,8667,75,0,1393,164,0,0,28878,192,15580,14187,8742,13134
2022-09-06 23:00:00+00,13231,475,5453,7722,77,0,1390,166,0,0,28514,206,14642,13252,7799,13706
2022-09-06 23:30:00+00,13256,495,5451,7392,77,0,1390,171,0,0,28232,209,14310,12920,7469,13751
2022-09-07 00:00:00+00,12833,490,5456,7332,76,0,1387,163,0,0,27737,207,14251,12864,7408,13323
2022-09-07 00:30:00+00,12470,480,5452,7348,58,22,1387,177,0,0,27394,204,14245,12858,7406,12950
2022-09-07 01:00:00+00,11578,479,5453,7892,58,32,1386,183,0,0,27061,194,14789,13403,7950,12057
2022-09-07 01:30:00+00,11522,484,5446,7656,58,16,1389,209,0,0,26780,195,14549,13160,7714,12006
2022-09-07 02:00:00+00,11534,493,5451,7850,58,38,1388,191,0,0,27003,194,14747,13359,7908,12027
2022-09-07 02:30:00+00,11062,485,5453,8352,59,16,1390,170,0,0,26987,187,15254,13864,8411,11547
2022-09-07 03:00:00+00,10826,346,5436,8388,59,74,1391,179,0,0,26699,182,15274,13883,8447,11172
2022-09-07 03:30:00+00,11290,389,5438,7961,59,82,1307,177,0,0,26703,190,14765,13458,8020,11679
2022-09-07 04:00:00+00,11844,367,5440,8134,78,222,1254,171,0,0,27510,194,14906,13652,8212,12211
2022-09-07 04:30:00+00,12710,338,5439,8087,81,260,1293,180,0,0,28388,200,14900,13607,8168,13048
2022-09-07 05:00:00+00,14074,377,5438,7936,101,272,1339,179,0,0,29716,210,14814,13475,8037,14451
2022-09-07 05:30:00+00,15448,400,5443,8022,109,326,1388,309,32,0,31477,219,14994,13606,8163,15848
2022-09-07 06:00:00+00,16749,691,5443,8093,166,550,1387,528,311,62,33980,231,15400,14013,8570,17440
2022-09-07 06:30:00+00,17545,908,5448,7978,165,534,1386,672,947,0,35583,236,15924,14538,9090,18453
2022-09-07 07:00:00+00,17598,915,5453,8003,164,400,1387,871,1686,0,36477,231,16693,15306,9853,18513
2022-09-07 07:30:00+00,17329,918,5452,8024,151,358,1386,878,2467,0,36963,225,17480,16094,10642,18247
2022-09-07 08:00:00+00,17514,941,5449,7217,121,276,1388,610,3126,180,36822,225,17301,15913,10464,18455
2022-09-07 08:30:00+00,17467,941,5458,7022,116,336,1389,663,3937,22,37351,223,17922,16533,11075,18408
2022-09-07 09:00:00+00,17233,834,5446,7315,102,404,1371,635,4505,0,37845,216,18739,17368,11922,18067
2022-09-07 09:30:00+00,17228,745,5437,7249,95,568,1390,296,5146,0,38154,210,19317,17927,12490,17973
2022-09-07 10:00:00+00,16701,766,5449,7510,78,626,1407,164,5435,0,38136,205,19879,18472,13023,17467
2022-09-07 10:30:00+00,16698,574,5445,7145,79,589,1407,172,5571,0,37680,202,19647,18240,12795,17272
2022-09-07 11:00:00+00,17069,591,5441,6806,77,504,1404,178,5799,0,37869,204,19527,18123,12682,17660
2022-09-07 11:30:00+00,16893,624,5436,6715,82,474,1408,180,5445,0,37257,206,19086,17678,12242,17517
2022-09-07 12:00:00+00,16961,653,5438,6680,83,406,1501,298,5800,60,37880,205,19502,18001,12563,17614
2022-09-07 12:30:00+00,16908,566,5440,7184,83,400,1561,300,5739,0,38181,200,20007,18446,13006,17474
2022-09-07 13:00:00+00,17404,471,5432,7240,89,444,1760,175,5396,0,38411,202,19917,18157,12725,17875
2022-09-07 13:30:00+00,17262,571,5431,7193,93,476,1903,274,4799,0,38002,207,19419,17516,12085,17833
2022-09-07 14:00:00+00,17281,686,5434,6916,107,544,1917,251,4316,18,37470,215,18690,16773,11339,17967
2022-09-07 14:30:00+00,17669,812,5430,6808,124,588,1927,350,3912,0,37620,222,18201,16274,10844,18481
2022-09-07 15:00:00+00,18169,1121,5438,7264,207,500,1928,465,3472,522,39086,227,18309,16381,10943,19290
2022-09-07 15:30:00+00,18269,1148,5426,7364,209,448,1928,622,2991,754,39159,229,17918,15990,10564,19417
2022-09-07 16:00:00+00,18369,984,5439,6769,193,318,1964,661,2127,1034,37858,234,16492,14528,9089,19353
2022-09-07 16:30:00+00,18328,1048,5438,6903,200,316,1966,807,1429,1212,37647,237,15936,13970,8532,19376
2022-09-07 17:00:00+00,18377,1072,5435,6352,255,336,1975,828,880,1422,36932,243,14897,12922,7487,19449
2022-09-07 17:30:00+00,18831,1192,5438,5752,272,338,1981,837,383,1458,36482,256,13826,11845,6407,20023
2022-09-07 18:00:00+00,18735,1017,5443,5780,237,590,1981,1045,65,1312,36205,257,13506,11525,6082,19752
2022-09-07 18:30:00+00,18658,1032,5431,5415,179,680,1982,1041,0,1428,35846,260,13007,11025,5594,19690
2022-09-07 19:00:00+00,19312,1011,5438,5538,232,552,1981,1061,0,1358,36483,261,13189,11208,5770,20323
2022-09-07 19:30:00+00,19230,1023,5432,5569,214,570,1982,913,0,966,35899,263,13197,11215,5783,20253
2022-09-07 20:00:00+00,18722,1055,5423,5701,141,542,1985,786,0,684,35039,261,13250,11265,5842,19777
2022-09-07 20:30:00+00,18390,990,5422,5561,120,542,1981,626,0,452,34084,260,13084,11103,5681,19380
2022-09-07 21:00:00+00,17826,871,5425,5872,89,556,1986,489,0,0,33114,256,13372,11386,5961,18697
2022-09-07 21:30:00+00,17133,549,5430,6024,89,344,1991,306,0,0,31866,244,13534,11543,6113,17682
2022-09-07 22:00:00+00,16226,254,5433,6518,89,120,1856,274,0,0,30770,227,13896,12040,6607,16480
2022-09-07 22:30:00+00,16086,243,5426,6107,89,0,1630,285,0,0,29866,230,13252,11622,6196,16329
2022-09-07 23:00:00+00,16462,269,5431,5475,89,0,1695,289,0,0,29710,237,12690,10995,5564,16731
2022-09-07 23:30:00+00,16493,425,5437,4972,89,0,1736,295,0,0,29447,245,12234,10498,5061,16918
2022-09-08 00:00:00+00,16081,452,5458,4857,89,0,1630,312,0,0,28879,244,12034,10404,4946,16533
2022-09-08 00:30:00+00,15762,450,5453,5217,89,0,1623,270,0,0,28864,240,12382,10759,5306,16212
2022-09-08 01:00:00+00,15664,450,5441,4855,89,0,1633,275,0,0,28407,242,12018,10385,4944,16114
2022-09-08 01:30:00+00,15461,324,5446,4970,88,0,1617,299,0,0,28205,237,12121,10504,5058,15785
2022-09-08 02:00:00+00,15048,235,5438,5070,88,0,1630,269,0,0,27778,232,12226,10596,5158,15283
2022-09-08 02:30:00+00,15182,248,5438,4961,88,0,1643,284,0,0,27844,234,12130,10487,5049,15430
2022-09-08 03:00:00+00,15337,259,5443,4854,87,0,1627,271,0,0,27878,236,12011,10384,4941,15596
2022-09-08 03:30:00+00,15208,276,5441,4845,89,0,1681,273,0,0,27813,235,12056,10375,4934,15484
2022-09-08 04:00:00+00,15846,282,5437,4740,103,0,1685,267,0,0,28360,240,11965,10280,4843,16128
2022-09-08 04:30:00+00,16183,348,5440,5394,103,0,1657,266,0,0,29391,238,12594,10937,5497,16531
2022-09-08 05:00:00+00,17067,615,5436,5245,102,160,1682,289,0,0,30596,251,12465,10783,5347,17682
2022-09-08 05:30:00+00,17960,847,5439,4610,100,432,1839,274,15,130,31646,267,12003,10164,4725,18807
2022-09-08 06:00:00+00,18732,1070,5439,4510,134,610,1997,322,168,398,33380,274,12248,10250,4812,19802
2022-09-08 06:30:00+00,18949,1284,5436,4368,175,490,2002,709,453,534,34400,276,12434,10432,4996,20233
2022-09-08 07:00:00+00,18780,1257,5444,4525,197,640,2001,718,906,84,34552,270,13073,11072,5628,20037
2022-09-08 07:30:00+00,18701,1154,5447,4467,185,628,2001,729,1549,134,34995,263,13649,11648,6201,19855
2022-09-08 08:00:00+00,18185,1090,5439,4616,210,304,2002,596,2283,200,34925,251,14550,12548,7109,19275
2022-09-08 08:30:00+00,18035,1090,5446,4492,212,303,2013,448,2867,388,35294,245,15030,13016,7570,19125
2022-09-08 09:00:00+00,18083,1094,5421,4467,181,248,2020,377,3423,350,35664,243,15512,13492,8071,19177
2022-09-08 09:30:00+00,17933,1099,5415,4433,188,258,2013,341,3408,360,35448,242,15457,13444,8029,19032
2022-09-08 10:00:00+00,17216,1074,5422,4675,149,1104,2067,342,3487,262,35798,234,15800,13733,8311,18290
2022-09-08 10:30:00+00,17212,1123,5424,4633,138,1122,2046,419,4085,144,36346,232,16326,14280,8856,18335
2022-09-08 11:00:00+00,16460,956,5419,4457,136,1838,2018,269,4192,170,35915,231,16222,14204,8785,17416
2022-09-08 11:30:00+00,16226,931,5421,5024,120,1918,2020,225,4111,32,36028,227,16696,14676,9255,17157
2022-09-08 12:00:00+00,16719,935,5417,5108,126,1314,2017,183,3831,0,35650,229,16499,14482,9065,17654
2022-09-08 12:30:00+00,16702,933,5411,5115,123,1312,2022,173,3654,78,35523,230,16325,14303,8892,17635
2022-09-08 13:00:00+00,17304,926,5419,5269,126,1196,2014,195,3307,14,35770,237,16135,14121,8702,18230
2022-09-08 13:30:00+00,16835,998,5417,5827,123,1226,2015,175,2907,0,35523,236,16289,14274,8857,17833
2022-09-08 14:00:00+00,17082,1083,5413,6170,119,762,2018,172,2881,0,35700,235,16601,14583,9170,18165
2022-09-08 14:30:00+00,17397,1126,5412,6333,129,738,2013,174,2547,60,35929,237,16434,14421,9009,18523
2022-09-08 15:00:00+00,17288,1253,5417,6195,152,624,1975,563,2365,516,36348,238,16104,14129,8712,18541
2022-09-08 15:30:00+00,17179,1335,5416,6378,169,510,2010,609,1910,492,36008,240,15883,13873,8457,18514
2022-09-08 16:00:00+00,17776,1377,5413,6550,227,172,2005,782,1646,1140,37088,240,15841,13836,8423,19153
2022-09-08 16:30:00+00,17992,1378,5423,6682,257,116,1999,855,1144,1188,37034,243,15505,13506,8083,19370
2022-09-08 17:00:00+00,17663,1377,5423,6754,293,164,1997,885,719,1188,36463,243,15186,13189,7766,19040
2022-09-08 17:30:00+00,17314,1374,5422,6909,271,164,1995,875,319,1018,35661,245,14916,12921,7499,18688
2022-09-08 18:00:00+00,17957,1379,5413,6707,269,90,1956,777,57,1296,35901,249,14402,12446,7033,19336
2022-09-08 18:30:00+00,18313,1366,5415,6730,268,88,2004,999,0,1168,36351,252,14417,12413,6998,19679
2022-09-08 19:00:00+00,18436,1432,5409,6806,223,48,2011,1119,0,1014,36498,255,14449,12438,7029,19868
2022-09-08 19:30:00+00,17987,1468,5415,6891,172,48,2011,913,0,926,35831,253,14489,12478,7063,19455
2022-09-08 20:00:00+00,17761,1471,5409,7010,116,82,1971,762,0,866,35448,252,14506,12535,7126,19232
2022-09-08 20:30:00+00,17355,1376,5403,7006,89,90,2023,599,0,310,34251,251,14521,12498,7095,18731
2022-09-08 21:00:00+00,16589,1211,5405,6808,88,186,2017,451,0,0,32755,248,14318,12301,6896,17800
2022-09-08 21:30:00+00,15575,1209,5402,6663,78,40,2012,315,0,0,31294,244,14155,12143,6741,16784
2022-09-08 22:00:00+00,14185,1240,5406,6540,76,160,2013,412,0,0,30032,239,14035,12022,6616,15425
2022-09-08 22:30:00+00,13558,1235,5408,6380,65,340,2013,339,0,0,29338,239,13866,11853,6445,14793
2022-09-08 23:00:00+00,13325,1153,5409,6504,64,116,2014,314,0,0,28899,233,13991,11977,6568,14478
2022-09-08 23:30:00+00,12920,978,5412,6509,63,0,2014,318,0,0,28214,225,13998,11984,6572,13898
2022-09-09 00:00:00+00,11570,979,5412,6388,63,0,2012,328,0,0,26752,217,13875,11863,6451,12549
2022-09-09 00:30:00+00,11463,975,5419,6303,63,0,2013,317,0,0,26553,217,13798,11785,6366,12438
2022-09-09 01:00:00+00,11095,979,5424,6353,63,2,1997,323,0,0,26236,214,13837,11840,6416,12074
2022-09-09 01:30:00+00,10974,976,5423,6091,64,16,2012,317,0,0,25873,216,13590,11578,6155,11950
2022-09-09 02:00:00+00,11648,974,5422,5911,64,76,2009,317,0,0,26421,223,13406,11397,5975,12622
2022-09-09 02:30:00+00,11612,976,5426,6019,64,166,2012,320,0,0,26595,223,13521,11509,6083,12588
2022-09-09 03:00:00+00,12045,977,5418,5895,64,442,2008,321,0,0,27170,229,13385,11377,5959,13022
2022-09-09 03:30:00+00,12101,978,5422,5856,64,504,2008,323,0,0,27256,230,13350,11342,5920,13079
2022-09-09 04:00:00+00,12637,976,5420,5916,64,604,2002,319,0,0,27938,234,13402,11400,5980,13613
2022-09-09 04:30:00+00,13641,974,5417,5726,66,580,2012,318,0,0,28734,241,13221,11209,5792,14615
2022-09-09 05:00:00+00,14999,971,5417,5608,118,440,1997,324,0,0,29874,247,13140,11143,5726,15970
2022-09-09 05:30:00+00,16244,975,5416,5319,152,336,2011,358,6,254,31071,252,12904,10893,5477,17219
2022-09-09 06:00:00+00,17322,976,5419,5093,256,160,2011,565,158,300,32260,256,12937,10926,5507,18298
2022-09-09 06:30:00+00,17587,974,5418,5071,271,108,2008,839,436,382,33094,254,13204,11196,5778,18561
2022-09-09 07:00:00+00,17942,975,5414,5024,271,16,2009,694,814,456,33615,252,13532,11523,6109,18917
2022-09-09 07:30:00+00,17998,973,5416,5184,278,0,2010,744,1339,380,34322,248,14227,12217,6801,18971
2022-09-09 08:00:00+00,17972,972,5414,5373,211,132,2007,430,1720,334,34565,244,14725,12718,7304,18944
2022-09-09 08:30:00+00,17873,971,5422,5635,187,132,2009,378,2191,212,35010,240,15444,13435,8013,18844
2022-09-09 09:00:00+00,17768,972,5401,5954,126,88,2008,325,2896,104,35642,233,16385,14377,8976,18740
2022-09-09 09:30:00+00,17289,975,5406,6451,121,44,2008,282,3036,0,35612,227,17022,15014,9608,18264
2022-09-09 10:00:00+00,17189,971,5405,6757,121,0,2005,175,3423,0,36046,221,17711,15706,10301,18160
2022-09-09 10:30:00+00,16589,973,5411,7171,122,0,2005,165,3865,0,36301,213,18574,16569,11158,17562
2022-09-09 11:00:00+00,16595,974,5407,7315,99,0,2006,167,3743,0,36306,213,18570,16564,11157,17569
2022-09-09 11:30:00+00,15947,975,5412,7615,102,0,1989,168,4183,0,36391,206,19301,17312,11900,16922
2022-09-09 12:00:00+00,15987,973,5402,7853,84,0,1963,167,4215,0,36644,205,19517,17554,12152,16960
2022-09-09 12:30:00+00,15365,973,5394,8050,94,0,1999,171,4140,0,36186,201,19677,17678,12284,16338
2022-09-09 13:00:00+00,15828,969,5399,7778,98,0,1998,172,4691,0,36933,201,19964,17966,12567,16797
2022-09-09 13:30:00+00,15932,973,5396,7879,98,0,2004,174,4582,0,37038,202,19959,17955,12559,16905
2022-09-09 14:00:00+00,16370,970,5372,7909,115,0,2004,182,3506,0,36428,210,18906,16902,11530,17340
2022-09-09 14:30:00+00,17080,975,5337,7836,110,38,2020,181,3283,4,36864,216,18586,16566,11229,18055
2022-09-09 15:00:00+00,17318,1039,5341,7982,155,0,2030,195,2924,16,37000,219,18432,16402,11061,18357
2022-09-09 15:30:00+00,17999,1288,5331,7998,183,0,2025,209,2534,0,37567,229,18071,16046,10715,19287
2022-09-09 16:00:00+00,18722,1440,5331,7675,231,0,2017,265,1982,298,37961,238,17236,15219,9888,20162
2022-09-09 16:30:00+00,18746,1461,5334,7247,271,0,2019,459,1339,626,37502,244,16210,14191,8857,20207
2022-09-09 17:00:00+00,18578,1464,5338,7037,278,0,2019,493,902,830,36939,246,15574,13555,8217,20042
2022-09-09 17:30:00+00,18971,1460,5344,6862,286,0,2019,837,400,678,36857,253,14911,12892,7548,20431
2022-09-09 18:00:00+00,18515,1468,5341,6846,257,0,2007,858,67,838,36197,253,14518,12511,7170,19983
2022-09-09 18:30:00+00,19056,1465,5339,6570,236,0,1968,649,0,744,36027,259,14113,12145,6806,20521
2022-09-09 19:00:00+00,18989,1469,5326,6568,199,0,1953,544,0,534,35582,260,14046,12093,6767,20458
2022-09-09 19:30:00+00,18645,1468,5308,6569,173,0,1954,300,0,396,34813,260,14004,12050,6742,20113
2022-09-09 20:00:00+00,18178,1476,5301,6175,154,14,1954,242,0,46,33540,264,13584,11630,6329,19654
2022-09-09 20:30:00+00,17278,1313,5282,6184,143,16,1944,174,0,0,32334,258,13553,11609,6327,18591
2022-09-09 21:00:00+00,16625,992,5265,6045,104,136,1999,122,0,14,31302,250,13413,11414,6149,17617
2022-09-09 21:30:00+00,15149,983,5246,6012,104,220,2009,127,0,26,29876,243,13371,11362,6116,16132
2022-09-09 22:00:00+00,13954,981,5233,5838,102,246,2007,159,0,0,28520,239,13180,11173,5940,14935
2022-09-09 22:30:00+00,13155,977,5220,5609,100,258,2000,159,0,0,27478,237,12929,10929,5709,14132
2022-09-09 23:00:00+00,13256,981,5216,5258,100,176,2001,134,0,0,27122,240,12575,10574,5358,14237
2022-09-09 23:30:00+00,12843,969,5199,5173,100,178,2005,123,0,0,26590,238,12477,10472,5273,13812
2022-09-10 00:00:00+00,12956,960,5198,5159,99,154,2015,121,0,0,26662,238,12471,10456,5258,13916
2022-09-10 00:30:00+00,12998,957,5194,4892,98,182,2018,120,0,0,26459,241,12202,10184,4990,13955
2022-09-10 01:00:00+00,13121,969,5196,4720,98,222,2014,122,0,0,26462,244,12028,10014,4818,14090
2022-09-10 01:30:00+00,12809,978,5199,4872,96,80,2017,117,0,0,26168,240,12184,10167,4968,13787
2022-09-10 02:00:00+00,12418,982,5184,5069,96,100,2011,116,0,0,25976,236,12360,10349,5165,13400
2022-09-10 02:30:00+00,12316,983,5173,5149,96,88,1669,121,0,0,25595,236,12087,10418,5245,13299
2022-09-10 03:00:00+00,12644,983,5153,5059,96,214,1425,114,0,0,25688,242,11733,10308,5155,13627
2022-09-10 03:30:00+00,12684,980,5136,4922,96,214,1429,125,0,0,25586,243,11583,10154,5018,13664
2022-09-10 04:00:00+00,13039,978,5118,4760,96,244,1426,120,0,0,25781,247,11400,9974,4856,14017
2022-09-10 04:30:00+00,13521,978,5099,4594,98,264,1427,121,0,0,26102,252,11218,9791,4692,14499
2022-09-10 05:00:00+00,13277,977,5087,4424,147,244,1428,116,0,0,25700,252,11086,9658,4571,14254
2022-09-10 05:30:00+00,13823,980,5067,4328,158,217,1427,117,3,0,26120,255,10983,9556,4489,14803
2022-09-10 06:00:00+00,14645,981,5020,4046,227,100,1428,168,169,30,26814,259,10890,9462,4442,15626
2022-09-10 06:30:00+00,15312,980,4984,3893,252,194,1420,334,561,86,28016,261,11110,9690,4706,16292
2022-09-10 07:00:00+00,15097,981,4968,3823,255,65,1275,225,1037,48,27774,256,11358,10083,5115,16078
2022-09-10 07:30:00+00,15666,980,4949,3550,255,38,1427,279,1514,8,28666,257,11695,10268,5319,16646
2022-09-10 08:00:00+00,15585,975,4939,3401,203,434,1428,202,2055,0,29222,253,12026,10598,5659,16560
2022-09-10 08:30:00+00,15655,978,4943,3245,176,446,1427,153,2611,0,29634,250,12402,10975,6032,16633
2022-09-10 09:00:00+00,15558,976,4754,3043,112,698,1427,146,3329,0,30043,247,12665,11238,6484,16534
2022-09-10 09:30:00+00,15539,978,4750,2760,114,700,1425,123,3620,48,30057,247,12669,11244,6494,16517
2022-09-10 10:00:00+00,15353,981,4749,2677,114,646,1427,141,4000,4,30092,245,12967,11540,6791,16334
2022-09-10 10:30:00+00,15538,980,4743,2462,114,652,1427,124,4409,38,30487,244,13155,11728,6985,16518
2022-09-10 11:00:00+00,15577,978,4750,2372,93,986,1425,121,4816,36,31154,240,13456,12031,7281,16555
2022-09-10 11:30:00+00,15593,973,4751,2111,93,970,1426,120,5212,0,31249,239,13593,12167,7416,16566
2022-09-10 12:00:00+00,15859,969,4756,1994,93,264,1426,147,5078,0,30586,242,13347,11921,7165,16828
2022-09-10 12:30:00+00,15741,950,4750,1920,93,274,1438,116,4747,0,30029,244,12948,11510,6760,16691
2022-09-10 13:00:00+00,15913,954,4749,1792,93,578,1429,116,4498,40,30162,250,12561,11132,6383,16867
2022-09-10 13:30:00+00,15853,962,4747,1676,92,532,1431,116,3997,0,29406,255,11943,10512,5765,16815
2022-09-10 14:00:00+00,16195,964,4744,1574,106,680,1432,116,3569,0,29380,261,11425,9993,5249,17159
2022-09-10 14:30:00+00,16488,967,4742,1584,106,610,1429,132,3444,0,29502,263,11305,9876,5134,17455
2022-09-10 15:00:00+00,16170,1039,4765,1567,106,766,1421,192,3026,0,29052,268,10885,9464,4699,17209
2022-09-10 15:30:00+00,16442,1269,4777,1574,148,846,1428,379,2711,6,29580,277,10638,9210,4433,17711
2022-09-10 16:00:00+00,16752,1447,4784,1489,213,528,1429,461,2270,142,29515,285,10185,8756,3972,18199
2022-09-10 16:30:00+00,16635,1479,4785,1414,250,536,1429,605,1629,618,29380,287,9507,8078,3293,18114
2022-09-10 17:00:00+00,16363,1469,4785,1405,342,1130,1486,501,959,942,29382,291,8977,7491,2706,17832
2022-09-10 17:30:00+00,16645,1454,4791,1329,347,1144,1555,536,383,972,29156,298,8405,6850,2059,18099
2022-09-10 18:00:00+00,16561,1458,4799,1220,307,1182,1794,574,44,918,28857,303,8164,6370,1571,18019
2022-09-10 18:30:00+00,16499,1460,4797,1174,304,1314,2006,666,0,782,29002,304,8281,6275,1478,17959
2022-09-10 19:00:00+00,16762,1459,4799,1142,267,1404,2030,636,0,718,29217,305,8238,6208,1409,18221
2022-09-10 19:30:00+00,16333,1460,4798,1123,256,1410,2016,458,0,404,28258,308,8193,6177,1379,17793
2022-09-10 20:00:00+00,16564,1461,4794,1173,203,1242,2021,453,0,96,28007,311,8191,6170,1376,18025
2022-09-10 20:30:00+00,16298,1463,4791,1164,180,1152,2021,206,0,70,27345,311,8156,6135,1344,17761
2022-09-10 21:00:00+00,16600,1453,4797,1140,135,954,2018,174,0,52,27323,312,8090,6072,1275,18053
2022-09-10 21:30:00+00,16143,1333,4789,1160,130,968,2021,135,0,0,26679,308,8100,6079,1290,17476
2022-09-10 22:00:00+00,15959,853,4791,1235,130,590,1991,144,0,0,25693,296,8147,6156,1365,16812
2022-09-10 22:30:00+00,15187,502,4783,1235,129,532,2004,232,0,30,24634,283,8151,6147,1364,15689
2022-09-10 23:00:00+00,15081,499,4791,1288,116,448,1957,240,0,30,24450,283,8152,6195,1404,15580
2022-09-10 23:30:00+00,14886,502,4793,1446,116,328,1954,157,0,0,24182,280,8308,6354,1562,15388
2022-09-11 00:00:00+00,14747,500,4798,1576,117,402,1952,125,0,0,24217,278,8443,6491,1693,15247
2022-09-11 00:30:00+00,14336,499,4795,1650,118,478,1881,140,0,0,23897,276,8444,6563,1768,14835
2022-09-11 01:00:00+00,14113,501,4792,1747,114,568,1852,159,0,0,23846,275,8505,6653,1861,14614
2022-09-11 01:30:00+00,13839,501,4791,1765,113,540,1854,131,0,0,23534,273,8523,6669,1878,14340
2022-09-11 02:00:00+00,14104,500,4802,1704,113,606,1855,116,0,0,23800,276,8474,6619,1817,14604
2022-09-11 02:30:00+00,14139,500,4805,1646,113,554,1849,133,0,0,23739,276,8413,6564,1759,14639
2022-09-11 03:00:00+00,14209,500,4804,1631,111,688,1855,116,0,0,23914,278,8401,6546,1742,14709
2022-09-11 03:30:00+00,14261,501,4799,1760,110,644,1855,118,0,0,24048,276,8524,6669,1870,14762
2022-09-11 04:00:00+00,14085,500,4801,1853,111,718,1961,116,0,0,24145,274,8726,6765,1964,14585
2022-09-11 04:30:00+00,14010,499,4801,1948,111,748,2016,116,0,0,24249,272,8876,6860,2059,14509
2022-09-11 05:00:00+00,14186,498,4795,1941,149,748,2020,120,0,0,24457,273,8905,6885,2090,14684
2022-09-11 05:30:00+00,14244,499,4797,2060,153,748,2020,167,18,0,24706,272,9048,7028,2231,14743
2022-09-11 06:00:00+00,13757,499,4792,2113,197,748,2019,175,310,0,24610,265,9431,7412,2620,14256
2022-09-11 06:30:00+00,14328,501,4793,2098,197,748,2021,203,809,34,25732,263,9918,7897,3104,14829
2022-09-11 07:00:00+00,14245,500,4789,2075,197,680,2021,147,1340,28,26022,257,10422,8401,3612,14745
2022-09-11 07:30:00+00,14562,500,4795,2070,182,638,2018,295,1942,54,27056,252,11007,8989,4194,15062
2022-09-11 08:00:00+00,14592,499,4793,2223,165,486,2020,178,2649,132,27737,242,11850,9830,5037,15091
2022-09-11 08:30:00+00,14439,499,4792,2376,300,438,2020,143,3383,56,28446,232,12871,10851,6059,14938
2022-09-11 09:00:00+00,14227,500,4790,2526,397,860,2019,142,4046,0,29507,228,13778,11759,6969,14727
2022-09-11 09:30:00+00,14062,500,4789,2795,397,760,2019,146,4651,0,30119,219,14651,12632,7843,14562
2022-09-11 10:00:00+00,14150,500,4786,3078,146,1392,2005,164,4916,26,31163,217,14931,12926,8140,14650
2022-09-11 10:30:00+00,14206,499,4793,3500,109,1330,1923,196,5351,0,31907,212,15676,13753,8960,14705
2022-09-11 11:00:00+00,13717,500,4788,3900,108,1538,1879,146,5845,0,32421,205,16520,14641,9853,14217
2022-09-11 11:30:00+00,13595,499,4788,4079,107,1546,1878,142,5851,0,32485,203,16703,14825,10037,14094
2022-09-11 12:00:00+00,12877,500,4796,4377,107,1710,1878,143,5664,0,32052,199,16822,14944,10148,13377
2022-09-11 12:30:00+00,12547,498,4793,4605,107,1712,1928,152,5974,0,32316,193,17407,15479,10686,13045
2022-09-11 13:00:00+00,13162,498,4792,4854,108,1310,1935,149,5020,0,31828,203,16709,14774,9982,13660
2022-09-11 13:30:00+00,13058,500,4781,5025,109,1274,1936,132,4489,0,31304,204,16340,14404,9623,13558
2022-09-11 14:00:00+00,14080,499,4780,5241,109,60,1937,120,4041,0,30867,204,16108,14171,9391,14579
2022-09-11 14:30:00+00,14476,500,4776,5529,109,66,1937,139,3535,0,31067,208,15886,13949,9173,14976
2022-09-11 15:00:00+00,15264,499,4779,5831,127,262,1998,141,2724,34,31659,217,15459,13461,8682,15763
2022-09-11 15:30:00+00,15563,499,4775,5819,245,424,2048,332,2056,170,31931,224,14943,12895,8120,16062
2022-09-11 16:00:00+00,15653,498,4777,5990,463,678,2136,639,1539,168,32541,227,14905,12769,7992,16151
2022-09-11 16:30:00+00,15574,495,4775,6485,500,716,2312,809,953,352,32971,226,15025,12713,7938,16069
2022-09-11 17:00:00+00,15826,494,4776,7095,542,718,2407,838,483,678,33857,224,15303,12896,8120,16320
2022-09-11 17:30:00+00,15782,493,4775,7710,538,742,2288,833,175,664,34000,223,15486,13198,8423,16275
2022-09-11 18:00:00+00,15737,495,4778,8178,504,736,1921,800,12,696,33857,221,15393,13472,8694,16232
2022-09-11 18:30:00+00,15675,495,4778,8680,451,748,1894,661,0,568,33950,219,15803,13909,9131,16170
2022-09-11 19:00:00+00,15804,495,4785,9331,330,612,1895,581,0,242,34075,216,16341,14446,9661,16299
2022-09-11 19:30:00+00,15045,494,4782,9733,243,364,1928,446,0,0,33035,210,16686,14758,9976,15539
2022-09-11 20:00:00+00,14982,495,4784,9873,190,450,1942,293,0,0,33009,209,16789,14847,10063,15477
2022-09-11 20:30:00+00,14042,496,4779,9898,181,236,1934,182,0,0,31748,201,16792,14858,10080,14538
2022-09-11 21:00:00+00,13456,498,4783,9926,134,266,2006,128,0,0,31197,198,16849,14843,10060,13954
2022-09-11 21:30:00+00,12309,494,4788,9986,137,80,2013,126,0,0,29934,188,16924,14912,10124,12803
2022-09-11 22:00:00+00,10910,495,4779,10292,155,88,2015,125,0,0,28859,176,17241,15226,10447,11405
2022-09-11 22:30:00+00,9986,500,4772,10186,148,200,2019,149,0,0,27960,171,17125,15106,10334,10486
2022-09-11 23:00:00+00,9747,574,4772,10031,131,118,2014,132,0,0,27519,171,16948,14934,10162,10321
2022-09-11 23:30:00+00,9387,730,4774,9994,131,80,2018,149,0,0,27263,173,16917,14899,10125,10117
2022-09-12 00:00:00+00,9117,863,4779,9981,113,24,2016,128,0,0,27021,174,16889,14873,10094,9980
2022-09-12 00:30:00+00,8797,919,4783,9946,111,86,2016,124,0,0,26782,173,16856,14840,10056,9716
2022-09-12 01:00:00+00,8702,974,4783,9798,111,74,2013,126,0,0,26581,175,16705,14692,9909,9676
2022-09-12 01:30:00+00,8514,977,4781,9722,112,16,2006,126,0,0,26254,174,16621,14615,9834,9491
2022-09-12 02:00:00+00,8193,939,4783,9823,113,76,2003,132,0,0,26062,170,16722,14719,9936,9132
2022-09-12 02:30:00+00,8305,939,4784,9747,112,62,1931,131,0,0,26011,171,16574,14643,9859,9244
2022-09-12 03:00:00+00,8586,902,4785,9582,110,154,1872,146,0,0,26137,175,16349,14477,9692,9488
2022-09-12 03:30:00+00,8809,974,4785,9323,109,104,1942,142,0,0,26188,180,16159,14217,9432,9783
2022-09-12 04:00:00+00,9867,979,4783,8812,111,162,2039,134,0,0,26887,192,15745,13706,8923,10846
2022-09-12 04:30:00+00,11417,974,4786,8341,114,112,2031,125,0,0,27900,206,15272,13241,8455,12391
2022-09-12 05:00:00+00,12972,978,4781,8056,149,130,2036,133,0,0,29235,218,15022,12986,8205,13950
2022-09-12 05:30:00+00,14459,977,4777,7741,239,32,2034,161,9,90,30519,227,14800,12766,7989,15436
2022-09-12 06:00:00+00,14835,975,4776,7183,429,124,2029,299,186,0,30836,232,14603,12574,7798,15810
2022-09-12 06:30:00+00,15613,976,4770,7065,479,126,2026,573,490,44,32162,234,14830,12804,8034,16589
2022-09-12 07:00:00+00,15340,964,4766,7137,489,574,2010,598,911,30,32819,233,15313,13303,8537,16304
2022-09-12 07:30:00+00,15614,975,4769,6816,497,646,1993,681,1332,14,33337,235,15407,13414,8645,16589
2022-09-12 08:00:00+00,15914,962,4770,6645,241,1470,1987,572,1824,102,34487,234,15467,13480,8710,16876
2022-09-12 08:30:00+00,15810,972,4770,6844,209,1514,1994,254,2606,2,34975,227,16423,14429,9659,16782
2022-09-12 09:00:00+00,15838,974,4770,7113,165,1292,1974,167,3148,0,35441,223,17170,15196,10426,16812
2022-09-12 09:30:00+00,15380,902,4770,7185,163,1328,1966,167,3607,96,35564,216,17691,15725,10955,16282
2022-09-12 10:00:00+00,14963,887,4780,7375,126,1778,1968,164,3972,0,36013,211,18221,16253,11473,15850
2022-09-12 10:30:00+00,14729,899,4780,7606,124,1782,1967,145,4603,0,36635,205,19080,17113,12333,15628
2022-09-12 11:00:00+00,15252,898,4759,7877,124,1684,1965,124,4558,160,37401,205,19283,17318,12559,16150
2022-09-12 11:30:00+00,15575,898,4738,8162,124,1684,1948,114,4391,30,37664,207,19363,17415,12677,16473
2022-09-12 12:00:00+00,16332,899,4735,8240,117,1246,1951,118,4204,0,37842,212,19247,17296,12561,17231
2022-09-12 12:30:00+00,16187,936,4736,8644,114,1204,1951,115,3838,24,37748,211,19282,17332,12596,17123
2022-09-12 13:00:00+00,15924,974,4738,9282,116,1110,1934,116,3124,0,37318,210,19194,17260,12522,16898
2022-09-12 13:30:00+00,15670,948,4735,9973,119,1108,1965,114,2699,0,37331,207,19491,17526,12791,16618
2022-09-12 14:00:00+00,16135,988,4728,10354,142,730,1951,158,2373,0,37559,211,19548,17597,12869,17123
2022-09-12 14:30:00+00,16500,1159,4725,10171,156,702,1981,173,2087,0,37654,219,19120,17139,12414,17659
2022-09-12 15:00:00+00,16550,1337,4756,10478,185,122,1986,249,1609,0,37272,219,19014,17028,12272,17887
2022-09-12 15:30:00+00,16727,1407,4774,10335,203,112,2000,400,1311,0,37269,224,18623,16623,11849,18134
2022-09-12 16:00:00+00,16686,1410,4784,9662,229,0,2007,533,1022,322,36655,227,17704,15697,10913,18096
2022-09-12 16:30:00+00,16782,1408,4782,9302,280,0,2005,807,633,438,36437,232,17002,14997,10215,18190
2022-09-12 17:00:00+00,16376,1446,4782,8962,395,484,2009,915,445,438,36252,238,16593,14584,9802,17822
2022-09-12 17:30:00+00,15845,1463,4776,9066,381,530,1957,738,170,974,35900,234,16350,14393,9617,17308
2022-09-12 18:00:00+00,16625,1462,4782,9499,362,160,1984,720,24,714,36332,234,16651,14667,9885,18087
2022-09-12 18:30:00+00,16325,1465,4780,9486,353,160,1989,902,0,690,36150,234,16608,14619,9839,17790
2022-09-12 19:00:00+00,16326,1467,4783,9278,287,250,1987,790,0,830,35998,234,16335,14348,9565,17793
2022-09-12 19:30:00+00,16394,1318,4779,8841,265,242,1985,694,0,398,34916,237,15870,13885,9106,17712
2022-09-12 20:00:00+00,16959,992,4781,8424,144,108,2003,492,0,446,34348,234,15352,13348,8568,17951
2022-09-12 20:30:00+00,16465,975,4789,8492,130,8,2004,188,0,24,33076,233,15416,13412,8622,17440
2022-09-12 21:00:00+00,16794,973,4767,8313,128,42,2002,130,0,34,33183,236,15210,13208,8441,17767
2022-09-12 21:30:00+00,15616,976,4764,8093,127,0,2003,130,0,94,31803,231,14987,12984,8220,16592
2022-09-12 22:00:00+00,13362,973,4776,8225,114,0,2003,127,0,0,29580,218,15118,13115,8339,14335
2022-09-12 22:30:00+00,11942,971,4771,8528,113,88,2002,135,0,0,28550,208,15414,13412,8641,12913
2022-09-12 23:00:00+00,11639,979,4765,8576,99,128,2000,130,0,0,28316,206,15440,13440,8675,12618
2022-09-12 23:30:00+00,11345,980,4762,8468,99,164,1998,131,0,0,27947,206,15327,13329,8567,12325
2022-09-13 00:00:00+00,11310,977,4763,8069,99,144,2002,140,0,0,27504,208,14933,12931,8168,12287
2022-09-13 00:30:00+00,11392,974,4770,7921,99,178,2002,121,0,0,27457,210,14792,12790,8020,12366
2022-09-13 01:00:00+00,11087,969,4775,7883,99,112,2001,117,0,0,27043,207,14758,12757,7982,12056
2022-09-13 01:30:00+00,10938,978,4770,7571,99,106,2003,126,0,0,26591,209,14443,12440,7670,11916
2022-09-13 02:00:00+00,11056,971,4778,7602,100,202,2004,119,0,0,26832,210,14484,12480,7702,12027
2022-09-13 02:30:00+00,10919,981,4766,7555,101,218,2004,129,0,0,26673,210,14426,12422,7656,11900
2022-09-13 03:00:00+00,11051,976,4771,7450,102,202,2002,120,0,0,26674,211,14325,12323,7552,12027
2022-09-13 03:30:00+00,11130,976,4775,7456,102,150,2004,122,0,0,26715,211,14337,12333,7558,12106
2022-09-13 04:00:00+00,11733,968,4774,7199,102,248,2090,120,0,0,27234,218,14165,12075,7301,12701
2022-09-13 04:30:00+00,12731,974,4770,6950,103,288,2137,124,0,0,28077,226,13960,11823,7053,13705
2022-09-13 05:00:00+00,14613,1138,4769,6605,152,546,2361,130,0,0,30314,244,13887,11526,6757,15751
2022-09-13 05:30:00+00,16084,1364,4770,6310,166,620,2571,188,8,94,32175,257,13825,11254,6484,17448
2022-09-13 06:00:00+00,17012,1464,4767,6125,252,636,2639,299,197,204,33595,262,13980,11341,6574,18476
2022-09-13 06:30:00+00,17346,1465,4763,5899,435,620,2642,723,648,72,34613,262,14387,11745,6982,18811
2022-09-13 07:00:00+00,17157,1428,4761,5733,200,626,2664,787,1166,0,34522,258,14524,11860,7099,18585
2022-09-13 07:30:00+00,17211,1420,4760,5368,317,548,2668,766,1696,202,34956,254,14809,12141,7381,18631
2022-09-13 08:00:00+00,17172,1422,4773,5263,390,1418,2668,610,2318,16,36050,250,15412,12744,7971,18594
2022-09-13 08:30:00+00,16829,1427,4769,5280,362,1678,2660,374,2865,30,36274,245,15936,13276,8507,18256
2022-09-13 09:00:00+00,17173,1426,4766,4949,116,1972,2670,301,3244,14,36631,248,15745,13075,8309,18599
2022-09-13 09:30:00+00,17148,1429,4761,4817,179,2116,2675,219,3679,130,37153,243,16111,13436,8675,18577
2022-09-13 10:00:00+00,16650,1429,4765,4739,145,2234,2674,162,3971,0,36769,241,16294,13620,8855,18079
2022-09-13 10:30:00+00,16687,1436,4768,4660,105,2276,2675,126,3975,18,36726,242,16183,13508,8740,18123
2022-09-13 11:00:00+00,16481,1429,4776,4334,104,2356,2673,119,3868,26,36166,244,15755,13082,8306,17910
2022-09-13 11:30:00+00,16749,1430,4777,3948,104,2296,2675,124,4026,0,36129,246,15530,12855,8078,18179
2022-09-13 12:00:00+00,16913,1429,4772,3770,105,2620,2670,115,4205,0,36599,247,15522,12852,8080,18342
2022-09-13 12:30:00+00,16868,1427,4773,3436,104,2550,2651,116,4000,0,35925,250,14964,12313,7540,18295
2022-09-13 13:00:00+00,16599,1454,4772,3346,104,2292,2667,116,4187,22,35559,251,15076,12409,7637,18053
2022-09-13 13:30:00+00,16879,1464,4776,3275,104,2174,2671,115,3633,0,35091,256,14459,11788,7012,18343
2022-09-13 14:00:00+00,17220,1470,4771,3206,123,1920,2675,157,3175,0,34717,262,13950,11275,6504,18690
2022-09-13 14:30:00+00,17358,1475,4771,3307,138,2038,2676,193,2701,0,34657,266,13593,10917,6146,18833
2022-09-13 15:00:00+00,17253,1477,4770,3515,317,1824,2676,365,2339,0,34536,264,13617,10941,6171,18730
2022-09-13 15:30:00+00,17434,1476,4763,3523,249,1810,2673,646,1804,486,34864,265,13012,10339,5576,18910
2022-09-13 16:00:00+00,17579,1475,4765,3548,293,1512,2666,866,1337,1048,35089,265,12609,9943,5178,19054
2022-09-13 16:30:00+00,17920,1479,4763,3352,393,1544,2679,994,923,1182,35229,269,12110,9431,4668,19399
2022-09-13 17:00:00+00,18212,1479,4762,3275,531,1824,2674,1057,529,1316,35659,268,11771,9097,4335,19691
2022-09-13 17:30:00+00,18261,1480,4761,3225,604,1844,2673,1077,200,1112,35237,272,11463,8790,4029,19741
2022-09-13 18:00:00+00,18289,1480,4761,3503,548,1586,2675,1142,15,1064,35063,273,11502,8827,4066,19769
2022-09-13 18:30:00+00,18350,1476,4753,3575,382,1570,2676,1125,0,1338,35245,273,11386,8710,3957,19826
2022-09-13 19:00:00+00,18293,1479,4761,3674,350,1556,2662,1061,0,740,34576,280,11447,8785,4024,19772
2022-09-13 19:30:00+00,18110,1476,4763,3709,170,1500,2662,774,0,492,33656,283,11304,8642,3879,19586
2022-09-13 20:00:00+00,17988,1471,4763,3617,119,1014,2669,606,0,418,32665,285,11168,8499,3736,19459
2022-09-13 20:30:00+00,17190,1470,4764,3627,117,862,2683,239,0,236,31188,284,11191,8508,3744,18660
2022-09-13 21:00:00+00,17599,1475,4764,3627,95,394,2665,169,0,40,30828,288,11151,8486,3722,19074
2022-09-13 21:30:00+00,16313,1351,4769,3457,92,368,2662,135,0,90,29237,281,10980,8318,3549,17664
2022-09-13 22:00:00+00,16441,1013,4772,3575,95,404,2667,421,0,22,29410,274,11109,8442,3670,17454
2022-09-13 22:30:00+00,16042,979,4668,3569,93,332,2660,207,0,0,28550,272,10990,8330,3662,17021
2022-09-13 23:00:00+00,15934,977,4320,3363,63,136,2663,138,0,100,27694,275,10409,7746,3426,16911
2022-09-13 23:30:00+00,15769,979,4298,3460,61,80,2662,122,0,0,27431,274,10481,7819,3521,16748
2022-09-14 00:00:00+00,15741,977,4283,3626,61,16,2661,125,0,0,27490,272,10631,7970,3687,16718
2022-09-14 00:30:00+00,15688,980,4283,3622,60,70,2659,123,0,0,27485,272,10624,7965,3682,16668
2022-09-14 01:00:00+00,15919,982,4286,3504,58,128,2659,125,0,0,27661,275,10507,7848,3562,16901
2022-09-14 01:30:00+00,15684,980,4288,3605,58,74,2662,123,0,0,27474,273,10613,7951,3663,16664
2022-09-14 02:00:00+00,15405,980,4286,3632,58,118,2660,122,0,0,27261,271,10636,7976,3690,16385
2022-09-14 02:30:00+00,15542,980,4285,3575,59,30,2660,126,0,0,27257,272,10579,7919,3634,16522
2022-09-14 03:00:00+00,15509,979,4285,3635,59,106,2661,124,0,0,27358,272,10640,7979,3694,16488
2022-09-14 03:30:00+00,15586,979,4290,3541,59,60,2662,127,0,0,27304,273,10552,7890,3600,16565
2022-09-14 04:00:00+00,15921,979,4293,3599,59,30,2658,122,0,0,27661,273,10609,7951,3658,16900
2022-09-14 04:30:00+00,16452,983,4297,3571,67,212,2662,120,0,0,28364,277,10597,7935,3638,17435
2022-09-14 05:00:00+00,17294,1115,4292,3299,137,470,2662,254,0,122,29645,286,10390,7728,3436,18409
2022-09-14 05:30:00+00,17798,1362,4292,3499,183,704,2660,655,4,182,31339,292,10638,7978,3686,19160
2022-09-14 06:00:00+00,18206,1461,4291,3524,280,694,2666,844,161,344,32471,292,10922,8256,3965,19667
2022-09-14 06:30:00+00,18394,1471,4290,3576,457,548,2671,965,530,962,33864,282,11524,8853,4563,19865
2022-09-14 07:00:00+00,18497,1480,4290,3585,467,490,2670,923,985,928,34315,278,11997,9327,5037,19977
2022-09-14 07:30:00+00,18486,1479,4292,3671,467,514,2670,929,1587,788,34883,273,12687,10017,5725,19965
2022-09-14 08:00:00+00,18311,1485,4288,3780,454,312,2673,861,2287,756,35207,267,13482,10809,6521,19796
2022-09-14 08:30:00+00,18004,1485,4293,3964,371,298,2673,829,3119,584,35620,259,14420,11747,7454,19489
2022-09-14 09:00:00+00,18217,1482,4289,4022,225,252,2675,770,3838,380,36150,256,15049,12374,8085,19699
2022-09-14 09:30:00+00,18161,1486,4294,4222,187,252,2691,703,4629,76,36701,251,16023,13332,9038,19647
2022-09-14 10:00:00+00,17393,1472,4294,4391,92,480,2693,648,5068,0,36531,247,16538,13845,9551,18865
2022-09-14 10:30:00+00,17100,1472,4289,4562,90,496,2692,515,5459,360,37035,239,17092,14400,10111,18572
2022-09-14 11:00:00+00,17576,1471,4296,4676,94,357,2695,336,6101,496,38098,234,17862,15167,10871,19047
2022-09-14 11:30:00+00,17320,1472,4298,4719,95,248,2695,274,6539,286,37946,230,18346,15651,11353,18792
2022-09-14 12:00:00+00,17274,1472,4295,4817,76,228,2698,252,6748,372,38232,227,18634,15936,11641,18746
2022-09-14 12:30:00+00,17126,1476,4296,5218,74,254,2699,201,6858,94,38296,225,19145,16446,12150,18602
2022-09-14 13:00:00+00,17431,1477,4299,5518,74,366,2700,183,6785,32,38865,226,19376,16676,12377,18908
2022-09-14 13:30:00+00,16586,1478,4301,6092,76,444,2694,175,6299,0,38145,223,19462,16768,12467,18064
2022-09-14 14:00:00+00,16169,1479,4300,6609,94,388,2696,205,5705,0,37645,221,19404,16708,12408,17648
2022-09-14 14:30:00+00,16752,1361,4299,7010,95,424,2696,222,5122,0,37981,223,19222,16526,12227,18113
2022-09-14 15:00:00+00,16880,1204,4301,7204,138,764,2656,254,4252,0,37653,227,18551,15895,11594,18084
2022-09-14 15:30:00+00,17266,1210,4295,7248,139,708,2647,316,3363,106,37298,233,17692,15045,10750,18476
2022-09-14 16:00:00+00,17098,1211,4293,7517,191,362,2697,536,2464,562,36931,231,17162,14465,10172,18309
2022-09-14 16:30:00+00,17079,1209,4294,7842,345,362,2698,768,1636,826,37059,232,16815,14117,9823,18288
2022-09-14 17:00:00+00,17082,1207,4293,8084,478,110,2700,834,877,844,36509,232,16432,13732,9439,18289
2022-09-14 17:30:00+00,16992,1164,4291,8102,502,204,2696,824,267,1024,36066,234,15858,13162,8871,18156
2022-09-14 18:00:00+00,17306,975,4293,8247,478,344,2698,862,11,1014,36228,235,15727,13029,8736,18281
2022-09-14 18:30:00+00,17788,977,4292,8183,451,466,2697,830,0,898,36582,239,15623,12926,8634,18765
2022-09-14 19:00:00+00,17365,978,4291,8001,238,620,2698,711,0,844,35746,241,15228,12530,8239,18343
2022-09-14 19:30:00+00,17395,977,4295,7718,153,612,2699,547,0,608,35004,245,14865,12166,7871,18372
2022-09-14 20:00:00+00,17138,977,4292,7642,100,404,2699,401,0,180,33833,245,14733,12034,7742,18115
2022-09-14 20:30:00+00,16201,977,4293,7525,100,308,2719,227,0,50,32400,242,14637,11918,7625,17178
2022-09-14 21:00:00+00,16114,980,4295,7386,72,472,2721,218,0,36,32294,244,14474,11753,7458,17094
2022-09-14 21:30:00+00,15027,979,4294,6975,72,384,2719,126,0,62,30638,241,14060,11341,7047,16006
2022-09-14 22:00:00+00,13848,978,4290,6702,72,268,2739,125,0,62,29084,235,13803,11064,6774,14826
2022-09-14 22:30:00+00,12583,973,4288,6634,72,364,2747,130,0,0,27791,229,13741,10994,6706,13556
2022-09-14 23:00:00+00,11964,976,4285,6791,72,30,2745,126,0,0,26989,223,13893,11148,6863,12940
2022-09-14 23:30:00+00,11845,978,4291,6409,72,0,2744,122,0,0,26461,225,13516,10772,6481,12823
2022-09-15 00:00:00+00,11693,985,4288,6041,72,0,2744,125,0,0,25948,227,13145,10401,6113,12678
2022-09-15 00:30:00+00,11927,971,4292,5981,72,16,2744,115,0,0,26118,229,13089,10345,6053,12898
2022-09-15 01:00:00+00,10968,969,4291,6721,72,24,2742,113,0,0,25900,216,13826,11084,6793,11937
2022-09-15 01:30:00+00,10982,980,4286,6412,72,73,2743,130,0,0,25677,220,13513,10770,6484,11962
2022-09-15 02:00:00+00,11460,971,4297,5959,71,111,2740,112,0,0,25721,227,13067,10327,6030,12431
2022-09-15 02:30:00+00,11293,977,4292,5861,72,175,2708,115,0,0,25492,228,12933,10225,5933,12270
2022-09-15 03:00:00+00,11904,971,4298,6052,72,288,2681,116,0,0,26382,231,13103,10422,6124,12875
2022-09-15 03:30:00+00,12019,971,4297,6069,72,328,2687,115,0,0,26558,232,13125,10438,6141,12990
2022-09-15 04:00:00+00,12551,966,4298,6308,72,212,2738,117,0,0,27262,232,13416,10678,6380,13517
2022-09-15 04:30:00+00,12463,976,4296,6987,81,258,2737,120,0,0,27918,226,14101,11364,7068,13439
2022-09-15 05:00:00+00,13411,979,4299,7226,167,339,2719,180,0,0,29320,230,14411,11692,7393,14390
2022-09-15 05:30:00+00,14586,970,4303,7437,167,625,2742,219,2,156,31207,235,14651,11909,7606,15556
2022-09-15 06:00:00+00,14876,902,4295,7445,162,527,2742,444,134,332,31859,233,14778,12036,7741,15778
2022-09-15 06:30:00+00,16009,896,4297,7176,154,622,2741,555,462,140,33052,240,14830,12089,7792,16905
2022-09-15 07:00:00+00,16399,894,4298,7314,204,910,2710,469,940,24,34162,235,15466,12756,8458,17293
2022-09-15 07:30:00+00,16385,898,4292,7388,207,866,2693,440,1668,134,34971,228,16248,13555,9263,17283
2022-09-15 08:00:00+00,15998,889,4296,7337,195,1010,2691,386,2170,74,35046,224,16689,13998,9702,16887
2022-09-15 08:30:00+00,15272,881,4296,8060,209,1026,2691,300,2729,136,35600,212,17985,15294,10998,16153
2022-09-15 09:00:00+00,15318,948,4288,8355,175,731,2691,287,3328,180,36301,211,18837,16146,11858,16266
2022-09-15 09:30:00+00,15032,963,4299,8480,170,732,2637,174,4268,0,36755,205,19854,17217,12918,15995
2022-09-15 10:00:00+00,14332,967,4293,8756,153,1228,2648,164,4140,0,36681,200,19990,17342,13049,15299
2022-09-15 10:30:00+00,13818,951,4297,9294,146,1296,2649,152,4540,0,37144,192,20926,18277,13980,14769
2022-09-15 11:00:00+00,13826,976,4291,9660,148,1244,2649,121,4754,12,37682,190,21502,18853,14562,14802
2022-09-15 11:30:00+00,13982,971,4298,9921,148,1295,2652,115,4877,10,38269,190,21896,19244,14946,14953
2022-09-15 12:00:00+00,13416,975,4300,10138,134,1016,2650,119,4325,0,37073,190,21547,18897,14597,14391
2022-09-15 12:30:00+00,12996,974,4300,10257,129,1020,2648,116,4686,0,37126,185,22020,19372,15072,13970
2022-09-15 13:00:00+00,13022,976,4299,10362,158,1002,2646,116,4725,0,37306,184,22190,19544,15245,13998
2022-09-15 13:30:00+00,12812,968,4300,10731,133,1002,2605,112,4423,0,37086,183,22192,19587,15287,13780
2022-09-15 14:00:00+00,12461,966,4303,11165,107,976,2597,112,4042,0,36729,180,22214,19617,15314,13427
2022-09-15 14:30:00+00,12579,971,4303,11685,89,946,2673,116,3345,0,36707,182,22095,19422,15119,13550
2022-09-15 15:00:00+00,13596,972,4302,11871,104,216,2723,141,2852,72,36849,183,21852,19129,14827,14568
2022-09-15 15:30:00+00,14629,974,4302,11631,121,194,2724,140,2167,246,37128,192,20945,18221,13919,15603
2022-09-15 16:00:00+00,15613,975,4302,11578,121,102,2722,158,1619,48,37238,201,20342,17620,13318,16588
2022-09-15 16:30:00+00,15743,971,4297,11546,133,104,2724,177,1056,24,36775,205,19756,17032,12735,16714
2022-09-15 17:00:00+00,15871,977,4293,11539,156,84,2720,334,593,424,36991,206,19301,16581,12288,16848
2022-09-15 17:30:00+00,15891,974,4295,11538,187,220,2723,318,170,592,36908,208,18913,16190,11895,16865
2022-09-15 18:00:00+00,15917,972,4295,11799,186,474,2744,320,4,328,37039,206,19028,16284,11989,16889
2022-09-15 18:30:00+00,15870,975,4291,11955,155,536,2747,346,0,516,37391,205,19148,16401,12110,16845
2022-09-15 19:00:00+00,16022,966,4293,11924,121,34,2747,273,0,68,36448,209,19086,16338,12046,16988
2022-09-15 19:30:00+00,15240,974,4288,11942,118,0,2745,236,0,90,35633,205,19093,16348,12060,16214
2022-09-15 20:00:00+00,14424,974,4290,12056,117,312,2748,122,0,72,35115,202,19211,16463,12173,15398
2022-09-15 20:30:00+00,13377,976,4292,11935,98,330,2747,117,0,0,33872,198,19072,16325,12033,14353
2022-09-15 21:00:00+00,11573,970,4294,11794,88,232,2675,114,0,0,31740,187,18851,16176,11882,12543
2022-09-15 21:30:00+00,9913,976,4295,11769,88,264,2600,129,0,0,30034,176,18752,16152,11857,10889
2022-09-15 22:00:00+00,7091,968,4299,11635,88,1488,2464,119,0,0,28152,157,18486,16022,11723,8059
2022-09-15 22:30:00+00,5771,979,4295,11638,88,1570,2504,132,0,0,26977,145,18525,16021,11726,6750
2022-09-15 23:00:00+00,4605,970,4295,11833,88,2488,2486,118,0,0,26883,134,18702,16216,11921,5575
2022-09-15 23:30:00+00,3726,977,4289,11762,86,2562,2521,117,0,0,26040,126,18658,16137,11848,4703
2022-09-16 00:00:00+00,3472,975,4294,11770,85,2624,2629,115,0,0,25964,117,18778,16149,11855,4447
2022-09-16 00:30:00+00,3295,971,4298,11833,84,2654,2514,114,0,0,25763,114,18729,16215,11917,4266
2022-09-16 01:00:00+00,3093,965,4298,11798,84,2810,2354,114,0,0,25516,112,18534,16180,11882,4058
2022-09-16 01:30:00+00,3243,826,4293,11826,84,2786,1981,113,0,0,25152,109,18184,16203,11910,4069
2022-09-16 02:00:00+00,3119,795,4291,11951,85,2722,1942,121,0,0,25026,108,18269,16327,12036,3914
2022-09-16 02:30:00+00,3012,922,4297,12079,84,2636,1931,117,0,0,25078,110,18391,16460,12163,3934
2022-09-16 03:00:00+00,3377,886,4297,12240,85,1588,2006,123,0,0,24602,111,18628,16622,12325,4263
2022-09-16 03:30:00+00,3739,796,4304,12178,85,1418,2110,116,0,0,24746,113,18677,16567,12263,4535
2022-09-16 04:00:00+00,5355,892,4301,12236,102,372,2444,115,0,0,25817,132,19083,16639,12338,6247
2022-09-16 04:30:00+00,5984,963,4307,12403,108,336,2664,115,0,0,26880,139,19482,16818,12511,6947
2022-09-16 05:00:00+00,7236,970,4323,12638,137,722,2683,157,0,0,28866,147,19781,17098,12775,8206
2022-09-16 05:30:00+00,8268,971,4315,12653,188,774,2727,410,0,0,30306,156,19883,17156,12841,9239
2022-09-16 06:00:00+00,8048,968,4311,12879,226,1756,2670,594,194,0,31646,156,20280,17610,13299,9016
2022-09-16 06:30:00+00,8284,977,4307,12869,197,1858,2743,664,842,344,33085,153,20958,18215,13908,9261
2022-09-16 07:00:00+00,8495,977,4307,12866,191,2759,2746,555,1841,40,34777,150,21951,19205,14898,9472
2022-09-16 07:30:00+00,8203,950,4312,13208,184,2768,2713,413,2976,0,35727,140,23393,20680,16368,9153
2022-09-16 08:00:00+00,7644,955,4309,13675,149,3038,2687,199,4049,0,36705,130,24869,22182,17873,8599
2022-09-16 08:30:00+00,7167,958,4304,13792,142,3002,2567,131,4993,0,37056,123,25798,23231,18927,8125
2022-09-16 09:00:00+00,6566,893,4301,14176,110,2704,2506,126,5776,38,37196,114,26869,24363,20062,7459
2022-09-16 09:30:00+00,5750,831,4300,14506,129,2704,2509,126,6411,66,37332,103,27855,25346,21046,6581
2022-09-16 10:00:00+00,5092,852,4301,14587,105,3054,2510,133,6728,58,37420,96,28231,25721,21420,5944
2022-09-16 10:30:00+00,4874,780,4304,14822,104,3100,2511,123,6708,52,37378,92,28449,25938,21634,5654
2022-09-16 11:00:00+00,4773,777,4299,14879,85,3049,2676,165,6683,168,37554,91,28622,25946,21647,5550
2022-09-16 11:30:00+00,4692,742,4302,14977,84,3048,2745,118,6611,0,37318,90,28719,25974,21672,5434
2022-09-16 12:00:00+00,4397,670,4297,14726,84,3093,2750,126,6882,110,37135,86,28739,25989,21692,5067
2022-09-16 12:30:00+00,4141,712,4305,14674,84,3090,2708,122,6570,0,36406,85,28341,25633,21328,4853
2022-09-16 13:00:00+00,3944,789,4305,14861,82,3025,2613,130,6235,0,35983,86,28096,25483,21178,4733
2022-09-16 13:30:00+00,4178,563,4310,14804,58,3019,2541,133,5939,0,35544,83,27652,25111,20801,4741
2022-09-16 14:00:00+00,4129,483,4310,15002,58,2910,2403,148,5401,0,34844,81,27174,24771,20461,4612
2022-09-16 14:30:00+00,4514,502,4306,14907,63,2860,2483,163,4960,0,34758,87,26719,24236,19930,5016
2022-09-16 15:00:00+00,6074,480,4311,14749,107,2607,2434,137,4209,130,35238,102,25810,23376,19065,6554
2022-09-16 15:30:00+00,7134,478,4305,14767,111,2567,2422,129,3718,138,35769,112,25323,22901,18596,7612
2022-09-16 16:00:00+00,8858,500,4303,14560,167,1644,2466,145,2768,392,35803,131,24264,21798,17495,9358
2022-09-16 16:30:00+00,10185,477,4307,14230,182,2012,2470,136,1774,174,35947,145,22963,20493,16186,10662
2022-09-16 17:00:00+00,10292,580,4299,14084,213,2076,2558,179,888,306,35475,151,22042,19484,15185,10872
2022-09-16 17:30:00+00,10321,622,4301,13709,216,2138,2589,323,223,554,34996,156,21038,18449,14148,10943
2022-09-16 18:00:00+00,9671,568,4298,13359,217,2981,2614,265,3,706,34682,150,20491,17877,13579,10239
2022-09-16 18:30:00+00,9877,467,4297,13300,203,3030,2658,244,0,646,34722,150,20458,17800,13503,10344
2022-09-16 19:00:00+00,10190,495,4297,13258,154,2720,2616,177,0,354,34261,155,20325,17709,13412,10685
2022-09-16 19:30:00+00,9683,416,4298,13215,152,2718,2600,156,0,274,33512,150,20265,17665,13367,10099
2022-09-16 20:00:00+00,8729,400,4295,13140,129,2783,2379,157,0,140,32153,143,19943,17564,13269,9129
2022-09-16 20:30:00+00,8182,399,4298,13169,119,2783,2008,135,0,72,31165,139,19594,17586,13288,8581
2022-09-16 21:00:00+00,7348,353,4297,12952,86,2563,1988,142,0,6,29735,133,19323,17335,13038,7701
2022-09-16 21:30:00+00,6310,300,4303,12795,83,2564,1881,129,0,150,28515,122,19062,17181,12878,6610
2022-09-16 22:00:00+00,3826,256,4310,12219,83,3406,1068,113,0,0,25281,92,17680,16612,12302,4082
2022-09-16 22:30:00+00,3463,232,4311,11617,83,3414,765,123,0,0,24008,89,16776,16011,11700,3695
2022-09-16 23:00:00+00,3575,230,4310,11198,76,3228,771,118,0,0,23506,93,16355,15584,11274,3805
2022-09-16 23:30:00+00,3503,271,4313,10893,47,3228,763,114,0,0,23132,95,16016,15253,10940,3774
2022-09-17 00:00:00+00,3551,301,4310,10721,48,2990,761,117,0,0,22799,91,15840,15079,10769,3852
2022-09-17 00:30:00+00,3577,303,4307,10641,48,2986,771,122,0,0,22755,92,15767,14996,10689,3880
2022-09-17 01:00:00+00,3574,306,4310,10605,47,2910,775,120,0,0,22647,92,15737,14962,10652,3880
2022-09-17 01:30:00+00,3487,300,4311,10645,47,2910,770,116,0,0,22586,90,15773,15003,10692,3787
2022-09-17 02:00:00+00,3602,307,4304,10513,48,2608,791,135,0,0,22308,90,15656,14865,10561,3909
2022-09-17 02:30:00+00,3550,305,4308,10614,47,2586,766,125,0,0,22301,89,15735,14969,10661,3855
2022-09-17 03:00:00+00,3525,304,4310,10746,48,2362,765,117,0,0,22177,89,15869,15104,10794,3829
2022-09-17 03:30:00+00,3410,298,4312,10883,48,2334,766,112,0,0,22163,87,16009,15243,10931,3708
2022-09-17 04:00:00+00,3412,297,4310,11153,47,2244,766,112,0,0,22341,88,16276,15510,11200,3709
2022-09-17 04:30:00+00,3474,306,4310,11158,48,2236,766,123,0,0,22421,90,16282,15516,11206,3780
2022-09-17 05:00:00+00,3495,299,4310,11431,99,2770,774,155,0,0,23333,92,16614,15840,11530,3794
2022-09-17 05:30:00+00,3636,301,4313,11518,105,2748,869,138,0,0,23628,93,16805,15936,11623,3937
2022-09-17 06:00:00+00,4698,345,4312,11886,110,2434,1070,120,193,0,25168,107,17571,16501,12189,5043
2022-09-17 06:30:00+00,5038,336,4314,12329,98,2398,1154,135,863,0,26665,106,18758,17604,13290,5374
2022-09-17 07:00:00+00,5250,231,4308,12304,109,2470,1072,143,1900,0,27787,101,19693,18621,14313,5481
2022-09-17 07:30:00+00,5263,231,4311,12033,97,2480,1194,150,2991,22,28772,98,20626,19432,15121,5494
2022-09-17 08:00:00+00,4480,230,4310,11948,82,3130,1213,121,4029,0,29543,85,21582,20369,16059,4710
2022-09-17 08:30:00+00,4047,230,4311,11969,80,3124,1048,114,5064,0,29987,78,22472,21424,17113,4277
2022-09-17 09:00:00+00,4380,58,4312,12022,65,2306,939,117,5897,0,30096,75,23235,22296,17984,4438
2022-09-17 09:30:00+00,3921,0,4309,12077,65,2290,849,112,6716,0,30339,67,24016,23167,18858,3921
2022-09-17 10:00:00+00,3610,0,4305,11877,65,2656,862,118,7270,0,30763,62,24379,23517,19212,3610
2022-09-17 10:30:00+00,3773,0,4305,11598,65,2666,859,115,7764,0,31145,64,24591,23732,19427,3773
2022-09-17 11:00:00+00,3809,0,4304,11585,47,2404,914,118,7903,0,31084,65,24753,23839,19535,3809
2022-09-17 11:30:00+00,3552,0,4306,12019,47,2384,901,116,8054,0,31379,61,25327,24426,20120,3552
2022-09-17 12:00:00+00,3053,0,4305,11336,47,3548,855,115,8018,0,31277,56,24561,23706,19401,3053
2022-09-17 12:30:00+00,2902,0,4304,10950,48,3632,858,116,7827,0,30637,55,23987,23129,18825,2902
2022-09-17 13:00:00+00,2884,0,4302,10780,48,3540,883,119,7432,0,29988,56,23445,22562,18260,2884
2022-09-17 13:30:00+00,2864,0,4310,11301,48,3516,864,116,6963,0,29982,55,23486,22622,18312,2864
2022-09-17 14:00:00+00,3130,0,4307,11547,48,2984,947,125,6201,0,29289,60,23050,22103,17796,3130
2022-09-17 14:30:00+00,3118,59,4313,12137,48,2946,1038,120,5399,0,29178,62,22935,21897,17584,3177
2022-09-17 15:00:00+00,4288,208,4311,12150,64,2014,1231,127,4652,0,29045,83,22408,21177,16866,4496
2022-09-17 15:30:00+00,5745,233,4310,11974,66,2016,1422,120,3798,0,29684,102,21570,20148,15838,5978
2022-09-17 16:00:00+00,8038,310,4314,11911,103,2434,1433,137,2811,0,31491,128,20572,19139,14825,8348
2022-09-17 16:30:00+00,9532,331,4313,11774,115,2492,1353,122,1723,26,31781,146,19278,17925,13612,9863
2022-09-17 17:00:00+00,9838,348,4314,11333,155,2744,1456,137,816,334,31475,151,18074,16618,12304,10186
2022-09-17 17:30:00+00,10006,515,4310,11201,200,2786,1417,132,188,280,31035,160,17316,15899,11589,10521
2022-09-17 18:00:00+00,10016,533,4306,11134,196,2998,1164,144,1,800,31292,159,16801,15637,11331,10549
2022-09-17 18:30:00+00,9925,589,4307,11231,202,3022,1159,172,0,620,31227,160,16899,15740,11433,10514
2022-09-17 19:00:00+00,9738,703,4306,10778,170,3066,1083,155,0,76,30075,167,16337,15254,10948,10441
2022-09-17 19:30:00+00,9354,708,4304,10545,154,3026,787,121,0,0,28999,167,15790,15003,10699,10062
2022-09-17 20:00:00+00,8982,711,4305,10446,93,2634,768,125,0,0,28064,167,15612,14844,10539,9693
2022-09-17 20:30:00+00,8283,711,4301,10039,88,2600,776,126,0,40,26964,164,15204,14428,10127,8994
2022-09-17 21:00:00+00,7526,674,4306,9822,88,2476,964,150,0,22,26028,158,15180,14216,9910,8200
2022-09-17 21:30:00+00,6428,596,4303,9550,87,2470,1052,202,0,0,24688,147,14992,13940,9637,7024
2022-09-17 22:00:00+00,5378,522,4308,9300,87,3590,773,126,0,0,24084,130,14468,13695,9387,5900
2022-09-17 22:30:00+00,4443,525,4312,8755,99,3764,768,138,0,0,22804,122,13934,13166,8854,4968
2022-09-17 23:00:00+00,3773,497,4310,8002,68,3768,765,124,0,0,21307,116,13145,12380,8070,4270
2022-09-17 23:30:00+00,3398,460,4315,7829,67,3746,765,112,0,0,20692,111,12976,12211,7896,3858
2022-09-18 00:00:00+00,3454,487,4304,7816,48,3300,842,121,0,0,20372,113,13010,12168,7864,3941
2022-09-18 00:30:00+00,3613,468,4309,7808,48,3274,766,126,0,0,20413,115,12931,12165,7856,4081
2022-09-18 01:00:00+00,3610,460,4309,7803,48,3108,769,122,0,0,20228,116,12929,12160,7851,4070
2022-09-18 01:30:00+00,3477,459,4318,7754,48,3104,766,112,0,0,20038,114,12886,12120,7802,3936
2022-09-18 02:00:00+00,3468,468,4307,7679,48,2820,770,121,0,0,19682,114,12804,12034,7727,3936
2022-09-18 02:30:00+00,3505,473,4310,7796,48,2818,770,126,0,0,19846,114,12924,12154,7844,3978
2022-09-18 03:00:00+00,3570,462,4313,7766,48,2534,768,115,0,0,19576,115,12895,12127,7814,4032
2022-09-18 03:30:00+00,3545,460,4314,8052,48,2530,766,113,0,0,19828,113,13180,12414,8100,4005
2022-09-18 04:00:00+00,3660,461,4312,8223,48,2396,769,114,0,0,19983,114,13352,12583,8271,4121
2022-09-18 04:30:00+00,3600,462,4315,8207,48,2384,768,114,0,0,19898,113,13338,12570,8255,4062
2022-09-18 05:00:00+00,3534,460,4311,7937,49,3576,767,122,0,0,20756,111,13064,12297,7986,3994
2022-09-18 05:30:00+00,3207,467,4310,8170,63,3582,786,121,0,0,20706,106,13329,12543,8233,3674
2022-09-18 06:00:00+00,3553,463,4312,8669,65,3052,944,116,111,0,21285,107,14101,13157,8845,4016
2022-09-18 06:30:00+00,3590,461,4313,9303,73,3032,1005,128,493,0,22398,103,15187,14182,9869,4051
2022-09-18 07:00:00+00,4075,298,4314,9751,129,3340,1101,119,1091,0,24218,100,16386,15285,10971,4373
2022-09-18 07:30:00+00,4224,230,4314,10037,115,3356,1096,116,1963,0,25451,95,17525,16429,12115,4454
2022-09-18 08:00:00+00,3549,230,4314,10231,108,4626,879,121,3029,16,27103,79,18561,17682,13368,3779
2022-09-18 08:30:00+00,3390,230,4317,10402,110,4696,878,114,3806,0,27943,74,19513,18635,14318,3620
2022-09-18 09:00:00+00,3359,230,4315,10277,84,4902,892,112,4560,0,28731,72,20128,19236,14921,3589
2022-09-18 09:30:00+00,3347,230,4315,9898,83,4888,892,112,4626,0,28391,72,19814,18922,14607,3577
2022-09-18 10:00:00+00,3491,231,4307,9954,65,4534,926,125,5138,118,28889,70,20390,19464,15157,3722
2022-09-18 10:30:00+00,3664,233,4309,10297,65,4528,941,118,5229,20,29404,71,20841,19900,15591,3897
2022-09-18 11:00:00+00,3716,230,4306,10644,49,4500,927,120,5036,230,29758,70,20962,20035,15729,3946
2022-09-18 11:30:00+00,4008,229,4305,10671,49,4508,983,116,4555,34,29458,75,20563,19580,15275,4237
2022-09-18 12:00:00+00,3915,230,4305,10778,49,4480,864,112,4740,0,29473,73,20736,19872,15567,4145
2022-09-18 12:30:00+00,3692,229,4303,10841,48,4476,866,115,4741,18,29329,70,20799,19933,15630,3921
2022-09-18 13:00:00+00,3803,230,4302,10906,49,4250,875,113,4464,0,28992,70,20596,19721,15419,4033
2022-09-18 13:30:00+00,3645,230,4299,10717,49,4252,872,115,3998,20,28197,70,19935,19063,14764,3875
2022-09-18 14:00:00+00,3684,230,4303,10425,49,5026,870,118,3652,2,28359,78,19299,18429,14126,3914
2022-09-18 14:30:00+00,4028,339,4303,10588,49,5056,859,114,3304,0,28640,86,19103,18244,13941,4367
2022-09-18 15:00:00+00,5357,663,4305,10450,68,4072,1230,137,2920,180,29382,106,18973,17743,13438,6020
2022-09-18 15:30:00+00,6531,678,4308,10442,68,4034,1404,120,2681,74,30340,119,18903,17499,13191,7209
2022-09-18 16:00:00+00,8307,699,4310,10306,71,3540,1400,117,1886,340,30976,137,17973,16573,12263,9006
2022-09-18 16:30:00+00,9369,847,4308,9990,74,3494,1292,182,1133,290,30979,155,16797,15505,11197,10216
2022-09-18 17:00:00+00,10278,867,4314,9835,140,2608,1243,176,571,410,30442,170,16103,14860,10546,11145
2022-09-18 17:30:00+00,10752,621,4312,9776,186,2532,1126,288,138,568,30299,170,15538,14412,10100,11373
2022-09-18 18:00:00+00,10963,548,4311,9794,191,2254,1125,323,0,484,29993,177,15421,14296,9985,11511
2022-09-18 18:30:00+00,11110,503,4308,9712,190,2306,1034,311,0,324,29798,179,15244,14210,9902,11613
2022-09-18 19:00:00+00,11056,475,4305,9478,155,2156,1022,254,0,594,29495,176,14960,13938,9633,11531
2022-09-18 19:30:00+00,11042,495,4308,9337,135,2158,1109,167,0,200,28951,180,14889,13780,9472,11537
2022-09-18 20:00:00+00,10799,650,4309,9025,108,1966,1422,145,0,86,28510,188,14864,13442,9133,11449
2022-09-18 20:30:00+00,10378,693,4306,8426,106,1928,1448,146,0,0,27431,191,14286,12838,8532,11071
2022-09-18 21:00:00+00,10202,393,4308,7991,103,1624,1400,137,0,0,26158,185,13802,12402,8094,10595
2022-09-18 21:30:00+00,9690,229,4306,7414,101,1610,1205,220,0,0,24775,181,13026,11821,7515,9919
2022-09-18 22:00:00+00,9071,229,4302,7027,68,1980,1451,165,0,6,24299,178,12848,11397,7095,9300
2022-09-18 22:30:00+00,8352,232,4308,6673,67,1986,1404,135,0,0,23157,174,12452,11048,6740,8584
2022-09-18 23:00:00+00,7574,230,4306,6593,49,2230,1359,132,0,0,22473,165,12307,10948,6642,7804
2022-09-18 23:30:00+00,7613,237,4312,6059,49,2252,1311,122,0,0,21955,169,11731,10420,6108,7850
2022-09-19 00:00:00+00,7299,234,4312,5755,49,2540,1261,113,0,0,21563,178,11377,10116,5804,7533
2022-09-19 00:30:00+00,7781,240,4312,5271,49,2542,1209,122,0,0,21526,187,10841,9632,5320,8021
2022-09-19 01:00:00+00,7889,233,4318,5066,49,2412,1326,113,0,0,21406,189,10759,9433,5115,8122
2022-09-19 01:30:00+00,7948,241,4311,4666,49,2406,1318,122,0,0,21061,194,10344,9026,4715,8189
2022-09-19 02:00:00+00,7917,232,4318,4487,49,2326,1410,115,0,0,20854,194,10264,8854,4536,8149
2022-09-19 02:30:00+00,7498,230,4310,4712,49,2318,1441,112,0,0,20670,188,10512,9071,4761,7728
2022-09-19 03:00:00+00,8628,355,4310,4701,49,1412,1472,130,0,18,21075,210,10532,9060,4750,8983
2022-09-19 03:30:00+00,8308,566,4314,5001,49,1312,1476,115,0,0,21141,212,10840,9364,5050,8874
2022-09-19 04:00:00+00,10498,895,4312,4847,49,570,1545,236,0,92,23044,238,10753,9208,4896,11393
2022-09-19 04:30:00+00,11078,935,4314,4799,54,262,1501,248,0,30,23221,242,10668,9167,4853,12013
2022-09-19 05:00:00+00,11907,971,4314,4941,110,102,1294,231,0,0,23870,247,10659,9365,5051,12878
2022-09-19 05:30:00+00,12589,973,4313,5165,107,69,1324,136,0,0,24676,248,10909,9585,5272,13562
2022-09-19 06:00:00+00,13592,960,4316,5309,106,46,1606,120,78,0,26133,249,11415,9809,5493,14552
2022-09-19 06:30:00+00,14477,922,4310,5221,101,23,1612,129,357,0,27152,251,11601,9989,5679,15399
2022-09-19 07:00:00+00,15250,966,4315,5039,68,0,1730,114,809,0,28291,253,11961,10231,5916,16216
2022-09-19 07:30:00+00,15827,850,4314,4965,74,2,1840,122,1320,0,29314,249,12513,10673,6359,16677
2022-09-19 08:00:00+00,16181,946,4311,4535,179,0,1851,143,1807,28,29981,251,12683,10832,6521,17127
2022-09-19 08:30:00+00,16206,972,4314,4210,383,0,1823,365,2337,32,30642,249,13067,11244,6930,17178
2022-09-19 09:00:00+00,16201,975,4307,3974,398,0,1854,246,2848,56,30859,246,13381,11527,7220,17176
2022-09-19 09:30:00+00,15810,976,4311,3625,335,0,1707,177,3450,0,30391,244,13428,11721,7410,16786
2022-09-19 10:00:00+00,15695,975,4307,3355,307,0,1627,116,3867,122,30371,241,13463,11836,7529,16670
2022-09-19 10:30:00+00,16052,976,4307,3185,307,0,1656,122,4432,128,31165,240,13887,12231,7924,17028
2022-09-19 11:00:00+00,16032,949,4304,3056,311,2,1634,114,4640,128,31170,239,13945,12311,8007,16981
2022-09-19 11:30:00+00,16816,977,4303,2831,321,2,1678,115,4271,130,31444,248,13404,11726,7423,17793
2022-09-19 12:00:00+00,16467,973,4305,2638,321,288,1664,113,4361,0,31130,246,13289,11625,7320,17440
2022-09-19 12:30:00+00,15929,972,4307,2554,172,320,1541,112,4402,370,30679,243,12976,11435,7128,16901
2022-09-19 13:00:00+00,16787,973,4308,2731,90,622,1773,112,4119,20,31535,249,13021,11248,6940,17760
2022-09-19 13:30:00+00,16698,972,4307,2603,88,628,1790,113,3165,224,30588,255,11953,10163,5856,17670
2022-09-19 14:00:00+00,16847,967,4309,2601,88,624,1915,112,2586,0,30049,262,11499,9584,5275,17814
2022-09-19 14:30:00+00,16818,972,4309,2621,88,624,2067,112,2192,0,29803,265,11277,9210,4901,17790
2022-09-19 15:00:00+00,16167,990,4307,2589,123,1194,1971,136,1680,82,29239,262,10670,8699,4392,17157
2022-09-19 15:30:00+00,17169,1003,4316,2377,124,1258,2009,291,1265,4,29816,272,10091,8082,3766,18172
2022-09-19 16:00:00+00,17447,1086,4313,2574,156,1642,2062,283,864,666,31093,269,9969,7907,3594,18533
2022-09-19 16:30:00+00,18069,1202,4315,2268,166,1634,2112,327,503,892,31488,278,9364,7252,2937,19271
2022-09-19 17:00:00+00,18519,1213,4319,2234,171,786,2309,623,211,804,31189,289,9244,6935,2616,19732
2022-09-19 17:30:00+00,18386,1206,4315,2149,184,758,2396,721,45,804,30964,291,9089,6693,2378,19592
2022-09-19 18:00:00+00,18588,1207,4315,2074,312,784,2308,754,0,612,30954,295,9009,6701,2386,19795
2022-09-19 18:30:00+00,18861,1206,4318,1989,312,850,2103,805,0,616,31060,298,8722,6619,2301,20067
2022-09-19 19:00:00+00,17889,1204,4313,1947,188,1140,2103,588,0,572,29944,294,8551,6448,2135,19093
2022-09-19 19:30:00+00,17314,1206,4311,1916,160,1148,2100,440,0,410,29005,292,8487,6387,2076,18520
2022-09-19 20:00:00+00,17737,1156,4314,1815,161,814,1843,361,0,14,28215,303,8133,6290,1976,18893
2022-09-19 20:30:00+00,17240,1053,4309,1742,153,818,1684,212,0,0,27211,302,7888,6204,1895,18293
2022-09-19 21:00:00+00,17941,955,4273,1757,103,474,1475,143,0,0,27121,308,7608,6133,1860,18896
2022-09-19 21:30:00+00,16887,978,4262,1670,103,228,1647,134,0,0,25909,304,7682,6035,1773,17865
2022-09-19 22:00:00+00,17122,979,3943,1742,103,58,2053,135,0,0,26135,306,7841,5788,1845,18101
2022-09-19 22:30:00+00,16750,970,3938,1913,99,0,1978,128,0,0,25776,303,7928,5950,2012,17720
2022-09-19 23:00:00+00,16409,906,3935,1943,68,0,1560,131,0,0,24952,303,7506,5946,2011,17315
2022-09-19 23:30:00+00,16026,867,3936,2041,52,0,1374,134,0,0,24430,301,7403,6029,2093,16893
2022-09-20 00:00:00+00,15780,973,3939,2168,52,0,1417,128,0,0,24457,301,7576,6159,2220,16753
2022-09-20 00:30:00+00,15679,979,3935,2261,52,18,1378,118,0,0,24420,300,7626,6248,2313,16658
2022-09-20 01:00:00+00,15084,982,3938,2342,52,16,1528,113,0,0,24055,295,7860,6332,2394,16066
2022-09-20 01:30:00+00,14467,979,3937,2404,52,16,1683,112,0,0,23650,291,8076,6393,2456,15446
2022-09-20 02:00:00+00,13985,979,3937,2527,51,16,1961,113,0,0,23569,285,8476,6515,2578,14964
2022-09-20 02:30:00+00,14049,979,3934,2420,51,18,2008,128,0,0,23587,286,8413,6405,2471,15028
2022-09-20 03:00:00+00,14252,980,3939,2378,52,16,2024,117,0,0,23758,288,8393,6369,2430,15232
2022-09-20 03:30:00+00,14513,980,3936,2350,52,16,2001,114,0,0,23962,290,8339,6338,2402,15493
2022-09-20 04:00:00+00,15516,980,3932,2259,52,78,1734,120,0,0,24671,297,7977,6243,2311,16496
2022-09-20 04:30:00+00,16145,980,3933,2289,58,268,1987,120,0,0,25780,299,8267,6280,2347,17125
2022-09-20 05:00:00+00,17318,978,3935,2236,90,444,2105,122,0,0,27228,303,8366,6261,2326,18296
2022-09-20 05:30:00+00,18607,976,3936,2253,100,566,2392,271,0,0,29101,306,8681,6289,2353,19583
2022-09-20 06:00:00+00,19603,930,3936,2129,168,399,2623,335,133,136,30392,304,8989,6366,2430,20533
2022-09-20 06:30:00+00,19802,980,3935,1905,312,399,2735,792,574,420,31854,299,9461,6726,2791,20782
2022-09-20 07:00:00+00,19709,979,3937,1743,463,290,2743,870,1149,56,31939,296,10035,7292,3355,20688
2022-09-20 07:30:00+00,19808,981,3934,1634,463,270,2740,849,1760,0,32439,292,10531,7791,3857,20789
2022-09-20 08:00:00+00,19836,979,3938,1523,405,188,2745,743,2282,94,32733,288,10893,8148,4210,20815
2022-09-20 08:30:00+00,19765,976,3935,1483,277,112,2734,692,2678,50,32702,286,11107,8373,4438,20741
2022-09-20 09:00:00+00,19544,976,3937,1520,179,96,2714,647,3377,0,32990,279,11727,9013,5076,20520
2022-09-20 09:30:00+00,19627,976,3933,1575,84,64,2705,286,4045,82,33377,272,12342,9637,5704,20603
2022-09-20 10:00:00+00,19656,973,3932,1571,72,146,2677,224,4261,14,33526,272,12513,9836,5904,20629
2022-09-20 10:30:00+00,19463,972,3950,1666,63,122,2637,185,4825,0,33883,266,13141,10504,6554,20435
2022-09-20 11:00:00+00,19396,970,3934,1700,52,190,2515,157,5022,0,33936,265,13223,10708,6774,20366
2022-09-20 11:30:00+00,19217,977,3935,1657,52,142,2495,149,4983,0,33607,265,13122,10627,6692,20194
2022-09-20 12:00:00+00,19588,994,3934,1635,52,186,2656,116,4976,42,34179,266,13253,10597,6663,20582
2022-09-20 12:30:00+00,19574,971,3933,1704,52,192,2670,115,4859,78,34148,266,13218,10548,6615,20545
2022-09-20 13:00:00+00,19277,966,3940,1761,52,254,2706,116,4189,0,33261,270,12648,9942,6002,20243
2022-09-20 13:30:00+00,19415,972,3936,1725,58,242,2662,116,3705,142,32973,274,12086,9424,5488,20387
2022-09-20 14:00:00+00,19491,1015,3934,1661,87,252,2498,113,3331,0,32382,281,11511,9013,5079,20506
2022-09-20 14:30:00+00,19425,1176,3934,1560,91,212,2486,313,3123,0,32320,287,11194,8708,4774,20601
2022-09-20 15:00:00+00,19346,1208,3934,1558,126,314,2373,458,2836,282,32435,287,10827,8454,4520,20554
2022-09-20 15:30:00+00,19612,1256,3938,1542,138,348,2457,686,2239,686,32902,290,10314,7857,3919,20868
2022-09-20 16:00:00+00,19566,1428,3934,1476,194,560,2579,756,1506,1082,33081,293,9689,7110,3176,20994
2022-09-20 16:30:00+00,19588,1469,3936,1374,460,606,2612,790,902,1016,32753,297,9284,6672,2736,21057
2022-09-20 17:00:00+00,19604,1462,3939,1267,532,1016,2627,817,400,1284,32948,296,8765,6138,2199,21066
2022-09-20 17:30:00+00,19692,1477,3945,1211,533,1052,2624,907,81,1436,32958,298,8394,5770,1825,21169
2022-09-20 18:00:00+00,19317,1478,3947,1185,445,1098,2656,566,0,1436,32128,298,8233,5577,1630,20795
2022-09-20 18:30:00+00,19350,1479,3951,1250,459,1072,2710,298,0,1020,31589,301,8370,5660,1709,20829
2022-09-20 19:00:00+00,19218,1478,3940,1382,367,488,2718,298,0,822,30711,307,8407,5689,1749,20696
2022-09-20 19:30:00+00,18865,1480,3946,1475,235,364,2720,277,0,958,30320,305,8376,5656,1710,20345
2022-09-20 20:00:00+00,19265,1476,3947,1552,128,162,2726,296,0,626,30178,314,8353,5627,1680,20741
2022-09-20 20:30:00+00,19088,1334,3947,1657,122,284,2726,184,0,188,29530,315,8452,5726,1779,20422
2022-09-20 21:00:00+00,19220,1009,3946,1760,72,428,2724,127,0,62,29348,309,8502,5778,1832,20229
2022-09-20 21:30:00+00,18095,892,3945,1861,68,440,2589,125,0,52,28067,304,8463,5874,1929,18987
2022-09-20 22:00:00+00,17273,937,3944,1966,68,244,2487,132,0,0,27051,301,8465,5978,2034,18210
2022-09-20 22:30:00+00,16198,964,3941,1956,66,92,2452,136,0,12,25817,297,8415,5963,2022,17162
2022-09-20 23:00:00+00,15439,964,3942,1949,51,4,2413,135,0,40,24937,294,8355,5942,2000,16403
2022-09-20 23:30:00+00,15269,976,3939,1976,52,0,2160,148,0,0,24520,295,8127,5967,2028,16245
2022-09-21 00:00:00+00,15044,974,3944,2001,52,4,2278,136,0,0,24433,293,8275,5997,2053,16018
2022-09-21 00:30:00+00,14856,976,3941,2068,52,96,2313,133,0,0,24435,292,8374,6061,2120,15832
2022-09-21 01:00:00+00,14566,974,3942,2081,52,100,2379,129,0,0,24223,290,8454,6075,2133,15540
2022-09-21 01:30:00+00,14319,972,3940,2230,52,128,2382,129,0,0,24152,287,8604,6222,2282,15291
2022-09-21 02:00:00+00,13712,974,3940,2524,52,274,2377,125,0,0,23978,284,8893,6516,2576,14686
2022-09-21 02:30:00+00,13472,950,3942,2766,52,264,2276,125,0,0,23847,280,9036,6760,2818,14422
2022-09-21 03:00:00+00,13443,908,3940,2846,52,322,2265,137,0,0,23913,277,9103,6838,2898,14351
2022-09-21 03:30:00+00,13363,917,3944,2982,52,312,2357,124,0,0,24051,274,9335,6978,3034,14280
2022-09-21 04:00:00+00,13919,928,3942,2888,68,340,2448,132,0,0,24665,278,9346,6898,2956,14847
2022-09-21 04:30:00+00,14756,968,3945,3040,71,352,2327,125,0,0,25584,282,9383,7056,3111,15724
2022-09-21 05:00:00+00,16572,906,3944,3048,87,248,2156,160,0,0,27121,288,9235,7079,3135,17478
2022-09-21 05:30:00+00,18261,973,3947,3186,92,352,2254,366,0,0,29431,294,9479,7225,3278,19234
2022-09-21 06:00:00+00,19736,970,3942,3347,126,284,2538,508,76,100,31627,294,10029,7491,3549,20706
2022-09-21 06:30:00+00,20010,968,3944,3422,245,372,2742,832,424,268,33227,288,10777,8035,4091,20978
2022-09-21 07:00:00+00,20100,969,3945,3567,390,222,2738,940,892,264,34027,281,11532,8794,4849,21069
2022-09-21 07:30:00+00,20094,974,3947,3744,376,102,2721,808,1503,186,34455,275,12291,9570,5623,21068
2022-09-21 08:00:00+00,20116,973,3945,3765,395,42,2725,766,2056,398,35181,268,12886,10161,6216,21089
2022-09-21 08:30:00+00,19985,970,3947,3941,227,0,2713,685,2635,198,35301,264,13463,10750,6803,20955
2022-09-21 09:00:00+00,19774,971,3939,4076,123,0,2700,324,3338,266,35511,257,14176,11476,7537,20745
2022-09-21 09:30:00+00,19493,973,3946,4401,113,0,2699,147,3867,224,35863,250,15026,12327,8381,20466
2022-09-21 10:00:00+00,19180,971,3947,4590,68,0,2710,136,4303,214,36119,245,15618,12908,8961,20151
2022-09-21 10:30:00+00,18992,969,3948,4973,68,0,2575,132,4695,0,36352,240,16259,13684,9736,19961
2022-09-21 11:00:00+00,19066,970,3943,5286,68,58,2428,142,4617,70,36648,240,16342,13914,9971,20036
2022-09-21 11:30:00+00,18799,970,3948,5295,68,52,2432,147,4986,194,36891,235,16729,14297,10349,19769
2022-09-21 12:00:00+00,18554,973,3952,5447,68,92,2433,283,4967,76,36845,235,16867,14434,10482,19527
2022-09-21 12:30:00+00,18240,974,3950,5628,68,74,2585,188,4387,0,36094,235,16618,14033,10083,19214
2022-09-21 13:00:00+00,17756,973,3954,6001,55,200,2737,97,4032,0,35805,233,16779,14042,10088,18729
2022-09-21 13:30:00+00,16938,976,3950,6691,67,218,2739,91,3956,0,35626,226,17403,14664,10714,17914
2022-09-21 14:00:00+00,16761,975,3947,6811,95,160,2726,108,3469,50,35102,226,17048,14322,10375,17736
2022-09-21 14:30:00+00,17113,975,3946,7187,106,286,2735,111,2824,56,35339,231,16798,14063,10117,18088
2022-09-21 15:00:00+00,17406,972,3941,7264,138,286,2737,111,2253,32,35140,235,16333,13596,9655,18378
2022-09-21 15:30:00+00,17700,967,3946,7599,141,549,2730,140,1799,0,35572,239,16215,13485,9539,18667
2022-09-21 16:00:00+00,18000,971,3942,7862,157,565,2734,194,1197,470,36091,240,15892,13158,9216,18971
2022-09-21 16:30:00+00,17961,962,3945,8002,186,668,2736,362,777,498,36097,242,15646,12910,8965,18923
2022-09-21 17:00:00+00,17748,967,3939,8108,259,680,2727,870,366,592,36256,243,15399,12672,8733,18715
2022-09-21 17:30:00+00,17707,972,3958,8069,269,681,2718,894,53,592,35913,245,15067,12349,8391,18679
2022-09-21 18:00:00+00,17773,973,3957,7996,261,717,2709,980,0,822,36188,245,14923,12214,8257,18746
2022-09-21 18:30:00+00,17773,968,3963,8157,255,726,2708,803,0,1072,36425,242,15083,12375,8412,18741
2022-09-21 19:00:00+00,17654,962,3957,8492,228,608,2709,713,0,130,35453,245,15386,12677,8720,18616
2022-09-21 19:30:00+00,16489,960,3945,9055,172,311,2739,342,0,154,34167,233,15911,13172,9227,17449
2022-09-21 20:00:00+00,15925,961,3945,9531,133,144,2584,187,0,0,33410,228,16193,13609,9664,16886
2022-09-21 20:30:00+00,14259,883,3946,9938,121,160,2217,98,0,0,31622,215,16222,14005,10059,15142
2022-09-21 21:00:00+00,13403,685,3945,10198,72,32,2235,95,0,0,30664,203,16450,14214,10270,14088
2022-09-21 21:30:00+00,11697,364,3946,10492,70,2,2133,108,0,0,28812,182,16641,14508,10562,12061
2022-09-21 22:00:00+00,9693,26,3943,10887,70,75,2295,112,0,0,27101,154,17195,14900,10957,9719
2022-09-21 22:30:00+00,8493,0,3939,10927,70,242,2242,136,0,0,26050,145,17178,14936,10997,8493
2022-09-21 23:00:00+00,7599,0,3943,11163,54,192,2103,104,0,0,25158,134,17263,15160,11217,7599
2022-09-21 23:30:00+00,7007,0,3938,11249,54,168,2161,113,0,0,24690,127,17402,15241,11303,7007
2022-09-22 00:00:00+00,6866,0,3941,11277,54,172,2177,119,0,0,24606,125,17449,15272,11331,6866
2022-09-22 00:30:00+00,7273,0,3944,10991,55,215,2130,106,0,0,24714,132,17120,14990,11046,7273
2022-09-22 01:00:00+00,7322,0,3941,10728,57,214,2210,117,0,0,24589,134,16936,14726,10785,7322
2022-09-22 01:30:00+00,7091,0,3940,10545,57,164,2274,117,0,0,24188,131,16816,14542,10602,7091
2022-09-22 02:00:00+00,7152,0,3939,10412,57,62,2268,103,0,0,23993,131,16676,14408,10469,7152
2022-09-22 02:30:00+00,7496,0,3939,10066,57,88,2177,99,0,0,23922,137,16239,14062,10123,7496
2022-09-22 03:00:00+00,7799,0,3942,9630,57,4,2207,102,0,0,23741,142,15836,13629,9687,7799
2022-09-22 03:30:00+00,8005,0,3961,9470,57,1,2179,87,0,0,23760,145,15667,13488,9527,8005
2022-09-22 04:00:00+00,8117,0,3939,9297,57,26,2209,96,0,40,23781,147,15502,13293,9354,8117
2022-09-22 04:30:00+00,9275,165,3942,8675,57,210,2334,138,0,178,24974,169,15008,12674,8732,9440
2022-09-22 05:00:00+00,11040,374,3944,8314,69,296,2575,385,0,180,27177,194,14902,12327,8383,11414
2022-09-22 05:30:00+00,12794,622,3944,8309,83,276,2468,645,0,0,29141,215,14804,12336,8392,13416
2022-09-22 06:00:00+00,15138,865,3941,8209,132,56,2328,723,124,122,31638,231,14734,12406,8465,16003
2022-09-22 06:30:00+00,16515,968,3943,7996,170,44,2359,594,598,12,33199,238,15066,12707,8764,17483
2022-09-22 07:00:00+00,16978,972,3945,7622,203,0,2655,614,1247,0,34236,237,15672,13017,9072,17950
2022-09-22 07:30:00+00,17198,834,3948,7199,207,0,2626,596,1970,280,34858,231,15950,13324,9376,18032
2022-09-22 08:00:00+00,17387,849,3948,6834,224,2,2535,529,2616,284,35208,230,16157,13622,9674,18236
2022-09-22 08:30:00+00,17506,882,3946,6854,221,0,2552,219,3369,12,35561,228,16942,14390,10444,18388
2022-09-22 09:00:00+00,17248,780,3945,7005,170,3,2309,183,3993,74,35710,220,17422,15113,11168,18028
2022-09-22 09:30:00+00,16763,835,3944,7147,170,5,2622,170,4485,0,36141,215,18368,15746,11802,17598
2022-09-22 10:00:00+00,16169,962,3942,7113,142,6,2693,196,4576,20,35819,214,18466,15773,11831,17131
2022-09-22 10:30:00+00,16288,969,3947,6913,123,7,2733,199,4763,196,36138,213,18479,15746,11799,17257
2022-09-22 11:00:00+00,16447,969,3947,6844,104,8,2746,244,4808,80,36197,215,18449,15703,11756,17416
2022-09-22 11:30:00+00,16679,973,3941,6618,103,8,2668,237,4723,0,35950,219,18053,15385,11444,17652
2022-09-22 12:00:00+00,16670,955,3942,6422,81,9,2565,250,4324,18,35235,223,17334,14769,10827,17625
2022-09-22 12:30:00+00,16806,868,3940,6206,74,12,2515,276,3961,550,35208,222,16696,14181,10241,17674
2022-09-22 13:00:00+00,17084,959,3944,5893,101,13,2592,240,3761,302,34889,230,16291,13699,9755,18043
2022-09-22 13:30:00+00,17414,966,3942,5655,99,13,2742,238,3303,290,34662,236,15741,12999,9057,18380
2022-09-22 14:00:00+00,18016,1048,3939,5455,101,18,2742,292,2716,464,34791,245,14953,12211,8272,19064
2022-09-22 14:30:00+00,18405,1196,3945,5291,106,0,2742,400,2243,434,34762,255,14327,11585,7640,19601
2022-09-22 15:00:00+00,18651,1352,3945,5322,133,2,2742,581,1688,646,35062,262,13830,11088,7143,20003
2022-09-22 15:30:00+00,18839,1461,3942,5328,145,2,2721,676,1356,1128,35598,264,13492,10771,6829,20300
2022-09-22 16:00:00+00,18791,1452,3948,5315,217,1,2722,847,909,1088,35290,268,13111,10389,6441,20243
2022-09-22 16:30:00+00,18877,1458,3943,5195,249,0,2710,889,512,1314,35147,270,12609,9899,5956,20335
2022-09-22 17:00:00+00,18802,1453,3946,5357,283,2,2703,927,191,1314,34978,270,12480,9777,5831,20255
2022-09-22 17:30:00+00,18636,1463,3943,5529,261,0,2702,733,24,1322,34613,269,12459,9757,5814,20099
2022-09-22 18:00:00+00,19109,1462,3944,5473,242,0,2703,743,0,1334,35010,272,12362,9659,5715,20571
2022-09-22 18:30:00+00,19094,1462,3941,5294,226,0,2704,837,0,1302,34860,274,12165,9461,5520,20556
2022-09-22 19:00:00+00,18524,1463,3947,5293,211,322,2703,735,0,820,34018,273,12154,9451,5504,19987
2022-09-22 19:30:00+00,17994,1464,3941,5436,181,344,2703,445,0,916,33424,269,12261,9558,5617,19458
2022-09-22 20:00:00+00,17965,1341,3944,5402,140,344,2704,198,0,438,32476,269,12190,9486,5542,19306
2022-09-22 20:30:00+00,17185,1018,3938,5346,137,268,2704,193,0,0,30789,264,12125,9421,5483,18203
2022-09-22 21:00:00+00,17443,959,3937,5118,136,1,2698,179,0,196,30667,266,11889,9191,5254,18402
2022-09-22 21:30:00+00,16607,973,3938,4829,132,0,2679,157,0,34,29349,267,11578,8899,4961,17580
2022-09-22 22:00:00+00,15280,967,3942,4689,115,0,2587,165,0,0,27745,263,11333,8746,4804,16247
2022-09-22 22:30:00+00,14549,975,3942,4253,118,2,2430,161,0,54,26484,264,10743,8313,4371,15524
2022-09-22 23:00:00+00,14300,971,3943,3338,84,0,2494,166,0,0,25296,272,9859,7365,3422,15271
2022-09-22 23:30:00+00,14233,971,3944,2781,84,0,2564,95,0,0,24672,278,9373,6809,2865,15204
2022-09-23 00:00:00+00,14163,965,3945,2668,66,2,2535,91,0,0,24435,279,9214,6679,2734,15128
2022-09-23 00:30:00+00,14209,977,3940,2449,65,0,2575,108,0,0,24323,282,9029,6454,2514,15186
2022-09-23 01:00:00+00,14177,974,3943,2283,65,0,2462,164,0,0,24068,284,8753,6291,2348,15151
2022-09-23 01:30:00+00,14213,976,3940,2121,65,0,2535,138,0,0,23988,286,8661,6126,2186,15189
2022-09-23 02:00:00+00,13948,973,3939,2062,64,0,2572,277,0,0,23835,286,8637,6065,2126,14921
2022-09-23 02:30:00+00,14023,967,3941,1880,66,0,2582,281,0,0,23740,289,8469,5887,1946,14990
2022-09-23 03:00:00+00,14232,965,3940,1858,82,0,2578,255,0,0,23910,289,8458,5880,1940,15197
2022-09-23 03:30:00+00,14456,973,3939,1820,81,0,2417,181,0,0,23867,291,8257,5840,1901,15429
2022-09-23 04:00:00+00,15120,1115,3943,1898,81,0,2470,157,0,0,24784,296,8392,5922,1979,16235
2022-09-23 04:30:00+00,15637,1355,3942,1973,84,37,2573,320,0,0,25921,304,8572,5999,2057,16992
2022-09-23 05:00:00+00,16182,1464,3943,2067,120,136,2644,500,0,0,27056,307,8774,6130,2187,17646
2022-09-23 05:30:00+00,17438,1473,3942,2147,136,286,2678,551,0,108,28759,309,8903,6225,2283,18911
2022-09-23 06:00:00+00,18530,1471,3943,2162,289,163,2678,817,27,330,30410,308,9099,6421,2478,20001
2022-09-23 06:30:00+00,18876,1468,3942,2101,350,344,2703,921,300,530,31535,305,9396,6693,2751,20344
2022-09-23 07:00:00+00,18917,1464,3941,2310,362,342,2702,915,797,238,31987,301,10112,7410,3469,20381
2022-09-23 07:30:00+00,18906,1467,3944,2342,360,310,2703,908,1387,250,32577,295,10736,8033,4089,20373
2022-09-23 08:00:00+00,18629,1467,3944,2420,245,409,2702,909,1997,254,32976,289,11308,8606,4662,20096
2022-09-23 08:30:00+00,18281,1469,3946,2519,234,445,2702,872,2742,0,33210,283,12143,9441,5495,19750
2022-09-23 09:00:00+00,17961,1469,3948,2582,193,505,2700,697,3486,110,33651,275,12909,10209,6261,19430
2022-09-23 09:30:00+00,17628,1468,3944,2613,191,532,2701,708,3973,0,33758,271,13422,10721,6777,19096
2022-09-23 10:00:00+00,16736,1470,3943,2779,155,578,2700,374,4637,0,33372,261,14214,11514,7571,18206
2022-09-23 10:30:00+00,16413,1471,3944,2981,154,605,2700,368,5217,0,33853,254,14996,12296,8352,17884
2022-09-23 11:00:00+00,16878,1470,3944,3020,93,721,2700,222,5322,2,34371,256,15079,12379,8435,18348
2022-09-23 11:30:00+00,16627,1470,3950,3096,92,819,2703,236,5551,0,34544,253,15392,12689,8739,18097
2022-09-23 12:00:00+00,16905,1469,3946,3139,92,885,2700,174,5553,38,34901,254,15430,12730,8784,18374
2022-09-23 12:30:00+00,16999,1470,3947,3291,92,831,2600,130,5640,0,35000,253,15570,12970,9023,18469
2022-09-23 13:00:00+00,16717,1465,3945,3506,92,976,2527,143,5273,0,34644,254,15343,12816,8871,18182
2022-09-23 13:30:00+00,16510,1467,3946,3723,91,926,2504,110,5195,0,34472,252,15459,12955,9009,17977
2022-09-23 14:00:00+00,16854,1464,3944,3811,91,917,2468,101,4327,0,33976,260,14641,12173,8229,18318
2022-09-23 14:30:00+00,17069,1464,3944,3947,93,1071,2418,94,3764,0,33864,266,14166,11748,7804,18533
2022-09-23 15:00:00+00,17129,1457,3942,3959,136,1277,2457,168,3152,0,33677,271,13646,11189,7247,18586
2022-09-23 15:30:00+00,17374,1464,3935,4010,139,1326,2513,630,2546,300,34236,275,13143,10630,6695,18838
2022-09-23 16:00:00+00,17335,1463,3934,4400,191,1330,2521,779,1941,494,34388,275,12987,10466,6532,18798
2022-09-23 16:30:00+00,17519,1462,3932,4699,191,1342,2544,837,1162,802,34490,277,12528,9984,6052,18981
2022-09-23 17:00:00+00,17726,1467,3937,4941,220,1368,2510,901,514,838,34422,282,12122,9612,5675,19193
2022-09-23 17:30:00+00,17500,1463,3935,5296,220,1362,2533,987,62,1062,34420,280,12046,9513,5578,18963
2022-09-23 18:00:00+00,17250,1464,3933,5412,219,1182,2462,982,0,880,33784,280,12026,9564,5631,18714
2022-09-23 18:30:00+00,17114,1468,3929,5534,200,1124,2414,907,0,810,33500,279,12077,9663,5734,18582
2022-09-23 19:00:00+00,17044,1458,3930,5512,175,1060,2435,735,0,798,33147,277,12052,9617,5687,18502
2022-09-23 19:30:00+00,16214,1465,3933,5454,181,952,2343,569,0,912,32023,273,11911,9568,5635,17679
2022-09-23 20:00:00+00,16736,1467,3939,5257,215,578,2513,388,0,104,31197,281,11924,9411,5472,18203
2022-09-23 20:30:00+00,16230,1347,3940,4955,169,518,2640,145,0,0,29944,277,11704,9064,5124,17577
2022-09-23 21:00:00+00,16155,1020,3938,4986,130,447,2688,133,0,174,29671,266,11742,9054,5116,17175
2022-09-23 21:30:00+00,15523,942,3938,4986,124,287,2661,271,0,0,28732,262,11709,9048,5110,16465
2022-09-23 22:00:00+00,15032,963,3940,4890,105,116,2385,286,0,0,27717,262,11320,8935,4995,15995
2022-09-23 22:30:00+00,14475,974,3941,4787,99,2,2027,214,0,0,26519,261,10854,8827,4886,15449
2022-09-23 23:00:00+00,14212,976,3944,4696,88,0,2027,152,0,0,26095,261,10755,8728,4784,15188
2022-09-23 23:30:00+00,13880,973,3940,4500,89,0,2027,118,0,0,25527,261,10556,8529,4589,14853
2022-09-24 00:00:00+00,13870,973,3938,4429,89,0,2025,147,0,0,25471,262,10481,8456,4518,14843
2022-09-24 00:30:00+00,13807,979,3937,4599,89,0,2025,188,0,0,25624,260,10650,8625,4688,14786
2022-09-24 01:00:00+00,13790,981,3943,4834,69,0,2025,125,0,0,25767,257,10871,8846,4903,14771
2022-09-24 01:30:00+00,13352,906,3941,5079,69,0,2027,87,0,0,25461,251,11116,9089,5148,14258
2022-09-24 02:00:00+00,13373,714,3940,5100,69,0,2014,96,0,0,25306,245,11123,9109,5169,14087
2022-09-24 02:30:00+00,12960,782,3941,5467,69,0,1776,85,0,0,25080,242,11253,9477,5536,13742
2022-09-24 03:00:00+00,12835,782,3938,5722,69,0,1454,88,0,0,24888,241,11183,9729,5791,13617
2022-09-24 03:30:00+00,12646,751,3940,5691,68,0,1451,86,0,0,24633,239,11150,9699,5759,13397
2022-09-24 04:00:00+00,12890,752,3936,5755,68,0,1451,85,0,0,24937,240,11210,9759,5823,13642
2022-09-24 04:30:00+00,12651,748,3941,6278,71,0,1450,85,0,0,25224,233,11740,10290,6349,13399
2022-09-24 05:00:00+00,13228,649,3942,6370,137,30,1452,96,0,0,25904,233,11901,10449,6507,13877
2022-09-24 05:30:00+00,13728,638,3945,6512,144,150,1454,86,0,0,26657,235,12055,10601,6656,14366
2022-09-24 06:00:00+00,14672,826,3946,6627,182,114,1459,104,67,0,27997,243,12281,10822,6876,15498
2022-09-24 06:30:00+00,15007,972,3946,6732,189,38,1457,155,516,0,29012,243,12840,11383,7437,15979
2022-09-24 07:00:00+00,15256,961,3948,6817,224,142,1457,206,1319,0,30330,238,13765,12308,8360,16217
2022-09-24 07:30:00+00,15495,926,3945,6690,211,164,1462,447,2241,12,31593,233,14549,13087,9142,16421
2022-09-24 08:00:00+00,15472,961,3947,6111,185,36,1459,438,3204,104,31917,229,14906,13447,9500,16433
2022-09-24 08:30:00+00,15504,973,3946,5650,172,12,1461,207,4061,136,32122,226,15290,13829,9883,16477
2022-09-24 09:00:00+00,15425,969,3947,5423,143,1,1459,113,4827,76,32383,222,15799,14340,10393,16394
2022-09-24 09:30:00+00,15399,971,3946,5435,141,2,1459,135,5427,0,32915,219,16408,14949,11003,16370
2022-09-24 10:00:00+00,15282,914,3943,5209,110,326,1459,103,6059,0,33405,214,16780,15321,11378,16196
2022-09-24 10:30:00+00,15192,902,3946,5169,109,334,1459,92,6262,0,33465,212,16945,15486,11540,16094
2022-09-24 11:00:00+00,15225,888,3948,5558,108,86,1460,89,6533,0,33895,209,17607,16147,12199,16113
2022-09-24 11:30:00+00,14874,877,3948,6164,105,0,1457,89,6022,0,33536,205,17696,16239,12291,15751
2022-09-24 12:00:00+00,14745,751,3944,6438,88,38,1455,105,5581,0,33145,203,17506,16051,12107,15496
2022-09-24 12:30:00+00,14931,717,3947,6520,86,0,1450,95,4808,110,32664,207,16811,15361,11414,15648
2022-09-24 13:00:00+00,14531,787,3943,6602,72,0,1447,99,4251,90,31822,209,16315,14868,10925,15318
2022-09-24 13:30:00+00,14446,898,3942,6549,72,54,1451,92,4036,118,31658,214,16050,14599,10657,15344
2022-09-24 14:00:00+00,14681,953,3941,7002,72,202,1455,90,3576,44,32016,218,16046,14591,10650,15634
2022-09-24 14:30:00+00,14076,963,3938,8014,74,286,1456,107,2984,102,32000,212,16466,15010,11072,15039
2022-09-24 15:00:00+00,15426,963,3941,8174,92,160,1458,92,2258,56,32620,222,15923,14465,10524,16389
2022-09-24 15:30:00+00,16027,947,3935,8413,92,232,1458,146,1820,168,33238,226,15718,14260,10325,16974
2022-09-24 16:00:00+00,15978,858,3936,8525,139,620,1458,131,1246,436,33327,225,15304,13846,9910,16836
2022-09-24 16:30:00+00,16417,874,3941,8158,139,604,1458,401,647,666,33305,233,14343,12885,8944,17291
2022-09-24 17:00:00+00,16442,971,3935,8344,231,250,1459,529,278,698,33137,236,14247,12788,8853,17413
2022-09-24 17:30:00+00,16618,972,3933,7964,243,276,1592,540,30,1016,33184,239,13762,12170,8237,17590
2022-09-24 18:00:00+00,16590,970,3936,7621,245,220,1819,687,0,1128,33216,240,13621,11802,7866,17560
2022-09-24 18:30:00+00,16854,975,3938,7320,251,158,1962,626,0,998,33082,243,13471,11509,7571,17829
2022-09-24 19:00:00+00,16953,977,3937,7042,252,126,1983,543,0,680,32493,248,13214,11231,7294,17930
2022-09-24 19:30:00+00,16917,974,3936,6880,236,16,2011,482,0,458,31910,250,13063,11052,7116,17891
2022-09-24 20:00:00+00,16688,976,3938,7108,127,0,1961,413,0,76,31287,251,13134,11173,7235,17664
2022-09-24 20:30:00+00,16018,973,3941,7245,116,46,1925,339,0,28,30631,247,13227,11302,7361,16991
2022-09-24 21:00:00+00,16001,973,3941,7082,73,140,1913,348,0,24,30495,250,13009,11096,7155,16974
2022-09-24 21:30:00+00,15149,971,3939,6596,86,226,1910,260,0,100,29237,249,12531,10621,6682,16120
2022-09-24 22:00:00+00,13591,948,3945,6510,86,166,1889,235,0,0,27370,242,12430,10541,6596,14539
2022-09-24 22:30:00+00,12825,810,3946,6599,86,10,1871,220,0,0,26367,232,12502,10631,6685,13635
2022-09-24 23:00:00+00,11961,821,3943,7001,69,7,1858,149,0,0,25809,223,12871,11013,7070,12782
2022-09-24 23:30:00+00,11623,729,3945,6757,69,3,1856,107,0,118,25208,219,12627,10771,6826,12352
2022-09-25 00:00:00+00,11740,505,3935,6805,69,0,1856,91,0,0,25001,214,12665,10809,6874,12245
2022-09-25 00:30:00+00,11995,392,3941,6766,69,0,1856,107,0,0,25126,213,12632,10776,6835,12387
2022-09-25 01:00:00+00,12142,250,3950,6896,69,0,1854,89,0,0,25250,209,12769,10915,6965,12392
2022-09-25 01:30:00+00,11629,230,3948,7191,69,0,1856,88,0,0,25011,202,13064,11208,7260,11859
2022-09-25 02:00:00+00,11494,235,3942,7612,69,0,1879,91,0,0,25322,198,13502,11623,7681,11729
2022-09-25 02:30:00+00,11281,234,3940,7678,69,0,1911,87,0,0,25200,195,13598,11688,7748,11515
2022-09-25 03:00:00+00,11262,239,3940,7508,69,0,1908,95,0,0,25021,197,13425,11517,7577,11501
2022-09-25 03:30:00+00,11153,237,3944,7593,69,0,1899,92,0,0,24987,195,13505,11606,7662,11390
2022-09-25 04:00:00+00,11034,231,3944,7842,95,0,2012,86,0,0,25244,191,13893,11881,7937,11265
2022-09-25 04:30:00+00,10609,240,3945,8152,101,0,2062,90,0,0,25199,186,14260,12198,8253,10849
2022-09-25 05:00:00+00,10982,245,3947,8102,141,0,2061,107,0,0,25585,189,14251,12190,8243,11227
2022-09-25 05:30:00+00,11377,276,3947,8215,138,0,2050,87,0,0,26090,192,14350,12300,8353,11653
2022-09-25 06:00:00+00,11681,301,3949,8178,180,0,2096,93,80,0,26558,194,14483,12387,8438,11982
2022-09-25 06:30:00+00,11942,438,3951,8084,203,0,2108,107,581,0,27414,197,14927,12819,8868,12380
2022-09-25 07:00:00+00,11669,495,3952,8080,229,0,2110,113,1315,0,27963,191,15686,13576,9624,12164
2022-09-25 07:30:00+00,12009,498,3953,7800,228,0,2103,123,2142,74,28930,190,16226,14123,10170,12507
2022-09-25 08:00:00+00,11975,499,3949,7718,212,0,2068,116,3133,130,29800,184,17080,15012,11063,12474
2022-09-25 08:30:00+00,12018,491,3952,7803,199,0,2065,172,3758,0,30458,180,17777,15712,11760,12509
2022-09-25 09:00:00+00,11907,438,3953,8022,159,0,2064,155,4428,66,31192,173,18626,16562,12609,12345
2022-09-25 09:30:00+00,11769,262,3951,8571,144,0,2034,123,4802,0,31656,163,19502,17468,13517,12031
2022-09-25 10:00:00+00,11780,234,3945,8695,112,0,2014,124,5116,0,32020,161,19882,17868,13923,12014
2022-09-25 10:30:00+00,11884,240,3941,8914,107,0,2014,128,5668,0,32896,158,20644,18630,14689,12124
2022-09-25 11:00:00+00,11992,379,3940,8837,88,0,2013,169,5498,0,32916,163,20376,18363,14423,12371
2022-09-25 11:30:00+00,11891,442,3941,9136,88,0,2021,330,4941,0,32790,166,20127,18106,14165,12333
2022-09-25 12:00:00+00,11762,452,3942,9471,72,0,2021,286,4403,0,32409,166,19909,17888,13946,12214
2022-09-25 12:30:00+00,11699,452,3943,9765,72,0,2020,398,3782,0,32131,168,19582,17562,13619,12151
2022-09-25 13:00:00+00,11951,445,3944,10175,72,0,2019,423,3289,0,32318,170,19499,17480,13536,12396
2022-09-25 13:30:00+00,11823,423,3944,10894,72,0,2020,414,2784,0,32374,167,19714,17694,13750,12246
2022-09-25 14:00:00+00,12613,383,3942,11343,72,0,2038,415,2624,0,33430,170,20019,17981,14039,12996
2022-09-25 14:30:00+00,13050,331,3940,11762,74,46,2037,413,2440,0,34093,171,20253,18216,14276,13381
2022-09-25 15:00:00+00,12807,311,3942,12361,116,154,2043,417,2111,0,34262,169,20573,18530,14588,13118
2022-09-25 15:30:00+00,13155,289,3942,13140,110,416,2046,423,1549,0,35070,172,20787,18741,14799,13444
2022-09-25 16:00:00+00,13362,263,3943,13828,128,390,2063,393,1090,0,35460,171,21052,18989,15046,13625
2022-09-25 16:30:00+00,13822,366,3942,14102,144,492,2072,370,529,0,35839,178,20789,18717,14775,14188
2022-09-25 17:00:00+00,13883,410,3946,14499,226,480,2076,308,192,30,36050,179,20939,18863,14917,14293
2022-09-25 17:30:00+00,13713,348,3950,15038,234,532,2078,313,9,0,36215,175,21309,19231,15281,14061
2022-09-25 18:00:00+00,13071,236,3948,15804,229,594,2079,308,0,0,36269,165,22060,19981,16033,13307
2022-09-25 18:30:00+00,12100,191,3950,16301,216,516,2083,269,0,0,35626,155,22550,20467,16517,12291
2022-09-25 19:00:00+00,10922,0,3943,16633,168,420,2082,114,0,0,34282,140,22826,20744,16801,10922
2022-09-25 19:30:00+00,9587,0,3938,16871,169,292,2061,94,0,0,33012,127,23039,20978,17040,9587
2022-09-25 20:00:00+00,7167,0,3938,17153,97,522,1943,113,0,24,30957,108,23131,21188,17250,7167
2022-09-25 20:30:00+00,5740,0,3947,17448,94,440,1948,123,0,0,29740,92,23437,21489,17542,5740
2022-09-25 21:00:00+00,5052,0,3945,17669,65,270,1943,121,0,0,29065,82,23622,21679,17734,5052
2022-09-25 21:30:00+00,4179,0,3947,17878,77,258,1938,97,0,0,28374,71,23840,21902,17955,4179
2022-09-25 22:00:00+00,3624,0,3943,17362,77,398,1917,107,0,0,27428,68,23299,21382,17439,3624
2022-09-25 22:30:00+00,3661,0,3946,16261,77,614,1882,126,0,0,26567,75,22166,20284,16338,3661
2022-09-25 23:00:00+00,3740,0,3949,15990,77,776,1829,93,0,0,26454,78,21845,20016,16067,3740
2022-09-25 23:30:00+00,3723,0,3947,16013,77,896,1657,93,0,0,26406,80,21694,20037,16090,3723
2022-09-26 00:00:00+00,3722,0,3947,15980,77,888,1685,96,0,0,26395,80,21689,20004,16057,3722
2022-09-26 00:30:00+00,3684,0,3952,15962,77,898,1797,88,0,0,26458,80,21788,19991,16039,3684
2022-09-26 01:00:00+00,3597,0,3947,15758,77,776,2017,101,0,0,26273,78,21799,19782,15835,3597
2022-09-26 01:30:00+00,3490,0,3952,15888,77,778,1804,92,0,0,26081,76,21721,19917,15965,3490
2022-09-26 02:00:00+00,3534,0,3949,15759,76,770,1815,103,0,0,26006,77,21599,19784,15835,3534
2022-09-26 02:30:00+00,3488,0,3954,15822,76,774,1778,92,0,0,25984,76,21630,19852,15898,3488
2022-09-26 03:00:00+00,3535,0,3945,15693,76,786,1824,101,0,0,25960,77,21538,19714,15769,3535
2022-09-26 03:30:00+00,3675,0,3946,16005,76,768,1768,90,0,0,26328,77,21795,20027,16081,3675
2022-09-26 04:00:00+00,3941,0,3937,15857,83,888,2005,119,0,0,26830,83,21882,19877,15940,3941
2022-09-26 04:30:00+00,5097,0,3940,15512,100,882,2208,106,0,0,27845,97,21760,19552,15612,5097
2022-09-26 05:00:00+00,6365,0,3940,16153,130,774,2322,116,0,0,29800,107,22545,20223,16283,6365
2022-09-26 05:30:00+00,7310,0,3941,16836,135,810,2513,125,0,0,31670,113,23425,20912,16971,7310
2022-09-26 06:00:00+00,9412,0,3940,16985,167,590,2690,143,20,262,34209,127,23802,21112,17172,9412
2022-09-26 06:30:00+00,10639,0,3940,17339,187,512,2783,164,304,16,35884,134,24553,21770,17830,10639
2022-09-26 07:00:00+00,11101,0,3940,17513,222,256,2756,168,843,132,36931,132,25274,22518,18578,11101
2022-09-26 07:30:00+00,11105,0,3940,17185,231,80,2740,212,1528,26,37047,130,25624,22884,18944,11105
2022-09-26 08:00:00+00,10778,0,3934,16644,218,8,2742,209,2409,340,37282,125,25947,23205,19271,10778
2022-09-26 08:30:00+00,10688,0,3941,16737,213,0,2707,314,3193,4,37797,123,26791,24084,20143,10688
2022-09-26 09:00:00+00,10243,0,3940,16994,195,0,2733,255,3577,0,37937,117,27439,24706,20766,10243
2022-09-26 09:30:00+00,9549,0,3944,17426,168,0,2746,153,4054,22,38062,109,28338,25592,21648,9549
2022-09-26 10:00:00+00,8217,0,3947,17688,130,0,2726,114,4615,0,37437,96,29106,26380,22433,8217
2022-09-26 10:30:00+00,8012,0,3942,17732,114,0,2740,112,4842,0,37494,94,29370,26630,22688,8012
2022-09-26 11:00:00+00,7771,18,3943,17857,111,60,2742,98,5327,0,37927,91,29980,27238,23295,7789
2022-09-26 11:30:00+00,7520,61,3944,17959,111,80,2744,93,4900,0,37412,90,29658,26914,22970,7581
2022-09-26 12:00:00+00,7730,88,3942,17791,111,196,2727,108,4621,104,37418,93,29192,26465,22523,7818
2022-09-26 12:30:00+00,7644,104,3944,17781,112,202,2727,89,4534,0,37137,93,29098,26371,22427,7748
2022-09-26 13:00:00+00,7465,194,3941,17806,112,222,2731,100,4446,8,37025,95,29036,26305,22364,7659
2022-09-26 13:30:00+00,7261,369,3943,17850,112,251,2724,104,3145,168,35927,101,27774,25050,21107,7630
2022-09-26 14:00:00+00,8365,339,3944,17945,111,134,2715,96,3068,70,36787,110,27783,25068,21124,8704
2022-09-26 14:30:00+00,8900,330,3941,18303,110,230,2724,94,2887,124,37643,114,27965,25241,21300,9230
2022-09-26 15:00:00+00,11338,348,3941,18173,133,122,2734,92,2373,48,39302,132,27354,24620,20679,11686
2022-09-26 15:30:00+00,12571,288,3939,18174,133,132,2738,127,1664,82,39848,142,26648,23910,19971,12859
2022-09-26 16:00:00+00,14135,0,3939,17910,167,186,2741,126,1089,166,40459,149,25846,23105,19166,14135
2022-09-26 16:30:00+00,14213,0,3943,17882,199,278,2740,330,574,18,40177,153,25338,22598,18655,14213
2022-09-26 17:00:00+00,14199,0,3943,17434,257,174,2741,335,167,420,39670,154,24542,21801,17858,14199
2022-09-26 17:30:00+00,14475,0,3944,16793,256,246,2741,356,7,710,39528,158,23741,21000,17056,14475
2022-09-26 18:00:00+00,14790,0,3949,16440,257,340,2743,324,0,558,39401,163,23389,20646,16697,14790
2022-09-26 18:30:00+00,14810,0,3948,16063,258,164,2745,377,0,436,38801,164,23014,20269,16321,14810
2022-09-26 19:00:00+00,14067,0,3950,15991,224,0,2742,269,0,374,37617,158,22907,20165,16215,14067
2022-09-26 19:30:00+00,13103,0,3950,16172,203,0,2733,181,0,330,36672,151,23058,20325,16375,13103
2022-09-26 20:00:00+00,12081,0,3946,15720,153,564,2784,188,0,272,35708,150,22603,19819,15873,12081
2022-09-26 20:30:00+00,11007,0,3945,15379,144,602,2766,132,0,112,34087,145,22234,19468,15523,11007
2022-09-26 21:00:00+00,10342,0,3945,14921,79,2,2742,115,0,392,32538,136,21687,18945,15000,10342
2022-09-26 21:30:00+00,8662,0,3951,15132,59,1,2660,154,0,92,30711,123,21802,19142,15191,8662
2022-09-26 22:00:00+00,6054,0,3945,15032,59,72,2517,144,0,296,28119,98,21553,19036,15091,6054
2022-09-26 22:30:00+00,4983,0,3947,15139,60,208,2366,126,0,74,26903,88,21512,19146,15199,4983
2022-09-26 23:00:00+00,4309,0,3943,15387,60,160,2220,119,0,0,26198,79,21610,19390,15447,4309
2022-09-26 23:30:00+00,3865,0,3945,15342,60,184,2171,121,0,0,25688,74,21518,19347,15402,3865
2022-09-27 00:00:00+00,3863,0,3948,15456,60,456,2197,119,0,0,26099,78,21661,19464,15516,3863
2022-09-27 00:30:00+00,3784,0,3946,15428,60,626,2191,117,0,0,26152,79,21625,19434,15488,3784
2022-09-27 01:00:00+00,4231,0,3948,15409,59,552,2192,115,0,0,26506,84,21608,19416,15468,4231
2022-09-27 01:30:00+00,3913,0,3949,15561,60,510,2143,121,0,0,26257,79,21713,19570,15621,3913
2022-09-27 02:00:00+00,4320,0,3949,15406,61,698,2272,100,0,0,26806,87,21688,19416,15467,4320
2022-09-27 02:30:00+00,4502,0,3950,15366,61,656,2334,90,0,0,26959,88,21711,19377,15427,4502
2022-09-27 03:00:00+00,4755,0,3948,15487,60,780,2257,101,0,0,27388,92,21752,19495,15547,4755
2022-09-27 03:30:00+00,4932,0,3951,15284,60,710,2348,94,0,0,27379,94,21643,19295,15344,4932
2022-09-27 04:00:00+00,5454,0,3947,15066,71,750,2366,95,0,0,27749,101,21450,19084,15137,5454
2022-09-27 04:30:00+00,5789,0,3948,15475,78,712,2371,97,0,0,28470,103,21872,19501,15553,5789
2022-09-27 05:00:00+00,7339,0,3945,15933,137,864,2384,104,0,0,30706,117,22399,20015,16070,7339
2022-09-27 05:30:00+00,9164,0,3940,15877,152,726,2504,105,0,184,32652,131,22473,19969,16029,9164
2022-09-27 06:00:00+00,12052,0,3939,15827,185,434,2713,105,29,320,35604,149,22693,19980,16041,12052
2022-09-27 06:30:00+00,13441,0,3940,15896,216,280,2749,176,277,152,37127,156,23078,20329,16389,13441
2022-09-27 07:00:00+00,13769,0,3942,15769,239,106,2731,153,820,348,37877,154,23501,20770,16828,13769
2022-09-27 07:30:00+00,14060,0,3942,15300,208,40,2728,314,1495,370,38457,155,23673,20945,17003,14060
2022-09-27 08:00:00+00,14470,0,3939,15004,220,0,2729,607,2147,586,39702,157,24039,21310,17371,14470
2022-09-27 08:30:00+00,14460,0,3944,14879,176,0,2730,756,2890,358,40193,156,24619,21889,17945,14460
2022-09-27 09:00:00+00,14556,0,3942,14981,143,0,2729,656,3564,0,40571,155,25359,22630,18688,14556
2022-09-27 09:30:00+00,14481,0,3941,14790,143,0,2728,450,3664,334,40531,153,25266,22538,18597,14481
2022-09-27 10:00:00+00,14152,0,3948,15027,120,0,2727,451,3736,452,40613,149,25558,22831,18883,14152
2022-09-27 10:30:00+00,14146,0,3953,14809,115,0,2728,669,4332,128,40880,150,25937,23209,19256,14146
2022-09-27 11:00:00+00,14216,0,3953,14256,106,50,2728,725,4281,534,40849,152,25324,22596,18643,14216
2022-09-27 11:30:00+00,14386,0,3955,14279,105,66,2728,806,4213,112,40650,155,25280,22552,18597,14386
2022-09-27 12:00:00+00,14217,0,3952,14007,106,284,2727,723,4540,78,40634,155,25332,22605,18653,14217
2022-09-27 12:30:00+00,14254,0,3956,13588,117,290,2728,521,3960,314,39728,158,24349,21621,17665,14254
2022-09-27 13:00:00+00,14456,0,3954,13248,117,332,2716,473,3265,150,38711,164,23300,20584,16630,14456
2022-09-27 13:30:00+00,14587,0,3957,13383,119,340,2726,322,2850,184,38468,165,23035,20309,16352,14587
2022-09-27 14:00:00+00,15389,0,3953,13342,120,334,2730,243,2792,310,39213,170,22937,20207,16254,15389
2022-09-27 14:30:00+00,16149,0,3951,13308,125,238,2735,369,2448,296,39619,175,22567,19832,15881,16149
2022-09-27 15:00:00+00,16693,0,3949,12943,158,300,2736,501,2241,602,40123,180,22027,19291,15342,16693
2022-09-27 15:30:00+00,17298,0,3944,12426,236,252,2738,689,1361,1144,40088,187,20705,17967,14023,17298
2022-09-27 16:00:00+00,17964,0,3943,11663,393,166,2744,958,1050,1466,40347,193,19793,17049,13106,17964
2022-09-27 16:30:00+00,18481,0,3948,11262,601,346,2745,1042,508,1206,40139,204,19064,16319,12371,18481
2022-09-27 17:00:00+00,18180,0,3945,11121,572,310,2746,1080,159,912,39025,206,18543,15797,11852,18180
2022-09-27 17:30:00+00,18374,0,3942,10728,578,416,2746,970,3,1268,39025,209,17997,15251,11309,18374
2022-09-27 18:00:00+00,18428,0,3946,10419,546,322,2744,1054,0,1090,38549,211,17655,14911,10965,18428
2022-09-27 18:30:00+00,18527,0,3945,10115,525,206,2745,1000,0,1004,38067,213,17330,14585,10640,18527
2022-09-27 19:00:00+00,17414,0,3947,10770,388,76,2740,966,0,936,37237,204,17845,15105,11158,17414
2022-09-27 19:30:00+00,17093,0,3947,10381,290,0,2737,559,0,1402,36409,200,17355,14618,10671,17093
2022-09-27 20:00:00+00,17732,0,3951,10027,201,38,2742,480,0,698,35869,210,16921,14179,10228,17732
2022-09-27 20:30:00+00,17511,0,3947,9292,177,0,2742,392,0,216,34277,215,16158,13416,9469,17511
2022-09-27 21:00:00+00,17222,0,3947,9108,150,0,2741,268,0,172,33608,214,15946,13205,9258,17222
2022-09-27 21:30:00+00,16186,0,3946,8981,116,38,2685,162,0,0,32114,211,15728,13043,9097,16186
2022-09-27 22:00:00+00,15402,0,3948,8370,85,42,2564,166,0,16,30593,211,14967,12403,8455,15402
2022-09-27 22:30:00+00,14647,0,3951,8448,81,0,2562,136,0,0,29825,205,15042,12480,8529,14647
2022-09-27 23:00:00+00,13974,0,3946,8613,81,0,2495,134,0,0,29243,200,15135,12640,8694,13974
2022-09-27 23:30:00+00,13318,0,3941,8331,81,0,2454,142,0,0,28267,198,14807,12353,8412,13318
2022-09-28 00:00:00+00,13479,0,3942,7759,80,0,2452,151,0,0,27863,203,14233,11781,7839,13479
2022-09-28 00:30:00+00,13835,0,3942,7126,72,0,2472,144,0,0,27591,210,13612,11140,7198,13835
2022-09-28 01:00:00+00,13823,0,3946,7097,57,0,2405,136,0,0,27464,210,13505,11100,7154,13823
2022-09-28 01:30:00+00,13554,0,3942,7265,58,0,2509,148,0,0,27476,207,13774,11265,7323,13554
2022-09-28 02:00:00+00,13330,0,3945,7315,58,0,2529,149,0,0,27326,205,13847,11318,7373,13330
2022-09-28 02:30:00+00,13576,0,3940,7014,58,0,2532,144,0,0,27264,209,13544,11012,7072,13576
2022-09-28 03:00:00+00,13994,0,3943,6660,57,0,2456,137,0,0,27247,215,13116,10660,6717,13994
2022-09-28 03:30:00+00,14319,0,3957,6567,57,0,2276,136,0,0,27312,218,12857,10581,6624,14319
2022-09-28 04:00:00+00,14492,29,3969,6321,68,0,2318,140,0,0,27337,222,12676,10358,6389,14521
2022-09-28 04:30:00+00,15258,144,4005,6124,69,0,2520,134,0,0,28254,230,12718,10198,6193,15402
2022-09-28 05:00:00+00,16658,295,4050,5967,116,74,2667,527,0,166,30520,241,12800,10133,6083,16953
2022-09-28 05:30:00+00,17914,492,4056,5804,237,184,2728,872,0,348,32635,252,12825,10097,6041,18406
2022-09-28 06:00:00+00,19086,738,4055,5791,456,176,2741,1123,29,424,34619,260,13072,10331,6276,19824
2022-09-28 06:30:00+00,19772,1050,4056,5899,505,76,2740,1132,358,546,36134,264,13558,10818,6762,20822
2022-09-28 07:00:00+00,19448,1109,4058,6025,444,22,2712,814,1147,550,36329,257,14386,11674,7616,20557
2022-09-28 07:30:00+00,19362,1097,4062,6144,281,0,2650,743,2064,484,36887,251,15201,12551,8489,20459
2022-09-28 08:00:00+00,19502,1111,4060,6238,286,0,2735,736,3202,342,38212,244,16521,13786,9726,20613
2022-09-28 08:30:00+00,19338,1148,4060,6184,262,0,2704,625,4222,64,38607,240,17432,14728,10668,20486
2022-09-28 09:00:00+00,18624,1131,4059,6187,218,0,2656,557,4885,0,38317,233,18005,15349,11290,19755
2022-09-28 09:30:00+00,18207,1119,4057,6109,216,0,2626,509,5408,26,38277,227,18416,15790,11733,19326
2022-09-28 10:00:00+00,18045,889,4061,6437,175,72,2637,368,5650,128,38462,218,18960,16323,12262,18934
2022-09-28 10:30:00+00,18151,819,4064,6313,134,232,2719,295,5602,88,38417,220,18832,16113,12049,18970
2022-09-28 11:00:00+00,18675,879,4073,6300,132,278,2776,264,5656,96,39129,223,18937,16161,12088,19554
2022-09-28 11:30:00+00,18670,898,4078,6438,133,288,2779,218,5496,28,39026,224,18924,16145,12067,19568
2022-09-28 12:00:00+00,18438,902,4081,6644,143,288,2763,210,5063,0,38532,224,18694,15931,11850,19340
2022-09-28 12:30:00+00,18018,863,4087,6725,144,288,2733,205,5190,0,38253,220,18879,16146,12059,18881
2022-09-28 13:00:00+00,17690,909,4103,6811,145,364,2640,221,4967,0,37850,221,18666,16026,11923,18599
2022-09-28 13:30:00+00,17619,1176,4146,6891,146,384,2589,212,4443,0,37606,229,18215,15626,11480,18795
2022-09-28 14:00:00+00,17212,1195,4151,7071,165,384,2541,212,3434,0,36365,232,17362,14821,10670,18407
2022-09-28 14:30:00+00,17659,1025,4151,7120,174,354,2683,242,3633,0,37041,229,17761,15078,10927,18684
2022-09-28 15:00:00+00,17797,894,4153,7133,176,276,2699,270,3090,60,36548,231,17251,14552,10399,18691
2022-09-28 15:30:00+00,18433,967,4149,7399,191,126,2645,354,1997,312,36573,238,16381,13736,9587,19400
2022-09-28 16:00:00+00,18840,1112,4158,7270,264,0,2596,341,1317,1122,37020,242,15605,13009,8851,19952
2022-09-28 16:30:00+00,19410,1332,4177,7016,257,0,2537,498,770,1136,37133,254,14757,12220,8043,20742
2022-09-28 17:00:00+00,19360,1443,4183,6944,270,0,2457,893,229,1106,36885,261,14083,11626,7443,20803
2022-09-28 17:30:00+00,19742,1319,4177,7011,283,0,2444,928,8,1092,37004,261,13923,11479,7302,21061
2022-09-28 18:00:00+00,19884,1202,4178,7262,283,20,2566,1125,0,1244,37764,255,14289,11723,7545,21086
2022-09-28 18:30:00+00,19487,911,4179,7632,265,26,2676,869,0,1182,37227,246,14752,12076,7897,20398
2022-09-28 19:00:00+00,19535,921,4178,7922,202,0,2589,560,0,934,36841,246,14891,12302,8124,20456
2022-09-28 19:30:00+00,19182,943,4183,7888,170,0,2461,271,0,822,35920,246,14702,12241,8058,20125
2022-09-28 20:00:00+00,19323,974,4183,8242,159,54,2548,293,0,84,35860,249,15132,12584,8401,20297
2022-09-28 20:30:00+00,18686,593,4184,7967,143,90,2523,187,0,136,34509,241,14817,12294,8110,19279
2022-09-28 21:00:00+00,17691,391,4181,7801,112,188,2526,110,0,6,33006,235,14620,12094,7913,18082
2022-09-28 21:30:00+00,16522,389,4182,7923,113,312,2511,94,0,0,32046,229,14729,12218,8036,16911
2022-09-28 22:00:00+00,15474,432,4203,7636,79,180,2387,111,0,0,30502,226,14305,11918,7715,15906
2022-09-28 22:30:00+00,15029,459,4225,7463,76,36,2379,91,0,0,29758,225,14143,11764,7539,15488
2022-09-28 23:00:00+00,14507,382,4227,7346,73,0,2397,92,0,0,29024,220,14043,11646,7419,14889
2022-09-28 23:30:00+00,14099,355,4243,7270,69,34,2331,88,0,0,28489,218,13913,11582,7339,14454
2022-09-29 00:00:00+00,14128,234,4249,6944,53,116,2356,89,0,0,28169,218,13602,11246,6997,14362
2022-09-29 00:30:00+00,14281,230,4247,6754,53,168,2391,90,0,0,28214,221,13445,11054,6807,14511
2022-09-29 01:00:00+00,14379,237,4246,6480,56,24,2404,95,0,0,27921,223,13186,10782,6536,14616
2022-09-29 01:30:00+00,14125,233,4242,6325,64,0,2407,96,0,0,27492,222,13038,10631,6389,14358
2022-09-29 02:00:00+00,14364,230,4236,5832,63,12,2413,109,0,0,27259,228,12544,10131,5895,14594
2022-09-29 02:30:00+00,14386,230,4244,5822,63,42,2396,85,0,0,27268,228,12525,10129,5885,14616
2022-09-29 03:00:00+00,14548,230,4242,5621,51,0,2408,96,0,0,27196,230,12322,9914,5672,14778
2022-09-29 03:30:00+00,14823,236,4241,5611,50,8,2404,84,0,0,27457,232,12306,9902,5661,15059
2022-09-29 04:00:00+00,15252,317,4237,5564,50,96,2254,111,0,0,27881,239,12105,9851,5614,15569
2022-09-29 04:30:00+00,16526,316,4241,5176,70,252,2270,94,0,0,28945,250,11757,9487,5246,16842
2022-09-29 05:00:00+00,17946,475,4243,4939,79,352,2514,109,0,0,30657,261,11775,9261,5018,18421
2022-09-29 05:30:00+00,19249,921,4244,4475,98,564,2711,108,0,0,32370,280,11528,8817,4573,20170
2022-09-29 06:00:00+00,19938,1232,4247,4169,175,516,2650,409,12,66,33414,291,11253,8603,4356,21170
2022-09-29 06:30:00+00,20359,1419,4245,3917,213,394,2659,878,234,100,34418,295,11268,8609,4364,21778
2022-09-29 07:00:00+00,20441,1308,4249,3635,235,430,2640,902,783,150,34773,288,11542,8902,4653,21749
2022-09-29 07:30:00+00,20457,1263,4242,3293,236,376,2604,709,1470,380,35030,282,11845,9241,4999,21720
2022-09-29 08:00:00+00,20534,1375,4248,3052,236,594,2632,682,2134,476,35963,277,12302,9670,5422,21909
2022-09-29 08:30:00+00,20442,1435,4245,3075,231,578,2603,758,2752,186,36305,276,12906,10303,6058,21877
2022-09-29 09:00:00+00,20274,1466,4247,3023,220,294,2576,706,3326,4,36136,276,13392,10816,6569,21740
2022-09-29 09:30:00+00,20026,1464,4237,2855,205,258,2585,754,3521,0,35905,276,13403,10818,6581,21490
2022-09-29 10:00:00+00,19793,1464,4233,2796,164,632,2511,589,3699,0,35881,278,13403,10892,6659,21257
2022-09-29 10:30:00+00,20029,1471,4224,2695,126,652,2458,195,4362,104,36316,274,13865,11407,7183,21500
2022-09-29 11:00:00+00,20098,1426,4236,2456,124,804,2424,196,4487,0,36251,275,13727,11303,7067,21524
2022-09-29 11:30:00+00,20043,1322,4237,2335,124,738,2219,267,4691,0,35976,273,13606,11387,7150,21365
2022-09-29 12:00:00+00,20138,1443,4242,2260,124,26,2357,608,4853,14,36065,271,13836,11479,7237,21581
2022-09-29 12:30:00+00,20116,1435,4282,2154,123,0,2365,625,4845,60,36005,271,13769,11404,7122,21551
2022-09-29 13:00:00+00,20250,1451,4300,2163,135,0,2430,613,4449,218,36009,273,13477,11047,6747,21701
2022-09-29 13:30:00+00,20202,1441,4303,2278,130,0,2533,614,4366,0,35867,273,13610,11077,6774,21643
2022-09-29 14:00:00+00,20035,1080,4304,2755,135,24,2375,683,3919,120,35430,267,13488,11113,6809,21115
2022-09-29 14:30:00+00,20176,844,4304,3355,144,64,2371,697,3795,270,36020,258,13969,11598,7294,21020
2022-09-29 15:00:00+00,20421,701,4307,3481,201,696,2197,698,2939,616,36257,259,13125,10928,6621,21122
2022-09-29 15:30:00+00,20817,729,4302,3609,230,768,2122,728,2323,956,36584,262,12586,10464,6162,21546
2022-09-29 16:00:00+00,20923,835,4302,3546,324,902,2063,693,1500,1356,36444,264,11735,9672,5370,21758
2022-09-29 16:30:00+00,21168,1016,4307,3471,363,928,2175,641,767,1576,36412,272,11083,8908,4601,22184
2022-09-29 17:00:00+00,21108,937,4302,3768,402,1170,2121,719,200,1610,36337,274,10793,8672,4370,22045
2022-09-29 17:30:00+00,21280,797,4317,4133,514,1194,2088,640,3,1602,36568,270,11055,8967,4650,22077
2022-09-29 18:00:00+00,21788,803,4350,4018,381,1038,2229,737,0,1538,36882,273,10978,8749,4399,22591
2022-09-29 18:30:00+00,21730,741,4353,4031,344,1026,2243,705,0,1322,36495,272,10971,8728,4375,22471
2022-09-29 19:00:00+00,21701,857,4348,4205,279,910,2323,532,0,844,35999,281,11155,8832,4484,22558
2022-09-29 19:30:00+00,20789,818,4346,4670,240,888,2200,312,0,742,35005,275,11456,9256,4910,21607
2022-09-29 20:00:00+00,20736,783,4341,4632,207,106,2253,219,0,186,33463,278,11433,9180,4839,21519
2022-09-29 20:30:00+00,19993,552,4347,4593,205,102,2287,176,0,14,32269,272,11432,9145,4798,20545
2022-09-29 21:00:00+00,19697,879,4346,4646,166,72,2386,153,0,68,32413,276,11544,9158,4812,20576
2022-09-29 21:30:00+00,18456,911,4346,5147,147,176,1890,95,0,0,31168,271,11530,9640,5294,19367
2022-09-29 22:00:00+00,17023,763,4343,5353,129,230,1538,132,0,156,29667,261,11363,9825,5482,17786
2022-09-29 22:30:00+00,15958,714,4346,5553,128,244,1533,102,0,0,28578,255,11560,10027,5681,16672
2022-09-29 23:00:00+00,15226,653,4347,5745,128,418,1512,86,0,0,28115,249,11732,10220,5873,15879
2022-09-29 23:30:00+00,14651,564,4350,6184,128,390,1510,91,0,0,27868,240,12172,10662,6312,15215
2022-09-30 00:00:00+00,13804,910,4349,6488,112,278,1510,99,0,0,27550,241,12459,10949,6600,14714
2022-09-30 00:30:00+00,13915,978,4348,6501,109,380,1402,99,0,0,27732,244,12360,10958,6610,14893
2022-09-30 01:00:00+00,14126,975,4351,6173,109,424,1387,96,0,0,27641,248,12020,10633,6282,15101
2022-09-30 01:30:00+00,13964,976,4353,6183,107,474,1389,99,0,0,27545,248,12032,10643,6290,14940
2022-09-30 02:00:00+00,13488,976,4356,6463,106,608,1388,87,0,0,27472,244,12313,10925,6569,14464
2022-09-30 02:30:00+00,13396,975,4356,6701,107,560,1386,88,0,0,27569,241,12550,11164,6808,14371
2022-09-30 03:00:00+00,13121,977,4359,6795,118,706,1364,92,0,0,27532,240,12636,11272,6913,14098
2022-09-30 03:30:00+00,13080,976,4357,7066,117,744,1351,87,0,0,27778,237,12891,11540,7183,14056
2022-09-30 04:00:00+00,13045,978,4356,7315,128,860,1367,84,0,0,28133,236,13166,11799,7443,14023
2022-09-30 04:30:00+00,13292,975,4364,7740,128,904,1417,84,0,0,28904,234,13649,12232,7868,14267
2022-09-30 05:00:00+00,14588,855,4372,8064,166,904,1416,84,0,0,30449,235,14018,12602,8230,15443
2022-09-30 05:30:00+00,16154,820,4372,8569,148,904,1416,93,0,0,32476,238,14505,13089,8717,16974
2022-09-30 06:00:00+00,17530,931,4370,8978,182,904,1415,377,27,0,34714,244,14972,13557,9187,18461
2022-09-30 06:30:00+00,17890,928,4373,9521,218,904,1413,711,312,0,36270,240,15837,14424,10051,18818
2022-09-30 07:00:00+00,18054,902,4373,10108,232,880,1406,847,607,0,37409,235,16726,15320,10947,18956
2022-09-30 07:30:00+00,17871,857,4369,10984,222,840,1432,603,919,0,38097,225,17926,16494,12125,18728
2022-09-30 08:00:00+00,17364,792,4365,11642,197,744,1431,407,1203,0,38145,215,18838,17407,13042,18156
2022-09-30 08:30:00+00,17053,921,4373,12412,197,648,1431,180,1249,0,38464,211,19662,18231,13858,17974
2022-09-30 09:00:00+00,16619,789,4367,13243,165,526,1406,99,1424,0,38638,200,20605,19199,14832,17408
2022-09-30 09:30:00+00,15974,402,4366,14032,162,602,1361,118,1523,0,38540,185,21444,20083,15717,16376
2022-09-30 10:00:00+00,13935,58,4367,14965,127,946,1342,113,1786,0,37639,163,22587,21245,16878,13993
2022-09-30 10:30:00+00,12825,0,4366,15895,124,1130,1351,93,2006,0,37790,151,23742,22391,18025,12825
2022-09-30 11:00:00+00,11777,0,4370,17018,117,1380,1388,94,1809,40,37993,143,24702,23314,18944,11777
2022-09-30 11:30:00+00,11089,0,4369,18151,115,1280,1229,85,1662,60,38040,134,25526,24297,19928,11089
2022-09-30 12:00:00+00,11316,0,4363,18679,126,1080,764,86,1460,0,37874,133,25392,24628,20265,11316
2022-09-30 12:30:00+00,10974,0,4360,19006,173,922,722,90,1134,0,37381,130,25395,24673,20313,10974
2022-09-30 13:00:00+00,11541,0,4360,19012,215,596,721,89,944,138,37616,131,25252,24531,20171,11541
2022-09-30 13:30:00+00,11446,0,4364,19269,203,592,840,84,739,0,37537,131,25415,24575,20211,11446
2022-09-30 14:00:00+00,12261,0,4365,19216,243,556,1090,88,645,26,38490,136,25559,24469,20104,12261
2022-09-30 14:30:00+00,12192,0,4359,19101,263,700,1263,184,496,174,38732,138,25482,24219,19860,12192
2022-09-30 15:00:00+00,12338,0,4362,18952,277,730,1241,731,411,260,39302,142,25243,24002,19640,12338
2022-09-30 15:30:00+00,12801,9,4359,18611,284,824,1311,845,334,0,39378,149,24899,23588,19229,12810
2022-09-30 16:00:00+00,13166,184,4356,18383,313,728,1311,965,271,500,40177,153,24634,23323,18967,13350
2022-09-30 16:30:00+00,13561,426,4358,17796,331,770,1401,970,124,594,40331,163,24010,22609,18251,13987
2022-09-30 17:00:00+00,13783,492,4360,17654,342,864,1404,899,46,594,40438,167,23806,22402,18042,14275
2022-09-30 17:30:00+00,13785,494,4359,17519,359,722,1334,913,0,594,40079,168,23571,22237,17878,14279
2022-09-30 18:00:00+00,13555,488,4358,17253,385,526,1307,825,0,696,39393,165,23303,21996,17638,14043
2022-09-30 18:30:00+00,13162,483,4358,16886,431,344,1301,779,0,844,38588,161,22976,21675,17317,13645
2022-09-30 19:00:00+00,12703,355,4358,16809,402,1070,1265,314,0,770,38045,157,22834,21569,17211,13058
2022-09-30 19:30:00+00,12009,241,4359,16667,358,1024,1368,213,0,998,37238,148,22752,21384,17025,12250
2022-09-30 20:00:00+00,11384,230,4360,16706,325,2344,1086,117,0,236,36788,152,22477,21391,17031,11614
2022-09-30 20:30:00+00,10434,229,4359,16709,307,2266,922,92,0,130,35448,145,22297,21375,17016,10663
2022-09-30 21:00:00+00,9431,230,4359,16139,317,2172,910,89,0,0,33647,139,21725,20815,16456,9661
2022-09-30 21:30:00+00,8097,215,4355,14926,310,2052,935,95,0,0,30985,132,20526,19591,15236,8312
2022-09-30 22:00:00+00,6828,108,4349,14442,246,1590,725,118,0,0,28406,113,19762,19037,14688,6935
2022-09-30 22:30:00+00,5701,0,4357,14022,239,1622,722,86,0,0,26749,98,19340,18618,14261,5701
2022-09-30 23:00:00+00,4863,0,4356,13949,242,1566,723,106,0,0,25805,83,19270,18547,14191,4863
2022-09-30 23:30:00+00,4335,0,4357,13917,242,1620,720,85,0,0,25275,77,19236,18516,14159,4335
2022-10-01 00:00:00+00,4231,0,4365,13363,241,1926,723,88,0,0,24938,74,18692,17969,13604,4231
2022-10-01 00:30:00+00,4227,0,4360,13159,239,1946,721,92,0,0,24744,75,18479,17758,13398,4227
2022-10-01 01:00:00+00,4054,0,4360,13134,218,1470,724,91,0,0,24051,74,18436,17712,13352,4054
2022-10-01 01:30:00+00,3746,0,4362,12894,214,1424,723,86,0,0,23449,70,18193,17470,13108,3746
2022-10-01 02:00:00+00,3840,0,4361,13101,197,1274,726,92,0,0,23591,71,18385,17659,13298,3840
2022-10-01 02:30:00+00,3738,0,4368,13386,195,1240,715,87,0,0,23729,69,18664,17949,13581,3738
2022-10-01 03:00:00+00,3705,0,4367,13411,189,1032,714,84,0,0,23502,69,18681,17967,13600,3705
2022-10-01 03:30:00+00,3750,0,4362,13317,188,1014,712,84,0,0,23427,70,18579,17867,13505,3750
2022-10-01 04:00:00+00,4366,0,4360,13684,193,454,715,95,0,0,23867,78,18952,18237,13877,4366
2022-10-01 04:30:00+00,4350,0,4364,14039,198,482,715,94,0,0,24242,77,19316,18601,14237,4350
2022-10-01 05:00:00+00,4369,0,4360,14170,228,664,718,123,0,0,24632,77,19476,18758,14398,4369
2022-10-01 05:30:00+00,4461,0,4359,14617,231,648,716,146,0,0,25178,77,19923,19207,14848,4461
2022-10-01 06:00:00+00,4034,0,4358,14710,298,1171,715,100,14,0,25400,71,20095,19380,15022,4034
2022-10-01 06:30:00+00,3966,0,4358,15245,310,1181,717,122,345,0,26245,67,20975,20258,15900,3966
2022-10-01 07:00:00+00,3669,0,4355,15119,312,1974,525,123,1102,188,27367,64,21413,20888,16533,3669
2022-10-01 07:30:00+00,3778,0,4360,15379,322,2094,412,100,1980,0,28425,63,22453,22041,17681,3778
2022-10-01 08:00:00+00,3406,0,4357,15679,265,2324,421,100,2932,0,29484,60,23654,23233,18876,3406
2022-10-01 08:30:00+00,3115,0,4360,15837,264,2292,424,95,3818,0,30205,54,24703,24279,19919,3115
2022-10-01 09:00:00+00,3255,0,4361,16028,211,2062,419,93,4537,0,30966,55,25556,25138,20776,3255
2022-10-01 09:30:00+00,3042,0,4361,16079,207,2062,411,86,5259,0,31507,52,26317,25906,21545,3042
2022-10-01 10:00:00+00,3072,0,4359,16172,202,2062,412,98,5833,0,32210,51,26978,26566,22207,3072
2022-10-01 10:30:00+00,2983,0,4359,16384,188,2062,412,94,6079,0,32561,49,27422,27010,22651,2983
2022-10-01 11:00:00+00,3236,0,4361,16488,188,2014,411,106,6263,0,33067,51,27711,27300,22939,3236
2022-10-01 11:30:00+00,3175,0,4358,16624,188,2014,411,97,6330,0,33197,50,27911,27500,23142,3175
2022-10-01 12:00:00+00,3156,0,4357,16683,188,1834,411,100,5954,0,32683,50,27593,27182,22825,3156
2022-10-01 12:30:00+00,2955,0,4356,16840,174,1828,409,85,5729,0,32376,48,27508,27099,22743,2955
2022-10-01 13:00:00+00,2944,0,4347,16892,171,1350,407,86,5054,0,31250,46,26870,26464,22116,2944
2022-10-01 13:30:00+00,2889,0,4343,16927,168,1328,408,101,4655,0,30819,46,26501,26093,21750,2889
2022-10-01 14:00:00+00,2758,0,4342,17026,184,1280,410,94,4596,0,30690,43,26558,26148,21806,2758
2022-10-01 14:30:00+00,3336,0,4342,17016,210,1302,410,98,3687,0,30401,51,25665,25255,20913,3336
2022-10-01 15:00:00+00,3649,0,4348,16838,222,1974,407,84,2999,0,30521,60,24814,24407,20059,3649
2022-10-01 15:30:00+00,4494,0,4345,16709,227,2036,412,94,2324,0,30641,71,24017,23605,19260,4494
2022-10-01 16:00:00+00,5593,2,4347,16551,255,1528,414,95,1268,278,30331,81,22835,22421,18074,5595
2022-10-01 16:30:00+00,6262,112,4347,16372,333,1718,429,194,582,510,30859,95,22063,21634,17287,6374
2022-10-01 17:00:00+00,6858,237,4350,16025,362,1920,427,321,101,806,31407,109,21265,20838,16488,7095
2022-10-01 17:30:00+00,7511,322,4350,15514,347,1944,420,363,0,858,31629,118,20631,20211,15861,7833
2022-10-01 18:00:00+00,7314,269,4352,15581,350,2216,419,375,0,748,31624,111,20702,20283,15931,7583
2022-10-01 18:30:00+00,7021,303,4351,15512,372,2018,421,389,0,550,30937,107,20656,20235,15884,7324
2022-10-01 19:00:00+00,6696,260,4350,15469,352,1908,430,367,0,392,30224,103,20601,20171,15821,6956
2022-10-01 19:30:00+00,6007,229,4355,16000,334,1852,420,250,0,102,29549,94,21109,20689,16334,6236
2022-10-01 20:00:00+00,5283,229,4355,16579,332,1458,422,125,0,92,28875,85,21688,21266,16911,5512
2022-10-01 20:30:00+00,4676,230,4355,16478,311,1406,421,101,0,154,28132,79,21565,21144,16789,4906
2022-10-01 21:00:00+00,4271,230,4354,16644,285,1336,447,110,0,200,27877,75,21730,21283,16929,4501
2022-10-01 21:30:00+00,3385,237,4358,16665,309,1362,526,94,0,150,27086,64,21858,21332,16974,3622
2022-10-01 22:00:00+00,2933,230,4365,15837,256,1578,645,124,0,0,25968,62,21103,20458,16093,3163
2022-10-01 22:30:00+00,2858,229,4358,14939,254,1614,711,84,0,0,25047,63,20262,19551,15193,3087
2022-10-01 23:00:00+00,2897,238,4357,14786,223,1446,720,93,0,0,24760,67,20086,19366,15009,3135
2022-10-01 23:30:00+00,2847,230,4362,14792,223,1364,710,94,0,0,24622,66,20087,19377,15015,3077
2022-10-02 00:00:00+00,2874,269,4354,15395,223,554,728,145,0,0,24542,62,20700,19972,15618,3143
2022-10-02 00:30:00+00,2983,312,4357,15151,222,540,727,105,0,0,24397,65,20457,19730,15373,3295
2022-10-02 01:00:00+00,3045,283,4368,14700,204,362,709,86,0,0,23757,66,19981,19272,14904,3328
2022-10-02 01:30:00+00,3060,286,4366,13907,202,354,704,101,0,0,22980,69,19179,18475,14109,3346
2022-10-02 02:00:00+00,3110,296,4365,13670,204,452,715,107,0,0,22919,71,18954,18239,13874,3406
2022-10-02 02:30:00+00,3291,302,4362,13139,204,474,721,90,0,0,22583,75,18426,17705,13343,3593
2022-10-02 03:00:00+00,3246,299,4364,12784,194,610,725,109,0,0,22331,75,18067,17342,12978,3545
2022-10-02 03:30:00+00,3297,302,4366,12049,195,628,729,109,0,0,21675,79,17339,16610,12244,3599
2022-10-02 04:00:00+00,3308,312,4366,11639,224,798,734,112,0,0,21493,82,16963,16229,11863,3620
2022-10-02 04:30:00+00,3368,269,4366,11335,239,864,732,154,0,0,21327,82,16672,15940,11574,3637
2022-10-02 05:00:00+00,3367,309,4370,11058,245,1606,734,96,0,0,21785,81,16407,15673,11303,3676
2022-10-02 05:30:00+00,3539,301,4367,10996,259,1648,756,122,0,200,22188,83,16378,15622,11255,3840
2022-10-02 06:00:00+00,4159,242,4368,9837,293,2126,741,95,1,138,22000,96,15240,14499,10131,4401
2022-10-02 06:30:00+00,5075,237,4367,9716,419,2122,737,92,137,26,22928,108,15376,14639,10272,5312
2022-10-02 07:00:00+00,4707,72,4370,9946,335,3840,726,91,491,0,24578,94,15868,15142,10772,4779
2022-10-02 07:30:00+00,5160,0,4362,9711,455,4020,683,180,999,280,25850,96,16210,15527,11165,5160
2022-10-02 08:00:00+00,5590,0,4365,9385,556,5088,425,127,1776,158,27470,103,16507,16082,11717,5590
2022-10-02 08:30:00+00,5908,0,4366,9334,566,5132,426,97,2636,0,28465,104,17328,16902,12536,5908
2022-10-02 09:00:00+00,5524,0,4364,9389,425,5140,429,88,3695,0,29054,96,18302,17873,13509,5524
2022-10-02 09:30:00+00,4891,0,4361,9322,398,5146,430,89,4565,0,29202,87,19076,18646,14285,4891
2022-10-02 10:00:00+00,4390,0,4365,9080,391,5288,429,84,5401,0,29428,80,19666,19237,14872,4390
2022-10-02 10:30:00+00,4463,0,4360,8897,378,5302,382,100,5907,24,29813,80,19924,19542,15182,4463
2022-10-02 11:00:00+00,5236,0,4375,9084,395,4916,128,88,6430,0,30652,83,20412,20284,15909,5236
2022-10-02 11:30:00+00,5460,0,4383,9051,396,4912,128,104,6347,0,30781,86,20305,20177,15794,5460
2022-10-02 12:00:00+00,6129,0,4378,8941,403,4362,125,99,5963,0,30400,93,19810,19685,15307,6129
2022-10-02 12:30:00+00,6328,0,4378,8726,427,4344,124,139,5653,0,30119,97,19308,19184,14806,6328
2022-10-02 13:00:00+00,5900,0,4391,8875,395,4772,341,94,5229,0,29997,95,19231,18890,14499,5900
2022-10-02 13:30:00+00,6007,0,4399,8855,348,4784,423,87,4678,0,29581,98,18703,18280,13881,6007
2022-10-02 14:00:00+00,6573,0,4408,8554,345,4728,425,91,4240,0,29364,104,17972,17547,13139,6573
2022-10-02 14:30:00+00,7626,73,4408,8220,345,4662,422,97,3753,0,29606,120,17148,16726,12318,7699
2022-10-02 15:00:00+00,10419,227,4399,7627,377,3290,415,108,3415,118,30395,153,16233,15818,11419,10646
2022-10-02 15:30:00+00,12338,517,4403,6786,400,3176,424,95,2444,286,30869,184,14457,14033,9630,12855
2022-10-02 16:00:00+00,13701,801,4399,6353,625,2222,525,93,1614,826,31159,203,13516,12991,8592,14502
2022-10-02 16:30:00+00,14659,953,4407,5892,629,2212,673,86,791,1068,31370,219,12392,11719,7312,15612
2022-10-02 17:00:00+00,15144,980,4416,5368,629,1902,754,421,135,1120,30869,233,11302,10548,6132,16124
2022-10-02 17:30:00+00,15343,974,4485,4948,646,2010,757,943,0,1254,31360,237,10836,10079,5594,16317
2022-10-02 18:00:00+00,15469,971,4487,4610,649,2446,757,975,0,1426,31790,235,10503,9746,5259,16440
2022-10-02 18:30:00+00,15549,973,4484,4282,656,2422,761,926,0,1160,31213,240,10183,9422,4938,16522
2022-10-02 19:00:00+00,15464,975,4473,4349,635,1508,771,828,0,1104,30107,248,10228,9457,4984,16439
2022-10-02 19:30:00+00,15325,848,4463,4467,633,1358,770,530,0,888,29282,245,10333,9563,5100,16173
2022-10-02 20:00:00+00,15194,960,4455,4559,620,908,768,404,0,884,28752,248,10402,9634,5179,16154
2022-10-02 20:30:00+00,14737,958,4448,4514,614,860,770,227,0,492,27620,250,10346,9576,5128,15695
2022-10-02 21:00:00+00,14150,974,4442,4304,526,802,770,149,0,496,26613,253,10042,9272,4830,15124
2022-10-02 21:30:00+00,13411,972,4434,4006,517,792,775,170,0,432,25509,252,9732,8957,4523,14383
2022-10-02 22:00:00+00,12373,903,4425,3673,397,1614,785,249,0,98,24517,244,9280,8495,4070,13276
2022-10-02 22:30:00+00,11797,833,4414,3695,395,1718,786,193,0,0,23831,238,9290,8504,4090,12630
2022-10-02 23:00:00+00,11416,754,4220,3703,395,1912,783,122,0,0,23305,232,9101,8318,4098,12170
2022-10-02 23:30:00+00,10966,726,4213,3411,393,1960,785,132,0,0,22586,231,8802,8017,3804,11692
2022-10-03 00:00:00+00,10901,681,4209,2943,378,2376,785,124,0,0,22397,234,8315,7530,3321,11582
2022-10-03 00:30:00+00,10783,673,4205,2630,404,2522,783,134,0,0,22134,238,8022,7239,3034,11456
2022-10-03 01:00:00+00,10934,781,4208,2442,463,2164,781,131,0,0,21904,246,7894,7113,2905,11715
2022-10-03 01:30:00+00,10949,849,4204,2313,463,2046,785,210,0,0,21819,249,7765,6980,2776,11798
2022-10-03 02:00:00+00,10857,726,4208,2184,362,2020,787,237,0,0,21381,250,7541,6754,2546,11583
2022-10-03 02:30:00+00,10984,640,4206,1939,355,2014,785,243,0,0,21166,251,7285,6500,2294,11624
2022-10-03 03:00:00+00,11738,735,4210,1852,354,2534,785,274,0,0,22482,261,7201,6416,2206,12473
2022-10-03 03:30:00+00,11776,657,4208,1934,357,2606,789,301,0,0,22628,258,7288,6499,2291,12433
2022-10-03 04:00:00+00,12708,633,4212,2031,410,1906,705,335,0,118,23058,268,7358,6653,2441,13341
2022-10-03 04:30:00+00,13701,642,4215,2131,419,1888,732,341,0,208,24277,272,7497,6765,2550,14343
2022-10-03 05:00:00+00,15529,722,4219,2289,525,1940,788,347,0,432,26791,279,7821,7033,2814,16251
2022-10-03 05:30:00+00,17256,772,4215,2396,528,1924,788,444,0,524,28847,285,7927,7139,2924,18028
2022-10-03 06:00:00+00,18218,838,4219,2558,711,2338,788,630,4,658,30962,281,8280,7492,3273,19056
2022-10-03 06:30:00+00,18714,972,4215,2759,735,2496,786,876,213,1012,32778,280,8708,7922,3707,19686
2022-10-03 07:00:00+00,18864,979,4216,2903,736,2238,787,898,650,934,33205,275,9292,8505,4289,19843
2022-10-03 07:30:00+00,18867,980,4216,3164,728,2120,786,917,1161,736,33675,270,10055,9269,5053,19847
2022-10-03 08:00:00+00,19108,956,4222,3393,612,2258,782,917,1928,588,34764,265,10937,10155,5933,20064
2022-10-03 08:30:00+00,19036,950,4218,3611,573,2184,784,767,2593,662,35378,257,11779,10995,6777,19986
2022-10-03 09:00:00+00,18682,974,4219,3962,512,1954,781,479,3368,556,35487,253,12842,12061,7842,19656
2022-10-03 09:30:00+00,18304,975,4210,4505,505,2227,775,293,4036,546,36376,246,14031,13256,9046,19279
2022-10-03 10:00:00+00,18572,978,4227,4928,394,1828,764,227,4296,146,36360,250,14609,13845,9618,19550
2022-10-03 10:30:00+00,18211,980,4296,5380,393,1829,765,176,4874,10,36914,242,15708,14943,10647,19191
2022-10-03 11:00:00+00,18299,967,4296,5795,397,1028,769,121,4891,156,36719,233,16148,15379,11083,19266
2022-10-03 11:30:00+00,17553,950,4294,6135,400,988,771,164,4516,146,35917,229,16116,15345,11051,18503
2022-10-03 12:00:00+00,17733,750,4298,6366,373,952,769,115,4257,2,35615,228,16063,15294,10996,18483
2022-10-03 12:30:00+00,17319,692,4298,6972,303,832,767,92,4067,0,35342,222,16407,15640,11342,18011
2022-10-03 13:00:00+00,17222,673,4295,7309,294,758,767,89,4138,0,35545,221,16803,16036,11741,17895
2022-10-03 13:30:00+00,17255,481,4288,7486,286,818,767,115,3756,0,35252,219,16583,15816,11528,17736
2022-10-03 14:00:00+00,17865,584,4288,7678,324,712,767,93,3157,174,35642,225,16214,15447,11159,18449
2022-10-03 14:30:00+00,17832,843,4300,8284,340,750,765,107,2409,136,35766,232,16098,15333,11033,18675
2022-10-03 15:00:00+00,17910,821,4309,8683,310,884,765,184,1942,136,35944,233,16009,15244,10935,18731
2022-10-03 15:30:00+00,18198,807,4305,8909,303,904,773,253,1506,482,36440,234,15796,15023,10718,19005
2022-10-03 16:00:00+00,18763,807,4301,9075,371,904,782,420,1075,696,37194,236,15604,14822,10521,19570
2022-10-03 16:30:00+00,19160,810,4302,9222,344,904,785,828,515,760,37630,241,15168,14383,10081,19970
2022-10-03 17:00:00+00,19604,902,4300,9251,303,904,786,1045,107,816,38018,247,14747,13961,9661,20506
2022-10-03 17:30:00+00,19551,973,4306,9790,312,904,786,1191,0,814,38627,246,15194,14408,10102,20524
2022-10-03 18:00:00+00,19160,896,4302,10477,314,904,786,1146,0,360,38345,241,15879,15093,10791,20056
2022-10-03 18:30:00+00,18487,846,4301,11011,285,904,786,612,0,120,37352,235,16383,15597,11296,19333
2022-10-03 19:00:00+00,17326,632,4295,11601,305,1040,788,230,0,86,36303,220,16989,16201,11906,17958
2022-10-03 19:30:00+00,16193,467,4289,11938,306,858,787,190,0,0,35028,208,17320,16533,12244,16660
2022-10-03 20:00:00+00,14928,510,4291,12136,297,850,786,191,0,0,33989,203,17510,16724,12433,15438
2022-10-03 20:30:00+00,12772,459,4295,12404,295,904,781,151,0,0,32061,188,17775,16994,12699,13231
2022-10-03 21:00:00+00,11341,459,4290,12915,299,904,788,149,0,0,31145,175,18292,17504,13214,11800
2022-10-03 21:30:00+00,9322,458,4291,13468,295,904,791,195,0,0,29724,157,18845,18054,13763,9780
2022-10-03 22:00:00+00,7925,462,4291,13413,303,904,791,166,0,0,28255,146,18798,18007,13716,8387
2022-10-03 22:30:00+00,6906,471,4293,13218,302,904,789,145,0,0,27028,137,18602,17813,13520,7377
2022-10-03 23:00:00+00,7124,304,4288,12988,324,904,790,164,0,0,26886,136,18390,17600,13312,7428
2022-10-03 23:30:00+00,7225,10,4297,12831,326,904,792,154,0,0,26539,129,18246,17454,13157,7235
2022-10-04 00:00:00+00,7363,0,4298,12640,310,904,795,156,0,0,26466,131,18043,17248,12950,7363
2022-10-04 00:30:00+00,7710,0,4291,12501,309,904,795,158,0,0,26668,135,17896,17101,12810,7710
2022-10-04 01:00:00+00,7705,0,4291,12305,310,904,794,158,0,0,26467,136,17700,16906,12615,7705
2022-10-04 01:30:00+00,7698,0,4289,12060,322,904,793,153,0,0,26219,137,17464,16671,12382,7698
2022-10-04 02:00:00+00,7602,0,4290,12244,299,900,790,145,0,0,26270,135,17623,16833,12543,7602
2022-10-04 02:30:00+00,6917,0,4294,12868,298,792,791,145,0,0,26105,124,18251,17460,13166,6917
2022-10-04 03:00:00+00,6629,0,4290,13419,298,792,789,145,0,0,26362,118,18796,18007,13717,6629
2022-10-04 03:30:00+00,6355,0,4286,13933,301,672,789,142,0,0,26478,111,19309,18520,14234,6355
2022-10-04 04:00:00+00,6611,0,4287,14092,306,438,858,144,0,0,26736,110,19543,18685,14398,6611
2022-10-04 04:30:00+00,6549,0,4291,14985,309,304,868,261,0,0,27567,105,20453,19585,15294,6549
2022-10-04 05:00:00+00,7613,3,4293,15302,313,574,1102,323,0,0,29523,118,21010,19908,15615,7616
2022-10-04 05:30:00+00,9320,168,4291,15745,325,444,1301,293,0,0,31887,134,21662,20361,16070,9488
2022-10-04 06:00:00+00,11258,228,4288,16038,370,174,1311,205,0,84,33956,146,22007,20696,16408,11486
2022-10-04 06:30:00+00,12642,460,4288,16340,392,0,1304,162,90,56,35734,157,22414,21110,16822,13102
2022-10-04 07:00:00+00,12809,669,4287,16866,406,0,1343,158,291,0,36829,160,23193,21850,17563,13478
2022-10-04 07:30:00+00,12867,616,4297,16890,399,0,1346,190,648,60,37313,157,23580,22234,17937,13483
2022-10-04 08:00:00+00,12986,472,4292,16983,389,0,1347,217,1201,78,37965,152,24212,22865,18573,13458
2022-10-04 08:30:00+00,12734,476,4296,17006,390,0,1414,214,1568,80,38178,149,24674,23260,18964,13210
2022-10-04 09:00:00+00,12427,471,4295,16698,394,0,1444,178,2062,84,38053,146,24893,23449,19154,12898
2022-10-04 09:30:00+00,12492,476,4294,16454,425,0,1430,164,2485,6,38226,146,25088,23658,19364,12968
2022-10-04 10:00:00+00,11726,474,4294,16329,495,24,1427,158,2228,234,37389,141,24773,23346,19052,12200
2022-10-04 10:30:00+00,11897,484,4306,15906,507,32,1429,165,2519,468,37713,142,24667,23238,18932,12381
2022-10-04 11:00:00+00,12173,479,4310,15329,492,540,1418,173,2372,500,37786,147,23921,22503,18193,12652
2022-10-04 11:30:00+00,12599,481,4310,14808,491,552,1423,162,2611,394,37831,152,23643,22220,17910,13080
2022-10-04 12:00:00+00,11629,460,4385,14751,498,1414,1430,150,2363,286,37366,151,23427,21997,17612,12089
2022-10-04 12:30:00+00,11423,459,4400,14900,530,1486,1431,151,1950,258,36988,151,23211,21780,17380,11882
2022-10-04 13:00:00+00,10632,461,4401,14873,529,1794,1342,149,1788,260,36229,147,22933,21591,17190,11093
2022-10-04 13:30:00+00,10557,461,4405,15288,531,1798,1234,150,1753,258,36435,145,23211,21977,17572,11018
2022-10-04 14:00:00+00,11181,459,4399,15158,552,1168,1357,177,1565,406,36422,148,23031,21674,17275,11640
2022-10-04 14:30:00+00,12552,460,4401,14886,535,1064,1432,176,1254,258,37018,160,22508,21076,16675,13012
2022-10-04 15:00:00+00,14478,460,4403,14703,524,2,1424,224,867,518,37603,170,21921,20497,16094,14938
2022-10-04 15:30:00+00,15506,461,4404,14137,539,0,1428,283,588,934,38280,178,21096,19668,15264,15967
2022-10-04 16:00:00+00,15930,460,4406,13164,565,650,1428,492,306,1428,38829,188,19869,18441,14035,16390
2022-10-04 16:30:00+00,16021,460,4406,12920,596,732,1431,649,146,1442,38803,191,19499,18068,13662,16481
2022-10-04 17:00:00+00,16837,460,4404,12878,699,0,1449,785,15,1508,39034,192,19444,17996,13592,17297
2022-10-04 17:30:00+00,17100,465,4400,12669,687,0,1453,892,0,1508,39174,195,19209,17756,13356,17565
2022-10-04 18:00:00+00,16934,427,4402,12312,593,102,1452,752,0,1354,38328,197,18759,17307,12905,17361
2022-10-04 18:30:00+00,16482,234,4403,12366,590,114,1454,521,0,1006,37170,191,18813,17359,12956,16716
2022-10-04 19:00:00+00,15273,204,4397,12845,509,632,1453,314,0,608,36235,183,19204,17751,13354,15477
2022-10-04 19:30:00+00,14682,0,4399,12977,494,668,1446,184,0,430,35280,175,19316,17870,13471,14682
2022-10-04 20:00:00+00,12804,0,4397,12965,495,954,1441,173,0,342,33571,163,19298,17857,13460,12804
2022-10-04 20:30:00+00,10334,0,4392,13506,486,1038,1440,183,0,286,31665,144,19824,18384,13992,10334
2022-10-04 21:00:00+00,7874,0,4393,13825,485,1304,1440,153,0,284,29758,124,20143,18703,14310,7874
2022-10-04 21:30:00+00,6076,0,4393,14020,478,1310,1442,159,0,240,28118,106,20334,18892,14498,6076
2022-10-04 22:00:00+00,4595,0,4395,14572,468,666,1259,192,0,0,26147,86,20694,19435,15040,4595
2022-10-04 22:30:00+00,3534,0,4394,14324,457,908,1023,174,0,0,24814,77,20198,19175,14781,3534
2022-10-04 23:00:00+00,3525,0,4392,14120,438,634,911,159,0,0,24179,74,19861,18950,14558,3525
2022-10-04 23:30:00+00,3384,0,4391,14107,449,656,898,187,0,0,24072,72,19845,18947,14556,3384
2022-10-05 00:00:00+00,3344,0,4393,14442,444,508,913,158,0,0,24202,69,20192,19279,14886,3344
2022-10-05 00:30:00+00,3350,0,4396,14909,446,410,960,167,0,0,24638,67,20711,19751,15355,3350
2022-10-05 01:00:00+00,3261,0,4395,15549,463,102,1185,165,0,0,25120,61,21592,20407,16012,3261
2022-10-05 01:30:00+00,3212,0,4400,15658,453,26,1145,149,0,0,25043,58,21656,20511,16111,3212
2022-10-05 02:00:00+00,3422,0,4390,15310,453,76,1119,168,0,0,24938,63,21272,20154,15764,3422
2022-10-05 02:30:00+00,3428,0,4392,15423,475,0,1221,161,0,0,25100,62,21511,20290,15898,3428
2022-10-05 03:00:00+00,3416,0,4393,15593,493,0,1097,151,0,0,25143,61,21576,20479,16086,3416
2022-10-05 03:30:00+00,3455,0,4388,15209,496,0,1198,184,0,0,24930,63,21291,20093,15705,3455
2022-10-05 04:00:00+00,3655,0,4402,14882,546,170,1010,163,0,0,24828,68,20840,19830,15428,3655
2022-10-05 04:30:00+00,4234,0,4403,14808,552,378,919,165,0,0,25459,77,20682,19763,15360,4234
2022-10-05 05:00:00+00,5183,0,4393,15161,555,990,1168,174,0,14,27638,90,21277,20109,15716,5183
2022-10-05 05:30:00+00,6786,0,4393,15037,695,1114,1397,230,0,464,30116,105,21522,20125,15732,6786
2022-10-05 06:00:00+00,8272,0,4390,14552,701,1238,1497,529,0,608,31787,118,21140,19643,15253,8272
2022-10-05 06:30:00+00,9109,0,4390,14131,676,1256,1518,862,83,1078,33103,127,20798,19280,14890,9109
2022-10-05 07:00:00+00,8737,0,4392,14042,670,1996,1607,468,373,924,33209,122,21084,19477,15085,8737
2022-10-05 07:30:00+00,8515,0,4391,14147,660,2136,1744,525,597,980,33695,120,21539,19795,15404,8515
2022-10-05 08:00:00+00,8471,0,4398,14266,629,2938,1779,496,1156,770,34903,117,22228,20449,16051,8471
2022-10-05 08:30:00+00,8536,0,4401,14550,632,2922,1855,486,1563,380,35325,116,23001,21146,16745,8536
2022-10-05 09:00:00+00,8714,0,4395,14854,609,2102,1856,569,2294,618,36011,117,24008,22152,17757,8714
2022-10-05 09:30:00+00,9138,0,4398,14737,495,2004,1974,535,2286,564,36131,120,23890,21916,17518,9138
2022-10-05 10:00:00+00,9054,0,4402,14983,484,2688,2069,395,1960,152,36187,121,23898,21829,17427,9054
2022-10-05 10:30:00+00,8877,0,4401,15866,497,2842,1998,393,1870,128,36872,117,24632,22634,18233,8877
2022-10-05 11:00:00+00,8833,0,4419,16350,506,3008,2027,297,1694,0,37134,116,24996,22969,18550,8833
2022-10-05 11:30:00+00,8712,0,4424,16819,499,2982,2003,282,1573,0,37294,114,25318,23315,18891,8712
2022-10-05 12:00:00+00,8611,0,4425,16837,489,2840,2023,197,1586,0,37008,113,25360,23337,18912,8611
2022-10-05 12:30:00+00,8403,0,4422,16928,468,2702,2021,176,1528,0,36648,110,25367,23346,18924,8403
2022-10-05 13:00:00+00,8291,0,4423,17201,451,1810,2029,174,1704,0,36083,105,25808,23779,19356,8291
2022-10-05 13:30:00+00,8140,0,4416,16878,447,1776,2044,244,1996,70,36011,104,25781,23737,19321,8140
2022-10-05 14:00:00+00,8097,0,4416,16125,541,2218,2031,196,2000,0,35625,107,25113,23082,18666,8097
2022-10-05 14:30:00+00,8178,0,4359,15398,523,2430,2034,189,1842,0,34954,114,24156,22122,17763,8178
2022-10-05 15:00:00+00,8365,0,4241,15083,423,1370,2021,254,1862,198,33817,119,23630,21609,17368,8365
2022-10-05 15:30:00+00,8807,0,4221,15764,419,1346,2045,297,1715,508,35123,120,24164,22119,17898,8807
2022-10-05 16:00:00+00,9182,0,4227,16425,488,1480,2062,319,1069,590,35842,122,24271,22209,17982,9182
2022-10-05 16:30:00+00,9611,0,4175,17277,517,1516,2043,362,513,924,36938,123,24525,22482,18307,9611
2022-10-05 17:00:00+00,9794,0,4127,17246,458,1924,2024,464,80,970,37087,125,23935,21911,17784,9794
2022-10-05 17:30:00+00,9855,0,4122,17466,454,1940,2051,501,0,970,37359,125,24093,22042,17920,9855
2022-10-05 18:00:00+00,9782,0,4126,17923,429,1826,2052,358,0,696,37191,121,24530,22478,18352,9782
2022-10-05 18:30:00+00,9624,0,4124,17895,421,1776,2052,230,0,404,36527,120,24492,22440,18316,9624
2022-10-05 19:00:00+00,9361,0,4127,17726,423,1632,2050,206,0,0,35526,119,24326,22276,18149,9361
2022-10-05 19:30:00+00,8887,0,4126,17538,426,1518,1903,194,0,0,34591,115,23993,22090,17964,8887
2022-10-05 20:00:00+00,8415,0,4119,17256,395,1658,1196,221,0,212,33472,113,22966,21770,17651,8415
2022-10-05 20:30:00+00,7606,0,4120,17052,390,1466,800,177,0,226,31837,105,22362,21562,17442,7606
2022-10-05 21:00:00+00,5971,0,4116,17186,391,1026,962,202,0,210,30064,87,22655,21693,17577,5971
2022-10-05 21:30:00+00,4584,0,4118,17310,373,858,940,188,0,0,28371,70,22741,21801,17683,4584
2022-10-05 22:00:00+00,3760,0,4118,16918,365,1302,728,157,0,0,27348,62,22129,21401,17283,3760
2022-10-05 22:30:00+00,3695,0,4114,16538,366,1294,456,156,0,0,26619,62,21474,21018,16904,3695
2022-10-05 23:00:00+00,4115,0,4096,16506,367,768,457,160,0,0,26469,67,21426,20969,16873,4115
2022-10-05 23:30:00+00,3938,0,4044,16574,367,670,458,162,0,0,26214,64,21444,20986,16942,3938
2022-10-06 00:00:00+00,3849,0,4007,16568,359,406,451,161,0,0,25801,66,21385,20934,16927,3849
2022-10-06 00:30:00+00,4226,0,3951,16528,358,468,441,156,0,0,26128,72,21278,20837,16886,4226
2022-10-06 01:00:00+00,4250,0,3947,16569,366,516,440,161,0,0,26249,73,21322,20882,16935,4250
2022-10-06 01:30:00+00,4032,0,3945,16538,373,480,427,154,0,0,25949,70,21283,20856,16911,4032
2022-10-06 02:00:00+00,4001,0,3943,16343,372,372,413,159,0,0,25603,71,21071,20658,16715,4001
2022-10-06 02:30:00+00,4066,0,3943,16308,370,406,409,152,0,0,25654,72,21030,20621,16678,4066
2022-10-06 03:00:00+00,4110,0,3948,16170,379,810,404,146,0,0,25967,73,20901,20497,16549,4110
2022-10-06 03:30:00+00,4223,0,3944,15944,379,780,404,144,0,0,25818,73,20671,20267,16323,4223
2022-10-06 04:00:00+00,4525,0,3947,15702,380,1326,390,144,0,0,26414,79,20419,20029,16082,4525
2022-10-06 04:30:00+00,5483,0,3953,15475,419,1448,390,142,0,0,27310,91,20237,19847,15894,5483
2022-10-06 05:00:00+00,6973,0,3953,15526,419,1724,391,181,0,0,29167,108,20289,19898,15945,6973
2022-10-06 05:30:00+00,8841,0,3956,15561,428,1758,401,243,0,168,31356,125,20346,19945,15989,8841
2022-10-06 06:00:00+00,11150,0,3957,15391,451,1622,303,337,0,392,33603,143,20102,19799,15842,11150
2022-10-06 06:30:00+00,10864,0,3957,15727,468,1604,90,462,190,686,34048,137,20432,20342,16385,10864
2022-10-06 07:00:00+00,10659,0,3957,16266,459,1676,96,422,837,298,34670,132,21615,21519,17562,10659
2022-10-06 07:30:00+00,10215,0,3955,16329,469,1496,95,411,1745,180,34895,124,22593,22498,18543,10215
2022-10-06 08:00:00+00,9756,0,3952,16472,487,1936,96,384,2667,0,35750,118,23674,23578,19626,9756
2022-10-06 08:30:00+00,9314,0,3954,16543,462,1976,98,260,3371,0,35978,112,24428,24330,20376,9314
2022-10-06 09:00:00+00,7841,0,3952,16765,470,2386,95,151,4087,0,35747,98,25369,25274,21322,7841
2022-10-06 09:30:00+00,7057,0,3953,16871,515,2386,95,132,4744,0,35753,89,26178,26083,22130,7057
2022-10-06 10:00:00+00,6295,0,3954,16920,533,2390,91,134,5840,0,36157,79,27338,27247,23293,6295
2022-10-06 10:30:00+00,5880,0,3958,17196,547,2390,83,133,5983,0,36170,75,27767,27684,23726,5880
2022-10-06 11:00:00+00,5768,0,3960,17400,533,2590,83,139,6141,0,36614,73,28117,28034,24074,5768
2022-10-06 11:30:00+00,5834,0,3959,17476,527,2580,84,147,6351,0,36958,73,28397,28313,24354,5834
2022-10-06 12:00:00+00,5882,0,3964,17552,540,2034,82,143,5678,0,35875,74,27816,27734,23770,5882
2022-10-06 12:30:00+00,6012,0,3964,17308,523,2032,82,139,5410,78,35548,76,27287,27205,23241,6012
2022-10-06 13:00:00+00,6130,0,3965,17334,499,2084,81,137,5030,0,35260,79,26909,26828,22863,6130
2022-10-06 13:30:00+00,6472,0,3965,17156,483,2068,81,131,4257,30,34643,84,25942,25861,21896,6472
2022-10-06 14:00:00+00,8361,0,3967,16894,465,1746,87,127,3662,0,35309,101,25075,24988,21021,8361
2022-10-06 14:30:00+00,9208,0,3962,16702,506,1316,93,153,3341,164,35445,107,24604,24511,20549,9208
2022-10-06 15:00:00+00,10420,0,3964,16457,655,1432,102,174,2589,706,36499,119,23767,23665,19701,10420
2022-10-06 15:30:00+00,11694,0,3963,16476,671,1516,105,162,1856,638,37081,131,23071,22966,19003,11694
2022-10-06 16:00:00+00,12696,0,3977,16433,701,1582,105,178,1119,598,37389,142,22335,22230,18253,12696
2022-10-06 16:30:00+00,12965,0,4017,16165,715,1734,103,386,434,912,37431,148,21434,21331,17314,12965
2022-10-06 17:00:00+00,13236,0,4014,16419,690,1866,101,459,50,974,37809,151,21274,21173,17159,13236
2022-10-06 17:30:00+00,13831,0,4051,16451,614,1896,94,488,0,974,38399,156,21210,21116,17065,13831
2022-10-06 18:00:00+00,13714,0,4069,16531,715,1986,85,609,0,886,38595,156,21400,21315,17246,13714
2022-10-06 18:30:00+00,13285,0,4064,16610,614,1858,90,444,0,844,37809,152,21378,21288,17224,13285
2022-10-06 19:00:00+00,12901,0,4063,16698,596,1608,87,372,0,758,37083,147,21444,21357,17294,12901
2022-10-06 19:30:00+00,12561,0,4074,16755,572,1516,82,300,0,340,36200,145,21483,21401,17327,12561
2022-10-06 20:00:00+00,11480,0,4087,16381,510,1520,74,279,0,70,34401,140,21052,20978,16891,11480
2022-10-06 20:30:00+00,10042,0,4095,16250,510,1470,84,262,0,0,32713,129,20939,20855,16760,10042
2022-10-06 21:00:00+00,8479,0,4092,16281,508,1536,186,210,0,102,31394,116,21067,20881,16789,8479
2022-10-06 21:30:00+00,7012,0,4097,16294,522,1518,325,199,0,0,29967,102,21238,20913,16816,7012
2022-10-06 22:00:00+00,5739,0,4163,16365,539,1578,486,246,0,0,29116,90,21553,21067,16904,5739
2022-10-06 22:30:00+00,4955,0,4197,16307,538,1650,468,208,0,0,28323,83,21510,21042,16845,4955
2022-10-06 23:00:00+00,4508,0,4196,16230,531,1332,466,192,0,0,27455,80,21423,20957,16761,4508
2022-10-06 23:30:00+00,4452,0,4198,16333,534,1188,433,189,0,0,27327,77,21498,21065,16867,4452
2022-10-07 00:00:00+00,4247,0,4192,16721,538,782,447,194,0,0,27121,75,21898,21451,17259,4247
2022-10-07 00:30:00+00,3649,0,4192,17269,536,720,425,192,0,0,26983,66,22422,21997,17805,3649
2022-10-07 01:00:00+00,3432,0,4193,17454,521,434,395,194,0,0,26623,62,22563,22168,17975,3432
2022-10-07 01:30:00+00,3284,0,4188,17352,521,500,395,192,0,0,26432,61,22456,22061,17873,3284
2022-10-07 02:00:00+00,3406,0,4193,17126,523,380,396,201,0,0,26225,62,22238,21842,17649,3406
2022-10-07 02:30:00+00,3389,0,4193,16979,523,308,427,195,0,0,26014,61,22122,21695,17502,3389
2022-10-07 03:00:00+00,3250,0,4193,16936,507,338,405,191,0,0,25820,57,22041,21636,17443,3250
2022-10-07 03:30:00+00,3291,0,4191,16533,507,472,396,179,0,0,25569,59,21627,21231,17040,3291
2022-10-07 04:00:00+00,3432,0,4194,15740,511,878,397,151,0,0,25303,62,20842,20445,16251,3432
2022-10-07 04:30:00+00,3544,0,4190,16299,515,1068,399,157,0,0,26172,64,21403,21004,16814,3544
2022-10-07 05:00:00+00,4291,0,4189,16285,539,1396,536,162,0,0,27398,72,21549,21013,16824,4291
2022-10-07 05:30:00+00,6041,0,4194,16281,573,1516,666,300,0,26,29597,93,21714,21048,16854,6041
2022-10-07 06:00:00+00,7704,0,4193,16248,609,1352,742,484,0,630,31962,107,21792,21050,16857,7704
2022-10-07 06:30:00+00,8102,0,4199,16256,616,1288,747,618,163,964,32953,109,21981,21234,17035,8102
2022-10-07 07:00:00+00,6959,0,4206,16439,622,1908,758,489,630,838,32849,97,22655,21897,17691,6959
2022-10-07 07:30:00+00,6596,0,4208,16769,609,2020,745,388,1351,632,33318,91,23682,22937,18729,6596
2022-10-07 08:00:00+00,6099,0,4204,16808,600,2942,748,231,1868,362,33862,87,24228,23480,19276,6099
2022-10-07 08:30:00+00,5637,0,4203,17239,610,2962,750,177,2907,330,34815,79,25709,24959,20756,5637
2022-10-07 09:00:00+00,4633,0,4263,17463,611,3128,688,166,3515,330,34797,69,26540,25852,21589,4633
2022-10-07 09:30:00+00,4295,0,4311,17692,641,3128,519,175,4202,336,35299,63,27365,26846,22535,4295
2022-10-07 10:00:00+00,3977,0,4297,17934,648,3128,597,172,4552,24,35329,60,28028,27431,23134,3977
2022-10-07 10:30:00+00,3650,0,4296,18024,647,3128,685,180,4614,0,35224,57,28266,27581,23285,3650
2022-10-07 11:00:00+00,4023,0,4295,17838,620,3086,751,180,4325,0,35118,61,27829,27078,22783,4023
2022-10-07 11:30:00+00,3987,0,4300,17877,604,3074,747,156,3997,0,34742,61,27525,26778,22478,3987
2022-10-07 12:00:00+00,3857,0,4299,18153,580,2946,750,164,3825,0,34574,59,27607,26857,22558,3857
2022-10-07 12:30:00+00,3840,0,4294,18156,583,2946,749,160,3806,0,34534,59,27588,26839,22545,3840
2022-10-07 13:00:00+00,3755,0,4294,18413,587,3042,750,158,3465,0,34464,59,27509,26759,22465,3755
2022-10-07 13:30:00+00,3985,0,4296,18261,571,3022,754,155,3184,0,34228,62,27066,26312,22016,3985
2022-10-07 14:00:00+00,4689,0,4293,17770,562,2460,753,162,2693,134,33516,69,26071,25318,21025,4689
2022-10-07 14:30:00+00,5563,0,4293,17248,565,2428,750,158,2091,188,33284,80,24947,24197,19904,5563
2022-10-07 15:00:00+00,8072,0,4298,16651,642,1632,761,194,1931,246,34427,104,24283,23522,19224,8072
2022-10-07 15:30:00+00,9395,0,4290,15970,659,1658,765,225,1477,530,34969,118,23161,22396,18106,9395
2022-10-07 16:00:00+00,10527,0,4284,15288,683,1440,753,512,1029,1128,35644,130,22037,21284,17000,10527
2022-10-07 16:30:00+00,10947,0,4289,15257,733,1342,755,937,456,1130,35846,137,21490,20735,16446,10947
2022-10-07 17:00:00+00,11156,0,4287,15226,847,1302,784,974,38,1478,36092,137,21182,20398,16111,11156
2022-10-07 17:30:00+00,11294,0,4286,15629,940,1172,818,1168,0,1514,36821,136,21673,20855,16569,11294
2022-10-07 18:00:00+00,10388,0,4318,16077,832,1096,845,1119,0,1202,35877,129,22072,21227,16909,10388
2022-10-07 18:30:00+00,10607,0,4339,15412,681,1096,873,930,0,1462,35400,131,21305,20432,16093,10607
2022-10-07 19:00:00+00,9566,0,4342,15445,630,1394,962,435,0,998,33772,123,21379,20417,16075,9566
2022-10-07 19:30:00+00,9083,0,4346,15466,590,1432,1184,302,0,532,32935,119,21586,20402,16056,9083
2022-10-07 20:00:00+00,8558,0,4338,15162,540,1096,1372,324,0,416,31806,115,21412,20040,15702,8558
2022-10-07 20:30:00+00,7935,0,4336,15001,533,1096,1402,158,0,148,30609,109,21272,19870,15534,7935
2022-10-07 21:00:00+00,6813,0,4342,15238,533,1096,1386,149,0,66,29623,98,21499,20113,15771,6813
2022-10-07 21:30:00+00,5277,0,4342,15474,533,1096,1329,150,0,0,28201,81,21678,20349,16007,5277
2022-10-07 22:00:00+00,3989,0,4346,15139,535,1524,1026,163,0,0,26722,70,21046,20020,15674,3989
2022-10-07 22:30:00+00,3535,0,4345,14803,535,1554,949,156,0,0,25877,65,20632,19683,15338,3535
2022-10-07 23:00:00+00,3434,0,4351,14640,532,1342,953,146,0,0,25398,62,20476,19523,15172,3434
2022-10-07 23:30:00+00,3457,0,4346,13866,548,1316,956,160,0,0,24649,65,19716,18760,14414,3457
2022-10-08 00:00:00+00,3477,0,4351,14223,537,1096,962,152,0,0,24798,62,20073,19111,14760,3477
2022-10-08 00:30:00+00,3636,0,4346,14026,534,1096,965,167,0,0,24770,65,19871,18906,14560,3636
2022-10-08 01:00:00+00,3636,0,4355,14073,534,1096,965,152,0,0,24811,65,19927,18962,14607,3636
2022-10-08 01:30:00+00,3581,0,4352,13985,533,1096,968,148,0,0,24663,64,19838,18870,14518,3581
2022-10-08 02:00:00+00,3590,0,4350,13788,541,1096,974,148,0,0,24487,65,19653,18679,14329,3590
2022-10-08 02:30:00+00,3572,0,4348,13514,541,1096,968,152,0,0,24191,65,19371,18403,14055,3572
2022-10-08 03:00:00+00,3538,0,4347,13154,541,1096,1001,164,0,0,23841,66,19043,18042,13695,3538
2022-10-08 03:30:00+00,3518,0,4348,12979,542,1096,997,154,0,0,23634,66,18866,17869,13521,3518
2022-10-08 04:00:00+00,3525,0,4369,12891,556,1096,984,154,0,0,23575,66,18800,17816,13447,3525
2022-10-08 04:30:00+00,3665,0,4460,12896,552,1096,956,153,0,0,23778,68,18864,17908,13448,3665
2022-10-08 05:00:00+00,4155,0,4459,13068,537,1096,964,155,0,0,24434,74,19028,18064,13605,4155
2022-10-08 05:30:00+00,4843,0,4457,13392,537,1096,993,165,0,2,25485,82,19379,18386,13929,4843
2022-10-08 06:00:00+00,6158,0,4458,13359,589,1096,983,156,0,0,26799,97,19389,18406,13948,6158
2022-10-08 06:30:00+00,6320,0,4445,12669,652,1096,1228,178,160,156,26904,100,19154,17926,13481,6320
2022-10-08 07:00:00+00,6482,0,4451,12184,731,2816,1404,159,896,14,29137,109,19666,18262,13811,6482
2022-10-08 07:30:00+00,6617,0,4455,11598,851,3098,1395,158,2070,214,30456,109,20369,18974,14519,6617
2022-10-08 08:00:00+00,6668,0,4458,11136,852,3156,1407,181,3277,352,31487,107,21130,19723,15265,6668
2022-10-08 08:30:00+00,6687,0,4515,10551,855,3158,1401,169,4326,290,31952,106,21648,20247,15732,6687
2022-10-08 09:00:00+00,6169,0,4559,10358,840,3158,1299,151,5245,140,31919,99,22301,21002,16443,6169
2022-10-08 09:30:00+00,6214,0,4559,9717,818,3158,1199,164,5892,0,31721,100,22185,20986,16427,6214
2022-10-08 10:00:00+00,6469,0,4558,9128,761,3156,1289,157,6268,0,31786,103,22004,20715,16157,6469
2022-10-08 10:30:00+00,6384,0,4567,8858,765,3154,1298,149,6945,0,32120,101,22433,21135,16568,6384
2022-10-08 11:00:00+00,6279,0,4564,8837,758,3100,1339,147,6850,0,31874,100,22348,21009,16445,6279
2022-10-08 11:30:00+00,5963,0,4564,9003,758,3098,1280,162,6966,0,31794,96,22571,21291,16727,5963
2022-10-08 12:00:00+00,5676,0,4563,8982,757,3098,1097,157,6848,52,31230,93,22247,21150,16587,5676
2022-10-08 12:30:00+00,5715,0,4610,8814,754,3100,1054,148,6645,0,30840,95,21877,20823,16213,5715
2022-10-08 13:00:00+00,5955,0,4614,8561,751,2766,1062,158,6308,0,30175,98,21296,20234,15620,5955
2022-10-08 13:30:00+00,6473,0,4611,8062,753,2760,1093,157,5653,0,29562,107,20172,19079,14468,6473
2022-10-08 14:00:00+00,7274,0,4621,7529,770,2550,1289,167,5045,108,29353,117,19254,17965,13344,7274
2022-10-08 14:30:00+00,8312,1,4618,7111,793,2436,1394,166,4242,2,29075,131,18158,16764,12146,8313
2022-10-08 15:00:00+00,11198,2,4616,6765,853,1096,1360,169,3419,188,29666,156,17013,15653,11037,11200
2022-10-08 15:30:00+00,13470,60,4616,6235,855,1096,1381,178,2411,382,30684,182,15498,14117,9501,13530
2022-10-08 16:00:00+00,14997,242,4621,5719,863,1096,1393,197,1396,1188,31712,201,13992,12599,7978,15239
2022-10-08 16:30:00+00,15510,344,4626,5556,860,1096,1394,570,443,1454,31853,214,12879,11485,6859,15854
2022-10-08 17:00:00+00,16059,444,4630,5598,860,1096,1386,868,24,1082,32047,225,12498,11112,6482,16503
2022-10-08 17:30:00+00,16009,357,4623,5736,872,1096,1388,897,0,1250,32228,221,12619,11231,6608,16366
2022-10-08 18:00:00+00,15798,248,4630,5855,870,1332,1381,845,0,1130,32089,219,12736,11355,6725,16046
2022-10-08 18:30:00+00,15799,287,4621,5796,873,1334,1193,431,0,1034,31368,219,12483,11290,6669,16086
2022-10-08 19:00:00+00,16033,259,4630,5995,852,1194,1162,185,0,560,30870,221,12639,11477,6847,16292
2022-10-08 19:30:00+00,15321,254,4626,6238,838,1218,1151,178,0,298,30122,217,12853,11702,7076,15575
2022-10-08 20:00:00+00,15251,393,4631,6357,850,1382,1131,172,0,88,30255,222,12969,11838,7207,15644
2022-10-08 20:30:00+00,14303,274,4628,6493,850,1602,1127,156,0,0,29433,214,13098,11971,7343,14577
2022-10-08 21:00:00+00,13577,0,4628,6718,809,1462,1119,146,0,0,28459,200,13274,12155,7527,13577
2022-10-08 21:30:00+00,12316,0,4628,6688,799,1594,1050,153,0,8,27236,193,13165,12115,7487,12316
2022-10-08 22:00:00+00,9205,0,4631,6930,605,2392,748,164,0,0,24675,170,12914,12166,7535,9205
2022-10-08 22:30:00+00,8123,0,4630,6977,570,2486,746,205,0,0,23737,160,12923,12177,7547,8123
2022-10-08 23:00:00+00,7105,0,4632,6707,569,2464,750,149,0,0,22376,147,12658,11908,7276,7105
2022-10-08 23:30:00+00,6285,0,4637,6827,572,2510,747,162,0,0,21740,137,12783,12036,7399,6285
2022-10-09 00:00:00+00,5168,0,4620,6620,553,3278,692,166,0,0,21097,133,12485,11793,7173,5168
2022-10-09 00:30:00+00,5052,0,4631,6677,552,3368,706,162,0,0,21148,132,12566,11860,7229,5052
2022-10-09 01:00:00+00,4850,0,4643,7158,552,3184,743,151,0,0,21281,130,13096,12353,7710,4850
2022-10-09 01:30:00+00,4257,0,4642,7513,604,3074,746,154,0,0,20990,119,13505,12759,8117,4257
2022-10-09 02:00:00+00,5078,0,4647,7944,605,1972,744,159,0,0,21149,120,13940,13196,8549,5078
2022-10-09 02:30:00+00,4528,0,4649,8506,604,1898,732,146,0,0,21062,109,14490,13758,9110,4528
2022-10-09 03:00:00+00,5051,0,4642,9076,604,1790,738,161,0,0,22062,115,15060,14322,9680,5051
2022-10-09 03:30:00+00,4675,0,4647,9655,602,1734,753,158,0,0,22224,108,15657,14904,10257,4675
2022-10-09 04:00:00+00,4871,0,4644,10408,603,1336,736,173,0,0,22771,108,16391,15655,11011,4871
2022-10-09 04:30:00+00,4717,0,4639,10938,606,1300,684,169,0,0,23053,104,16867,16183,11544,4717
2022-10-09 05:00:00+00,4484,0,4644,11629,671,1026,750,153,0,0,23357,98,17694,16944,12300,4484
2022-10-09 05:30:00+00,4490,0,4641,12023,692,1068,692,179,0,0,23785,97,18048,17356,12715,4490
2022-10-09 06:00:00+00,4896,0,4644,11874,691,1272,634,162,0,42,24215,98,17843,17209,12565,4896
2022-10-09 06:30:00+00,5109,0,4643,12083,695,1280,754,182,126,86,24958,99,18301,17547,12904,5109
2022-10-09 07:00:00+00,4889,0,4643,12555,634,1394,754,177,774,112,25932,95,19360,18606,13963,4889
2022-10-09 07:30:00+00,4965,0,4641,12843,593,1404,754,166,1769,148,27283,91,20600,19846,15205,4965
2022-10-09 08:00:00+00,4538,0,4642,13277,573,1218,753,176,2718,264,28159,80,21963,21210,16568,4538
2022-10-09 08:30:00+00,4274,0,4645,14343,614,1140,652,152,3756,28,29604,71,24010,23358,18713,4274
2022-10-09 09:00:00+00,3811,0,4649,14956,588,1502,719,152,4413,0,30790,65,25325,24606,19957,3811
2022-10-09 09:30:00+00,3408,0,4641,15221,558,1420,749,150,4947,0,31094,58,26116,25367,20726,3408
2022-10-09 10:00:00+00,3630,0,4640,15744,560,888,752,152,5189,0,31555,55,26885,26133,21493,3630
2022-10-09 10:30:00+00,3497,0,4640,16078,511,1064,753,154,5478,0,32175,55,27460,26707,22067,3497
2022-10-09 11:00:00+00,3477,0,4640,15715,483,1044,752,159,5765,0,32035,54,27355,26603,21963,3477
2022-10-09 11:30:00+00,3677,0,4642,15706,483,1039,751,157,5918,0,32372,56,27500,26749,22107,3677
2022-10-09 12:00:00+00,3915,0,4648,15369,495,914,750,154,5663,0,31908,58,26925,26175,21527,3915
2022-10-09 12:30:00+00,4306,0,4650,15035,504,852,752,158,5398,0,31655,63,26339,25587,20937,4306
2022-10-09 13:00:00+00,4240,0,4652,14893,505,911,748,163,4965,0,31077,63,25763,25015,20363,4240
2022-10-09 13:30:00+00,4384,0,4649,14866,514,950,752,163,4251,0,30529,66,25032,24280,19631,4384
2022-10-09 14:00:00+00,5202,0,4647,14792,525,1016,749,158,3545,0,30634,75,24258,23509,18862,5202
2022-10-09 14:30:00+00,6447,0,4646,14506,526,1099,748,155,3037,214,31378,89,23463,22715,18069,6447
2022-10-09 15:00:00+00,7408,0,4645,14025,519,1234,750,530,2090,566,31767,102,22029,21279,16634,7408
2022-10-09 15:30:00+00,8664,0,4641,13891,521,1436,837,713,1348,572,32623,119,21238,20401,15760,8664
2022-10-09 16:00:00+00,9144,0,4644,13908,680,1359,862,791,706,1112,33206,123,20800,19938,15294,9144
2022-10-09 16:30:00+00,9497,0,4648,14248,615,1342,992,792,231,868,33233,128,20734,19742,15094,9497
2022-10-09 17:00:00+00,9287,0,4641,14190,601,1239,1220,879,13,1152,33222,125,20665,19445,14804,9287
2022-10-09 17:30:00+00,9107,0,4645,14766,595,1202,1706,826,0,932,33779,122,21712,20006,15361,9107
2022-10-09 18:00:00+00,8628,0,4652,15241,570,1484,1910,684,0,772,33941,116,22373,20463,15811,8628
2022-10-09 18:30:00+00,7624,0,4653,15412,581,1510,1939,213,0,762,32694,104,22585,20646,15993,7624
2022-10-09 19:00:00+00,7571,0,4652,15051,617,1274,1916,160,0,746,31987,105,22236,20320,15668,7571
2022-10-09 19:30:00+00,6836,0,4659,15189,658,1296,1747,151,0,466,31001,98,22253,20506,15847,6836
2022-10-09 20:00:00+00,6133,0,4655,15453,639,1311,1683,156,0,20,30050,92,22430,20747,16092,6133
2022-10-09 20:30:00+00,5063,0,4662,15252,549,1334,1739,156,0,0,28754,82,22202,20463,15801,5063
2022-10-09 21:00:00+00,4075,0,4663,15089,594,1332,1629,149,0,0,27530,71,21975,20346,15683,4075
2022-10-09 21:30:00+00,3499,0,4662,15015,545,1341,1425,162,0,0,26648,64,21647,20222,15560,3499
2022-10-09 22:00:00+00,3316,0,4655,14369,522,1358,1231,165,0,0,25616,63,20777,19546,14891,3316
2022-10-09 22:30:00+00,3311,0,4653,13735,505,1322,1230,149,0,0,24905,64,20123,18893,14240,3311
2022-10-09 23:00:00+00,3318,0,4648,13005,503,1096,1431,172,0,0,24173,64,19587,18156,13508,3318
2022-10-09 23:30:00+00,3312,0,4657,12937,524,1096,1493,150,0,0,24169,64,19611,18118,13461,3312
2022-10-10 00:00:00+00,3310,0,4651,12929,499,1096,1399,165,0,0,24049,64,19478,18079,13428,3310
2022-10-10 00:30:00+00,3254,0,4657,12980,495,1096,1342,159,0,0,23983,62,19474,18132,13475,3254
2022-10-10 01:00:00+00,3035,0,4659,12897,468,1232,1319,147,0,0,23757,61,19343,18024,13365,3035
2022-10-10 01:30:00+00,2698,0,4653,12548,471,1236,1426,155,0,0,23188,58,19098,17672,13020,2698
2022-10-10 02:00:00+00,2484,0,4660,12633,458,1275,1347,152,0,0,23009,55,19098,17751,13091,2484
2022-10-10 02:30:00+00,2303,0,4655,12490,453,1301,1282,153,0,0,22637,53,18880,17598,12943,2303
2022-10-10 03:00:00+00,2148,0,4661,12841,453,1220,1271,152,0,0,22746,49,19226,17955,13294,2148
2022-10-10 03:30:00+00,1915,0,4655,12568,453,1310,1260,156,0,0,22317,47,18936,17676,13021,1915
2022-10-10 04:00:00+00,1973,0,4656,11413,470,1364,1321,182,0,0,21379,52,17860,16539,11883,1973
2022-10-10 04:30:00+00,2099,0,4654,11225,471,1474,1492,184,0,0,21599,57,17842,16350,11696,2099
2022-10-10 05:00:00+00,2697,0,4658,11041,498,1666,1949,275,0,214,22997,72,18146,16197,11539,2697
2022-10-10 05:30:00+00,3480,0,4654,11486,503,1702,2036,314,0,170,24345,82,18679,16643,11989,3480
2022-10-10 06:00:00+00,4702,0,4660,11965,510,2236,2034,459,0,74,26640,102,19169,17135,12475,4702
2022-10-10 06:30:00+00,5782,0,4655,12578,514,2214,2018,604,61,40,28465,111,19826,17808,13153,5782
2022-10-10 07:00:00+00,6751,0,4650,13027,488,2018,2042,487,536,94,30093,113,20743,18701,14051,6751
2022-10-10 07:30:00+00,7280,0,4647,13197,469,1932,2041,347,1472,122,31507,112,21826,19785,15138,7280
2022-10-10 08:00:00+00,7628,0,4641,12841,444,1770,2038,301,2551,190,32404,112,22515,20477,15836,7628
2022-10-10 08:30:00+00,7831,0,4643,13387,441,1722,2017,174,3554,40,33809,109,24042,22025,17382,7831
2022-10-10 09:00:00+00,7975,0,4639,13954,462,1128,2010,115,4541,24,34848,104,25606,23596,18957,7975
2022-10-10 09:30:00+00,7993,0,4633,14373,445,1050,1841,115,5426,0,35876,100,26718,24877,20244,7993
2022-10-10 10:00:00+00,7989,0,4631,14077,437,498,1919,115,6376,0,36042,97,27440,25521,20890,7989
2022-10-10 10:30:00+00,7934,0,4633,14679,453,446,1837,113,6972,0,37067,93,28574,26737,22104,7934
2022-10-10 11:00:00+00,7917,0,4631,14442,432,244,1944,120,7273,26,37029,92,28722,26778,22147,7917
2022-10-10 11:30:00+00,7561,0,4636,14413,428,244,1909,122,7254,0,36567,89,28640,26731,22095,7561
2022-10-10 12:00:00+00,7549,0,4638,14462,420,298,2024,118,7033,0,36542,89,28577,26553,21915,7549
2022-10-10 12:30:00+00,7482,0,4641,14284,418,300,2029,132,6962,0,36248,89,28334,26305,21664,7482
2022-10-10 13:00:00+00,7983,0,4637,14017,415,272,2034,122,6608,0,36088,95,27711,25677,21040,7983
2022-10-10 13:30:00+00,8624,0,4637,13925,411,274,2040,121,6141,0,36173,102,27154,25114,20477,8624
2022-10-10 14:00:00+00,8386,97,4639,13675,425,394,2039,127,5315,84,35181,105,26093,24054,19415,8483
2022-10-10 14:30:00+00,9714,218,4641,13301,432,432,2043,137,4548,38,35504,122,24965,22922,18281,9932
2022-10-10 15:00:00+00,10800,251,4635,13089,621,706,1957,148,3596,470,36273,132,23898,21941,17306,11051
2022-10-10 15:30:00+00,12972,278,4636,12523,679,764,2044,170,2476,544,37086,153,22358,20314,15678,13250
2022-10-10 16:00:00+00,14702,360,4633,11710,711,1064,1975,175,1274,1050,37654,171,20303,18328,13695,15062
2022-10-10 16:30:00+00,15636,469,4628,11368,704,1096,2047,281,373,1290,37892,183,19120,17073,12445,16105
2022-10-10 17:00:00+00,16639,484,4630,11020,709,1096,2050,480,14,1438,38560,193,18423,16373,11743,17123
2022-10-10 17:30:00+00,17441,513,4626,10580,786,1096,2007,645,0,1394,39088,200,17999,15992,11366,17954
2022-10-10 18:00:00+00,17556,668,4626,9930,789,1100,2048,657,0,1164,38538,207,17393,15345,10719,18224
2022-10-10 18:30:00+00,17515,657,4633,9591,768,1120,2045,240,0,822,37391,210,17037,14992,10359,18172
2022-10-10 19:00:00+00,17216,547,4631,9534,714,1108,2046,153,0,376,36325,209,16925,14879,10248,17763
2022-10-10 19:30:00+00,16559,483,4636,9304,663,1096,2048,140,0,170,35099,207,16651,14603,9967,17042
2022-10-10 20:00:00+00,15542,459,4634,9267,662,1096,2050,150,0,338,34198,200,16613,14563,9929,16001
2022-10-10 20:30:00+00,14862,218,4639,8938,646,1096,2046,135,0,34,32614,195,16269,14223,9584,15080
2022-10-10 21:00:00+00,13624,109,4649,8777,476,1096,2045,122,0,98,30996,186,15947,13902,9253,13733
2022-10-10 21:30:00+00,12057,0,4649,8567,458,1100,2050,131,0,0,29012,174,15724,13674,9025,12057
2022-10-10 22:00:00+00,11386,0,4652,8431,312,1240,2046,132,0,0,28199,169,15441,13395,8743,11386
2022-10-10 22:30:00+00,10545,0,4640,8256,289,1258,2045,125,0,0,27158,164,15230,13185,8545,10545
2022-10-10 23:00:00+00,10060,0,4644,8028,289,1258,2039,116,0,0,26434,161,15000,12961,8317,10060
2022-10-10 23:30:00+00,9889,0,4642,7636,288,1258,2036,114,0,0,25863,162,14602,12566,7924,9889
2022-10-11 00:00:00+00,9683,0,4638,7488,286,1258,2037,110,0,0,25500,161,14449,12412,7774,9683
2022-10-11 00:30:00+00,9710,0,4635,7320,285,1258,2041,128,0,0,25377,162,14281,12240,7605,9710
2022-10-11 01:00:00+00,9929,0,4631,6998,282,1258,2044,134,0,0,25276,166,13955,11911,7280,9929
2022-10-11 01:30:00+00,9838,0,4634,6858,281,1260,2046,124,0,0,25041,166,13819,11773,7139,9838
2022-10-11 02:00:00+00,10381,0,4636,6491,280,1382,2048,125,0,0,25343,173,13455,11407,6771,10381
2022-10-11 02:30:00+00,10640,0,4639,6204,280,1398,2042,116,0,0,25319,177,13165,11123,6484,10640
2022-10-11 03:00:00+00,11824,191,4637,5906,286,1398,2048,117,0,0,26407,194,12877,10829,6192,12015
2022-10-11 03:30:00+00,12265,231,4635,5652,283,1388,2050,116,0,0,26620,200,12620,10570,5935,12496
2022-10-11 04:00:00+00,13551,232,4638,5002,282,1108,2048,126,0,0,26987,217,11970,9922,5284,13783
2022-10-11 04:30:00+00,14759,370,4643,4644,324,1054,2052,118,0,0,27964,231,11663,9611,4968,15129
2022-10-11 05:00:00+00,16191,647,4642,4399,628,1366,2052,119,0,0,30044,242,11721,9669,5027,16838
2022-10-11 05:30:00+00,18038,871,4640,4237,650,1412,2050,183,0,400,32481,254,11577,9527,4887,18909
2022-10-11 06:00:00+00,19169,970,4640,4207,735,1426,2044,669,0,832,34692,258,11626,9582,4942,20139
2022-10-11 06:30:00+00,19446,977,4634,3930,761,1558,2045,893,101,1208,35553,259,11471,9426,4792,20423
2022-10-11 07:00:00+00,19437,980,4641,3571,734,1898,2045,817,681,782,35586,260,11672,9627,4986,20417
2022-10-11 07:30:00+00,19463,976,4645,3416,740,1974,2044,689,1708,544,36199,255,12553,10509,5864,20439
2022-10-11 08:00:00+00,19766,978,4639,3230,715,1498,2043,509,2688,634,36700,250,13315,11272,6633,20744
2022-10-11 08:30:00+00,19807,979,4633,3187,674,1494,2047,254,3705,506,37286,244,14246,12199,7566,20786
2022-10-11 09:00:00+00,19689,978,4620,3240,662,1358,2047,187,4551,302,37634,239,15120,13073,8453,20667
2022-10-11 09:30:00+00,18992,812,4623,3552,640,1330,2060,159,5353,222,37743,227,16228,14168,9545,19804
2022-10-11 10:00:00+00,18533,552,4620,3791,607,1428,2057,166,6029,250,38033,216,17104,15047,10427,19085
2022-10-11 10:30:00+00,18305,458,4618,3927,587,1362,2023,168,6219,176,37843,212,17374,15351,10733,18763
2022-10-11 11:00:00+00,18733,609,4619,4040,473,722,2000,162,6240,18,37616,220,17372,15372,10753,19342
2022-10-11 11:30:00+00,18498,539,4620,3943,467,682,1991,161,6028,32,36961,219,17049,15058,10438,19037
2022-10-11 12:00:00+00,18539,463,4623,4465,457,476,2044,161,5816,0,37044,218,17405,15361,10738,19002
2022-10-11 12:30:00+00,18442,460,4624,4722,457,440,2044,161,5437,42,36829,218,17284,15240,10616,18902
2022-10-11 13:00:00+00,18371,460,4627,4904,457,656,2044,168,5252,20,36959,219,17284,15240,10613,18831
2022-10-11 13:30:00+00,18333,466,4630,5119,458,644,2033,158,4583,0,36424,222,16823,14790,10160,18799
2022-10-11 14:00:00+00,18251,683,4631,5362,459,1136,2043,170,3941,0,36676,227,16436,14393,9762,18934
2022-10-11 14:30:00+00,18538,969,4629,5476,460,1394,2042,175,3494,18,37195,237,16101,14059,9430,19507
2022-10-11 15:00:00+00,18677,948,4634,5520,531,1894,2047,196,2720,312,37479,237,15452,13405,8771,19625
2022-10-11 15:30:00+00,18942,982,4623,5608,480,2048,2048,337,1727,740,37535,243,14486,12438,7815,19924
2022-10-11 16:00:00+00,18757,985,4624,5697,547,2038,2047,473,969,1192,37329,241,13884,11837,7213,19742
2022-10-11 16:30:00+00,19121,980,4616,5895,592,2395,2048,640,298,1292,37877,247,13449,11401,6785,20101
2022-10-11 17:00:00+00,18958,772,4621,5865,728,2584,2037,1078,8,1270,37921,246,13259,11222,6601,19730
2022-10-11 17:30:00+00,19121,878,4609,6020,736,2628,2048,1070,0,1420,38530,247,13413,11365,6756,19999
2022-10-11 18:00:00+00,18931,979,4623,6346,728,2338,2046,1138,0,1110,38239,249,13743,11697,7074,19910
2022-10-11 18:30:00+00,18212,978,4611,6450,709,2296,2045,953,0,1106,37360,245,13815,11770,7159,19190
2022-10-11 19:00:00+00,18564,979,4615,6797,536,1942,2048,856,0,836,37173,246,13996,11948,7333,19543
2022-10-11 19:30:00+00,18460,853,4611,6960,488,1754,2048,679,0,322,36175,245,14107,12059,7448,19313
2022-10-11 20:00:00+00,18374,395,4616,7185,456,1136,2049,315,0,374,34900,234,14306,12257,7641,18769
2022-10-11 20:30:00+00,17347,38,4619,7411,443,1168,2049,182,0,0,33257,224,14522,12473,7854,17385
2022-10-11 21:00:00+00,16808,0,4624,7597,394,872,2049,182,0,106,32632,221,14664,12615,7991,16808
2022-10-11 21:30:00+00,14911,0,4628,7841,345,772,2043,164,0,4,30708,209,14857,12814,8186,14911
2022-10-11 22:00:00+00,12611,0,4631,8034,297,1172,2035,304,0,4,29088,191,14997,12962,8331,12611
2022-10-11 22:30:00+00,11321,0,4633,8378,295,1346,2023,313,0,46,28355,180,15329,13306,8673,11321
2022-10-11 23:00:00+00,10301,0,4629,8768,279,1468,1983,208,0,0,27636,172,15659,13676,9047,10301
2022-10-11 23:30:00+00,9803,0,4631,8875,277,1448,1983,169,0,0,27186,166,15766,13783,9152,9803
2022-10-12 00:00:00+00,9788,0,4628,8830,258,1670,1981,155,0,0,27310,164,15697,13716,9088,9788
2022-10-12 00:30:00+00,9712,0,4632,9041,258,1756,1982,155,0,0,27536,163,15913,13931,9299,9712
2022-10-12 01:00:00+00,9468,0,4629,9181,257,1694,1980,156,0,0,27365,160,16047,14067,9438,9468
2022-10-12 01:30:00+00,9170,0,4627,9320,254,1550,1981,163,0,0,27065,155,16182,14201,9574,9170
2022-10-12 02:00:00+00,8922,0,4625,9268,252,1516,1975,164,0,0,26722,154,16120,14145,9520,8922
2022-10-12 02:30:00+00,8803,0,4623,9431,251,1292,1978,152,0,0,26530,150,16283,14305,9682,8803
2022-10-12 03:00:00+00,9031,2,4615,9572,252,756,2038,163,0,0,26429,151,16477,14439,9824,9033
2022-10-12 03:30:00+00,8959,168,4623,10041,264,442,2045,150,0,0,26692,150,16973,14928,10305,9127
2022-10-12 04:00:00+00,9180,230,4615,10204,278,42,2049,164,0,0,26762,154,17146,15097,10482,9410
2022-10-12 04:30:00+00,10110,411,4621,10458,343,0,2047,163,0,0,28153,166,17469,15422,10801,10521
2022-10-12 05:00:00+00,11846,461,4622,10926,483,56,2045,155,0,0,30594,177,18076,16031,11409,12307
2022-10-12 05:30:00+00,14179,461,4621,11089,423,8,2046,164,0,108,33099,191,18179,16133,11512,14640
2022-10-12 06:00:00+00,16704,539,4615,11168,460,48,2048,208,0,172,35962,206,18291,16243,11628,17243
2022-10-12 06:30:00+00,17881,691,4617,11131,463,78,2045,238,35,172,37351,214,18291,16246,11629,18572
2022-10-12 07:00:00+00,18316,650,4617,11183,443,470,2046,308,297,232,38562,212,18586,16540,11923,18966
2022-10-12 07:30:00+00,18265,598,4622,11524,436,510,2040,221,873,0,39089,206,19495,17455,12833,18863
2022-10-12 08:00:00+00,17855,630,4620,11660,457,452,2046,313,1394,64,39491,202,20177,18131,13511,18485
2022-10-12 08:30:00+00,17724,476,4623,11700,518,410,2047,229,2191,56,39974,194,21079,19032,14409,18200
2022-10-12 09:00:00+00,17623,429,4601,11629,601,34,2046,201,2555,154,39873,192,21432,19386,14785,18052
2022-10-12 09:30:00+00,17435,230,4602,11973,591,0,2045,164,2986,12,40038,184,22197,20152,15550,17665
2022-10-12 10:00:00+00,16550,233,4596,12280,521,0,2044,167,3368,0,39759,177,22809,20765,16169,16783
2022-10-12 10:30:00+00,16249,229,4598,12494,497,0,2017,161,3786,16,40047,172,23392,21375,16777,16478
2022-10-12 11:00:00+00,16236,230,4588,12171,560,12,2038,179,3967,70,40051,173,23324,21286,16698,16466
2022-10-12 11:30:00+00,16514,229,4593,11731,565,34,2041,166,3371,0,39244,179,22301,20260,15667,16743
2022-10-12 12:00:00+00,16657,237,4588,11521,457,274,2043,171,3316,62,39326,180,21925,19882,15294,16894
2022-10-12 12:30:00+00,16976,229,4587,11646,375,308,2041,162,2942,12,39278,183,21591,19550,14963,17205
2022-10-12 13:00:00+00,17264,241,4595,11357,333,698,2039,169,2556,0,39252,187,20880,18841,14246,17505
2022-10-12 13:30:00+00,17899,236,4596,11077,342,740,2042,170,1984,0,39086,194,20041,17999,13403,18135
2022-10-12 14:00:00+00,18376,235,4600,10605,400,710,2043,184,1400,0,38553,201,19048,17005,12405,18611
2022-10-12 14:30:00+00,19303,310,4587,10011,512,742,2046,214,1093,148,38966,211,18249,16203,11616,19613
2022-10-12 15:00:00+00,19254,452,4600,9598,625,1116,2047,324,791,304,39110,214,17660,15614,11014,19706
2022-10-12 15:30:00+00,19415,658,4595,9274,678,1162,2047,569,550,698,39646,219,17144,15097,10502,20073
2022-10-12 16:00:00+00,19630,719,4598,9067,750,1248,2046,682,247,1476,40463,220,16708,14662,10064,20349
2022-10-12 16:30:00+00,20114,721,4598,8677,757,1258,2048,846,53,1556,40628,225,16133,14085,9487,20835
2022-10-12 17:00:00+00,20937,708,4596,8105,755,1378,2047,1078,0,1540,41144,232,15503,13456,8860,21645
2022-10-12 17:30:00+00,21386,769,4593,7688,833,1498,2045,1215,0,1442,41469,238,15159,13114,8521,22155
2022-10-12 18:00:00+00,20280,758,4596,7390,871,1618,2047,1176,0,1506,40242,236,14904,12857,8261,21038
2022-10-12 18:30:00+00,19887,649,4598,6922,850,1648,2045,940,0,1222,38761,237,14415,12370,7772,20536
2022-10-12 19:00:00+00,20070,612,4589,7072,741,1260,2046,381,0,722,37493,236,14448,12402,7813,20682
2022-10-12 19:30:00+00,19513,611,4586,6844,672,1252,2048,336,0,532,36394,237,14150,12102,7516,20124
2022-10-12 20:00:00+00,19439,545,4586,6322,588,1202,2048,320,0,382,35432,240,13544,11496,6910,19984
2022-10-12 20:30:00+00,18574,470,4588,6113,546,1186,2046,253,0,64,33840,239,13293,11247,6659,19044
2022-10-12 21:00:00+00,17871,461,4588,6343,508,794,2048,184,0,68,32865,237,13487,11439,6851,18332
2022-10-12 21:30:00+00,16911,237,4591,6378,410,738,2049,174,0,0,31488,228,13428,11379,6788,17148
2022-10-12 22:00:00+00,16306,5,4594,6088,385,346,2049,287,0,0,30060,225,13116,11067,6473,16311
2022-10-12 22:30:00+00,15756,0,4598,5828,384,294,2049,188,0,0,29097,224,12859,10810,6212,15756
2022-10-12 23:00:00+00,15987,0,4594,5365,345,22,2048,165,0,0,28526,231,12352,10304,5710,15987
2022-10-12 23:30:00+00,16272,0,4593,4913,342,0,2048,164,0,0,28332,237,11896,9848,5255,16272
2022-10-13 00:00:00+00,16128,0,4597,4468,324,22,2048,174,0,0,27761,240,11437,9389,4792,16128
2022-10-13 00:30:00+00,16402,0,4599,3976,325,36,2047,165,0,0,27550,245,10947,8900,4301,16402
2022-10-13 01:00:00+00,16029,0,4594,4066,324,166,2049,168,0,0,27396,241,11033,8984,4390,16029
2022-10-13 01:30:00+00,16060,0,4592,3792,324,172,2049,163,0,0,27152,244,10757,8708,4116,16060
2022-10-13 02:00:00+00,16115,0,4592,3621,323,122,2050,165,0,0,26988,246,10586,8536,3944,16115
2022-10-13 02:30:00+00,16004,0,4591,3532,323,122,2049,164,0,0,26785,246,10495,8446,3855,16004
2022-10-13 03:00:00+00,15823,0,4594,3558,323,182,2051,161,0,0,26692,245,10526,8475,3881,15823
2022-10-13 03:30:00+00,15921,0,4591,3400,327,206,2050,165,0,0,26660,246,10368,8318,3727,15921
2022-10-13 04:00:00+00,15898,122,4590,3201,339,376,2052,158,0,0,26736,250,10182,8130,3540,16020
2022-10-13 04:30:00+00,16538,289,4585,3102,360,419,2049,164,0,0,27506,258,10096,8047,3462,16827
2022-10-13 05:00:00+00,17416,510,4586,2825,651,822,2051,170,0,0,29030,264,10113,8062,3476,17926
2022-10-13 05:30:00+00,19355,842,4587,2627,669,888,2051,273,0,34,31326,280,9934,7883,3296,20197
2022-10-13 06:00:00+00,20533,979,4590,2513,745,1259,2050,752,0,0,33421,286,9898,7848,3258,21512
2022-10-13 06:30:00+00,21148,984,4587,2471,757,1294,2049,1090,24,258,34662,285,9888,7839,3252,22132
2022-10-13 07:00:00+00,21054,984,4585,2300,756,1940,2049,884,300,552,35404,283,9990,7941,3356,22038
2022-10-13 07:30:00+00,21451,990,4589,2059,753,2018,2048,836,916,266,35926,284,10365,8317,3728,22441
2022-10-13 08:00:00+00,21875,983,4583,1977,712,1762,2048,608,1504,462,36514,279,10824,8776,4193,22858
2022-10-13 08:30:00+00,21783,979,4590,2047,708,1718,2050,557,2209,414,37055,273,11604,9554,4964,22762
2022-10-13 09:00:00+00,21722,979,4576,2099,676,1208,2049,489,2856,420,37074,267,12256,10207,5631,22701
2022-10-13 09:30:00+00,21554,904,4573,2316,634,1160,2048,312,3567,352,37420,260,13138,11090,6517,22458
2022-10-13 10:00:00+00,21706,799,4573,2533,553,772,2046,226,3888,0,37096,260,13593,11547,6974,22505
2022-10-13 10:30:00+00,21383,721,4575,2848,500,712,2047,196,4245,0,37227,253,14215,12168,7593,22104
2022-10-13 11:00:00+00,20891,686,4572,3269,435,604,2048,188,4787,0,37480,245,15111,13063,8491,21577
2022-10-13 11:30:00+00,20111,620,4577,3852,437,592,2047,181,5117,0,37534,235,16030,13983,9406,20731
2022-10-13 12:00:00+00,19454,464,4573,4202,420,564,2036,178,5240,0,37131,226,16471,14435,9862,19918
2022-10-13 12:30:00+00,18722,461,4574,4504,419,572,2032,171,5376,0,36831,220,16905,14873,10299,19183
2022-10-13 13:00:00+00,18462,460,4566,4697,416,726,2042,190,4878,0,36437,220,16599,14557,9991,18922
2022-10-13 13:30:00+00,18095,462,4570,5459,426,690,2044,185,4426,0,36357,216,16925,14881,10311,18557
2022-10-13 14:00:00+00,17222,460,4565,5501,464,894,2046,194,3889,0,35235,217,16465,14419,9854,17682
2022-10-13 14:30:00+00,17984,460,4572,5771,467,942,2041,190,3315,0,35742,223,16166,14125,9553,18444
2022-10-13 15:00:00+00,18239,533,4568,5751,504,1562,2048,266,2581,204,36256,228,15452,13404,8836,18772
2022-10-13 15:30:00+00,18855,717,4570,5836,527,1642,2048,277,1675,374,36521,238,14656,12608,8038,19572
2022-10-13 16:00:00+00,18891,798,4572,6315,528,2132,2048,489,717,778,37268,239,14180,12132,7560,19689
2022-10-13 16:30:00+00,19236,853,4570,6409,548,2074,2048,735,148,786,37407,244,13723,11675,7105,20089
2022-10-13 17:00:00+00,20466,955,4568,6311,570,1398,2047,896,1,1198,38410,247,13497,11450,6882,21421
2022-10-13 17:30:00+00,20588,983,4570,6464,561,1372,2047,1052,0,1292,38929,247,13642,11595,7025,21571
2022-10-13 18:00:00+00,20381,984,4574,6628,555,1120,2049,1014,0,1028,38333,249,13806,11757,7183,21365
2022-10-13 18:30:00+00,20117,984,4568,6676,526,1082,2036,723,0,1054,37766,247,13806,11770,7202,21101
2022-10-13 19:00:00+00,19988,984,4576,6992,504,944,2048,511,0,574,37121,248,14120,12072,7496,20972
2022-10-13 19:30:00+00,19321,879,4573,7096,479,890,2047,249,0,244,35778,245,14195,12148,7575,20200
2022-10-13 20:00:00+00,19089,847,4568,7206,438,552,2047,179,0,170,35096,246,14259,12212,7644,19936
2022-10-13 20:30:00+00,18012,464,4571,7283,435,482,2048,168,0,0,33462,235,14337,12289,7718,18476
2022-10-13 21:00:00+00,17156,227,4564,7421,389,151,2047,170,0,92,32217,227,14421,12374,7810,17383
2022-10-13 21:30:00+00,15236,227,4568,7620,382,144,2046,185,0,0,30408,216,14616,12570,8002,15463
2022-10-13 22:00:00+00,14583,0,4562,7568,347,70,2047,172,0,58,29407,207,14524,12477,7915,14583
2022-10-13 22:30:00+00,13711,0,4572,7657,347,0,2047,160,0,0,28494,200,14623,12576,8004,13711
2022-10-13 23:00:00+00,13199,0,4568,7712,282,0,2019,151,0,0,27931,196,14581,12562,7994,13199
2022-10-13 23:30:00+00,12602,0,4571,7746,280,10,2013,160,0,0,27382,192,14610,12597,8026,12602
2022-10-14 00:00:00+00,12375,0,4572,8058,286,28,2045,177,0,0,27541,188,14961,12916,8344,12375
2022-10-14 00:30:00+00,12506,0,4570,7969,288,28,2045,183,0,0,27590,190,14872,12827,8257,12506
2022-10-14 01:00:00+00,12486,0,4572,7855,289,28,2046,176,0,0,27451,191,14762,12716,8144,12486
2022-10-14 01:30:00+00,12347,0,4565,7632,287,28,2049,186,0,0,27094,191,14533,12484,7919,12347
2022-10-14 02:00:00+00,12347,0,4568,7376,285,28,2049,184,0,0,26837,193,14278,12229,7661,12347
2022-10-14 02:30:00+00,12393,2,4575,7412,285,0,2049,169,0,0,26885,193,14321,12272,7697,12395
2022-10-14 03:00:00+00,12448,144,4573,7269,286,0,2049,170,0,0,26939,198,14177,12128,7555,12592
2022-10-14 03:30:00+00,12401,240,4574,6927,296,0,2048,167,0,0,26653,203,13845,11797,7223,12641
2022-10-14 04:00:00+00,12614,238,4576,6622,348,0,2048,171,0,0,26618,206,13594,11546,6970,12852
2022-10-14 04:30:00+00,12878,234,4576,6311,381,0,2047,241,0,0,26668,210,13315,11268,6692,13112
2022-10-14 05:00:00+00,13595,385,4575,5754,495,0,2048,263,0,138,27253,222,12872,10824,6249,13980
2022-10-14 05:30:00+00,14474,588,4576,5459,524,0,2045,223,0,82,27972,235,12604,10559,5983,15062
2022-10-14 06:00:00+00,15773,725,4576,5424,750,304,2043,548,0,0,30143,247,12793,10750,6174,16498
2022-10-14 06:30:00+00,16911,729,4570,5360,778,324,2043,631,15,336,31697,250,12766,10723,6153,17640
2022-10-14 07:00:00+00,18007,724,4580,5268,942,94,2044,849,210,778,33497,248,13044,11000,6420,18731
2022-10-14 07:30:00+00,18599,718,4570,5334,820,154,2044,865,637,758,34499,247,13405,11361,6791,19317
2022-10-14 08:00:00+00,18974,676,4573,5697,798,368,2047,782,1034,746,35695,241,14149,12102,7529,19650
2022-10-14 08:30:00+00,19245,715,4569,6166,867,376,2046,759,1502,364,36609,239,15150,13104,8535,19960
2022-10-14 09:00:00+00,19446,542,4554,6621,781,590,2045,684,1873,272,37408,234,15874,13829,9275,19988
2022-10-14 09:30:00+00,19596,487,4550,6963,739,590,2061,513,2440,142,38081,230,16753,14692,10142,20083
2022-10-14 10:00:00+00,19730,483,4549,7215,663,502,2075,490,2634,136,38477,229,17136,15061,10512,20213
2022-10-14 10:30:00+00,19760,507,4549,7261,656,464,2045,282,2497,0,38021,230,17008,14963,10414,20267
2022-10-14 11:00:00+00,19856,549,4556,7622,572,72,2045,220,2563,0,38055,227,17358,15313,10757,20405
2022-10-14 11:30:00+00,19296,575,4547,7951,559,56,2046,193,2514,0,37737,224,17617,15571,11024,19871
2022-10-14 12:00:00+00,19445,474,4544,7881,434,2,2045,182,2627,0,37634,223,17531,15486,10942,19919
2022-10-14 12:30:00+00,19221,478,4536,7605,433,2,2046,191,2651,28,37191,224,17271,15225,10689,19699
2022-10-14 13:00:00+00,19595,472,4533,7362,478,2,2045,176,2665,0,37328,227,17083,15038,10505,20067
2022-10-14 13:30:00+00,19646,469,4529,7096,481,2,2045,177,2859,0,37304,227,17010,14965,10436,20115
2022-10-14 14:00:00+00,19366,467,4531,7218,487,2,2047,184,2406,0,36708,228,16689,14642,10111,19833
2022-10-14 14:30:00+00,19666,473,4518,6928,493,34,2046,206,1927,142,36433,233,15912,13866,9348,20139
2022-10-14 15:00:00+00,19162,474,4526,6306,606,828,2048,303,1446,624,36323,234,14932,12884,8358,19636
2022-10-14 15:30:00+00,19277,488,4535,6034,773,936,2048,540,1145,1078,36854,235,14535,12487,7952,19765
2022-10-14 16:00:00+00,19042,477,4535,5998,793,1258,2048,718,566,1584,37019,233,13940,11892,7357,19519
2022-10-14 16:30:00+00,19876,474,4538,5516,793,1322,2049,767,154,1616,37105,241,13050,11001,6463,20350
2022-10-14 17:00:00+00,20775,502,4543,5417,823,1636,2049,1026,0,1410,38181,247,12832,10783,6240,21277
2022-10-14 17:30:00+00,21027,465,4539,5298,803,1652,2035,1049,0,1486,38354,247,12675,10640,6101,21492
2022-10-14 18:00:00+00,20384,288,4529,5203,790,1608,2050,798,0,1474,37124,244,12572,10522,5993,20672
2022-10-14 18:30:00+00,20186,283,4532,5004,775,1558,2050,591,0,1188,36167,247,12361,10311,5779,20469
2022-10-14 19:00:00+00,20309,270,4532,4998,710,1540,2051,466,0,428,35304,256,12291,10240,5708,20579
2022-10-14 19:30:00+00,19453,287,4531,4858,706,1610,2036,318,0,138,33937,256,12131,10095,5564,19740
2022-10-14 20:00:00+00,19731,237,4532,4498,687,1016,2049,199,0,98,33047,258,11766,9717,5185,19968
2022-10-14 20:30:00+00,19183,134,4534,4056,683,1112,2052,209,0,68,32031,257,11325,9273,4739,19317
2022-10-14 21:00:00+00,19758,67,4531,3790,673,610,2050,169,0,38,31686,263,11044,8994,4463,19825
2022-10-14 21:30:00+00,18321,0,4532,3709,566,550,2053,179,0,14,29924,257,10860,8807,4275,18321
2022-10-14 22:00:00+00,15874,0,4528,3828,377,340,2051,173,0,72,27244,246,10784,8734,4206,15874
2022-10-14 22:30:00+00,14299,0,4536,4217,363,286,2051,210,0,20,25982,234,11167,9116,4580,14299
2022-10-14 23:00:00+00,13350,0,4533,4363,357,548,2050,180,0,0,25381,225,11303,9253,4720,13350
2022-10-14 23:30:00+00,12102,0,4538,4685,357,670,2050,169,0,0,24571,214,11630,9580,5042,12102
2022-10-15 00:00:00+00,10725,0,4528,4940,357,1272,2020,179,0,0,24021,200,11845,9825,5297,10725
2022-10-15 00:30:00+00,10110,0,4536,5393,356,1270,1985,176,0,0,23826,191,12270,10285,5749,10110
2022-10-15 01:00:00+00,9964,0,4541,6121,337,754,1983,180,0,0,23880,185,12982,10999,6458,9964
2022-10-15 01:30:00+00,9373,0,4550,6723,336,720,1999,169,0,0,23870,176,13608,11609,7059,9373
2022-10-15 02:00:00+00,9434,0,4546,7216,334,406,1980,168,0,0,24084,174,14076,12096,7550,9434
2022-10-15 02:30:00+00,9073,0,4550,7593,333,400,1759,168,0,0,23876,168,14235,12476,7926,9073
2022-10-15 03:00:00+00,9634,0,4546,8010,332,372,1405,179,0,0,24478,171,14293,12888,8342,9634
2022-10-15 03:30:00+00,9278,0,4548,8604,349,236,1405,192,0,0,24612,162,14906,13501,8953,9278
2022-10-15 04:00:00+00,9458,0,4553,9283,388,152,1404,575,0,0,25813,160,15628,14224,9671,9458
2022-10-15 04:30:00+00,9514,0,4561,10074,402,222,1403,602,0,0,26778,157,16440,15037,10476,9514
2022-10-15 05:00:00+00,10200,0,4564,11112,579,134,1376,628,0,0,28593,155,17631,16255,11691,10200
2022-10-15 05:30:00+00,9393,0,4559,12587,550,220,1290,440,0,0,29039,141,18986,17696,13137,9393
2022-10-15 06:00:00+00,9179,0,4558,13472,556,150,1310,468,0,0,29693,134,19896,18586,14028,9179
2022-10-15 06:30:00+00,9542,0,4564,14188,562,220,1350,485,34,0,30945,135,20698,19348,14784,9542
2022-10-15 07:00:00+00,9315,0,4562,14990,561,134,1364,322,358,0,31606,126,21835,20471,15909,9315
2022-10-15 07:30:00+00,8632,0,4561,15651,562,192,1396,439,1123,0,32556,116,23293,21897,17336,8632
2022-10-15 08:00:00+00,8570,0,4554,15795,547,84,1402,436,2093,24,33505,111,24391,22989,18435,8570
2022-10-15 08:30:00+00,8504,0,4556,15919,533,76,1400,237,3077,0,34302,106,25485,24085,19529,8504
2022-10-15 09:00:00+00,8356,0,4540,15944,542,194,1398,183,3991,0,35148,103,26415,25017,20477,8356
2022-10-15 09:30:00+00,7704,0,4526,16165,542,136,1398,194,4670,0,35335,94,27301,25903,21377,7704
2022-10-15 10:00:00+00,6343,0,4531,16443,560,132,1397,180,5128,0,34714,80,28059,26662,22131,6343
2022-10-15 10:30:00+00,6078,0,4530,16393,560,102,1403,193,5121,0,34380,78,28007,26604,22074,6078
2022-10-15 11:00:00+00,5485,0,4533,16856,402,272,1397,169,5336,0,34450,72,28524,27127,22594,5485
2022-10-15 11:30:00+00,5132,0,4534,17060,396,420,1399,171,4810,0,33922,71,28199,26800,22266,5132
2022-10-15 12:00:00+00,4760,0,4540,17594,388,646,1258,171,4679,0,34036,67,28459,27201,22661,4760
2022-10-15 12:30:00+00,4763,0,4544,17843,398,548,937,170,4428,0,33631,65,28150,27213,22669,4763
2022-10-15 13:00:00+00,4941,0,4538,17431,401,1090,908,186,4109,0,33604,70,27387,26479,21941,4941
2022-10-15 13:30:00+00,5002,0,4545,17558,404,1014,1007,173,3641,0,33344,71,27155,26148,21603,5002
2022-10-15 14:00:00+00,5559,0,4537,16949,473,400,1106,193,3437,0,32654,79,26502,25396,20859,5559
2022-10-15 14:30:00+00,6268,0,4537,16600,488,400,1322,199,2798,0,32612,88,25745,24423,19886,6268
2022-10-15 15:00:00+00,7943,0,4540,16264,556,400,1400,191,1718,0,33012,107,24478,23078,18538,7943
2022-10-15 15:30:00+00,9065,0,4543,15782,575,400,1401,371,1436,0,33573,120,23737,22336,17793,9065
2022-10-15 16:00:00+00,9733,0,4538,15266,587,474,1400,644,597,674,33913,129,22388,20988,16450,9733
2022-10-15 16:30:00+00,10178,0,4542,15478,585,532,1395,805,145,704,34364,134,22145,20750,16208,10178
2022-10-15 17:00:00+00,9611,0,4567,15730,568,1380,1530,579,0,582,34547,132,22395,20865,16298,9611
2022-10-15 17:30:00+00,9541,0,4599,16248,548,1446,1736,536,0,462,35116,129,23131,21395,16796,9541
2022-10-15 18:00:00+00,8957,0,4594,16277,671,1308,1993,476,0,352,34628,125,23535,21542,16948,8957
2022-10-15 18:30:00+00,8235,0,4589,16301,674,1092,2045,334,0,356,33626,117,23609,21564,16975,8235
2022-10-15 19:00:00+00,8491,0,4591,16243,614,530,2048,277,0,0,32794,118,23496,21448,16857,8491
2022-10-15 19:30:00+00,7285,0,4584,16692,594,532,2046,191,0,8,31932,106,23916,21870,17286,7285
2022-10-15 20:00:00+00,5646,0,4586,16530,460,1098,1840,165,0,0,30325,93,23416,21576,16990,5646
2022-10-15 20:30:00+00,4472,0,4601,16520,452,1166,1600,242,0,0,29053,81,23173,21573,16972,4472
2022-10-15 21:00:00+00,3729,0,4611,16799,427,1512,1287,264,0,0,28629,71,23124,21837,17226,3729
2022-10-15 21:30:00+00,3435,0,4620,16439,456,1536,1194,203,0,0,27883,67,22709,21515,16895,3435
2022-10-15 22:00:00+00,3429,0,4622,16207,421,1284,1187,191,0,0,27341,64,22437,21250,16628,3429
2022-10-15 22:30:00+00,3376,0,4546,15672,417,1210,1183,162,0,0,26566,64,21818,20635,16089,3376
2022-10-15 23:00:00+00,3878,0,4166,15337,402,232,1216,177,0,0,25408,68,21121,19905,15739,3878
2022-10-15 23:30:00+00,3610,0,4119,15378,402,198,1293,179,0,0,25179,65,21192,19899,15780,3610
2022-10-16 00:00:00+00,3409,0,4100,15525,393,262,1217,182,0,0,25088,62,21235,20018,15918,3409
2022-10-16 00:30:00+00,3417,0,4087,15587,391,240,1372,190,0,0,25284,63,21437,20065,15978,3417
2022-10-16 01:00:00+00,3590,0,4090,15926,374,8,1495,189,0,0,25672,64,21885,20390,16300,3590
2022-10-16 01:30:00+00,3523,0,4095,15895,373,0,1480,173,0,0,25539,63,21843,20363,16268,3523
2022-10-16 02:00:00+00,3718,0,4108,16139,388,0,1511,185,0,0,26049,65,22146,20635,16527,3718
2022-10-16 02:30:00+00,3701,0,4130,16114,388,0,1477,169,0,0,25979,65,22109,20632,16502,3701
2022-10-16 03:00:00+00,3652,0,4134,16334,392,0,1380,165,0,0,26057,63,22240,20860,16726,3652
2022-10-16 03:30:00+00,3631,0,4131,16357,394,0,1152,173,0,0,25838,63,22034,20882,16751,3631
2022-10-16 04:00:00+00,3667,0,4137,15912,384,0,1249,179,0,0,25528,65,21682,20433,16296,3667
2022-10-16 04:30:00+00,3642,0,4157,15892,383,0,1320,175,0,0,25569,64,21752,20432,16275,3642
2022-10-16 05:00:00+00,3614,0,4163,16075,401,0,1309,168,0,0,25730,63,21948,20639,16476,3614
2022-10-16 05:30:00+00,3822,0,4169,16055,407,58,1366,183,0,0,26060,66,21997,20631,16462,3822
2022-10-16 06:00:00+00,3424,0,4176,16058,442,420,1492,173,0,0,26185,60,22168,20676,16500,3424
2022-10-16 06:30:00+00,3266,0,4173,16303,453,466,1749,192,36,0,26638,58,22714,20965,16792,3266
2022-10-16 07:00:00+00,2872,0,4180,16365,596,1624,1978,173,487,0,28275,57,23606,21628,17448,2872
2022-10-16 07:30:00+00,2963,0,4180,16149,679,1700,2045,172,1550,0,29438,57,24603,22558,18378,2963
2022-10-16 08:00:00+00,2985,0,4182,15581,689,2298,2041,172,2754,0,30702,59,25247,23206,19024,2985
2022-10-16 08:30:00+00,3390,0,4182,15108,690,2324,2028,169,3815,0,31706,62,25823,23795,19613,3390
2022-10-16 09:00:00+00,3532,0,4185,14288,672,2970,1853,175,4779,0,32454,65,25777,23924,19739,3532
2022-10-16 09:30:00+00,3853,0,4186,13641,513,3026,1582,170,5566,0,32537,68,25488,23906,19720,3853
2022-10-16 10:00:00+00,3505,0,4188,13010,478,3336,1750,165,6108,0,32540,65,25534,23784,19596,3505
2022-10-16 10:30:00+00,3804,0,4182,12109,465,3372,1899,168,6246,78,32323,69,24901,23002,18820,3804
2022-10-16 11:00:00+00,4109,0,4181,11112,434,3390,1907,168,6405,66,31772,74,24039,22132,17951,4109
2022-10-16 11:30:00+00,4672,0,4176,10329,432,3392,1905,171,6229,406,31712,81,23071,21166,16990,4672
2022-10-16 12:00:00+00,4238,0,4178,9334,432,4112,1904,161,5776,466,30601,80,21624,19720,15542,4238
2022-10-16 12:30:00+00,5475,0,4174,8376,431,4176,1902,162,5057,316,30069,98,19940,18038,13864,5475
2022-10-16 13:00:00+00,6502,0,4177,7465,421,4336,1902,458,4193,168,29622,116,18158,16256,12079,6502
2022-10-16 13:30:00+00,6414,0,4192,7163,420,4368,1902,604,3341,222,28626,121,17018,15116,10924,6414
2022-10-16 14:00:00+00,6440,0,4205,7132,458,3398,1906,490,2706,754,27490,123,16407,14501,10296,6440
2022-10-16 14:30:00+00,6590,0,4220,6904,462,3448,1906,438,1915,736,26619,130,15407,13501,9281,6590
2022-10-16 15:00:00+00,6843,0,4230,6618,508,1714,1906,604,1181,924,24529,136,14443,12537,8307,6843
2022-10-16 15:30:00+00,7352,0,4250,6329,523,1694,1886,532,710,1002,24278,145,13698,11812,7562,7352
2022-10-16 16:00:00+00,7799,0,4260,6273,612,1578,2007,582,270,1306,24687,150,13422,11415,7155,7799
2022-10-16 16:30:00+00,8375,0,4269,6819,640,1618,2052,728,46,1402,25949,154,13826,11774,7505,8375
2022-10-16 17:00:00+00,8649,0,4282,6822,766,1436,2052,934,0,1548,26490,157,13922,11870,7588,8649
2022-10-16 17:30:00+00,8828,0,4293,7476,935,1412,2049,978,0,1180,27150,156,14753,12704,8411,8828
2022-10-16 18:00:00+00,8897,0,4294,8201,920,1046,2051,911,0,720,27040,157,15466,13415,9121,8897
2022-10-16 18:30:00+00,8829,0,4289,9903,745,990,2049,493,0,374,27672,147,16986,14937,10648,8829
2022-10-16 19:00:00+00,8760,0,4287,11141,681,596,2044,413,0,494,28416,141,18153,16109,11822,8760
2022-10-16 19:30:00+00,8520,0,4278,11515,682,514,2040,227,0,376,28151,137,18515,16475,12197,8520
2022-10-16 20:00:00+00,8295,0,4283,12037,666,400,2040,179,0,306,28207,133,19026,16986,12703,8295
2022-10-16 20:30:00+00,7737,0,4285,12684,664,400,2039,166,0,30,28005,126,19672,17633,13348,7737
2022-10-16 21:00:00+00,7096,0,4286,13659,611,400,2030,168,0,94,28344,115,20586,18556,14270,7096
2022-10-16 21:30:00+00,6084,0,4287,14542,625,400,2022,173,0,0,28133,102,21476,19454,15167,6084
2022-10-16 22:00:00+00,5104,0,4288,15241,394,400,1914,175,0,0,27516,90,21837,19923,15635,5104
2022-10-16 22:30:00+00,4236,0,4287,15384,389,400,1677,211,0,0,26583,80,21737,20060,15773,4236
2022-10-16 23:00:00+00,3621,0,4287,15856,390,400,1258,169,0,0,25982,70,21791,20533,16246,3621
2022-10-16 23:30:00+00,3278,0,4289,16033,397,400,1147,181,0,0,25724,65,21866,20719,16430,3278
2022-10-17 00:00:00+00,3359,0,4302,15945,371,400,1340,184,0,0,25901,67,21958,20618,16316,3359
2022-10-17 00:30:00+00,3334,0,4319,16209,364,400,1366,171,0,0,26163,65,22258,20892,16573,3334
2022-10-17 01:00:00+00,3376,0,4320,16129,365,400,1315,174,0,0,26079,66,22129,20814,16494,3376
2022-10-17 01:30:00+00,3313,0,4324,16351,366,400,1207,164,0,0,26125,64,22248,21041,16717,3313
2022-10-17 02:00:00+00,3352,0,4326,16411,369,400,1355,171,0,0,26384,65,22461,21106,16780,3352
2022-10-17 02:30:00+00,3308,0,4334,16496,382,400,1381,164,0,0,26465,64,22593,21212,16878,3308
2022-10-17 03:00:00+00,3353,0,4344,16619,385,400,1163,168,0,0,26432,64,22511,21348,17004,3353
2022-10-17 03:30:00+00,3323,0,4350,16378,389,400,1302,272,0,0,26414,66,22419,21117,16767,3323
2022-10-17 04:00:00+00,3576,0,4362,16303,484,400,1512,323,0,0,26960,69,22661,21149,16787,3576
2022-10-17 04:30:00+00,4469,0,4360,16026,512,400,1439,300,0,0,27506,80,22337,20898,16538,4469
2022-10-17 05:00:00+00,6057,0,4362,16037,635,400,1569,276,0,0,29336,97,22603,21034,16672,6057
2022-10-17 05:30:00+00,8000,0,4373,16202,568,400,2006,271,0,0,31820,115,23149,21143,16770,8000
2022-10-17 06:00:00+00,9297,0,4369,17075,587,400,2036,282,0,92,34138,122,24067,22031,17662,9297
2022-10-17 06:30:00+00,10097,0,4374,17156,581,400,2034,427,5,138,35212,129,24150,22116,17742,10097
2022-10-17 07:00:00+00,11472,0,4370,17260,529,400,2037,466,149,442,37125,137,24345,22308,17938,11472
2022-10-17 07:30:00+00,11978,0,4386,17102,529,400,2036,360,600,98,37489,140,24653,22617,18231,11978
2022-10-17 08:00:00+00,12319,0,4400,16611,527,400,2039,350,1372,6,38024,142,24949,22910,18510,12319
2022-10-17 08:30:00+00,11989,0,4404,16345,524,400,2035,195,2436,0,38328,136,25744,23709,19305,11989
2022-10-17 09:00:00+00,10381,0,4408,16403,570,400,2015,159,3583,0,37919,120,26979,24964,20556,10381
2022-10-17 09:30:00+00,9688,0,4417,16357,598,400,2031,165,4578,0,38234,112,27981,25950,21533,9688
2022-10-17 10:00:00+00,9715,0,4434,16535,487,472,1827,168,5126,0,38764,111,28409,26582,22148,9715
2022-10-17 10:30:00+00,9824,0,4434,16642,504,568,1250,164,5593,0,38979,111,28423,27173,22739,9824
2022-10-17 11:00:00+00,9267,0,4449,16936,468,708,1220,172,5773,0,38993,107,28846,27626,23177,9267
2022-10-17 11:30:00+00,9017,0,4468,16953,477,550,1234,172,6149,0,39020,103,29281,28047,23579,9017
2022-10-17 12:00:00+00,9575,0,4462,16613,594,526,1246,180,6165,0,39361,107,29080,27834,23372,9575
2022-10-17 12:30:00+00,9878,0,4464,16307,667,304,1252,193,5974,0,39039,109,28664,27412,22948,9878
2022-10-17 13:00:00+00,10707,0,4466,15947,596,350,1239,171,5730,0,39206,117,27978,26739,22273,10707
2022-10-17 13:30:00+00,11051,0,4467,16002,595,100,1241,172,5158,0,38786,119,27463,26222,21755,11051
2022-10-17 14:00:00+00,11142,0,4463,16008,594,0,1280,176,4486,0,38149,120,26831,25551,21088,11142
2022-10-17 14:30:00+00,11829,0,4469,15917,598,68,1289,174,3506,0,37850,129,25779,24490,20021,11829
2022-10-17 15:00:00+00,12464,0,4469,15786,831,344,1502,182,2661,0,38239,138,25249,23747,19278,12464
2022-10-17 15:30:00+00,13699,0,4473,15698,855,340,1674,219,1565,42,38565,150,24265,22591,18118,13699
2022-10-17 16:00:00+00,15107,0,4481,15800,868,190,1668,211,635,582,39542,159,23452,21784,17303,15107
2022-10-17 16:30:00+00,15961,0,4487,15749,894,184,1831,295,125,944,40470,165,23086,21255,16768,15961
2022-10-17 17:00:00+00,16214,0,4494,15844,918,0,1928,519,0,1130,41047,165,23184,21256,16762,16214
2022-10-17 17:30:00+00,16583,0,4498,15726,917,0,2043,568,0,1034,41369,168,23184,21141,16643,16583
2022-10-17 18:00:00+00,16392,0,4495,15574,917,0,2044,564,0,668,40654,170,23030,20986,16491,16392
2022-10-17 18:30:00+00,15698,0,4494,15532,827,0,2050,441,0,520,39562,166,22903,20853,16359,15698
2022-10-17 19:00:00+00,15873,0,4496,15391,638,0,2050,278,0,176,38902,169,22575,20525,16029,15873
2022-10-17 19:30:00+00,15301,0,4493,15130,505,0,2049,242,0,0,37720,168,22177,20128,15635,15301
2022-10-17 20:00:00+00,14688,0,4490,14860,468,0,2045,260,0,0,36811,166,21863,19818,15328,14688
2022-10-17 20:30:00+00,14247,0,4494,14291,471,0,1846,224,0,0,35573,166,21102,19256,14762,14247
2022-10-17 21:00:00+00,14051,0,4494,13654,586,0,1628,220,0,0,34633,167,20362,18734,14240,14051
2022-10-17 21:30:00+00,13064,0,4498,12785,636,0,1406,217,0,0,32606,165,19325,17919,13421,13064
2022-10-17 22:00:00+00,12818,0,4496,11936,404,0,1389,230,0,0,31273,169,18225,16836,12340,12818
2022-10-17 22:30:00+00,12604,0,4499,10978,403,0,1402,201,0,0,30087,173,17282,15880,11381,12604
2022-10-17 23:00:00+00,12149,0,4507,9742,414,0,1433,203,0,0,28448,176,16096,14663,10156,12149
2022-10-17 23:30:00+00,11987,0,4511,8885,428,0,1558,174,0,0,27543,180,15382,13824,9313,11987
2022-10-18 00:00:00+00,12237,0,4528,7942,432,0,1918,175,0,0,27232,187,14820,12902,8374,12237
2022-10-18 00:30:00+00,12576,0,4524,7477,433,0,2042,207,0,0,27259,193,14476,12434,7910,12576
2022-10-18 01:00:00+00,12738,0,4525,6854,412,0,2047,180,0,0,26756,199,13838,11791,7266,12738
2022-10-18 01:30:00+00,12761,0,4534,5983,403,0,2049,195,0,0,25925,206,12969,10920,6386,12761
2022-10-18 02:00:00+00,12906,0,4542,5625,391,0,2049,166,0,0,25679,210,12607,10558,6016,12906
2022-10-18 02:30:00+00,13080,0,4556,5514,393,0,2052,167,0,0,25763,212,12515,10463,5907,13080
2022-10-18 03:00:00+00,13260,0,4556,5289,390,0,2045,167,0,0,25706,215,12280,10235,5679,13260
2022-10-18 03:30:00+00,13333,0,4554,5061,385,0,1941,167,0,0,25442,218,11941,10000,5446,13333
2022-10-18 04:00:00+00,13657,0,4552,4752,397,128,1862,166,0,0,25514,224,11563,9701,5149,13657
2022-10-18 04:30:00+00,14006,0,4549,4385,429,194,1792,166,0,0,25521,230,11155,9363,4814,14006
2022-10-18 05:00:00+00,14802,0,4547,3961,678,612,1679,237,0,0,26516,241,10865,9186,4639,14802
2022-10-18 05:30:00+00,15763,0,4542,3554,691,876,1793,284,0,0,27504,251,10580,8787,4245,15763
2022-10-18 06:00:00+00,17170,0,4539,3276,861,964,1945,533,0,486,29774,249,10621,8676,4137,17170
2022-10-18 06:30:00+00,18387,0,4544,2892,907,960,1981,809,19,658,31158,255,10343,8362,3818,18387
2022-10-18 07:00:00+00,19480,0,4544,2588,920,1474,2046,892,350,660,32953,257,10448,8402,3858,19480
2022-10-18 07:30:00+00,20137,0,4543,2342,931,1514,2044,724,1300,640,34175,254,11160,9116,4573,20137
2022-10-18 08:00:00+00,20625,0,4541,2212,898,1646,2041,596,2460,420,35439,248,12152,10111,5570,20625
2022-10-18 08:30:00+00,20969,0,4546,2096,862,1568,2043,545,3478,82,36189,246,13025,10982,6436,20969
2022-10-18 09:00:00+00,21243,0,4546,1963,844,1014,1961,359,4364,134,36428,244,13678,11717,7171,21243
2022-10-18 09:30:00+00,21368,0,4547,1786,820,928,1686,336,5231,0,36702,242,14070,12384,7837,21368
2022-10-18 10:00:00+00,21577,0,4545,1706,711,480,1490,285,5982,14,36790,240,14434,12944,8399,21577
2022-10-18 10:30:00+00,21130,0,4545,1563,710,446,1739,194,6505,0,36832,235,15062,13323,8778,21130
2022-10-18 11:00:00+00,20969,0,4545,1555,691,428,1680,198,6724,0,36790,234,15195,13515,8970,20969
2022-10-18 11:30:00+00,20681,0,4547,1647,688,474,1710,170,6810,0,36727,232,15402,13692,9145,20681
2022-10-18 12:00:00+00,20433,0,4545,1775,684,460,1697,167,6657,0,36418,233,15358,13661,9116,20433
2022-10-18 12:30:00+00,20458,0,4545,1906,536,438,1534,170,6335,0,35922,236,14856,13322,8777,20458
2022-10-18 13:00:00+00,20352,11,4540,2037,538,426,1548,179,5790,0,35420,238,14453,12905,8365,20362
2022-10-18 13:30:00+00,20609,21,4540,2103,534,509,1917,193,5058,0,35484,243,14152,12235,7695,20630
2022-10-18 14:00:00+00,20218,46,4541,2332,536,1002,2045,178,4252,0,35150,243,13706,11661,7120,20264
2022-10-18 14:30:00+00,20140,119,4536,2506,536,1262,1977,195,3145,546,34962,248,12700,10723,6187,20259
2022-10-18 15:00:00+00,19757,230,4542,2866,721,2048,1954,446,2064,904,35532,250,12147,10193,5651,19987
2022-10-18 15:30:00+00,20497,231,4544,3053,804,2130,1872,669,1092,1036,35928,258,11365,9493,4949,20728
2022-10-18 16:00:00+00,20648,230,4543,3136,816,2296,2019,788,350,1488,36314,256,10864,8845,4302,20878
2022-10-18 16:30:00+00,20588,229,4555,3389,836,2336,1947,1097,49,1668,36694,255,10776,8829,4274,20817
2022-10-18 17:00:00+00,21015,230,4557,4053,872,2478,1956,1241,0,1648,38050,253,11438,9482,4925,21245
2022-10-18 17:30:00+00,20928,230,4562,4686,873,2452,2038,1095,0,1778,38642,248,12159,10121,5559,21158
2022-10-18 18:00:00+00,20823,230,4560,5116,837,1968,2051,715,0,1606,37906,247,12564,10513,5953,21053
2022-10-18 18:30:00+00,20034,230,4561,5614,847,1880,2053,474,0,1218,36911,243,13075,11022,6461,20264
2022-10-18 19:00:00+00,19838,186,4559,5998,831,1286,2052,270,0,1302,36322,239,13440,11388,6829,20024
2022-10-18 19:30:00+00,19642,149,4562,6135,650,1170,2051,336,0,764,35459,241,13398,11347,6785,19791
2022-10-18 20:00:00+00,19770,112,4558,6564,503,942,1984,370,0,134,34936,247,13609,11625,7067,19882
2022-10-18 20:30:00+00,18611,74,4552,6861,502,912,1793,207,0,34,33547,241,13708,11915,7363,18685
2022-10-18 21:00:00+00,18169,37,4545,7100,491,864,1487,182,0,26,32901,238,13623,12136,7591,18206
2022-10-18 21:30:00+00,17467,0,4539,7223,470,734,803,171,0,0,31407,235,13035,12232,7693,17467
2022-10-18 22:00:00+00,16199,0,4538,7492,332,564,426,183,0,0,29734,227,12788,12362,7824,16199
2022-10-18 22:30:00+00,15213,0,4539,7752,329,544,423,183,0,0,28983,219,13043,12620,8081,15213
2022-10-18 23:00:00+00,14439,0,4538,7813,326,592,418,190,0,0,28316,214,13095,12677,8139,14439
2022-10-18 23:30:00+00,13589,0,4541,8345,326,590,414,167,0,0,27972,205,13626,13212,8671,13589
2022-10-19 00:00:00+00,12938,0,4540,8648,327,604,422,174,0,0,27653,198,13937,13515,8975,12938
2022-10-19 00:30:00+00,12807,0,4536,8923,326,604,423,178,0,0,27797,195,14208,13785,9249,12807
2022-10-19 01:00:00+00,12611,0,4543,9333,326,604,424,178,0,0,28019,191,14626,14202,9659,12611
2022-10-19 01:30:00+00,12074,0,4543,9482,325,604,429,188,0,0,27645,186,14779,14350,9807,12074
2022-10-19 02:00:00+00,11667,0,4548,9666,323,604,423,170,0,0,27401,182,14960,14537,9989,11667
2022-10-19 02:30:00+00,11367,0,4543,9725,323,600,424,170,0,0,27152,179,15015,14591,10048,11367
2022-10-19 03:00:00+00,11220,0,4544,9887,323,604,423,171,0,0,27172,177,15177,14754,10210,11220
2022-10-19 03:30:00+00,11031,0,4544,10007,325,592,433,177,0,0,27109,174,15309,14876,10332,11031
2022-10-19 04:00:00+00,11616,0,4544,10112,441,522,428,173,0,0,27836,177,15525,15097,10553,11616
2022-10-19 04:30:00+00,12297,0,4551,10577,461,540,419,162,0,0,29007,179,16008,15589,11038,12297
2022-10-19 05:00:00+00,13474,0,4549,11181,493,460,417,160,0,0,30734,183,16640,16223,11674,13474
2022-10-19 05:30:00+00,14824,0,4549,11770,499,492,569,160,0,0,32863,188,17387,16818,12269,14824
2022-10-19 06:00:00+00,16749,0,4545,12265,717,336,718,181,0,0,35511,194,18245,17527,12982,16749
2022-10-19 06:30:00+00,17140,0,4548,12797,785,360,758,349,10,60,36807,193,18898,18140,13592,17140
2022-10-19 07:00:00+00,17877,0,4545,13107,681,150,759,399,255,66,37839,194,19347,18588,14043,17877
2022-10-19 07:30:00+00,17699,0,4546,13330,643,18,759,442,777,66,38280,188,20055,19296,14750,17699
2022-10-19 08:00:00+00,17829,0,4544,13864,477,0,758,266,1307,66,39111,184,20950,20192,15648,17829
2022-10-19 08:30:00+00,17564,0,4545,14243,448,0,602,184,1637,80,39303,179,21475,20873,16328,17564
2022-10-19 09:00:00+00,16649,0,4550,14843,379,0,415,174,2289,16,39315,169,22476,22061,17511,16649
2022-10-19 09:30:00+00,15901,0,4547,15210,380,0,415,168,2592,0,39213,162,23144,22729,18182,15901
2022-10-19 10:00:00+00,15274,0,4562,15593,344,100,414,164,3011,0,39462,156,23924,23510,18948,15274
2022-10-19 10:30:00+00,14253,0,4564,16041,333,174,414,167,3240,0,39186,148,24592,24178,19614,14253
2022-10-19 11:00:00+00,14054,0,4551,16115,314,40,414,174,3670,0,39332,144,25064,24650,20099,14054
2022-10-19 11:30:00+00,13880,0,4558,16101,83,16,414,166,4085,0,39303,142,25241,24827,20269,13880
2022-10-19 12:00:00+00,13760,0,4560,15933,208,136,413,169,3966,28,39173,143,25080,24667,20107,13760
2022-10-19 12:30:00+00,13549,0,4561,15701,301,376,411,162,3951,0,39012,144,24925,24514,19953,13549
2022-10-19 13:00:00+00,13658,0,4570,15403,321,530,412,178,3455,0,38527,149,24161,23749,19179,13658
2022-10-19 13:30:00+00,13544,0,4572,15635,328,574,411,163,3233,0,38460,148,24179,23768,19196,13544
2022-10-19 14:00:00+00,13367,0,4569,15935,399,532,412,164,2869,0,38247,147,24184,23772,19203,13367
2022-10-19 14:30:00+00,13563,0,4568,16599,410,572,415,171,2250,22,38570,148,24242,23827,19259,13563
2022-10-19 15:00:00+00,14317,0,4567,17241,471,594,414,175,1412,40,39231,153,24105,23691,19124,14317
2022-10-19 15:30:00+00,15152,0,4571,17542,564,624,414,232,839,152,40090,159,23930,23516,18945,15152
2022-10-19 16:00:00+00,15497,0,4568,17871,636,574,415,255,284,650,40750,159,23774,23359,18791,15497
2022-10-19 16:30:00+00,15794,0,4576,18207,614,706,415,325,25,772,41434,162,23837,23422,18846,15794
2022-10-19 17:00:00+00,16283,0,4581,18306,631,728,415,492,0,886,42322,164,23933,23518,18937,16283
2022-10-19 17:30:00+00,16620,0,4587,18516,733,684,414,508,0,536,42598,166,24250,23836,19249,16620
2022-10-19 18:00:00+00,16185,0,4585,18479,660,660,414,448,0,188,41619,165,24138,23724,19139,16185
2022-10-19 18:30:00+00,15083,0,4589,18667,622,426,413,352,0,150,40302,156,24291,23878,19289,15083
2022-10-19 19:00:00+00,13945,0,4587,18850,555,544,416,215,0,0,39112,150,24408,23992,19405,13945
2022-10-19 19:30:00+00,12575,0,4599,18971,485,620,413,195,0,0,37858,141,24468,24055,19456,12575
2022-10-19 20:00:00+00,11022,0,4598,18933,389,832,416,235,0,0,36425,133,24336,23920,19322,11022
2022-10-19 20:30:00+00,9968,0,4598,18985,377,772,413,196,0,0,35309,124,24373,23960,19362,9968
2022-10-19 21:00:00+00,8735,0,4593,18770,350,856,417,192,0,0,33913,116,24130,23713,19120,8735
2022-10-19 21:30:00+00,7524,0,4600,18533,343,828,413,172,0,0,32413,106,23889,23476,18876,7524
2022-10-19 22:00:00+00,6986,0,4604,18332,297,688,415,244,0,0,31566,101,23648,23233,18629,6986
2022-10-19 22:30:00+00,6868,0,4599,17896,295,430,414,180,0,0,30682,98,23204,22790,18191,6868
2022-10-19 23:00:00+00,7057,0,4608,17537,296,404,414,160,0,0,30476,101,22855,22441,17833,7057
2022-10-19 23:30:00+00,7451,0,4601,17068,297,384,416,186,0,0,30403,106,22382,21966,17365,7451
2022-10-20 00:00:00+00,7687,0,4600,16623,298,312,412,164,0,0,30096,109,21933,21521,16921,7687
2022-10-20 00:30:00+00,7908,0,4598,16312,298,532,413,186,0,0,30247,115,21621,21208,16610,7908
2022-10-20 01:00:00+00,7646,0,4596,15707,298,444,412,239,0,0,29342,114,21013,20601,16005,7646
2022-10-20 01:30:00+00,7873,0,4604,15278,299,384,413,251,0,0,29102,117,20594,20181,15577,7873
2022-10-20 02:00:00+00,7954,0,4605,14733,300,346,414,256,0,0,28608,120,20052,19638,15033,7954
2022-10-20 02:30:00+00,8312,0,4610,14182,300,386,413,255,0,0,28458,126,19505,19092,14482,8312
2022-10-20 03:00:00+00,8638,0,4609,13911,300,488,415,252,0,0,28613,131,19235,18820,14211,8638
2022-10-20 03:30:00+00,9007,0,4613,13415,316,572,414,252,0,0,28589,138,18758,18344,13731,9007
2022-10-20 04:00:00+00,10174,0,4609,12959,317,394,416,184,0,0,29053,148,18301,17885,13276,10174
2022-10-20 04:30:00+00,11607,0,4610,12290,317,600,416,166,0,0,30006,165,17633,17217,12607,11607
2022-10-20 05:00:00+00,12877,0,4611,12368,373,674,417,172,0,0,31492,174,17769,17352,12741,12877
2022-10-20 05:30:00+00,15959,0,4607,11891,394,450,417,173,0,0,33891,195,17309,16892,12285,15959
2022-10-20 06:00:00+00,19017,0,4605,11650,460,186,416,196,0,0,36530,211,17131,16715,12110,19017
2022-10-20 06:30:00+00,20756,0,4607,10977,466,188,432,207,0,322,37955,223,16482,16050,11443,20756
2022-10-20 07:00:00+00,20955,0,4610,10739,489,302,436,306,7,50,37894,227,16281,15845,11235,20955
2022-10-20 07:30:00+00,21111,0,4601,9947,487,450,416,355,67,292,37726,232,15518,15102,10501,21111
2022-10-20 08:00:00+00,21301,0,4606,9542,449,930,414,392,191,340,38165,233,15202,14788,10182,21301
2022-10-20 08:30:00+00,21292,0,4606,9800,444,964,486,369,341,216,38518,231,15677,15191,10585,21292
2022-10-20 09:00:00+00,19973,0,4602,10412,409,1368,462,411,529,130,38296,221,16414,15952,11350,19973
2022-10-20 09:30:00+00,19919,0,4604,10698,409,1364,382,385,790,124,38675,218,16883,16501,11897,19919
2022-10-20 10:00:00+00,19985,0,4600,10296,366,1298,383,431,796,544,38699,217,16441,16058,11458,19985
2022-10-20 10:30:00+00,21022,0,4606,9585,362,1224,430,279,1102,350,38960,225,16085,15655,11049,21022
2022-10-20 11:00:00+00,21251,30,4605,8436,325,1294,661,286,1491,526,38904,231,15518,14857,10252,21281
2022-10-20 11:30:00+00,20957,59,4611,8195,320,1258,600,633,2007,202,38842,231,15733,15133,10522,21016
2022-10-20 12:00:00+00,20705,89,4607,7852,323,888,539,597,1915,0,37515,236,15236,14697,10090,20794
2022-10-20 12:30:00+00,19525,216,4612,8614,308,850,425,477,2034,0,37061,228,15993,15568,10956,19741
2022-10-20 13:00:00+00,18485,247,4607,9793,319,734,390,478,2522,0,37575,215,17631,17241,12634,18732
2022-10-20 13:30:00+00,18651,279,4609,9329,338,818,400,478,2544,0,37446,220,17220,16820,12211,18930
2022-10-20 14:00:00+00,18424,375,4604,8802,453,802,384,538,2331,694,37407,219,16574,16190,11586,18799
2022-10-20 14:30:00+00,18691,460,4606,8262,495,980,384,528,1854,784,37044,228,15601,15217,10611,19151
2022-10-20 15:00:00+00,19099,461,4603,8083,528,736,383,588,1544,888,36913,232,15141,14758,10155,19560
2022-10-20 15:30:00+00,19441,467,4607,7976,556,820,384,731,1079,1400,37461,234,14602,14218,9611,19908
2022-10-20 16:00:00+00,19084,480,4606,8195,686,1698,383,801,425,1320,37678,235,14295,13912,9306,19564
2022-10-20 16:30:00+00,19149,485,4604,8032,697,1886,386,975,39,1576,37829,237,13758,13372,8768,19634
2022-10-20 17:00:00+00,19863,489,4604,7535,712,2794,385,1015,0,1704,39101,240,13236,12851,8247,20352
2022-10-20 17:30:00+00,20879,462,4607,6935,801,2796,383,993,0,1154,39010,250,12726,12343,7736,21341
2022-10-20 18:00:00+00,20758,465,4609,6618,800,2434,388,874,0,732,37678,256,12415,12027,7418,21223
2022-10-20 18:30:00+00,20472,463,4607,6136,689,2378,395,743,0,362,36245,262,11827,11432,6825,20935
2022-10-20 19:00:00+00,20280,470,4607,5729,568,1428,395,509,0,262,34248,268,11299,10904,6297,20750
2022-10-20 19:30:00+00,19884,469,4611,5265,539,1420,396,452,0,76,33112,273,10811,10415,5804,20353
2022-10-20 20:00:00+00,19804,473,4610,4829,545,904,395,470,0,194,32224,276,10379,9984,5374,20277
2022-10-20 20:30:00+00,19081,458,4608,4775,464,770,394,302,0,94,30946,275,10241,9847,5239,19539
2022-10-20 21:00:00+00,19406,418,4609,4913,386,586,394,234,0,10,30956,274,10302,9908,5299,19824
2022-10-20 21:30:00+00,18679,187,4607,4992,358,612,395,203,0,244,30277,264,10352,9957,5350,18866
2022-10-20 22:00:00+00,17842,0,4607,5102,324,470,395,168,0,0,28908,254,10428,10033,5426,17842
2022-10-20 22:30:00+00,16362,0,4608,5479,324,444,397,167,0,0,27781,243,10808,10411,5803,16362
2022-10-20 23:00:00+00,16282,0,4602,5211,309,604,397,179,0,0,27584,246,10519,10122,5520,16282
2022-10-20 23:30:00+00,16258,0,4607,5044,309,656,396,175,0,0,27445,248,10356,9960,5353,16258
2022-10-21 00:00:00+00,15999,0,4602,4797,307,736,395,175,0,0,27011,250,10101,9706,5104,15999
2022-10-21 00:30:00+00,16140,0,4605,4825,288,870,393,162,0,0,27283,251,10111,9718,5113,16140
2022-10-21 01:00:00+00,16372,0,4602,4629,287,904,393,167,0,0,27354,255,9911,9518,4916,16372
2022-10-21 01:30:00+00,15972,0,4602,4684,286,904,394,159,0,0,27001,252,9966,9572,4970,15972
2022-10-21 02:00:00+00,16393,0,4603,4837,285,904,395,165,0,0,27582,253,10120,9725,5122,16393
2022-10-21 02:30:00+00,16115,0,4604,4758,291,904,396,170,0,0,27238,252,10049,9653,5049,16115
2022-10-21 03:00:00+00,16668,0,4608,4779,308,904,420,164,0,0,27851,254,10115,9695,5087,16668
2022-10-21 03:30:00+00,16674,0,4606,4881,329,904,428,174,0,0,27996,253,10244,9816,5210,16674
2022-10-21 04:00:00+00,17116,0,4612,4884,334,904,487,172,0,0,28509,255,10317,9830,5218,17116
2022-10-21 04:30:00+00,17420,0,4611,5077,375,904,403,267,0,0,29057,255,10466,10063,5452,17420
2022-10-21 05:00:00+00,16842,0,4613,5389,534,904,405,442,0,0,29129,249,10941,10536,5923,16842
2022-10-21 05:30:00+00,17786,157,4613,5858,620,904,406,453,0,230,31027,250,11497,11091,6478,17943
2022-10-21 06:00:00+00,18701,230,4611,6434,783,1074,406,498,0,478,33215,248,12234,11828,7217,18931
2022-10-21 06:30:00+00,19427,239,4608,6893,750,1062,407,606,1,630,34623,247,12659,12252,7644,19666
2022-10-21 07:00:00+00,19904,240,4608,7027,844,1310,407,643,111,908,36002,248,12997,12590,7982,20144
2022-10-21 07:30:00+00,19792,235,4610,7602,862,1344,408,736,335,718,36642,243,13817,13409,8799,20027
2022-10-21 08:00:00+00,19907,234,4606,8004,808,1362,409,732,676,974,37712,238,14503,14094,9488,20141
2022-10-21 08:30:00+00,19384,231,4610,8652,790,1346,408,679,1047,822,37969,230,15507,15099,10489,19615
2022-10-21 09:00:00+00,19206,236,4611,9151,778,1026,408,679,1551,598,38244,223,16499,16091,11480,19442
2022-10-21 09:30:00+00,19594,232,4613,9644,753,862,408,661,1783,174,38724,222,17201,16793,12180,19826
2022-10-21 10:00:00+00,19768,233,4610,10200,647,856,408,524,2388,0,39634,217,18253,17845,13235,20001
2022-10-21 10:30:00+00,19272,234,4613,10446,542,1016,408,517,2496,0,39544,214,18505,18097,13484,19506
2022-10-21 11:00:00+00,18497,225,4610,10942,454,1290,408,492,2349,92,39359,210,18763,18355,13745,18722
2022-10-21 11:30:00+00,19061,1,4611,10728,379,1276,409,416,2301,120,39302,210,18428,18019,13408,19062
2022-10-21 12:00:00+00,20051,0,4614,10992,378,904,423,290,2547,126,40325,210,18954,18531,13917,20051
2022-10-21 12:30:00+00,19353,0,4611,11182,378,904,444,201,2874,38,39985,204,19489,19045,14434,19353
2022-10-21 13:00:00+00,19390,0,4612,11015,383,904,445,171,2397,130,39447,207,18852,18407,13795,19390
2022-10-21 13:30:00+00,19574,0,4614,10802,308,904,447,173,1732,44,38598,213,17903,17456,12842,19574
2022-10-21 14:00:00+00,19563,0,4609,10698,330,904,424,178,1316,50,38072,216,17377,16953,12344,19563
2022-10-21 14:30:00+00,20062,0,4606,10180,361,904,470,207,973,520,38283,220,16590,16120,11514,20062
2022-10-21 15:00:00+00,20414,0,4608,10404,514,878,494,318,676,484,38790,222,16696,16202,11594,20414
2022-10-21 15:30:00+00,20085,0,4605,10778,615,874,477,599,463,800,39296,218,16938,16461,11856,20085
2022-10-21 16:00:00+00,19582,0,4604,10542,791,694,459,847,175,1298,38992,216,16571,16112,11508,19582
2022-10-21 16:30:00+00,19336,0,4609,10878,755,846,474,953,10,1306,39167,215,16726,16252,11643,19336
2022-10-21 17:00:00+00,19292,0,4606,11232,749,758,504,783,0,1630,39554,210,17091,16587,11981,19292
2022-10-21 17:30:00+00,19182,0,4606,12154,711,704,415,810,0,1138,39720,207,17886,17471,12865,19182
2022-10-21 18:00:00+00,19367,0,4602,12908,671,788,415,659,0,368,39778,208,18596,18181,13579,19367
2022-10-21 18:30:00+00,18648,0,4601,13139,626,580,426,340,0,232,38592,202,18792,18366,13765,18648
2022-10-21 19:00:00+00,17851,0,4602,12925,563,666,427,231,0,50,37315,201,18517,18090,13488,17851
2022-10-21 19:30:00+00,17015,0,4608,12714,479,776,414,167,0,0,36173,198,18215,17801,13193,17015
2022-10-21 20:00:00+00,16890,0,4604,12962,407,676,416,161,0,38,36154,195,18389,17973,13369,16890
2022-10-21 20:30:00+00,15907,0,4607,12828,373,666,417,163,0,0,34961,191,18225,17808,13201,15907
2022-10-21 21:00:00+00,15038,0,4608,12894,347,542,417,165,0,0,34011,184,18266,17849,13241,15038
2022-10-21 21:30:00+00,13684,0,4605,12737,322,570,429,178,0,42,32567,177,18093,17664,13059,13684
2022-10-21 22:00:00+00,12242,0,4608,12486,320,436,423,178,0,0,30693,167,17837,17414,12806,12242
2022-10-21 22:30:00+00,11075,0,4604,12290,325,378,418,171,0,0,29261,159,17637,17219,12615,11075
2022-10-21 23:00:00+00,10663,0,4604,12266,331,590,419,210,0,0,29083,158,17620,17201,12597,10663
2022-10-21 23:30:00+00,10229,0,4602,12165,347,694,424,187,0,0,28648,156,17538,17114,12512,10229
2022-10-22 00:00:00+00,9513,0,4609,12113,335,674,415,163,0,0,27822,149,17472,17057,12448,9513
2022-10-22 00:30:00+00,9340,0,4606,12206,352,760,414,165,0,0,27844,148,17578,17164,12558,9340
2022-10-22 01:00:00+00,9028,0,4608,11958,351,612,415,165,0,0,27137,145,17332,16917,12309,9028
2022-10-22 01:30:00+00,8918,0,4607,11696,350,554,422,172,0,0,26719,145,17075,16653,12046,8918
2022-10-22 02:00:00+00,7776,0,4610,12264,362,624,421,169,0,0,26226,132,17657,17236,12626,7776
2022-10-22 02:30:00+00,7586,0,4608,12369,361,606,420,166,0,0,26116,129,17758,17338,12730,7586
2022-10-22 03:00:00+00,7491,0,4612,12228,360,704,424,169,0,0,25988,130,17624,17200,12588,7491
2022-10-22 03:30:00+00,7625,0,4612,11857,358,674,429,174,0,0,25729,133,17256,16827,12215,7625
2022-10-22 04:00:00+00,8476,0,4611,11590,359,792,424,167,0,0,26419,144,16984,16560,11949,8476
2022-10-22 04:30:00+00,9207,0,4613,11569,370,742,429,179,0,0,27109,150,16981,16552,11939,9207
2022-10-22 05:00:00+00,9655,0,4615,11780,433,874,416,162,0,0,27935,154,17244,16828,12213,9655
2022-10-22 05:30:00+00,10659,0,4613,11527,473,874,419,163,0,0,28728,164,17032,16613,12000,10659
2022-10-22 06:00:00+00,11542,0,4614,11295,544,784,420,176,0,0,29375,171,16873,16453,11839,11542
2022-10-22 06:30:00+00,12743,0,4613,11077,547,654,420,187,1,0,30242,179,16658,16238,11625,12743
2022-10-22 07:00:00+00,14168,0,4611,11052,615,662,427,192,245,0,31972,187,16950,16523,11912,14168
2022-10-22 07:30:00+00,14697,0,4614,11048,653,716,419,193,855,0,33195,188,17589,17170,12556,14697
2022-10-22 08:00:00+00,14554,0,4613,11197,660,628,415,181,1814,0,34062,178,18699,18284,13671,14554
2022-10-22 08:30:00+00,14087,0,4613,11393,618,568,416,219,2690,0,34604,170,19730,19314,14701,14087
2022-10-22 09:00:00+00,13924,0,4612,11563,529,336,417,201,3665,0,35247,162,20786,20369,15757,13924
2022-10-22 09:30:00+00,13623,0,4613,11384,504,232,418,163,4328,0,35265,158,21247,20829,16216,13623
2022-10-22 10:00:00+00,13484,0,4608,11311,412,184,423,174,4667,0,35263,156,21421,20998,16390,13484
2022-10-22 10:30:00+00,13448,0,4607,11354,412,22,428,181,4793,0,35245,154,21594,21166,16559,13448
2022-10-22 11:00:00+00,13515,0,4608,11386,374,0,429,181,4620,0,35114,155,21418,20988,16380,13515
2022-10-22 11:30:00+00,13620,0,4609,11285,371,0,418,165,4172,0,34640,158,20855,20437,15828,13620
2022-10-22 12:00:00+00,12599,0,4611,11400,356,36,463,168,3967,0,33600,151,20797,20334,15723,12599
2022-10-22 12:30:00+00,12689,0,4610,11346,356,38,499,175,3800,0,33513,153,20611,20112,15502,12689
2022-10-22 13:00:00+00,13977,0,4608,11215,356,0,435,166,2999,0,33756,166,19613,19178,14570,13977
2022-10-22 13:30:00+00,14563,0,4608,10883,366,78,434,170,2239,0,33341,176,18530,18096,13488,14563
2022-10-22 14:00:00+00,15726,0,4610,10573,381,218,475,165,1790,0,33938,189,17829,17354,12744,15726
2022-10-22 14:30:00+00,16749,0,4607,9776,382,244,419,160,1469,0,33806,201,16653,16234,11627,16749
2022-10-22 15:00:00+00,17087,0,4607,9389,470,100,415,157,943,0,33168,207,15824,15409,10802,17087
2022-10-22 15:30:00+00,17809,0,4601,9165,474,78,433,182,566,324,33632,213,15239,14806,10205,17809
2022-10-22 16:00:00+00,18216,0,4606,8664,652,92,427,185,214,880,33936,215,14563,14136,9530,18216
2022-10-22 16:30:00+00,18665,0,4605,8510,756,170,443,422,12,1060,34643,219,14326,13883,9278,18665
2022-10-22 17:00:00+00,18645,0,4600,8064,798,466,487,527,0,1342,34929,217,13949,13462,8862,18645
2022-10-22 17:30:00+00,18570,0,4606,8199,803,460,441,595,0,1194,34868,217,14049,13608,9002,18570
2022-10-22 18:00:00+00,18144,0,4603,7858,766,88,422,442,0,1060,33382,220,13648,13226,8624,18144
2022-10-22 18:30:00+00,18531,0,4605,7407,680,20,420,285,0,640,32588,228,13112,12692,8087,18531
2022-10-22 19:00:00+00,18582,0,4604,7046,614,0,476,278,0,816,32416,230,12740,12264,7660,18582
2022-10-22 19:30:00+00,18459,0,4606,6907,602,0,481,195,0,440,31690,233,12596,12115,7509,18459
2022-10-22 20:00:00+00,18337,0,4607,6794,467,0,424,188,0,340,31157,235,12292,11868,7261,18337
2022-10-22 20:30:00+00,17725,0,4607,6858,447,0,469,174,0,10,30290,234,12381,11912,7305,17725
2022-10-22 21:00:00+00,17665,0,4607,6684,359,0,528,169,0,0,30012,236,12178,11650,7043,17665
2022-10-22 21:30:00+00,16211,0,4610,6731,414,0,615,184,0,12,28777,226,12370,11755,7145,16211
2022-10-22 22:00:00+00,13857,0,4607,6787,420,0,724,172,0,0,26567,211,12538,11814,7207,13857
2022-10-22 22:30:00+00,12793,0,4610,6932,419,0,732,172,0,0,25658,202,12693,11961,7351,12793
2022-10-22 23:00:00+00,11395,0,4610,6951,400,20,726,181,0,0,24283,191,12687,11961,7351,11395
2022-10-22 23:30:00+00,11106,0,4607,6416,396,40,751,198,0,0,23514,193,12170,11419,6812,11106
2022-10-23 00:00:00+00,11268,0,4608,5863,358,266,733,174,0,0,23270,197,11562,10829,6221,11268
2022-10-23 00:30:00+00,11492,0,4592,5540,358,292,723,176,0,0,23173,202,11213,10490,5898,11492
2022-10-23 01:00:00+00,10782,0,4595,5261,351,1124,745,181,0,0,23039,193,10952,10207,5612,10782
2022-10-23 01:30:00+00,10700,0,4610,4878,317,1174,731,190,0,0,22600,195,10536,9805,5195,10700
2022-10-23 02:00:00+00,10415,0,4614,5241,317,1316,717,169,0,0,22789,189,10889,10172,5558,10415
2022-10-23 02:30:00+00,10197,0,4613,5497,320,1308,722,168,0,0,22825,185,11152,10430,5817,10197
2022-10-23 03:00:00+00,10683,0,4610,5222,340,928,726,168,0,0,22677,193,10898,10172,5562,10683
2022-10-23 03:30:00+00,10374,0,4612,5768,340,912,719,169,0,0,22894,186,11439,10720,6108,10374
2022-10-23 04:00:00+00,10678,0,4612,6105,339,766,716,165,0,0,23381,187,11772,11056,6444,10678
2022-10-23 04:30:00+00,10313,0,4609,6338,341,760,733,181,0,0,23275,182,12021,11288,6679,10313
2022-10-23 05:00:00+00,11541,0,4609,5956,644,434,736,182,0,0,24102,195,11945,11209,6600,11541
2022-10-23 05:30:00+00,11768,0,4612,6130,808,418,721,188,0,0,24645,195,12271,11550,6938,11768
2022-10-23 06:00:00+00,11519,0,4615,6857,818,208,714,173,0,0,24904,188,13004,12290,7675,11519
2022-10-23 06:30:00+00,10694,0,4609,8026,693,242,733,197,0,26,25220,173,14061,13328,8719,10694
2022-10-23 07:00:00+00,10338,0,4612,8543,624,1128,719,171,8,22,26165,163,14506,13787,9175,10338
2022-10-23 07:30:00+00,10482,0,4608,9519,618,1188,686,265,81,34,27481,159,15512,14826,10218,10482
2022-10-23 08:00:00+00,10718,0,4610,9887,614,1752,426,194,236,26,28463,156,15773,15347,10737,10718
2022-10-23 08:30:00+00,11275,0,4608,9526,618,1786,422,175,464,196,29070,160,15638,15216,10608,11275
2022-10-23 09:00:00+00,11654,0,4606,9372,600,2258,423,184,1002,72,30171,160,16003,15580,10974,11654
2022-10-23 09:30:00+00,11868,0,4607,9038,597,2278,425,181,1665,178,30837,160,16332,15907,11300,11868
2022-10-23 10:00:00+00,11844,0,4608,9272,515,2464,418,174,2116,0,31411,157,16929,16511,11903,11844
2022-10-23 10:30:00+00,11712,0,4609,9431,514,2466,415,165,2512,0,31824,153,17481,17066,12457,11712
2022-10-23 11:00:00+00,11689,0,4605,8969,504,2986,427,192,2818,282,32472,151,17323,16896,12291,11689
2022-10-23 11:30:00+00,11999,0,4609,8380,564,3008,415,171,2792,166,32104,156,16760,16345,11736,11999
2022-10-23 12:00:00+00,11892,0,4607,8054,623,3074,419,181,3018,38,31906,156,16721,16302,11695,11892
2022-10-23 12:30:00+00,11462,0,4608,8022,627,3230,414,238,3071,0,31672,154,16742,16328,11720,11462
2022-10-23 13:00:00+00,11630,0,4606,7978,385,3618,418,192,2902,0,31729,157,16289,15871,11265,11630
2022-10-23 13:30:00+00,11483,0,4605,8600,354,3624,421,187,2422,0,31696,155,16402,15981,11376,11483
2022-10-23 14:00:00+00,12565,0,4607,8920,354,2946,414,173,1545,0,31524,165,15840,15426,10819,12565
2022-10-23 14:30:00+00,13173,0,4604,9118,357,2956,414,170,958,96,31846,171,15451,15037,10433,13173
2022-10-23 15:00:00+00,13562,0,4606,9158,459,3662,428,187,558,336,32956,173,15209,14781,10175,13562
2022-10-23 15:30:00+00,14906,0,4599,8797,474,3660,413,183,286,556,33874,184,14569,14156,9557,14906
2022-10-23 16:00:00+00,15572,0,4600,8610,552,3510,406,189,112,768,34319,191,14280,13874,9274,15572
2022-10-23 16:30:00+00,15838,0,4602,8963,561,3508,400,185,8,918,34983,191,14534,14134,9532,15838
2022-10-23 17:00:00+00,15799,0,4601,8741,643,3676,406,224,0,890,34980,193,14391,13985,9384,15799
2022-10-23 17:30:00+00,15148,0,4610,8937,661,3716,407,218,0,890,34587,188,14615,14208,9598,15148
2022-10-23 18:00:00+00,14707,0,4604,8315,661,3454,401,218,0,1038,33398,191,13981,13580,8976,14707
2022-10-23 18:30:00+00,14167,0,4606,8054,651,3440,405,212,0,894,32429,190,13716,13311,8705,14167
2022-10-23 19:00:00+00,13662,0,4607,9071,565,2522,414,193,0,278,31312,186,14657,14243,9636,13662
2022-10-23 19:30:00+00,12850,0,4610,9106,538,2490,421,176,0,82,30273,181,14675,14254,9644,12850
2022-10-23 20:00:00+00,12116,0,4610,9376,398,1970,431,186,0,112,29199,175,14815,14384,9774,12116
2022-10-23 20:30:00+00,11391,0,4609,9390,396,1964,420,175,0,62,28407,170,14815,14395,9786,11391
2022-10-23 21:00:00+00,10604,0,4607,9879,382,1044,425,165,0,52,27158,164,15293,14868,10261,10604
2022-10-23 21:30:00+00,9414,0,4609,10095,365,1016,546,164,0,0,26209,152,15615,15069,10460,9414
2022-10-23 22:00:00+00,8350,0,4606,9834,365,1554,726,179,0,0,25614,145,15531,14805,10199,8350
2022-10-23 22:30:00+00,7674,0,4609,9475,371,1584,723,171,0,0,24607,140,15178,14455,9846,7674
2022-10-23 23:00:00+00,6611,0,4611,9553,373,1830,716,167,0,0,23861,127,15253,14537,9926,6611
2022-10-23 23:30:00+00,5834,0,4605,9817,371,1848,754,193,0,0,23422,117,15547,14793,10188,5834
2022-10-24 00:00:00+00,5625,0,4610,9709,355,2236,718,169,0,0,23422,113,15392,14674,10064,5625
2022-10-24 00:30:00+00,5611,0,4607,9925,356,2254,741,195,0,0,23689,112,15629,14888,10281,5611
2022-10-24 01:00:00+00,5810,0,4609,9195,356,2342,789,168,0,0,23269,118,14949,14160,9551,5810
2022-10-24 01:30:00+00,5627,0,4611,9168,356,2336,718,173,0,0,22989,116,14853,14135,9524,5627
2022-10-24 02:00:00+00,5276,0,4612,8961,339,2332,730,184,0,0,22434,112,14642,13912,9300,5276
2022-10-24 02:30:00+00,5326,0,4610,8689,324,2332,733,169,0,0,22183,113,14356,13623,9013,5326
2022-10-24 03:00:00+00,5367,0,4609,8571,323,2268,719,162,0,0,22019,115,14222,13503,8894,5367
2022-10-24 03:30:00+00,5610,0,4614,8198,327,2244,741,171,0,0,21905,120,13880,13139,8525,5610
2022-10-24 04:00:00+00,7152,0,4609,8200,396,1338,714,159,0,0,22568,140,13919,13205,8596,7152
2022-10-24 04:30:00+00,7938,0,4611,8702,424,1272,721,161,0,0,23829,145,14458,13737,9126,7938
2022-10-24 05:00:00+00,10265,0,4618,9517,545,936,603,159,0,0,26643,161,15283,14680,10062,10265
2022-10-24 05:30:00+00,11786,0,4619,10061,544,938,392,160,0,0,28500,170,15616,15224,10605,11786
2022-10-24 06:00:00+00,12544,0,4621,10860,710,1116,404,164,0,0,30419,173,16595,16191,11570,12544
2022-10-24 06:30:00+00,13103,0,4615,11646,701,1132,416,242,0,0,31855,173,17378,16962,12347,13103
2022-10-24 07:00:00+00,14651,0,4614,11821,552,1654,410,220,95,0,34017,180,17492,17082,12468,14651
2022-10-24 07:30:00+00,15648,0,4619,11775,553,1710,374,276,445,0,35400,185,17766,17392,12773,15648
2022-10-24 08:00:00+00,15857,0,4620,11915,535,1752,377,192,1146,0,36394,182,18593,18216,13596,15857
2022-10-24 08:30:00+00,15810,0,4630,11787,497,1748,376,168,2081,0,37097,178,19371,18995,14365,15810
2022-10-24 09:00:00+00,16008,0,4620,11565,353,1634,383,175,2869,22,37629,177,19790,19407,14787,16008
2022-10-24 09:30:00+00,15842,0,4611,11382,372,1632,389,159,3525,0,37912,174,20279,19890,15279,15842
2022-10-24 10:00:00+00,15932,0,4612,11005,371,1774,396,163,3772,16,38041,175,20156,19760,15148,15932
2022-10-24 10:30:00+00,15898,0,4614,10877,373,1778,388,161,3967,0,38056,175,20219,19831,15217,15898
2022-10-24 11:00:00+00,15655,0,4614,11144,377,1690,429,183,3945,0,38037,172,20509,20080,15466,15655
2022-10-24 11:30:00+00,15678,0,4616,11262,377,1690,444,175,3791,0,38033,172,20490,20046,15430,15678
2022-10-24 12:00:00+00,15485,0,4614,11420,379,1570,396,187,3772,0,37823,170,20581,20185,15571,15485
2022-10-24 12:30:00+00,15020,0,4617,11947,378,1570,391,185,3551,0,37659,166,20884,20493,15876,15020
2022-10-24 13:00:00+00,15351,0,4617,11947,379,682,402,187,3329,22,36916,169,20674,20272,15655,15351
2022-10-24 13:30:00+00,15360,0,4611,12016,380,664,405,185,2943,0,36564,170,20355,19950,15339,15360
2022-10-24 14:00:00+00,16219,0,4603,11544,381,150,409,182,2495,446,36429,179,19432,19023,14420,16219
2022-10-24 14:30:00+00,17297,0,4593,11135,385,142,407,174,2286,356,36775,188,18806,18399,13806,17297
2022-10-24 15:00:00+00,17801,0,4580,11109,415,318,500,191,1628,420,36962,194,18232,17732,13152,17801
2022-10-24 15:30:00+00,18493,0,4566,10826,444,422,561,282,972,842,37408,201,17369,16808,12242,18493
2022-10-24 16:00:00+00,18431,0,4555,11120,750,880,564,382,288,1094,38064,200,17277,16713,12158,18431
2022-10-24 16:30:00+00,18229,0,4539,11921,783,928,580,569,10,1084,38643,197,17833,17253,12714,18229
2022-10-24 17:00:00+00,17956,0,4519,12602,813,1550,588,597,0,1532,40157,190,18522,17934,13415,17956
2022-10-24 17:30:00+00,17657,0,4508,13076,810,1546,578,537,0,1574,40286,186,18972,18394,13886,17657
2022-10-24 18:00:00+00,17902,0,4493,13131,817,1014,590,437,0,1062,39446,189,19031,18441,13948,17902
2022-10-24 18:30:00+00,17764,0,4484,13049,802,1004,587,207,0,440,38337,191,18922,18335,13851,17764
2022-10-24 19:00:00+00,17233,0,4474,13276,767,338,586,225,0,284,37183,187,19103,18517,14043,17233
2022-10-24 19:30:00+00,15990,0,4470,13309,740,338,593,230,0,216,35886,180,19112,18519,14049,15990
2022-10-24 20:00:00+00,15162,0,4458,13228,523,402,592,228,0,28,34621,178,18801,18209,13751,15162
2022-10-24 20:30:00+00,14066,0,4446,13155,452,396,581,210,0,0,33306,172,18634,18053,13607,14066
2022-10-24 21:00:00+00,13325,0,4429,12940,445,134,583,211,0,0,32067,169,18397,17814,13385,13325
2022-10-24 21:30:00+00,12126,0,4418,13043,462,0,578,207,0,0,30834,159,18501,17923,13505,12126
2022-10-24 22:00:00+00,8950,0,4404,13028,438,302,579,214,0,0,27915,133,18449,17870,13466,8950
2022-10-24 22:30:00+00,7561,0,4389,13250,419,310,581,215,0,0,26725,119,18639,18058,13669,7561
2022-10-24 23:00:00+00,7070,0,4378,13207,399,164,584,218,0,0,26020,113,18568,17984,13606,7070
2022-10-24 23:30:00+00,6821,0,4363,12952,400,164,581,220,0,0,25501,112,18296,17715,13352,6821
2022-10-25 00:00:00+00,6896,0,4349,12478,381,136,583,221,0,0,25044,115,17791,17208,12859,6896
2022-10-25 00:30:00+00,7263,0,4335,12515,376,172,581,212,0,0,25454,120,17807,17226,12891,7263
2022-10-25 01:00:00+00,7469,0,4331,12523,368,112,581,211,0,0,25595,122,17803,17222,12891,7469
2022-10-25 01:30:00+00,7547,0,4333,12333,372,110,584,226,0,0,25505,123,17622,17038,12705,7547
2022-10-25 02:00:00+00,7749,0,4333,12428,372,0,580,217,0,0,25679,124,17713,17133,12800,7749
2022-10-25 02:30:00+00,7977,0,4335,12262,374,0,581,221,0,0,25749,127,17552,16971,12636,7977
2022-10-25 03:00:00+00,8220,0,4336,12077,394,31,586,224,0,0,25868,131,17393,16807,12471,8220
2022-10-25 03:30:00+00,8370,0,4334,11775,395,38,595,241,0,0,25748,134,17099,16504,12170,8370
2022-10-25 04:00:00+00,8787,0,4336,11173,409,0,591,240,0,0,25536,141,16509,15918,11582,8787
2022-10-25 04:30:00+00,9262,0,4336,11142,409,37,586,229,0,0,26002,146,16473,15887,11551,9262
2022-10-25 05:00:00+00,10201,0,4332,10480,456,170,630,229,0,96,26594,159,15898,15268,10936,10201
2022-10-25 05:30:00+00,11308,12,4332,10143,461,28,598,230,0,24,27136,170,15534,14936,10604,11320
2022-10-25 06:00:00+00,12834,23,4335,9626,586,4,589,238,0,666,28902,181,15136,14547,10212,12857
2022-10-25 06:30:00+00,14186,50,4332,9116,695,0,584,398,0,664,30025,194,14727,14143,9811,14236
2022-10-25 07:00:00+00,15417,79,4328,8620,785,102,619,428,173,732,31283,204,14525,13906,9578,15496
2022-10-25 07:30:00+00,16283,88,4341,8465,782,104,614,583,733,626,32619,208,14935,14321,9980,16371
2022-10-25 08:00:00+00,16921,200,4343,8405,783,718,593,461,1561,626,34611,210,15685,15092,10749,17121
2022-10-25 08:30:00+00,17309,265,4333,8208,780,764,582,330,2380,638,35588,209,16283,15701,11368,17574
2022-10-25 09:00:00+00,17692,263,4331,8113,719,1340,577,328,3076,632,37071,209,16816,16239,11908,17955
2022-10-25 09:30:00+00,17943,262,4329,8197,463,1350,567,313,3421,402,37247,211,16977,16410,12081,18205
2022-10-25 10:00:00+00,18194,263,4330,8067,427,1442,571,227,3845,56,37421,213,17240,16669,12339,18457
2022-10-25 10:30:00+00,18423,267,4331,7658,427,1604,573,207,4319,24,37834,215,17308,16735,12404,18690
2022-10-25 11:00:00+00,18700,383,4330,7470,427,1778,578,211,4284,0,38161,220,17089,16511,12181,19083
2022-10-25 11:30:00+00,18692,401,4330,7417,427,1676,577,216,3999,0,37735,222,16750,16173,11843,19093
2022-10-25 12:00:00+00,18703,398,4332,7323,430,1686,559,203,4268,0,37902,222,16912,16353,12021,19101
2022-10-25 12:30:00+00,18755,401,4331,7170,439,1686,543,164,4069,0,37558,224,16552,16009,11678,19156
2022-10-25 13:00:00+00,19013,401,4336,7300,428,1304,539,184,3407,16,36928,228,16010,15471,11135,19414
2022-10-25 13:30:00+00,19119,400,4335,7511,432,1336,555,164,2895,0,36747,231,15728,15173,10838,19519
2022-10-25 14:00:00+00,19278,402,4333,7771,568,680,556,168,2367,448,36571,228,15595,15039,10706,19680
2022-10-25 14:30:00+00,19576,401,4332,7676,591,718,578,223,1529,652,36276,235,14706,14128,9796,19977
2022-10-25 15:00:00+00,20132,397,4337,7741,758,636,582,488,1065,1476,37612,235,14483,13901,9564,20529
2022-10-25 15:30:00+00,20435,399,4336,8025,912,654,581,732,602,1678,38354,236,14456,13875,9539,20834
2022-10-25 16:00:00+00,20741,401,4335,8350,949,530,584,912,147,1552,38501,238,14365,13781,9446,21142
2022-10-25 16:30:00+00,20987,400,4334,8432,952,624,595,937,3,1672,38936,239,14316,13721,9387,21387
2022-10-25 17:00:00+00,21122,399,4333,8677,939,608,720,948,0,2056,39802,235,14669,13949,9616,21521
2022-10-25 17:30:00+00,21070,263,4333,8827,911,532,926,857,0,1876,39595,232,14997,14071,9738,21333
2022-10-25 18:00:00+00,20668,132,4329,9286,768,654,933,682,0,1386,38838,229,15316,14383,10054,20800
2022-10-25 18:30:00+00,19714,0,4332,10033,698,518,936,369,0,1118,37718,219,15999,15063,10731,19714
2022-10-25 19:00:00+00,19812,0,4332,10882,610,714,941,299,0,576,38166,218,16765,15824,11492,19812
2022-10-25 19:30:00+00,18597,0,4332,11487,564,668,936,189,0,238,37011,211,17319,16383,12051,18597
2022-10-25 20:00:00+00,17613,0,4337,11729,425,842,691,156,0,92,35885,208,17182,16491,12154,17613
2022-10-25 20:30:00+00,15600,0,4332,12330,406,880,593,155,0,0,34296,194,17661,17068,12736,15600
2022-10-25 21:00:00+00,13693,0,4333,12805,407,744,592,161,0,102,32837,178,18137,17545,13212,13693
2022-10-25 21:30:00+00,11805,0,4335,13032,408,844,592,155,0,110,31281,165,18367,17775,13440,11805
2022-10-25 22:00:00+00,10122,0,4332,13571,409,888,591,161,0,0,30074,150,18903,18312,13980,10122
2022-10-25 22:30:00+00,8699,0,4334,13508,406,904,592,164,0,154,28761,138,18840,18248,13914,8699
2022-10-25 23:00:00+00,7613,0,4333,13766,403,904,581,157,0,110,27867,127,19083,18502,14169,7613
2022-10-25 23:30:00+00,6473,0,4335,14492,401,904,534,153,0,108,27400,112,19762,19228,14893,6473
2022-10-26 00:00:00+00,6078,0,4328,15080,380,904,527,166,0,34,27497,106,20315,19788,15460,6078
2022-10-26 00:30:00+00,5765,0,4335,15866,374,904,524,155,0,0,27923,100,21099,20575,16240,5765
2022-10-26 01:00:00+00,5397,0,4326,16339,345,904,517,157,0,0,27985,95,21527,21010,16684,5397
2022-10-26 01:30:00+00,5008,0,4329,16451,346,904,506,162,0,0,27706,90,21632,21126,16797,5008
2022-10-26 02:00:00+00,5086,0,4326,16540,346,904,498,168,0,0,27868,91,21710,21212,16886,5086
2022-10-26 02:30:00+00,4915,0,4329,16862,345,904,497,155,0,0,28007,88,22033,21536,17207,4915
2022-10-26 03:00:00+00,5086,0,4324,16896,347,904,497,173,0,0,28227,90,22064,21567,17243,5086
2022-10-26 03:30:00+00,5356,0,4323,16900,356,904,498,156,0,0,28493,92,22077,21579,17256,5356
2022-10-26 04:00:00+00,5271,0,4330,17215,387,904,508,153,0,0,28768,90,22440,21932,17602,5271
2022-10-26 04:30:00+00,5458,0,4346,17313,393,904,517,156,0,0,29087,92,22569,22052,17706,5458
2022-10-26 05:00:00+00,6122,0,4362,17433,452,904,515,184,0,0,29972,98,22762,22247,17885,6122
2022-10-26 05:30:00+00,7780,0,4381,17537,463,894,523,155,0,0,31733,113,22904,22381,18000,7780
2022-10-26 06:00:00+00,10472,0,4399,17549,551,664,536,158,0,212,34541,131,23035,22499,18100,10472
2022-10-26 06:30:00+00,12042,0,4413,17870,544,586,525,163,0,104,36247,141,23352,22827,18414,12042
2022-10-26 07:00:00+00,12470,0,4422,18037,568,476,535,169,87,102,36866,142,23649,23114,18692,12470
2022-10-26 07:30:00+00,12324,0,4430,17853,509,734,510,262,581,238,37441,142,23883,23373,18943,12324
2022-10-26 08:00:00+00,11972,0,4439,18044,458,726,511,185,1276,66,37677,137,24728,24217,19778,11972
2022-10-26 08:30:00+00,11575,0,4444,18022,454,548,517,163,1895,0,37618,131,25332,24815,20371,11575
2022-10-26 09:00:00+00,11290,0,4458,18126,383,608,512,151,2755,30,38313,126,26234,25722,21264,11290
2022-10-26 09:30:00+00,10144,0,4466,18777,382,508,513,149,3171,0,38110,114,27309,26796,22330,10144
2022-10-26 10:00:00+00,9137,0,4479,19281,348,660,475,153,3860,0,38393,104,28443,27968,23489,9137
2022-10-26 10:30:00+00,8419,0,4480,19445,351,796,377,153,4443,34,38498,98,29096,28719,24239,8419
2022-10-26 11:00:00+00,8529,0,4489,19542,348,898,377,157,4731,0,39071,99,29487,29110,24621,8529
2022-10-26 11:30:00+00,8113,0,4503,19785,329,836,374,142,4721,0,38803,94,29712,29338,24835,8113
2022-10-26 12:00:00+00,7712,0,4511,19903,312,902,376,153,4541,0,38410,92,29643,29267,24756,7712
2022-10-26 12:30:00+00,7447,0,4523,19864,312,904,376,147,4725,0,38298,90,29800,29424,24901,7447
2022-10-26 13:00:00+00,7869,0,4530,19612,313,904,377,151,4162,0,37918,95,28994,28617,24087,7869
2022-10-26 13:30:00+00,8074,0,4542,19463,315,904,380,165,3999,0,37842,98,28699,28319,23777,8074
2022-10-26 14:00:00+00,9097,0,4551,19336,312,886,514,177,3249,0,38122,108,27962,27448,22897,9097
2022-10-26 14:30:00+00,10064,0,4563,19075,305,862,688,172,2509,0,38238,118,27140,26452,21889,10064
2022-10-26 15:00:00+00,11341,0,4565,18872,333,752,618,168,1791,0,38440,128,26179,25561,20996,11341
2022-10-26 15:30:00+00,12428,0,4570,18481,363,774,708,173,908,122,38527,140,25030,24322,19752,12428
2022-10-26 16:00:00+00,12687,0,4577,17983,483,564,481,180,237,1006,38198,141,23761,23280,18703,12687
2022-10-26 16:30:00+00,13507,0,4578,17972,557,726,401,226,4,988,38959,148,23512,23111,18533,13507
2022-10-26 17:00:00+00,14020,0,4586,17921,615,1002,384,482,0,1008,40018,151,23506,23122,18536,14020
2022-10-26 17:30:00+00,14071,0,4587,17574,611,880,537,628,0,954,39842,152,23309,22772,18185,14071
2022-10-26 18:00:00+00,14054,0,4595,17266,468,536,721,572,0,598,38810,155,23050,22329,17734,14054
2022-10-26 18:30:00+00,13650,0,4600,17307,451,338,722,196,0,172,37436,151,23080,22358,17758,13650
2022-10-26 19:00:00+00,13877,0,4599,17395,417,404,726,157,0,142,37717,154,23137,22411,17812,13877
2022-10-26 19:30:00+00,13235,0,4603,17075,409,304,727,152,0,86,36591,150,22814,22087,17484,13235
2022-10-26 20:00:00+00,13176,0,4603,16589,422,528,576,167,0,0,36061,154,22190,21614,17011,13176
2022-10-26 20:30:00+00,12464,0,4612,15934,438,626,420,168,0,0,34662,153,21404,20984,16372,12464
2022-10-26 21:00:00+00,11056,0,4611,15541,446,862,444,169,0,0,33129,147,21042,20598,15987,11056
2022-10-26 21:30:00+00,9826,0,4620,15319,449,904,533,161,0,0,31812,138,20921,20388,15768,9826
2022-10-26 22:00:00+00,9692,0,4628,14946,390,832,525,153,0,50,31216,138,20489,19964,15336,9692
2022-10-26 22:30:00+00,8835,0,4627,14811,391,830,485,155,0,0,30134,132,20314,19829,15202,8835
2022-10-26 23:00:00+00,8220,0,4629,14517,390,794,395,147,0,0,29092,127,19931,19536,14907,8220
2022-10-26 23:30:00+00,7953,0,4632,14430,386,858,384,145,0,0,28788,126,19832,19448,14816,7953
2022-10-27 00:00:00+00,7946,0,4626,14070,358,742,384,147,0,0,28273,126,19438,19054,14428,7946
2022-10-27 00:30:00+00,7782,0,4625,14066,358,764,465,168,0,0,28228,125,19514,19049,14424,7782
2022-10-27 01:00:00+00,7719,0,4626,13842,325,664,545,169,0,0,27890,125,19338,18793,14167,7719
2022-10-27 01:30:00+00,7541,0,4627,13577,325,658,528,156,0,0,27412,124,19057,18529,13902,7541
2022-10-27 02:00:00+00,7179,0,4621,13547,324,694,540,163,0,0,27068,121,19032,18492,13871,7179
2022-10-27 02:30:00+00,7564,0,4622,13237,323,662,547,159,0,0,27114,126,18729,18182,13560,7564
2022-10-27 03:00:00+00,7631,0,4624,12998,323,720,538,158,0,0,26992,128,18483,17945,13321,7631
2022-10-27 03:30:00+00,8048,0,4620,12498,324,746,552,181,0,0,26969,135,17994,17442,12822,8048
2022-10-27 04:00:00+00,8073,0,4623,11947,342,848,563,161,0,0,26557,139,17475,16912,12289,8073
2022-10-27 04:30:00+00,9021,0,4621,11887,348,858,601,153,0,0,27489,148,17457,16856,12235,9021
2022-10-27 05:00:00+00,9758,0,4619,12433,408,660,549,182,0,0,28609,149,18009,17460,12841,9758
2022-10-27 05:30:00+00,12048,0,4622,12394,412,552,578,169,0,92,30867,166,18006,17428,12806,12048
2022-10-27 06:00:00+00,14492,18,4620,12664,586,544,719,178,0,140,33960,180,18588,17870,13250,14510
2022-10-27 06:30:00+00,16026,54,4623,12712,640,614,727,218,0,40,35654,191,18702,17975,13352,16080
2022-10-27 07:00:00+00,16779,78,4622,13021,625,408,727,368,8,0,36636,193,19003,18276,13654,16857
2022-10-27 07:30:00+00,17049,154,4625,12971,624,574,727,400,71,238,37433,196,19018,18291,13666,17203
2022-10-27 08:00:00+00,17576,241,4623,12643,610,814,728,289,243,560,38327,198,18847,18119,13496,17817
2022-10-27 08:30:00+00,17729,265,4625,12517,601,696,729,338,458,326,38284,200,18930,18201,13576,17994
2022-10-27 09:00:00+00,17529,255,4629,12909,581,552,729,373,627,96,38280,197,19475,18746,14117,17784
2022-10-27 09:30:00+00,17486,259,4623,12909,578,434,727,352,1192,74,38634,193,20029,19302,14679,17745
2022-10-27 10:00:00+00,16952,253,4625,13966,576,368,729,242,1795,0,39506,182,21691,20962,16337,17205
2022-10-27 10:30:00+00,16191,255,4620,14624,571,212,727,150,2159,0,39509,172,22701,21974,17354,16446
2022-10-27 11:00:00+00,16421,339,4616,14371,544,30,726,249,2375,0,39671,176,22632,21906,17290,16760
2022-10-27 11:30:00+00,15958,394,4619,14465,524,98,727,182,2322,0,39289,174,22657,21930,17311,16352
2022-10-27 12:00:00+00,16441,401,4622,13883,532,188,727,186,2469,258,39707,179,22233,21506,16884,16842
2022-10-27 12:30:00+00,16451,410,4623,13453,539,224,727,199,2708,236,39570,180,22050,21323,16700,16861
2022-10-27 13:00:00+00,16537,406,4628,13540,537,450,726,227,2531,154,39736,183,21962,21236,16608,16943
2022-10-27 13:30:00+00,16079,400,4624,13866,636,528,727,274,2424,146,39704,179,22277,21550,16926,16479
2022-10-27 14:00:00+00,15323,400,4626,13715,758,538,728,298,2612,438,39436,173,22439,21711,17085,15723
2022-10-27 14:30:00+00,15717,400,4629,13288,796,818,729,305,2149,438,39269,181,21591,20862,16233,16117
2022-10-27 15:00:00+00,16246,398,4628,12435,844,904,727,382,1573,860,38997,190,20207,19480,14852,16644
2022-10-27 15:30:00+00,17168,400,4625,11731,910,904,727,541,776,1078,38860,201,18769,18042,13417,17568
2022-10-27 16:00:00+00,17332,399,4626,11220,881,904,729,764,186,1394,38435,207,17642,16913,12287,17731
2022-10-27 16:30:00+00,17842,398,4625,10809,888,904,728,1029,1,1570,38794,212,17051,16323,11698,18240
2022-10-27 17:00:00+00,17879,401,4626,10570,889,1018,728,1247,0,1506,38864,215,16813,16085,11459,18280
2022-10-27 17:30:00+00,17996,285,4624,10491,955,1020,728,1228,0,1440,38767,214,16798,16070,11446,18281
2022-10-27 18:00:00+00,18218,0,4622,10510,903,888,728,1206,0,1048,38123,211,16763,16035,11413,18218
2022-10-27 18:30:00+00,18028,0,4619,10664,824,794,723,591,0,790,37033,209,16830,16107,11488,18028
2022-10-27 19:00:00+00,17579,0,4619,11267,713,884,728,422,0,308,36520,207,17327,16599,11980,17579
2022-10-27 19:30:00+00,16482,0,4616,11280,733,904,728,337,0,268,35348,201,17357,16629,12013,16482
2022-10-27 20:00:00+00,15537,0,4620,11711,649,904,726,314,0,0,34461,195,17706,16980,12360,15537
2022-10-27 20:30:00+00,14309,0,4616,11550,558,866,726,265,0,54,32944,189,17450,16724,12108,14309
2022-10-27 21:00:00+00,13552,0,4624,11706,639,720,599,221,0,0,32061,181,17568,16969,12345,13552
2022-10-27 21:30:00+00,11902,0,4618,12023,531,608,495,219,0,0,30396,168,17667,17172,12554,11902
2022-10-27 22:00:00+00,8878,0,4621,11998,462,544,384,219,0,0,27106,143,17465,17081,12460,8878
2022-10-27 22:30:00+00,7753,0,4620,11705,438,414,398,239,0,0,25567,132,17161,16763,12143,7753
2022-10-27 23:00:00+00,7486,0,4628,11242,420,330,382,210,0,0,24698,130,16672,16290,11662,7486
2022-10-27 23:30:00+00,6999,0,4624,11087,421,222,393,222,0,0,23968,124,16525,16132,11508,6999
2022-10-28 00:00:00+00,7557,0,4627,11054,409,178,550,216,0,0,24591,129,16640,16090,11463,7557
2022-10-28 00:30:00+00,7502,0,4630,11315,406,136,561,211,0,0,24761,126,16912,16351,11721,7502
2022-10-28 01:00:00+00,7355,0,4625,11345,387,148,391,237,0,0,24488,125,16748,16357,11732,7355
2022-10-28 01:30:00+00,6663,0,4631,11902,382,102,382,212,0,0,24274,114,17297,16915,12284,6663
2022-10-28 02:00:00+00,6100,0,4627,12766,383,5,382,213,0,0,24476,103,18158,17776,13149,6100
2022-10-28 02:30:00+00,5499,0,4625,13256,385,10,384,216,0,0,24375,94,18650,18266,13641,5499
2022-10-28 03:00:00+00,5988,0,4617,13345,401,60,391,241,0,0,25043,100,18754,18363,13746,5988
2022-10-28 03:30:00+00,6109,0,4618,13394,402,62,394,249,0,0,25228,101,18808,18414,13796,6109
2022-10-28 04:00:00+00,7201,0,4622,13389,401,52,397,262,0,0,26324,113,18809,18412,13790,7201
2022-10-28 04:30:00+00,7806,0,4624,13278,408,62,391,214,0,0,26783,120,18701,18310,13686,7806
2022-10-28 05:00:00+00,9272,0,4623,13332,519,154,573,228,0,0,28701,135,19047,18474,13851,9272
2022-10-28 05:30:00+00,10448,0,4623,13830,630,166,711,218,0,0,30626,142,19794,19083,14460,10448
2022-10-28 06:00:00+00,12840,0,4621,14458,748,18,724,235,0,24,33668,155,20551,19827,15206,12840
2022-10-28 06:30:00+00,13750,0,4624,15434,691,0,719,345,0,12,35575,158,21468,20749,16125,13750
2022-10-28 07:00:00+00,13521,0,4627,16526,688,0,717,362,28,38,36507,151,22586,21869,17242,13521
2022-10-28 07:30:00+00,13144,0,4622,17502,709,0,722,381,189,64,37333,144,23744,23022,18400,13144
2022-10-28 08:00:00+00,13102,0,4624,18430,555,0,718,377,504,0,38310,140,24831,24113,19489,13102
2022-10-28 08:30:00+00,12977,0,4627,18603,541,0,723,255,1017,0,38743,136,25511,24788,20161,12977
2022-10-28 09:00:00+00,12869,0,4625,18535,677,0,723,222,1519,66,39236,133,26079,25356,20731,12869
2022-10-28 09:30:00+00,12482,0,4631,18063,680,0,680,206,2416,26,39184,129,26470,25790,21159,12482
2022-10-28 10:00:00+00,12191,0,4634,17701,649,120,507,201,3168,0,39171,127,26659,26152,21518,12191
2022-10-28 10:30:00+00,11466,0,4631,16967,639,446,469,212,3923,162,38915,124,26629,26160,21529,11466
2022-10-28 11:00:00+00,10935,0,4631,16775,619,686,469,205,4599,6,38925,122,27093,26624,21993,10935
2022-10-28 11:30:00+00,10311,0,4629,16913,622,706,595,201,5194,0,39171,115,27953,27358,22729,10311
2022-10-28 12:00:00+00,9841,0,4628,17166,622,762,522,199,5011,18,38769,112,27949,27427,22799,9841
2022-10-28 12:30:00+00,8962,0,4626,17657,622,818,525,214,4617,58,38099,106,28047,27522,22896,8962
2022-10-28 13:00:00+00,9436,0,4624,17145,623,872,532,231,4310,120,37893,112,27234,26702,22078,9436
2022-10-28 13:30:00+00,9757,0,4627,16831,624,904,529,211,4048,34,37565,117,26659,26130,21503,9757
2022-10-28 14:00:00+00,10598,0,4627,16451,604,888,455,194,3516,244,37577,125,25653,25198,20571,10598
2022-10-28 14:30:00+00,11744,0,4624,15683,605,884,411,173,2993,594,37711,136,24316,23905,19281,11744
2022-10-28 15:00:00+00,13306,0,4629,14497,671,750,452,175,2106,800,37386,152,22355,21903,17274,13306
2022-10-28 15:30:00+00,14943,0,4635,13357,678,778,653,335,956,762,37097,173,20279,19626,14991,14943
2022-10-28 16:00:00+00,15835,0,4631,12472,750,682,721,639,208,758,36696,186,18782,18061,13430,15835
2022-10-28 16:30:00+00,16415,0,4630,12203,740,736,726,797,0,956,37203,192,18299,17573,12943,16415
2022-10-28 17:00:00+00,16550,0,4632,12351,763,1040,727,918,0,922,37903,193,18473,17746,13114,16550
2022-10-28 17:30:00+00,16505,0,4629,12633,778,942,728,802,0,912,37929,190,18768,18040,13411,16505
2022-10-28 18:00:00+00,16198,0,4630,12653,791,1110,728,528,0,494,37132,189,18802,18074,13444,16198
2022-10-28 18:30:00+00,15703,0,4628,12596,774,1018,728,248,0,204,35899,187,18726,17998,13370,15703
2022-10-28 19:00:00+00,15860,0,4623,12222,548,948,728,164,0,60,35153,192,18121,17393,12770,15860
2022-10-28 19:30:00+00,15017,0,4616,12081,506,930,728,157,0,0,34035,189,17931,17203,12587,15017
2022-10-28 20:00:00+00,14759,0,4622,11992,474,779,728,146,0,0,33500,189,17816,17088,12466,14759
2022-10-28 20:30:00+00,13582,0,4618,11704,485,454,729,180,0,0,31752,180,17536,16807,12189,13582
2022-10-28 21:00:00+00,13342,0,4623,11241,490,556,703,163,0,0,31118,182,17057,16354,11731,13342
2022-10-28 21:30:00+00,12236,0,4619,10980,460,414,558,185,0,0,29452,174,16617,16059,11440,12236
2022-10-28 22:00:00+00,9648,0,4622,10588,437,640,499,136,0,0,26570,156,16146,15647,11025,9648
2022-10-28 22:30:00+00,8757,0,4589,9958,439,874,580,133,0,0,25330,153,15566,14986,10397,8757
2022-10-28 23:00:00+00,8799,0,4596,9346,441,864,684,125,0,0,24855,156,15067,14383,9787,8799
2022-10-28 23:30:00+00,8878,0,4596,8226,444,878,705,129,0,0,23856,164,13971,13266,8670,8878
2022-10-29 00:00:00+00,8708,0,4601,8373,410,916,687,121,0,0,23816,159,14071,13384,8783,8708
2022-10-29 00:30:00+00,8727,0,4607,7848,404,1086,697,131,0,0,23500,164,13556,12859,8252,8727
2022-10-29 01:00:00+00,8011,0,4614,7338,412,1444,703,133,0,0,22655,156,13067,12364,7750,8011
2022-10-29 01:30:00+00,7975,0,4617,6977,415,1432,706,129,0,0,22251,157,12715,12009,7392,7975
2022-10-29 02:00:00+00,8171,0,4616,6530,495,1724,685,122,0,0,22343,162,12326,11641,7025,8171
2022-10-29 02:30:00+00,8388,0,4619,6111,495,1660,683,123,0,0,22079,167,11908,11225,6606,8388
2022-10-29 03:00:00+00,9025,0,4622,5664,498,1236,710,137,0,0,21892,181,11494,10784,6162,9025
2022-10-29 03:30:00+00,9435,0,4629,5199,499,1126,722,141,0,0,21751,188,11049,10327,5698,9435
2022-10-29 04:00:00+00,9954,0,4633,4695,541,916,707,138,0,0,21584,199,10576,9869,5236,9954
2022-10-29 04:30:00+00,10169,0,4633,4757,545,1044,690,127,0,0,21965,202,10625,9935,5302,10169
2022-10-29 05:00:00+00,10857,0,4632,4857,731,918,720,136,0,0,22851,207,10940,10220,5588,10857
2022-10-29 05:30:00+00,11373,0,4633,5180,766,936,720,134,0,0,23742,208,11299,10579,5946,11373
2022-10-29 06:00:00+00,12412,0,4630,5441,896,996,721,145,0,328,25569,210,11688,10967,6337,12412
2022-10-29 06:30:00+00,13132,0,4632,5805,915,1136,725,143,0,282,26770,213,12077,11352,6720,13132
2022-10-29 07:00:00+00,13321,0,4630,6101,922,1244,717,123,14,340,27412,207,12384,11667,7037,13321
2022-10-29 07:30:00+00,13350,0,4635,6936,922,1352,629,135,131,286,28376,201,13253,12624,7989,13350
2022-10-29 08:00:00+00,12850,0,4634,7937,903,1642,420,134,384,318,29222,188,14278,13858,9224,12850
2022-10-29 08:30:00+00,13179,0,4636,8346,897,1526,325,127,775,346,30157,185,14979,14654,10018,13179
2022-10-29 09:00:00+00,13736,0,4637,9103,783,968,115,139,890,288,30659,188,15528,15413,10776,13736
2022-10-29 09:30:00+00,13673,0,4637,9455,762,850,115,139,1175,314,31120,183,16144,16029,11392,13673
2022-10-29 10:00:00+00,13543,0,4640,9897,651,776,115,136,1535,212,31505,181,16838,16723,12083,13543
2022-10-29 10:30:00+00,12926,0,4638,10338,649,908,114,124,1736,214,31647,174,17475,17361,12723,12926
2022-10-29 11:00:00+00,12480,0,4637,10345,479,906,115,124,2160,186,31432,171,17736,17621,12984,12480
2022-10-29 11:30:00+00,12431,0,4631,10228,483,904,115,121,2614,70,31597,170,18071,17956,13325,12431
2022-10-29 12:00:00+00,12165,0,4635,10466,486,904,114,122,2888,0,31780,165,18589,18475,13840,12165
2022-10-29 12:30:00+00,11854,0,4630,10484,483,904,113,124,2641,0,31233,164,18351,18238,13608,11854
2022-10-29 13:00:00+00,11304,0,4633,10855,484,968,113,125,2414,0,30896,159,18499,18386,13753,11304
2022-10-29 13:30:00+00,11007,0,4629,11342,483,970,113,135,1984,0,30663,157,18551,18438,13809,11007
2022-10-29 14:00:00+00,11755,0,4630,11619,527,1008,115,137,1623,74,31488,162,18514,18399,13769,11755
2022-10-29 14:30:00+00,12068,0,4630,11784,542,1002,115,145,1268,32,31586,166,18339,18224,13594,12068
2022-10-29 15:00:00+00,13020,0,4633,11917,656,904,115,127,783,88,32243,174,18104,17989,13356,13020
2022-10-29 15:30:00+00,14135,0,4631,11830,510,904,115,148,468,12,32753,184,17554,17439,12808,14135
2022-10-29 16:00:00+00,14237,0,4632,12249,510,904,115,330,111,488,33576,183,17617,17502,12870,14237
2022-10-29 16:30:00+00,14450,0,4633,12810,556,916,116,448,0,592,34521,181,18115,17999,13366,14450
2022-10-29 17:00:00+00,14167,0,4635,13580,620,1072,116,610,0,560,35360,175,18951,18835,14200,14167
2022-10-29 17:30:00+00,13029,0,4636,14414,647,1052,115,550,0,512,34955,164,19812,19697,15061,13029
2022-10-29 18:00:00+00,12801,0,4637,14347,653,904,117,339,0,378,34176,163,19755,19638,15000,12801
2022-10-29 18:30:00+00,12470,0,4638,14282,619,904,116,144,0,0,33173,162,19656,19540,14901,12470
2022-10-29 19:00:00+00,12038,0,4638,14217,615,904,117,118,0,20,32667,159,19587,19470,14832,12038
2022-10-29 19:30:00+00,11408,0,4636,14149,612,904,114,109,0,0,31933,155,19511,19397,14761,11408
2022-10-29 20:00:00+00,10801,0,4634,14067,527,904,114,141,0,80,31268,151,19342,19228,14594,10801
2022-10-29 20:30:00+00,9875,0,4637,13962,480,904,114,137,0,294,30404,143,19193,19079,14442,9875
2022-10-29 21:00:00+00,8897,0,4636,13841,466,904,147,124,0,78,29093,137,19090,18943,14307,8897
2022-10-29 21:30:00+00,7577,0,4635,13712,447,860,280,134,0,252,27898,124,19074,18794,14159,7577
2022-10-29 22:00:00+00,6301,0,4634,13571,389,888,414,116,0,104,26417,113,19007,18593,13960,6301
2022-10-29 22:30:00+00,5140,0,4632,13408,382,904,414,107,0,0,24988,101,18837,18423,13790,5140
2022-10-29 23:00:00+00,4245,0,4630,13250,750,904,828,210,0,0,24818,91,19459,18631,14000,4245
2022-10-29 23:30:00+00,3638,0,4629,13118,730,904,826,208,0,0,24053,84,19302,18476,13848,3638
2022-10-30 00:00:00+00,3453,0,4626,13014,726,904,824,208,0,0,23755,81,19190,18366,13740,3453
2022-10-30 00:30:00+00,3371,0,4627,12922,752,904,822,238,0,0,23636,81,19123,18301,13674,3371
2022-10-30 01:00:00+00,3132,0,4625,12819,387,904,411,115,0,0,22393,77,18242,17831,13206,3132
2022-10-30 01:30:00+00,2770,0,4628,12701,367,904,414,120,0,0,21904,73,18110,17696,13068,2770
2022-10-30 02:00:00+00,2529,0,4628,12585,366,904,414,127,0,0,21553,70,17993,17579,12951,2529
2022-10-30 02:30:00+00,2328,0,4629,12494,376,904,414,113,0,0,21258,67,17913,17499,12870,2328
2022-10-30 03:00:00+00,2170,0,4631,12413,345,904,414,104,0,0,20981,64,17803,17389,12758,2170
2022-10-30 03:30:00+00,1936,0,4633,12318,390,904,414,104,0,0,20699,61,17755,17341,12708,1936
2022-10-30 04:00:00+00,1962,0,4633,12237,389,904,413,131,0,0,20669,62,17672,17259,12626,1962
2022-10-30 04:30:00+00,2038,0,4637,12189,396,912,414,127,0,0,20713,63,17636,17222,12585,2038
2022-10-30 05:00:00+00,2579,0,4637,12165,425,1032,414,128,0,0,21381,71,17642,17228,12590,2579
2022-10-30 05:30:00+00,3305,0,4639,12139,428,1066,415,133,0,0,22126,82,17621,17206,12567,3305
2022-10-30 06:00:00+00,4462,0,4638,12087,446,1278,414,127,0,0,23451,96,17585,17171,12533,4462
2022-10-30 06:30:00+00,5460,0,4636,12021,455,1272,415,138,0,0,24396,109,17526,17111,12476,5460
2022-10-30 07:00:00+00,5575,0,4636,11938,507,1154,415,104,2,0,24331,108,17498,17083,12447,5575
2022-10-30 07:30:00+00,6051,0,4637,12374,509,1194,414,109,54,0,25342,112,17988,17574,12937,6051
2022-10-30 08:00:00+00,6247,0,4633,12785,480,1466,414,113,188,0,26326,110,18500,18086,13453,6247
2022-10-30 08:30:00+00,7149,0,4632,12786,503,1508,413,111,408,32,27542,119,18742,18329,13697,7149
2022-10-30 09:00:00+00,7531,0,4636,13034,507,1690,328,105,683,92,28606,120,19188,18860,14224,7531
2022-10-30 09:30:00+00,7731,0,4633,13233,505,1706,115,125,1036,214,29298,119,19522,19407,14774,7731
2022-10-30 10:00:00+00,7773,0,4635,13545,472,1962,116,110,1380,0,29993,118,20148,20032,15397,7773
2022-10-30 10:30:00+00,7792,0,4626,13583,463,1956,115,124,1895,46,30600,116,20682,20567,15941,7792
2022-10-30 11:00:00+00,7804,0,4627,13826,429,2192,114,107,1855,0,30954,119,20851,20737,16110,7804
2022-10-30 11:30:00+00,7668,0,4629,14265,426,2178,114,115,2204,0,31600,115,21638,21524,16895,7668
2022-10-30 12:00:00+00,7548,0,4632,14803,405,2032,113,107,2133,0,31773,110,22086,21973,17341,7548
2022-10-30 12:30:00+00,7316,0,4624,15183,407,1986,112,107,2224,0,31959,106,22550,22438,17814,7316
2022-10-30 13:00:00+00,7220,0,4629,15568,388,1728,111,105,2282,0,32032,106,22978,22867,18238,7220
2022-10-30 13:30:00+00,7135,0,4625,15656,409,1644,111,109,2299,0,31988,104,23100,22989,18364,7135
2022-10-30 14:00:00+00,7166,0,4629,15737,405,1292,111,107,2213,0,31660,105,23095,22984,18355,7166
2022-10-30 14:30:00+00,7327,0,4627,15555,407,1146,113,113,2017,0,31305,107,22719,22606,17979,7327
2022-10-30 15:00:00+00,7601,0,4626,15850,422,880,113,159,1317,24,30992,112,22328,22215,17589,7601
2022-10-30 15:30:00+00,8134,0,4631,16285,424,904,114,155,677,20,31344,117,22131,22017,17386,8134
2022-10-30 16:00:00+00,8597,0,4628,16335,422,946,115,177,144,234,31598,123,21644,21529,16901,8597
2022-10-30 16:30:00+00,9108,0,4626,16655,447,958,115,309,0,632,32850,125,21843,21728,17102,9108
2022-10-30 17:00:00+00,9369,0,4631,17075,630,1268,116,584,0,880,34553,124,22452,22336,17705,9369
2022-10-30 17:30:00+00,9517,0,4630,16972,586,1184,115,573,0,664,34241,125,22303,22188,17558,9517
2022-10-30 18:00:00+00,9544,0,4634,16742,534,1274,115,517,0,688,34048,126,22025,21910,17276,9544
2022-10-30 18:30:00+00,9513,0,4636,16517,533,1302,115,435,0,656,33707,127,21801,21686,17050,9513
2022-10-30 19:00:00+00,9416,0,4632,16629,544,1070,115,411,0,384,33201,129,21920,21805,17173,9416
2022-10-30 19:30:00+00,9125,0,4632,16114,604,980,115,339,0,288,32197,128,21465,21350,16718,9125
2022-10-30 20:00:00+00,8834,0,4632,16173,628,949,115,384,0,300,32015,126,21548,21433,16801,8834
2022-10-30 20:30:00+00,8190,0,4631,15748,626,904,116,256,0,178,30649,122,21121,21005,16374,8190
2022-10-30 21:00:00+00,7376,0,4631,15526,616,940,115,249,0,44,29497,116,20888,20773,16142,7376
2022-10-30 21:30:00+00,6895,0,4633,15516,585,760,115,140,0,2,28646,109,20849,20734,16101,6895
2022-10-30 22:00:00+00,6767,0,4634,15266,531,830,150,132,0,10,28320,110,20581,20431,15797,6767
2022-10-30 22:30:00+00,5981,0,4634,14969,585,620,281,125,0,0,27195,100,20469,20188,15554,5981
2022-10-30 23:00:00+00,4841,0,4633,14803,521,648,414,133,0,6,25999,87,20371,19957,15324,4841
2022-10-30 23:30:00+00,4294,0,4637,14764,401,960,414,147,0,0,25617,85,20216,19802,15165,4294
2022-10-31 00:00:00+00,4213,0,4633,14136,366,976,413,122,0,0,24859,87,19548,19135,14502,4213
2022-10-31 00:30:00+00,4221,0,4637,13764,363,972,412,175,0,0,24544,89,19176,18764,14127,4221
2022-10-31 01:00:00+00,4268,0,4638,13576,356,904,412,175,0,0,24329,90,18982,18570,13932,4268
2022-10-31 01:30:00+00,4282,0,4637,13137,356,904,412,176,0,0,23904,92,18542,18130,13493,4282
2022-10-31 02:00:00+00,4394,0,4638,12820,355,904,421,184,0,0,23716,95,18234,17813,13175,4394
2022-10-31 02:30:00+00,4776,0,4637,12436,352,904,432,140,0,0,23677,101,17857,17425,12788,4776
2022-10-31 03:00:00+00,5267,0,4638,12270,367,904,413,162,0,0,24021,108,17688,17275,12637,5267
2022-10-31 03:30:00+00,4942,0,4637,12311,367,904,412,181,0,0,23754,104,17727,17315,12678,4942
2022-10-31 04:00:00+00,5343,0,4634,11769,366,904,413,178,0,0,23607,111,17182,16769,12135,5343
2022-10-31 04:30:00+00,5439,0,4634,11619,368,904,413,165,0,0,23542,113,17034,16621,11987,5439
2022-10-31 05:00:00+00,6405,0,4631,11899,367,904,418,218,0,0,24842,123,17315,16897,12266,6405
2022-10-31 05:30:00+00,7546,0,4633,12269,366,904,420,331,0,2,26471,134,17688,17268,12635,7546
2022-10-31 06:00:00+00,9177,0,4631,12243,422,904,429,383,0,42,28231,149,17725,17296,12665,9177
2022-10-31 06:30:00+00,11504,0,4636,12878,466,904,413,291,0,0,31092,163,18393,17980,13344,11504
2022-10-31 07:00:00+00,12367,0,4632,12749,475,1062,574,249,49,312,32469,168,18479,17905,13273,12367
2022-10-31 07:30:00+00,12936,0,4634,12776,525,1070,752,592,506,256,34047,170,19193,18441,13807,12936
2022-10-31 08:00:00+00,11964,0,4632,12511,470,1688,742,229,1091,116,33443,159,19446,18704,14072,11964
2022-10-31 08:30:00+00,11969,0,4633,12761,457,1734,757,182,1733,0,34226,155,20341,19584,14951,11969
2022-10-31 09:00:00+00,11846,0,4634,13010,436,2082,756,180,2217,0,35161,147,21053,20297,15663,11846
2022-10-31 09:30:00+00,11819,0,4636,13048,418,1828,757,138,2726,0,35370,143,21585,20828,16192,11819
2022-10-31 10:00:00+00,11900,0,4634,13393,420,926,757,103,3064,0,35197,140,22268,21511,16877,11900
2022-10-31 10:30:00+00,11609,0,4631,13723,396,798,755,115,3246,0,35273,136,22751,21996,17365,11609
2022-10-31 11:00:00+00,11514,0,4629,13963,446,547,754,133,3418,0,35404,133,23210,22456,17827,11514
2022-10-31 11:30:00+00,11430,0,4633,13931,541,490,753,134,3135,0,35047,133,22993,22240,17607,11430
2022-10-31 12:00:00+00,11607,0,4628,13804,578,532,749,259,3278,126,35561,135,23037,22288,17660,11607
2022-10-31 12:30:00+00,12558,0,4632,13220,468,480,754,288,3032,14,35446,146,22106,21352,16720,12558
2022-10-31 13:00:00+00,14781,0,4626,13100,472,380,752,332,2370,68,36881,164,21320,20568,15942,14781
2022-10-31 13:30:00+00,15498,0,4628,13120,461,372,752,333,1940,46,37150,171,20901,20149,15521,15498
2022-10-31 14:00:00+00,15482,0,4631,13557,448,32,751,350,1308,0,36559,172,20695,19944,15313,15482
2022-10-31 14:30:00+00,15858,0,4624,13313,435,60,752,377,729,74,36222,178,19853,19101,14477,15858
2022-10-31 15:00:00+00,16275,0,4625,12616,585,402,753,502,354,270,36382,185,18933,18180,13555,16275
2022-10-31 15:30:00+00,16737,0,4630,12505,621,422,754,718,121,318,36826,189,18631,17877,13247,16737
2022-10-31 16:00:00+00,15798,0,4628,12347,650,884,753,686,7,584,36337,182,18385,17632,13004,15798
2022-10-31 16:30:00+00,16347,0,4630,12596,651,952,754,711,0,952,37593,182,18631,17877,13247,16347
2022-10-31 17:00:00+00,15433,0,4630,13503,658,1772,752,834,0,1124,38706,171,19543,18791,14161,15433
2022-10-31 17:30:00+00,14887,0,4631,13893,645,1816,754,813,0,1382,38821,164,19923,19169,14538,14887
2022-10-31 18:00:00+00,15304,0,4634,13705,651,1490,756,833,0,1356,38729,169,19746,18990,14356,15304
2022-10-31 18:30:00+00,15048,0,4633,13755,660,1470,755,444,0,1140,37905,167,19803,19048,14415,15048
2022-10-31 19:00:00+00,14728,0,4634,14683,668,1972,756,317,0,320,38078,166,20741,19985,15351,14728
2022-10-31 19:30:00+00,13781,0,4629,14904,666,2002,755,204,0,432,37373,158,20954,20199,15570,13781
2022-10-31 20:00:00+00,12259,0,4630,15240,672,2064,755,167,0,58,35845,149,21297,20542,15912,12259
2022-10-31 20:30:00+00,11240,0,4628,14751,710,2202,757,139,0,250,34677,143,20846,20089,15461,11240
2022-10-31 21:00:00+00,9548,0,4627,14457,708,1834,744,129,0,318,32365,128,20536,19792,15165,9548
2022-10-31 21:30:00+00,7858,0,4624,14369,791,1838,757,135,0,296,30668,114,20541,19784,15160,7858
2022-10-31 22:00:00+00,6047,0,4626,14075,710,2418,583,142,0,280,28881,101,19994,19411,14785,6047
2022-10-31 22:30:00+00,4898,0,4631,13980,565,2440,524,138,0,280,27456,90,19700,19176,14545,4898
2022-10-31 23:00:00+00,3757,0,4632,13692,492,2640,609,125,0,0,25947,76,19425,18816,14184,3757
2022-10-31 23:30:00+00,3422,0,4633,13169,489,2704,751,125,0,0,25293,73,19042,18291,13658,3422
2022-11-01 00:00:00+00,3387,0,4628,12611,465,2206,812,129,0,0,24238,65,18516,17704,13076,3387
2022-11-01 00:30:00+00,3479,0,4627,12131,529,2400,834,131,0,0,24131,70,18121,17287,12660,3479
2022-11-01 01:00:00+00,4023,0,4633,11736,486,2306,883,131,0,0,24198,78,17738,16855,12222,4023
2022-11-01 01:30:00+00,3733,0,4635,12373,490,2114,798,124,0,0,24267,69,18296,17498,12863,3733
2022-11-01 02:00:00+00,3907,0,4634,12536,488,1776,873,136,0,0,24350,72,18531,17658,13024,3907
2022-11-01 02:30:00+00,3971,0,4633,12168,486,1768,881,176,0,0,24083,74,18168,17287,12654,3971
2022-11-01 03:00:00+00,4133,0,4633,12223,489,1504,876,147,0,0,24005,75,18221,17345,12712,4133
2022-11-01 03:30:00+00,3906,0,4635,12435,476,1472,842,124,0,0,23890,71,18388,17546,12911,3906
2022-11-01 04:00:00+00,4015,0,4634,12939,459,992,826,122,0,0,23987,72,18858,18032,13398,4015
2022-11-01 04:30:00+00,3828,0,4636,13217,458,950,793,121,0,0,24003,69,19104,18311,13675,3828
2022-11-01 05:00:00+00,3811,0,4633,13068,458,1416,643,129,0,0,24158,73,18802,18159,13526,3811
2022-11-01 05:30:00+00,3712,0,4633,13164,462,1690,428,149,0,0,24238,75,18687,18259,13626,3712
2022-11-01 06:00:00+00,3891,0,4633,13660,569,2544,482,147,0,148,26074,76,19344,18862,14229,3891
2022-11-01 06:30:00+00,5590,0,4637,13680,637,2668,638,152,0,286,28288,95,19592,18954,14317,5590
2022-11-01 07:00:00+00,6447,0,4632,13483,635,3628,537,145,26,248,29781,102,19313,18776,14144,6447
2022-11-01 07:30:00+00,6602,0,4632,14417,638,3690,418,183,267,280,31127,98,20372,19954,15322,6602
2022-11-01 08:00:00+00,5646,0,4629,15418,652,5062,417,165,722,62,32773,82,21838,21421,16792,5646
2022-11-01 08:30:00+00,5267,0,4630,15848,636,5110,411,134,1159,286,33481,76,22684,22273,17643,5267
2022-11-01 09:00:00+00,5277,0,4626,16545,623,4944,413,139,1228,146,33941,75,23435,23022,18396,5277
2022-11-01 09:30:00+00,5094,0,4625,17014,614,4936,411,129,1727,24,34574,71,24391,23980,19355,5094
2022-11-01 10:00:00+00,5714,4,4629,17073,564,3650,501,134,2198,250,34717,77,24965,24464,19835,5718
2022-11-01 10:30:00+00,5718,24,4629,17409,553,3580,515,125,2723,34,35310,76,25829,25314,20685,5742
2022-11-01 11:00:00+00,5661,120,4629,17700,543,3680,562,128,2952,0,35975,77,26386,25824,21195,5781
2022-11-01 11:30:00+00,5754,215,4630,17683,409,3684,539,140,3477,0,36531,80,26738,26199,21569,5969
2022-11-01 12:00:00+00,5715,238,4636,17920,347,3772,428,168,3316,0,36540,80,26647,26219,21583,5953
2022-11-01 12:30:00+00,5669,231,4630,17997,382,3776,454,159,3427,0,36725,79,26890,26436,21806,5900
2022-11-01 13:00:00+00,5611,229,4634,17641,391,4054,543,127,2881,0,36111,79,26090,25547,20913,5840
2022-11-01 13:30:00+00,5807,230,4630,17398,393,4056,700,131,2110,0,35455,84,25231,24531,19901,6037
2022-11-01 14:00:00+00,6427,230,4630,16909,406,3732,659,127,2093,0,35213,91,24697,24038,19408,6657
2022-11-01 14:30:00+00,6942,231,4634,16640,390,3704,530,126,1730,0,34927,97,23924,23394,18760,7173
2022-11-01 15:00:00+00,8158,277,4628,16195,425,2738,671,181,953,222,34448,114,22872,22201,17573,8435
2022-11-01 15:30:00+00,9646,301,4631,15398,516,2704,652,412,343,552,35154,131,21540,20888,16256,9947
2022-11-01 16:00:00+00,10656,299,4634,14999,632,3226,732,732,69,374,36353,141,21066,20334,15700,10955
2022-11-01 16:30:00+00,11057,301,4632,15426,633,3422,750,837,0,440,37498,144,21441,20691,16059,11358
2022-11-01 17:00:00+00,11045,299,4631,15961,661,4124,752,904,0,1212,39589,137,22005,21253,16622,11344
2022-11-01 17:30:00+00,11145,300,4630,15854,661,4104,754,886,0,1230,39564,137,21899,21145,16515,11445
2022-11-01 18:00:00+00,11042,300,4636,15306,776,4158,751,756,0,1274,38999,138,21469,20718,16082,11342
2022-11-01 18:30:00+00,11050,300,4635,14902,838,4038,753,415,0,1176,38107,138,21128,20375,15740,11350
2022-11-01 19:00:00+00,11828,299,4636,14788,765,3096,756,296,0,902,37366,150,20945,20189,15553,12127
2022-11-01 19:30:00+00,11537,301,4638,14792,714,2934,762,224,0,190,36092,150,20906,20144,15506,11838
2022-11-01 20:00:00+00,10662,300,4637,15021,641,3068,690,184,0,0,35203,146,20989,20299,15662,10962
2022-11-01 20:30:00+00,9671,299,4632,14990,614,3212,450,178,0,24,34070,140,20686,20236,15604,9970
2022-11-01 21:00:00+00,8607,146,4637,14836,456,3756,418,126,0,0,32982,130,20347,19929,15292,8753
2022-11-01 21:30:00+00,6796,0,4633,14965,455,3700,507,125,0,0,31181,109,20560,20053,15420,6796
2022-11-01 22:00:00+00,5412,0,4629,15342,422,3430,750,126,0,12,30123,94,21143,20393,15764,5412
2022-11-01 22:30:00+00,4364,0,4629,15468,404,3294,685,135,0,2,28981,81,21186,20501,15872,4364
2022-11-01 23:00:00+00,4358,0,4634,16068,458,2016,718,128,0,0,28380,72,21878,21160,16526,4358
2022-11-01 23:30:00+00,3595,0,4635,16552,458,1834,694,124,0,0,27892,60,22339,21645,17010,3595
2022-11-02 00:00:00+00,3805,0,4634,16650,388,1662,761,124,0,0,28024,61,22433,21672,17038,3805
2022-11-02 00:30:00+00,3920,0,4633,16518,387,1664,766,125,0,0,28013,62,22304,21538,16905,3920
2022-11-02 01:00:00+00,3670,0,4634,16377,354,1714,665,124,0,0,27538,61,22030,21365,16731,3670
2022-11-02 01:30:00+00,3727,0,4627,16188,354,1664,642,132,0,0,27334,62,21811,21169,16542,3727
2022-11-02 02:00:00+00,3662,0,4634,16159,354,1470,611,145,0,0,27035,63,21758,21147,16513,3662
2022-11-02 02:30:00+00,3648,0,4629,16034,354,1398,553,143,0,0,26759,62,21570,21017,16388,3648
2022-11-02 03:00:00+00,3550,0,4634,15737,353,1540,416,126,0,0,26356,65,21140,20724,16090,3550
2022-11-02 03:30:00+00,3606,0,4635,15356,353,1494,423,126,0,0,25993,67,20767,20344,15709,3606
2022-11-02 04:00:00+00,4245,0,4628,15172,346,1000,523,137,0,0,26051,80,20669,20146,15518,4245
2022-11-02 04:30:00+00,4229,0,4633,15492,363,1000,576,128,0,0,26421,79,21064,20488,15855,4229
2022-11-02 05:00:00+00,4200,0,4633,15681,363,1026,591,145,0,0,26639,82,21268,20677,16044,4200
2022-11-02 05:30:00+00,5318,0,4629,15496,364,1038,719,130,0,0,27694,96,21208,20489,15860,5318
2022-11-02 06:00:00+00,7094,0,4630,15811,379,904,771,136,0,168,29893,112,21591,20820,16190,7094
2022-11-02 06:30:00+00,7849,0,4625,16071,379,904,771,261,0,326,31186,119,21846,21075,16450,7849
2022-11-02 07:00:00+00,8604,141,4623,16658,381,2620,605,180,46,198,34056,128,22313,21708,17085,8745
2022-11-02 07:30:00+00,9007,352,4626,16812,381,2898,431,252,529,310,35598,133,22779,22348,17722,9359
2022-11-02 08:00:00+00,9031,414,4623,16979,408,3456,434,161,1334,262,37102,129,23778,23344,18721,9445
2022-11-02 08:30:00+00,8704,430,4623,17125,416,3490,439,152,2186,186,37751,123,24789,24350,19727,9134
2022-11-02 09:00:00+00,8300,430,4626,17893,402,3460,440,129,2590,96,38366,118,25951,25511,20885,8730
2022-11-02 09:30:00+00,8199,429,4627,17967,397,3382,441,130,2951,0,38523,116,26383,25942,21315,8628
2022-11-02 10:00:00+00,7870,431,4628,18634,381,3060,438,128,3147,0,38717,111,27228,26790,22162,8301
2022-11-02 10:30:00+00,7291,430,4632,19342,378,3028,448,145,2935,0,38629,106,27735,27287,22655,7721
2022-11-02 11:00:00+00,6998,429,4632,19993,364,3056,439,130,2485,0,38526,102,27913,27474,22842,7427
2022-11-02 11:30:00+00,7155,429,4632,20321,347,3028,443,179,1995,0,38529,104,27738,27295,22663,7584
2022-11-02 12:00:00+00,7352,430,4631,20824,320,2966,597,154,1813,0,39087,105,28185,27588,22957,7782
2022-11-02 12:30:00+00,7703,430,4634,20897,328,2890,775,133,1571,0,39361,108,28205,27430,22796,8133
2022-11-02 13:00:00+00,8365,429,4631,20657,336,2606,778,124,1369,0,39295,116,27771,26993,22362,8794
2022-11-02 13:30:00+00,8412,430,4634,20222,355,2618,777,137,1236,0,38821,118,27224,26447,21813,8842
2022-11-02 14:00:00+00,9054,377,4628,20027,411,1980,773,202,843,414,38709,121,26682,25909,21281,9431
2022-11-02 14:30:00+00,9096,240,4633,20405,409,1970,776,205,607,430,38771,118,26830,26054,21421,9336
2022-11-02 15:00:00+00,9935,240,4625,20395,428,1330,775,174,272,892,39066,124,26495,25720,21095,10175
2022-11-02 15:30:00+00,10564,231,4636,20482,548,1324,775,408,123,1030,40121,128,26564,25789,21153,10795
2022-11-02 16:00:00+00,10605,233,4636,20668,590,1232,774,629,12,1072,40451,128,26680,25906,21270,10838
2022-11-02 16:30:00+00,11508,266,4635,20532,609,1236,774,803,0,1438,41801,134,26550,25776,21141,11774
2022-11-02 17:00:00+00,11471,305,4637,20655,584,1730,772,828,0,1482,42464,133,26648,25876,21239,11776
2022-11-02 17:30:00+00,11328,251,4634,20631,471,1742,775,896,0,1366,42094,132,26511,25736,21102,11579
2022-11-02 18:00:00+00,11389,287,4635,20625,456,2028,777,871,0,1318,42386,133,26493,25716,21081,11676
2022-11-02 18:30:00+00,10956,234,4635,20737,458,1814,778,844,0,1280,41736,127,26608,25830,21195,11190
2022-11-02 19:00:00+00,10189,274,4634,20446,460,2066,777,690,0,754,40290,125,26317,25540,20906,10463
2022-11-02 19:30:00+00,9299,433,4635,20269,426,2020,780,616,0,456,38934,123,26110,25330,20695,9732
2022-11-02 20:00:00+00,8219,450,4634,20108,368,2422,777,348,0,292,37618,118,25887,25110,20476,8669
2022-11-02 20:30:00+00,7248,466,4636,19617,367,2448,773,251,0,50,35856,112,25393,24620,19984,7714
2022-11-02 21:00:00+00,6410,479,4635,18873,365,2704,776,252,0,144,34638,107,24649,23873,19238,6889
2022-11-02 21:30:00+00,5074,427,4636,18485,358,2696,780,143,0,66,32665,95,24259,23479,18843,5501
2022-11-02 22:00:00+00,4609,322,4634,18095,356,1994,779,129,0,64,30982,86,23864,23085,18451,4931
2022-11-02 22:30:00+00,4222,280,4633,17714,358,1734,769,129,0,0,29839,79,23474,22705,18072,4502
2022-11-02 23:00:00+00,4206,311,4631,17668,357,534,765,126,0,0,28598,75,23421,22656,18025,4517
2022-11-02 23:30:00+00,4326,84,4633,17766,371,352,767,126,0,0,28425,68,23537,22770,18137,4410
2022-11-03 00:00:00+00,4322,0,4632,17625,392,348,754,132,0,0,28205,68,23403,22649,18017,4322
2022-11-03 00:30:00+00,4560,0,4630,17570,412,356,675,147,0,0,28350,71,23287,22612,17982,4560
2022-11-03 01:00:00+00,4511,0,4635,17296,417,390,609,124,0,0,27982,70,22958,22348,17714,4511
2022-11-03 01:30:00+00,4385,0,4634,17050,424,452,444,126,0,0,27515,69,22552,22108,17474,4385
2022-11-03 02:00:00+00,4182,0,4637,16748,442,648,523,128,0,0,27308,67,22350,21827,17190,4182
2022-11-03 02:30:00+00,4235,0,4633,16189,440,676,550,132,0,0,26855,69,21812,21262,16629,4235
2022-11-03 03:00:00+00,4193,0,4638,15707,438,804,813,129,0,0,26722,68,21596,20783,16145,4193
2022-11-03 03:30:00+00,4562,0,4636,14506,428,830,1086,132,0,0,26180,76,20656,19570,14934,4562
2022-11-03 04:00:00+00,4324,0,4636,13756,426,1555,1123,131,0,0,25951,82,19941,18818,14182,4324
2022-11-03 04:30:00+00,4393,0,4643,13342,440,1734,1212,134,0,0,25898,86,19637,18425,13782,4393
2022-11-03 05:00:00+00,5025,0,4637,12450,493,1746,1351,142,0,0,25844,93,18931,17580,12943,5025
2022-11-03 05:30:00+00,6096,0,4637,11896,625,1738,1501,172,0,324,26989,106,18659,17158,12521,6096
2022-11-03 06:00:00+00,8548,0,4639,10805,663,1788,1578,152,0,514,28687,135,17685,16107,11468,8548
2022-11-03 06:30:00+00,12168,0,4633,9843,669,1690,1828,184,0,576,31591,169,16973,15145,10512,12168
2022-11-03 07:00:00+00,14842,0,4629,9180,701,1396,2016,187,0,438,33389,194,16526,14510,9881,14842
2022-11-03 07:30:00+00,16885,0,4631,8426,709,1428,2055,256,29,552,34971,209,15850,13795,9164,16885
2022-11-03 08:00:00+00,17201,0,4629,8079,571,2484,2058,147,215,264,35648,210,15552,13494,8865,17201
2022-11-03 08:30:00+00,17800,0,4630,7437,575,2576,2046,159,599,404,36226,213,15287,13241,8611,17800
2022-11-03 09:00:00+00,16772,0,4632,7180,585,3850,2051,222,1186,376,36854,200,15634,13583,8951,16772
2022-11-03 09:30:00+00,16780,0,4629,6597,645,3942,2057,240,1629,422,36941,200,15557,13500,8871,16780
2022-11-03 10:00:00+00,16983,0,4633,6011,713,4076,2058,194,1928,242,36838,202,15343,13285,8652,16983
2022-11-03 10:30:00+00,17046,0,4630,5310,671,4230,2055,224,2181,194,36541,205,14847,12792,8162,17046
2022-11-03 11:00:00+00,16906,0,4630,4521,641,4942,2049,225,2783,138,36835,203,14624,12575,7945,16906
2022-11-03 11:30:00+00,17401,0,4628,3838,601,5002,2048,279,2790,140,36727,209,13905,11857,7229,17401
2022-11-03 12:00:00+00,17384,0,4635,3430,601,5474,2042,295,3068,0,36929,209,13776,11734,7099,17384
2022-11-03 12:30:00+00,17199,0,4630,3273,592,5494,2051,366,3434,0,37039,207,13980,11929,7299,17199
2022-11-03 13:00:00+00,16505,0,4634,3009,710,6032,2049,392,3227,0,36558,203,13629,11580,6946,16505
2022-11-03 13:30:00+00,16201,0,4638,2868,722,6050,2050,395,2839,0,35763,204,13117,11067,6429,16201
2022-11-03 14:00:00+00,16114,0,4635,2526,757,5966,2053,473,2214,276,35014,208,12185,10132,5497,16114
2022-11-03 14:30:00+00,16372,0,4637,2535,788,5964,2052,470,1601,280,34699,213,11613,9561,4924,16372
2022-11-03 15:00:00+00,17126,0,4632,2210,800,5788,2138,492,1043,352,34581,222,10823,8685,4053,17126
2022-11-03 15:30:00+00,18274,0,4631,1973,797,5826,2186,478,398,386,34949,233,9985,7799,3168,18274
2022-11-03 16:00:00+00,18895,0,4634,1642,863,6418,2179,528,34,826,36019,235,9352,7173,2539,18895
2022-11-03 16:30:00+00,19826,0,4631,1691,876,6446,2188,703,0,1150,37511,237,9386,7198,2567,19826
2022-11-03 17:00:00+00,20586,0,4635,1810,920,6446,2192,849,0,1790,39228,236,9557,7365,2730,20586
2022-11-03 17:30:00+00,20601,0,4638,1986,943,6448,2181,826,0,1762,39386,235,9748,7568,2930,20601
2022-11-03 18:00:00+00,20250,0,4636,1988,955,6446,2204,756,0,1744,38979,234,9783,7579,2943,20250
2022-11-03 18:30:00+00,19785,0,4637,2072,957,6500,2209,553,0,1582,38295,232,9875,7666,3029,19785
2022-11-03 19:00:00+00,19914,0,4637,2009,954,6068,2209,407,0,976,37174,237,9809,7600,2963,19914
2022-11-03 19:30:00+00,19125,0,4643,2231,959,5914,2210,374,0,650,36106,233,10043,7833,3190,19125
2022-11-03 20:00:00+00,18740,0,4641,2091,916,5790,2208,227,0,348,34961,238,9856,7648,3007,18740
2022-11-03 20:30:00+00,18421,0,4641,1957,759,5652,2201,139,0,212,33982,239,9558,7357,2716,18421
2022-11-03 21:00:00+00,17570,0,4641,1944,732,5166,2196,130,0,18,32397,238,9513,7317,2676,17570
2022-11-03 21:30:00+00,15769,0,4640,2191,714,5136,2194,137,0,0,30781,228,9739,7545,2905,15769
2022-11-03 22:00:00+00,14462,0,4642,2573,702,4406,2188,140,0,44,29157,223,10105,7917,3275,14462
2022-11-03 22:30:00+00,12548,0,4636,2749,836,4434,2189,138,0,48,27578,208,10410,8221,3585,12548
2022-11-03 23:00:00+00,9671,0,4635,3113,775,5972,2191,131,0,0,26488,177,10714,8523,3888,9671
2022-11-03 23:30:00+00,7902,0,4636,3452,758,6154,2155,124,0,0,25181,159,11001,8846,4210,7902
2022-11-04 00:00:00+00,6662,0,4628,3796,759,6564,2180,128,0,0,24717,150,11363,9183,4555,6662
2022-11-04 00:30:00+00,6042,0,4632,4411,757,6651,2189,126,0,0,24808,141,11989,9800,5168,6042
2022-11-04 01:00:00+00,5942,0,4629,4757,756,5793,2193,141,0,0,24211,138,12335,10142,5513,5942
2022-11-04 01:30:00+00,5228,0,4631,5093,754,5652,2190,134,0,0,23682,127,12668,10478,5847,5228
2022-11-04 02:00:00+00,5932,0,4629,5399,635,4823,2190,135,0,0,23744,136,12853,10663,6034,5932
2022-11-04 02:30:00+00,5580,0,4635,5832,628,4789,2154,121,0,0,23739,130,13249,11095,6460,5580
2022-11-04 03:00:00+00,5916,0,4630,6597,598,3516,2187,123,0,0,23567,130,14012,11825,7195,5916
2022-11-04 03:30:00+00,5459,0,4635,7097,597,3498,2155,125,0,0,23566,122,14484,12329,7694,5459
2022-11-04 04:00:00+00,6382,0,4636,7480,597,2510,2189,135,0,0,23929,131,14902,12713,8077,6382
2022-11-04 04:30:00+00,5928,0,4642,8405,597,2480,2189,132,0,0,24373,121,15833,13644,9002,5928
2022-11-04 05:00:00+00,6168,0,4640,8838,699,2192,2194,143,0,0,24874,121,16371,14177,9537,6168
2022-11-04 05:30:00+00,6717,0,4641,9222,697,2334,2191,179,0,0,25981,127,16751,14560,9919,6717
2022-11-04 06:00:00+00,9775,0,4642,9616,822,1852,2195,133,0,0,29035,150,17275,15080,10438,9775
2022-11-04 06:30:00+00,12107,0,4641,9550,836,1770,2196,139,0,0,31239,168,17223,15027,10386,12107
2022-11-04 07:00:00+00,14280,0,4637,9629,880,1628,2195,168,12,202,33631,180,17353,15158,10521,14280
2022-11-04 07:30:00+00,14799,0,4642,9923,886,1592,2179,508,335,84,34948,182,17965,15786,11144,14799
2022-11-04 08:00:00+00,14805,0,4637,10176,893,2002,2184,396,1359,0,36452,176,19249,17065,12428,14805
2022-11-04 08:30:00+00,14737,0,4636,10290,911,2006,2194,239,2613,0,37626,168,20644,18450,13814,14737
2022-11-04 09:00:00+00,15491,0,4637,9657,896,1790,2228,136,3684,108,38627,170,21102,18874,14237,15491
2022-11-04 09:30:00+00,14649,0,4643,10054,898,1766,2233,123,4471,0,38837,161,22299,20066,15423,14649
2022-11-04 10:00:00+00,14091,0,4638,10844,848,1388,2225,138,5158,0,39330,150,23713,21488,16850,14091
2022-11-04 10:30:00+00,13874,0,4635,11246,843,1384,2180,160,5681,0,40003,146,24585,22405,17770,13874
2022-11-04 11:00:00+00,13918,0,4640,11524,811,1212,2148,128,5852,0,40233,145,24975,22827,18187,13918
2022-11-04 11:30:00+00,13340,0,4636,11675,807,1200,2147,150,5915,0,39870,141,25180,23033,18397,13340
2022-11-04 12:00:00+00,13379,0,4643,11879,800,1340,2095,135,5834,0,40105,141,25251,23156,18513,13379
2022-11-04 12:30:00+00,13708,0,4639,11704,759,1334,2103,142,5069,0,39458,147,24274,22171,17532,13708
2022-11-04 13:00:00+00,14716,0,4638,11250,731,1215,2126,149,4615,0,39440,156,23360,21234,16596,14716
2022-11-04 13:30:00+00,15239,0,4637,10602,685,1096,2148,161,3785,0,38353,165,21857,19709,15072,15239
2022-11-04 14:00:00+00,15785,0,4639,10494,695,1096,2165,166,3184,0,38224,171,21177,19012,14373,15785
2022-11-04 14:30:00+00,16617,0,4641,10182,704,1096,2118,148,2326,0,37832,181,19971,17853,13212,16617
2022-11-04 15:00:00+00,17655,0,4639,9788,757,1198,2051,180,1411,22,37701,194,18646,16595,11956,17655
2022-11-04 15:30:00+00,18587,0,4639,8962,804,1198,2022,552,480,458,37702,206,16907,14885,10246,18587
2022-11-04 16:00:00+00,19332,0,4642,8835,868,1096,2019,1031,45,240,38108,215,16409,14390,9748,19332
2022-11-04 16:30:00+00,19949,0,4634,9116,903,1096,2030,1330,0,820,39878,214,16683,14653,10019,19949
2022-11-04 17:00:00+00,19462,0,4632,8948,935,2040,2047,1159,0,1488,40711,210,16562,14515,9883,19462
2022-11-04 17:30:00+00,19982,0,4639,8447,935,2102,2025,1092,0,1404,40626,215,16046,14021,9382,19982
2022-11-04 18:00:00+00,20140,0,4634,8314,950,2081,2032,1052,0,1424,40627,216,15930,13898,9264,20140
2022-11-04 18:30:00+00,19563,0,4635,8792,921,2015,2030,799,0,1364,40119,211,16378,14348,9713,19563
2022-11-04 19:00:00+00,19279,0,4630,9178,904,1754,2031,451,0,520,38747,211,16743,14712,10082,19279
2022-11-04 19:30:00+00,18691,0,4631,9297,916,1756,1896,202,0,282,37671,208,16740,14844,10213,18691
2022-11-04 20:00:00+00,18060,0,4630,9399,897,1378,1837,140,0,370,36711,203,16763,14926,10296,18060
2022-11-04 20:30:00+00,16857,0,4633,9675,895,1484,1692,125,0,136,35497,197,16895,15203,10570,16857
2022-11-04 21:00:00+00,16319,0,4631,9355,857,1338,1569,145,0,204,34418,197,16412,14843,10212,16319
2022-11-04 21:30:00+00,15244,0,4631,8795,856,1472,1740,148,0,194,33080,194,16022,14282,9651,15244
2022-11-04 22:00:00+00,13612,0,4638,8410,855,2356,1631,138,0,228,31868,188,15534,13903,9265,13612
2022-11-04 22:30:00+00,12521,0,4638,8034,855,2430,1141,169,0,344,30132,184,14668,13527,8889,12521
2022-11-04 23:00:00+00,10190,0,4639,7565,637,3016,764,137,0,194,27142,172,13605,12841,8202,10190
2022-11-04 23:30:00+00,9822,0,4638,7219,635,2934,784,139,0,0,26171,171,13276,12492,7854,9822
2022-11-05 00:00:00+00,9816,0,4632,6452,635,2633,785,146,0,0,25099,175,12504,11719,7087,9816
2022-11-05 00:30:00+00,10053,0,4635,5901,635,2792,780,126,0,110,25032,182,11951,11171,6536,10053
2022-11-05 01:00:00+00,10284,0,4635,5458,634,2886,762,98,0,0,24757,188,11489,10727,6092,10284
2022-11-05 01:30:00+00,10125,0,4636,4969,634,2828,762,107,0,0,24061,190,11001,10239,5603,10125
2022-11-05 02:00:00+00,9689,0,4640,4815,632,3102,762,95,0,0,23735,189,10849,10087,5447,9689
2022-11-05 02:30:00+00,9469,0,4642,5059,631,3264,761,93,0,0,23919,187,11093,10332,5690,9469
2022-11-05 03:00:00+00,8540,0,4639,5371,619,3358,761,93,0,0,23381,178,11390,10629,5990,8540
2022-11-05 03:30:00+00,8174,0,4636,5506,619,3360,761,96,0,0,23152,174,11522,10761,6125,8174
2022-11-05 04:00:00+00,8358,0,4636,5303,617,3306,762,101,0,0,23083,176,11318,10556,5920,8358
2022-11-05 04:30:00+00,8385,0,4642,5109,616,3158,762,101,0,0,22773,177,11129,10367,5725,8385
2022-11-05 05:00:00+00,9409,0,4642,5419,693,2382,764,104,0,0,23413,180,11518,10754,6112,9409
2022-11-05 05:30:00+00,9311,0,4645,6082,715,2332,763,101,0,0,23949,173,12205,11442,6797,9311
2022-11-05 06:00:00+00,9651,0,4648,6387,755,2616,762,121,0,0,24940,174,12552,11790,7142,9651
2022-11-05 06:30:00+00,10352,0,4647,6699,758,2466,762,105,0,140,25929,175,12866,12104,7457,10352
2022-11-05 07:00:00+00,10004,0,4654,7561,782,2438,763,99,1,140,26442,170,13761,12998,8344,10004
2022-11-05 07:30:00+00,9797,0,4647,8597,778,2320,763,119,59,334,27414,160,14844,14081,9434,9797
2022-11-05 08:00:00+00,9714,0,4645,9076,776,3064,740,100,212,176,28503,153,15449,14709,10064,9714
2022-11-05 08:30:00+00,10317,0,4644,9753,757,2924,721,105,411,140,29772,151,16286,15565,10921,10317
2022-11-05 09:00:00+00,10478,0,4646,10719,725,2700,721,107,563,140,30799,145,17374,16653,12007,10478
2022-11-05 09:30:00+00,10485,0,4641,11395,725,2698,721,120,630,138,31553,142,18112,17391,12750,10485
2022-11-05 10:00:00+00,10752,0,4639,11833,700,3064,723,118,776,138,32743,145,18671,17948,13309,10752
2022-11-05 10:30:00+00,10891,0,4640,12036,699,3056,731,131,821,192,33197,145,18927,18196,13556,10891
2022-11-05 11:00:00+00,11190,0,4641,12419,685,2526,735,105,859,138,33298,143,19339,18604,13963,11190
2022-11-05 11:30:00+00,11433,0,4639,12527,687,2498,745,105,904,68,33606,144,19502,18757,14118,11433
2022-11-05 12:00:00+00,11130,0,4643,12808,687,2600,758,101,786,0,33513,141,19682,18924,14281,11130
2022-11-05 12:30:00+00,10973,0,4640,13061,688,2604,743,100,823,14,33646,138,19955,19212,14572,10973
2022-11-05 13:00:00+00,10830,0,4643,13456,690,2779,743,101,682,0,33924,134,20214,19471,14828,10830
2022-11-05 13:30:00+00,10458,0,4641,13500,699,2608,748,109,622,0,33385,130,20210,19462,14821,10458
2022-11-05 14:00:00+00,12289,0,4645,13295,697,1616,756,99,483,102,33982,148,19876,19120,14475,12289
2022-11-05 14:30:00+00,12356,0,4641,13439,699,1608,753,99,381,0,33976,149,19913,19160,14519,12356
2022-11-05 15:00:00+00,13288,0,4641,13195,715,1270,722,104,235,278,34448,156,19508,18786,14145,13288
2022-11-05 15:30:00+00,13728,0,4641,13060,716,1270,719,98,121,290,34643,160,19257,18538,13897,13728
2022-11-05 16:00:00+00,14255,0,4629,13048,746,1637,719,96,8,530,35668,163,19150,18431,13802,14255
2022-11-05 16:30:00+00,14739,0,4634,13009,745,1815,718,370,0,760,36790,167,19106,18388,13754,14739
2022-11-05 17:00:00+00,14322,0,4629,13013,810,2188,716,338,0,1436,37452,161,19168,18452,13823,14322
2022-11-05 17:30:00+00,14418,0,4637,13061,814,2232,717,333,0,1112,37324,162,19229,18512,13875,14418
2022-11-05 18:00:00+00,14374,0,4636,12955,791,2156,716,325,0,962,36915,164,19098,18382,13746,14374
2022-11-05 18:30:00+00,13768,0,4633,12719,794,2128,717,171,0,956,35886,160,18863,18146,13513,13768
2022-11-05 19:00:00+00,13862,0,4637,12603,793,2378,716,114,0,338,35441,166,18749,18033,13396,13862
2022-11-05 19:30:00+00,12602,0,4632,12424,793,2616,716,126,0,178,34087,162,18565,17849,13217,12602
2022-11-05 20:00:00+00,10837,0,4635,12193,760,3392,716,132,0,156,32821,151,18304,17588,12953,10837
2022-11-05 20:30:00+00,10140,0,4639,12360,752,3580,717,96,0,28,32312,147,18468,17751,13112,10140
2022-11-05 21:00:00+00,8612,0,4633,12368,727,3700,718,121,0,44,30923,136,18446,17728,13095,8612
2022-11-05 21:30:00+00,7940,0,4639,12234,724,3750,718,123,0,44,30172,132,18315,17597,12958,7940
2022-11-05 22:00:00+00,7111,0,4639,11762,712,3808,715,113,0,38,28898,126,17828,17113,12474,7111
2022-11-05 22:30:00+00,6924,0,4642,11063,712,3666,525,148,0,0,27680,126,16942,16417,11775,6924
2022-11-05 23:00:00+00,6447,0,4644,10570,710,2740,375,106,0,0,25592,120,16299,15924,11280,6447
2022-11-05 23:30:00+00,6049,0,4647,9958,709,2606,376,107,0,0,24452,116,15690,15314,10667,6049
2022-11-06 00:00:00+00,5593,0,4646,9497,708,2966,462,103,0,0,23975,112,15313,14851,10205,5593
2022-11-06 00:30:00+00,5785,0,4641,9127,708,3078,690,118,0,0,24147,118,15166,14476,9835,5785
2022-11-06 01:00:00+00,5532,0,4635,9023,705,2838,690,109,0,0,23532,116,15053,14363,9728,5532
2022-11-06 01:30:00+00,5064,0,4636,9127,702,2728,452,101,0,0,22810,108,14917,14465,9829,5064
2022-11-06 02:00:00+00,5041,0,4638,9166,689,2616,403,107,0,0,22660,107,14896,14493,9855,5041
2022-11-06 02:30:00+00,4806,0,4640,9167,687,2470,596,98,0,0,22464,102,15090,14494,9854,4806
2022-11-06 03:00:00+00,4672,0,4638,9245,687,2342,603,96,0,0,22283,101,15173,14570,9932,4672
2022-11-06 03:30:00+00,4529,0,4637,9427,690,2182,629,98,0,0,22192,95,15383,14754,10117,4529
2022-11-06 04:00:00+00,4237,0,4639,9712,687,2282,641,98,0,0,22296,94,15679,15038,10399,4237
2022-11-06 04:30:00+00,4180,0,4640,10202,667,2132,474,96,0,0,22391,89,15983,15509,10869,4180
2022-11-06 05:00:00+00,4110,0,4643,10349,600,2392,375,97,0,0,22566,90,15967,15592,10949,4110
2022-11-06 05:30:00+00,4098,0,4645,10529,586,2432,375,99,0,0,22764,89,16135,15760,11115,4098
2022-11-06 06:00:00+00,4120,0,4643,10526,619,2662,376,117,0,0,23063,89,16164,15788,11145,4120
2022-11-06 06:30:00+00,4027,0,4645,10980,637,2756,374,111,0,0,23530,87,16636,16262,11617,4027
2022-11-06 07:00:00+00,4048,0,4644,11183,654,3452,375,111,0,0,24467,85,16856,16481,11837,4048
2022-11-06 07:30:00+00,4172,0,4646,11612,648,3540,375,110,45,0,25148,85,17326,16951,12305,4172
2022-11-06 08:00:00+00,5048,0,4645,11993,631,3272,520,111,255,0,26475,92,18044,17524,12879,5048
2022-11-06 08:30:00+00,5478,0,4640,12238,663,3426,661,140,519,62,27827,97,18721,18060,13420,5478
2022-11-06 09:00:00+00,4979,0,4642,12052,671,4918,704,108,665,230,28969,87,18734,18030,13388,4979
2022-11-06 09:30:00+00,6191,0,4643,11931,717,5076,719,113,781,34,30205,100,18791,18072,13429,6191
2022-11-06 10:00:00+00,6024,0,4636,11477,610,6396,718,120,861,204,31046,96,18302,17584,12948,6024
2022-11-06 10:30:00+00,6225,0,4645,11687,740,6542,711,99,880,0,31529,98,18663,17952,13307,6225
2022-11-06 11:00:00+00,6602,0,4640,11657,764,6446,719,115,1087,46,32076,100,18867,18148,13508,6602
2022-11-06 11:30:00+00,7036,0,4638,11615,797,6426,719,125,1235,104,32695,103,19004,18285,13647,7036
2022-11-06 12:00:00+00,7626,0,4642,11146,803,6562,719,188,1500,108,33294,111,18810,18091,13449,7626
2022-11-06 12:30:00+00,7559,0,4640,11015,837,6662,717,277,1414,108,33229,112,18623,17906,13266,7559
2022-11-06 13:00:00+00,7166,0,4641,10926,823,6548,711,316,1597,264,32992,107,18698,17987,13346,7166
2022-11-06 13:30:00+00,6873,0,4636,10962,813,6536,711,299,1557,378,32765,104,18679,17968,13332,6873
2022-11-06 14:00:00+00,7283,0,4633,10746,672,6508,715,321,1161,286,32325,111,17927,17212,12579,7283
2022-11-06 14:30:00+00,8522,0,4641,10241,673,6490,714,185,1076,208,32750,123,17345,16631,11990,8522
2022-11-06 15:00:00+00,9078,0,4637,10424,709,6218,715,156,502,0,32439,129,16987,16272,11635,9078
2022-11-06 15:30:00+00,9104,0,4640,10977,725,6366,715,160,338,0,33025,130,17395,16680,12040,9104
2022-11-06 16:00:00+00,9415,0,4636,10961,783,6476,715,208,34,564,33792,132,17129,16414,11778,9415
2022-11-06 16:30:00+00,9991,0,4640,11531,795,6584,711,617,0,670,35539,137,17677,16966,12326,9991
2022-11-06 17:00:00+00,9969,0,4637,12673,870,6210,745,774,0,1032,36910,130,18925,18180,13543,9969
2022-11-06 17:30:00+00,9366,0,4637,12616,979,6084,829,816,0,1196,36523,124,19061,18232,13595,9366
2022-11-06 18:00:00+00,9363,0,4640,13032,977,5232,847,723,0,952,35765,127,19496,18649,14009,9363
2022-11-06 18:30:00+00,9296,0,4632,13981,973,5094,862,406,0,950,36194,121,20448,19586,14954,9296
2022-11-06 19:00:00+00,9171,0,4638,13979,970,4602,862,373,0,570,35164,125,20449,19587,14949,9171
2022-11-06 19:30:00+00,8864,0,4638,13766,981,4480,862,280,0,462,34333,122,20247,19385,14747,8864
2022-11-06 20:00:00+00,8569,0,4638,14592,695,4920,716,258,0,102,34489,119,20641,19925,15287,8569
2022-11-06 20:30:00+00,7931,0,4635,14974,713,4978,619,248,0,0,34098,113,20941,20322,15687,7931
2022-11-06 21:00:00+00,7236,0,4637,14904,612,4570,651,280,0,0,32890,107,20804,20153,15516,7236
2022-11-06 21:30:00+00,6186,0,4643,14854,514,4362,662,244,0,0,31465,97,20673,20011,15368,6186
2022-11-06 22:00:00+00,5170,0,4640,14795,582,3614,648,176,0,0,29625,91,20665,20017,15377,5170
2022-11-06 22:30:00+00,4270,0,4646,14760,555,3548,577,99,0,0,28455,80,20538,19961,15315,4270
2022-11-06 23:00:00+00,3632,0,4641,14897,661,2002,534,174,0,0,26541,68,20733,20199,15558,3632
2022-11-06 23:30:00+00,3277,0,4645,15015,641,2064,524,103,0,0,26268,65,20825,20301,15656,3277
2022-11-07 00:00:00+00,3332,0,4642,15066,613,1766,525,115,0,0,26059,65,20846,20320,15678,3332
2022-11-07 00:30:00+00,3480,0,4640,15001,537,1852,526,110,0,0,26146,68,20704,20178,15538,3480
2022-11-07 01:00:00+00,3475,0,4641,14958,478,2098,525,101,0,0,26276,66,20602,20077,15436,3475
2022-11-07 01:30:00+00,3356,0,4636,14824,453,2094,524,101,0,0,25988,65,20437,19913,15277,3356
2022-11-07 02:00:00+00,3369,0,4637,14970,438,1844,526,108,0,0,25891,64,20571,20045,15408,3369
2022-11-07 02:30:00+00,3413,0,4637,15034,431,1830,523,96,0,0,25964,64,20625,20102,15465,3413
2022-11-07 03:00:00+00,3468,0,4636,15150,423,1650,529,109,0,0,25964,66,20738,20209,15573,3468
2022-11-07 03:30:00+00,3435,0,4634,15114,422,1666,543,100,0,0,25914,66,20713,20170,15536,3435
2022-11-07 04:00:00+00,3666,0,4635,15044,435,1664,578,109,0,0,26131,70,20692,20114,15479,3666
2022-11-07 04:30:00+00,3936,0,4637,15059,433,1676,643,96,0,0,26480,73,20772,20129,15492,3936
2022-11-07 05:00:00+00,4074,0,4633,15024,433,1692,759,102,0,0,26717,75,20849,20090,15457,4074
2022-11-07 05:30:00+00,4312,0,4638,15298,579,1852,832,101,0,0,27612,79,21347,20515,15877,4312
2022-11-07 06:00:00+00,5338,0,4639,15446,628,1748,1087,162,0,0,29048,89,21800,20713,16074,5338
2022-11-07 06:30:00+00,7051,0,4635,15588,654,1686,1637,155,0,0,31406,105,22514,20877,16242,7051
2022-11-07 07:00:00+00,8558,0,4635,15889,713,1810,1976,133,0,0,33714,114,23213,21237,16602,8558
2022-11-07 07:30:00+00,9391,0,4634,16239,716,1850,2158,137,65,0,35190,119,23812,21654,17020,9391
2022-11-07 08:00:00+00,9580,0,4635,16877,694,2140,2156,107,210,202,36601,115,24572,22416,17781,9580
2022-11-07 08:30:00+00,9621,0,4636,17186,656,2120,2163,122,374,214,37092,113,25015,22852,18216,9621
2022-11-07 09:00:00+00,9454,0,4634,17388,664,2450,2162,112,569,184,37617,111,25417,23255,18621,9454
2022-11-07 09:30:00+00,9280,0,4632,17909,763,2470,2160,123,709,0,38046,109,26173,24013,19381,9280
2022-11-07 10:00:00+00,9810,0,4631,17790,749,2502,2023,204,807,138,38654,112,26000,23977,19346,9810
2022-11-07 10:30:00+00,10047,0,4630,18082,704,2502,1667,223,970,138,38963,113,26053,24386,19756,10047
2022-11-07 11:00:00+00,10147,0,4630,18315,584,2600,1554,125,1031,0,38986,113,26114,24560,19930,10147
2022-11-07 11:30:00+00,10167,0,4630,18425,556,2682,1562,118,1075,0,39215,114,26248,24686,20056,10167
2022-11-07 12:00:00+00,10145,0,4633,18518,482,2838,1566,100,1087,0,39369,115,26286,24720,20087,10145
2022-11-07 12:30:00+00,10010,0,4625,18329,418,2794,1658,106,1200,0,39140,114,26230,24572,19947,10010
2022-11-07 13:00:00+00,10742,0,4630,18404,404,1944,2101,107,973,110,39415,120,26512,24411,19781,10742
2022-11-07 13:30:00+00,10731,0,4628,18275,377,1976,2158,102,827,0,39074,122,26265,24107,19479,10731
2022-11-07 14:00:00+00,11163,0,4631,18190,384,1772,2070,103,655,0,38968,128,25930,23860,19229,11163
2022-11-07 14:30:00+00,11282,0,4629,17814,390,1742,1898,113,467,0,38335,131,25198,23300,18671,11282
2022-11-07 15:00:00+00,11712,0,4633,17442,393,1630,2045,113,258,218,38444,134,24771,22726,18093,11712
2022-11-07 15:30:00+00,11964,0,4634,18102,453,1686,2104,105,80,232,39360,134,25373,23269,18635,11964
2022-11-07 16:00:00+00,11671,0,4638,18574,527,1720,2075,149,3,408,39765,130,25817,23742,19104,11671
2022-11-07 16:30:00+00,11843,0,4634,18908,546,1794,1769,431,0,1042,40967,130,25857,24088,19454,11843
2022-11-07 17:00:00+00,12010,0,4638,19196,543,1760,1845,730,0,1090,41812,129,26222,24377,19739,12010
2022-11-07 17:30:00+00,11894,0,4635,19323,517,1568,2080,698,0,1144,41859,126,26555,24475,19840,11894
2022-11-07 18:00:00+00,11417,0,4637,19614,483,2110,2003,497,0,1118,41879,121,26737,24734,20097,11417
2022-11-07 18:30:00+00,11117,0,4635,19278,450,2000,2056,307,0,954,40797,118,26419,24363,19728,11117
2022-11-07 19:00:00+00,11675,0,4636,19219,422,1640,2176,258,0,124,40150,124,26453,24277,19641,11675
2022-11-07 19:30:00+00,10976,0,4639,19209,421,1580,2170,206,0,0,39201,119,26439,24269,19630,10976
2022-11-07 20:00:00+00,9780,0,4637,19394,411,1096,2172,214,0,0,37704,111,26614,24442,19805,9780
2022-11-07 20:30:00+00,8407,0,4633,19354,405,1096,2179,227,0,0,36301,100,26571,24392,19759,8407
2022-11-07 21:00:00+00,6728,0,4634,19135,387,1620,2146,177,0,0,34827,89,26302,24156,19522,6728
2022-11-07 21:30:00+00,5618,0,4632,19020,386,1664,1857,126,0,0,33303,78,25895,24038,19406,5618
2022-11-07 22:00:00+00,4946,0,4634,18745,389,1704,1254,104,0,0,31776,71,25022,23768,19134,4946
2022-11-07 22:30:00+00,4922,0,4636,18357,403,1692,736,78,0,0,30824,71,24132,23396,18760,4922
2022-11-07 23:00:00+00,5170,0,4641,18260,409,694,585,83,0,0,29842,72,23895,23310,18669,5170
2022-11-07 23:30:00+00,4646,0,4641,18168,399,622,589,109,0,0,29174,67,23797,23208,18567,4646
2022-11-08 00:00:00+00,4804,0,4640,18031,399,346,603,82,0,0,28905,70,23673,23070,18430,4804
2022-11-08 00:30:00+00,5083,0,4644,18185,399,312,591,78,0,0,29292,72,23819,23228,18584,5083
2022-11-08 01:00:00+00,4731,0,4642,17734,391,388,612,114,0,0,28612,70,23379,22767,18125,4731
2022-11-08 01:30:00+00,4321,0,4641,17446,390,382,710,98,0,0,27988,66,23187,22477,17836,4321
2022-11-08 02:00:00+00,4240,0,4639,17391,373,138,593,90,0,0,27464,64,22996,22403,17764,4240
2022-11-08 02:30:00+00,4418,0,4639,16970,375,140,589,87,0,0,27218,68,22573,21984,17345,4418
2022-11-08 03:00:00+00,5164,0,4637,16684,378,304,592,88,0,0,27847,77,22291,21699,17062,5164
2022-11-08 03:30:00+00,5131,0,4639,16442,378,330,593,92,0,0,27605,77,22052,21459,16820,5131
2022-11-08 04:00:00+00,4996,0,4639,16513,377,674,592,99,0,0,27890,74,22121,21529,16890,4996
2022-11-08 04:30:00+00,5102,0,4638,16217,377,716,592,100,0,0,27742,76,21824,21232,16594,5102
2022-11-08 05:00:00+00,4779,0,4636,15958,390,1144,644,119,0,0,27670,74,21628,20984,16348,4779
2022-11-08 05:30:00+00,5508,0,4638,15693,396,1414,808,78,0,0,28535,86,21535,20727,16089,5508
2022-11-08 06:00:00+00,5710,0,4639,15730,510,1802,689,154,0,0,29234,91,21568,20879,16240,5710
2022-11-08 06:30:00+00,6250,0,4634,16099,470,1944,593,207,0,0,30198,97,21796,21203,16569,6250
2022-11-08 07:00:00+00,6790,0,4634,16233,457,3002,375,219,0,0,31710,105,21699,21324,16690,6790
2022-11-08 07:30:00+00,7233,0,4633,16650,628,3058,290,330,120,110,33052,106,22320,22030,17398,7233
2022-11-08 08:00:00+00,7042,0,4634,16772,525,4048,290,251,572,400,34534,100,22793,22503,17869,7042
2022-11-08 08:30:00+00,6971,0,4636,16774,544,4016,289,215,1178,630,35253,96,23421,23132,18496,6971
2022-11-08 09:00:00+00,7017,0,4631,16960,546,3520,288,167,1857,482,35468,94,24282,23994,19363,7017
2022-11-08 09:30:00+00,6522,0,4634,17444,541,3456,289,101,2480,480,35947,86,25388,25099,20465,6522
2022-11-08 10:00:00+00,6682,0,4629,17822,557,3450,288,112,2770,618,36928,86,26066,25778,21149,6682
2022-11-08 10:30:00+00,6304,0,4625,18477,476,3478,286,116,2785,384,36931,82,26649,26363,21738,6304
2022-11-08 11:00:00+00,6109,0,4627,18955,451,3100,286,97,3066,126,36817,77,27385,27099,22472,6109
2022-11-08 11:30:00+00,6270,0,4628,18938,435,3048,285,122,3035,0,36761,79,27321,27036,22408,6270
2022-11-08 12:00:00+00,7243,0,4628,18833,485,2694,282,115,2464,0,36744,89,26692,26410,21782,7243
2022-11-08 12:30:00+00,7592,0,4628,19095,470,2708,275,105,2240,0,37113,92,26708,26433,21805,7592
2022-11-08 13:00:00+00,8763,0,4629,18921,483,2050,261,115,2072,0,37294,103,26366,26105,21476,8763
2022-11-08 13:30:00+00,9593,0,4632,18446,489,1806,270,110,1816,0,37162,110,25653,25383,20751,9593
2022-11-08 14:00:00+00,9841,0,4636,18105,583,1642,282,107,1696,0,36892,114,25302,25020,20384,9841
2022-11-08 14:30:00+00,10071,0,4636,18187,597,1506,279,109,1260,0,36645,115,24959,24680,20044,10071
2022-11-08 15:00:00+00,10123,0,4640,18442,593,1514,284,100,715,486,36897,115,24674,24390,19750,10123
2022-11-08 15:30:00+00,11075,0,4638,18403,515,1572,283,112,312,626,37536,124,24151,23868,19230,11075
2022-11-08 16:00:00+00,11898,0,4638,18102,548,1754,286,362,15,712,38315,130,23589,23303,18665,11898
2022-11-08 16:30:00+00,12647,0,4636,17766,662,1780,291,638,0,994,39414,137,23355,23064,18428,12647
2022-11-08 17:00:00+00,12564,0,4640,17788,833,2390,291,962,0,1296,40764,134,23552,23260,18620,12564
2022-11-08 17:30:00+00,12538,0,4638,17777,869,2352,292,999,0,1374,40839,133,23576,23284,18646,12538
2022-11-08 18:00:00+00,12205,0,4635,17622,867,2288,291,730,0,1446,40084,131,23415,23124,18489,12205
2022-11-08 18:30:00+00,11654,0,4635,17673,868,2298,291,524,0,1438,39381,126,23467,23176,18541,11654
2022-11-08 19:00:00+00,10448,0,4636,17616,716,2896,292,210,0,1118,37932,118,23260,22968,18332,10448
2022-11-08 19:30:00+00,9805,0,4638,17455,708,2906,293,121,0,786,36712,114,23094,22801,18163,9805
2022-11-08 20:00:00+00,9540,0,4638,17260,626,2890,294,121,0,722,36091,115,22818,22524,17886,9540
2022-11-08 20:30:00+00,8755,0,4637,17154,640,2896,295,115,0,544,35036,110,22726,22431,17794,8755
2022-11-08 21:00:00+00,7582,0,4637,16956,612,3374,295,114,0,68,33638,104,22500,22205,17568,7582
2022-11-08 21:30:00+00,6271,0,4636,16900,545,3466,297,105,0,76,32296,94,22378,22081,17445,6271
2022-11-08 22:00:00+00,5605,0,4636,16899,470,2998,371,109,0,0,31088,87,22376,22005,17369,5605
2022-11-08 22:30:00+00,4434,0,4638,16600,464,2852,472,135,0,0,29595,74,22174,21702,17064,4434
2022-11-08 23:00:00+00,4136,0,4640,16413,433,2308,610,131,0,0,28671,69,22096,21486,16846,4136
2022-11-08 23:30:00+00,4082,0,4656,16272,432,2164,614,115,0,0,28335,66,21974,21360,16704,4082
2022-11-09 00:00:00+00,4051,0,4645,16115,433,1760,616,136,0,0,27756,65,21809,21193,16548,4051
2022-11-09 00:30:00+00,4122,0,4645,16126,431,1804,619,125,0,0,27872,67,21821,21202,16557,4122
2022-11-09 01:00:00+00,4160,0,4641,16057,402,1562,619,134,0,0,27575,67,21719,21100,16459,4160
2022-11-09 01:30:00+00,4051,0,4641,15966,400,1530,618,131,0,0,27338,66,21626,21008,16366,4051
2022-11-09 02:00:00+00,3971,0,4640,15726,399,1770,617,125,0,0,27248,65,21382,20765,16125,3971
2022-11-09 02:30:00+00,3970,0,4635,15602,399,1778,617,128,0,0,27129,66,21253,20636,16001,3970
2022-11-09 03:00:00+00,3957,0,4633,15360,398,1668,619,129,0,0,26764,66,21010,20391,15758,3957
2022-11-09 03:30:00+00,4005,0,4631,15216,399,1668,617,135,0,0,26671,67,20863,20246,15615,4005
2022-11-09 04:00:00+00,4238,0,4635,15312,397,1280,653,123,0,0,26638,68,20997,20344,15709,4238
2022-11-09 04:30:00+00,4196,0,4629,15272,397,1312,705,123,0,0,26634,68,21003,20298,15669,4196
2022-11-09 05:00:00+00,4293,0,4632,15166,409,1394,770,131,0,0,26795,70,20977,20207,15575,4293
2022-11-09 05:30:00+00,5102,0,4629,14918,411,1416,962,128,0,0,27566,81,20920,19958,15329,5102
2022-11-09 06:00:00+00,6980,0,4628,14861,629,1516,1147,135,0,150,30046,103,21265,20118,15490,6980
2022-11-09 06:30:00+00,8976,0,4629,15076,577,1404,1358,139,0,162,32321,119,21640,20282,15653,8976
2022-11-09 07:00:00+00,9772,0,4635,15593,594,1864,1492,151,0,328,34429,124,22314,20822,16187,9772
2022-11-09 07:30:00+00,10458,0,4631,15853,567,1882,1662,242,95,396,35786,129,22808,21146,16515,10458
2022-11-09 08:00:00+00,10178,0,4633,16028,546,2152,1690,203,588,430,36448,123,23485,21795,17162,10178
2022-11-09 08:30:00+00,9856,0,4633,16190,558,2152,1689,134,1567,430,37209,117,24637,22948,18315,9856
2022-11-09 09:00:00+00,9931,0,4634,16503,574,1990,1679,144,2377,372,38204,114,25767,24088,19454,9931
2022-11-09 09:30:00+00,9365,0,4638,16885,521,1990,1623,126,3285,0,38433,107,26952,25329,20691,9365
2022-11-09 10:00:00+00,9649,0,4635,17111,475,1968,1652,132,3711,0,39333,108,27584,25932,21297,9649
2022-11-09 10:30:00+00,9626,0,4636,17037,479,1966,1584,123,4093,0,39544,107,27829,26245,21609,9626
2022-11-09 11:00:00+00,9656,0,4635,17191,481,1430,1591,125,4225,0,39334,105,28123,26532,21897,9656
2022-11-09 11:30:00+00,9441,0,4632,17213,481,1356,1658,146,4314,6,39247,103,28298,26640,22008,9441
2022-11-09 12:00:00+00,9620,0,4635,17115,486,1150,1846,127,4070,2,39051,104,28152,26306,21671,9620
2022-11-09 12:30:00+00,9644,0,4633,17201,487,1164,1905,137,3695,0,38866,106,27921,26016,21383,9644
2022-11-09 13:00:00+00,10103,0,4638,17030,499,1318,1945,167,3597,0,39297,111,27709,25764,21126,10103
2022-11-09 13:30:00+00,10359,1,4632,16636,494,1310,1957,147,3091,34,38660,115,26810,24853,20221,10360
2022-11-09 14:00:00+00,11568,1,4636,16245,494,1402,1954,157,2765,0,39222,127,26094,24140,19504,11569
2022-11-09 14:30:00+00,12633,18,4632,15895,506,1300,1950,168,1887,66,39055,138,24870,22920,18288,12651
2022-11-09 15:00:00+00,13256,43,4637,15760,516,1268,1976,136,1038,662,39292,143,23927,21951,17314,13299
2022-11-09 15:30:00+00,13906,149,4634,15519,524,1488,1985,134,323,936,39598,154,22985,21000,16366,14055
2022-11-09 16:00:00+00,14491,227,4638,15301,568,1640,1985,469,13,1194,40526,162,22505,20520,15882,14718
2022-11-09 16:30:00+00,14841,229,4634,15651,583,1754,1991,1052,0,1546,42281,164,22859,20868,16234,15070
2022-11-09 17:00:00+00,14867,231,4638,16126,583,1612,1986,1176,0,1526,42745,162,23333,21347,16709,15098
2022-11-09 17:30:00+00,15190,229,4638,16244,564,1630,1990,1121,0,1136,42742,164,23436,21446,16808,15419
2022-11-09 18:00:00+00,15146,230,4634,16479,552,1744,1993,668,0,1400,42846,162,23658,21665,17031,15376
2022-11-09 18:30:00+00,15144,230,4638,16577,559,1686,1984,380,0,1392,42590,160,23758,21774,17136,15374
2022-11-09 19:00:00+00,15165,231,4634,16385,558,1852,1897,258,0,602,41582,165,23474,21577,16943,15396
2022-11-09 19:30:00+00,13881,231,4639,16877,553,1792,1831,191,0,208,40203,156,23900,22069,17430,14112
2022-11-09 20:00:00+00,12681,229,4631,17057,535,1836,1747,196,0,256,39168,149,23970,22223,17592,12910
2022-11-09 20:30:00+00,11429,189,4632,17428,531,1934,1878,190,0,144,38355,140,24469,22591,17959,11618
2022-11-09 21:00:00+00,10060,94,4635,17405,530,1982,1929,186,0,0,36822,129,24499,22570,17935,10154
2022-11-09 21:30:00+00,8981,0,4636,17367,506,2000,1881,112,0,0,35483,119,24390,22509,17873,8981
2022-11-09 22:00:00+00,7606,0,4636,16921,480,2000,1928,128,0,0,33699,109,23965,22037,17401,7606
2022-11-09 22:30:00+00,6269,0,4634,16680,465,1992,2032,141,0,0,32213,98,23811,21779,17145,6269
2022-11-09 23:00:00+00,4754,0,4637,16718,465,2000,2104,145,0,0,30823,84,23924,21820,17183,4754
2022-11-09 23:30:00+00,4028,0,4643,16358,452,1968,2161,118,0,0,29728,77,23614,21453,16810,4028
2022-11-10 00:00:00+00,4268,0,4640,16331,425,2000,2222,105,0,0,29991,80,23618,21396,16756,4268
2022-11-10 00:30:00+00,4389,0,4639,16390,414,2000,2242,120,0,0,30194,81,23685,21443,16804,4389
2022-11-10 01:00:00+00,4370,0,4641,16468,405,2000,2216,107,0,0,30207,81,23730,21514,16873,4370
2022-11-10 01:30:00+00,3814,0,4636,16646,413,1962,1962,105,0,0,29538,74,23657,21695,17059,3814
2022-11-10 02:00:00+00,3845,0,4632,16665,415,1574,1682,108,0,0,28921,75,23394,21712,17080,3845
2022-11-10 02:30:00+00,4049,0,4641,16492,420,1330,1385,103,0,0,28420,75,22938,21553,16912,4049
2022-11-10 03:00:00+00,4162,0,4632,16608,442,878,1309,108,0,0,28139,75,22991,21682,17050,4162
2022-11-10 03:30:00+00,4172,0,4633,16201,443,782,1329,122,0,0,27682,76,22606,21277,16644,4172
2022-11-10 04:00:00+00,4166,0,4630,16159,444,768,1376,120,0,0,27663,76,22609,21233,16603,4166
2022-11-10 04:30:00+00,4164,0,4635,16349,437,776,1534,101,0,0,27996,76,22955,21421,16786,4164
2022-11-10 05:00:00+00,4213,0,4631,16506,443,1302,1471,118,0,0,28684,76,23051,21580,16949,4213
2022-11-10 05:30:00+00,4678,0,4634,16638,448,1538,1566,104,0,0,29606,83,23286,21720,17086,4678
2022-11-10 06:00:00+00,5354,0,4628,17119,472,1962,2042,151,0,0,31728,89,24261,22219,17591,5354
2022-11-10 06:30:00+00,6810,0,4627,17021,495,2000,2240,167,0,0,33360,103,24383,22143,17516,6810
2022-11-10 07:00:00+00,8934,0,4631,17116,546,2000,2241,129,0,0,35597,119,24534,22293,17662,8934
2022-11-10 07:30:00+00,10374,0,4635,17212,582,1958,2234,203,58,24,37280,129,24721,22487,17852,10374
2022-11-10 08:00:00+00,10407,0,4633,17216,613,2000,2243,236,241,498,38087,128,24946,22703,18070,10407
2022-11-10 08:30:00+00,10244,0,4637,17695,623,1958,2247,160,552,492,38608,123,25754,23507,18870,10244
2022-11-10 09:00:00+00,9275,0,4640,18193,666,1778,2242,169,899,344,38206,112,26640,24398,19758,9275
2022-11-10 09:30:00+00,9312,0,4637,18350,626,1666,2249,158,1169,420,38587,110,27031,24782,20145,9312
2022-11-10 10:00:00+00,9570,0,4644,18722,594,1563,2265,162,1233,136,38889,111,27458,25193,20549,9570
2022-11-10 10:30:00+00,9704,0,4639,18780,595,1542,2292,138,1207,224,39121,111,27513,25221,20582,9704
2022-11-10 11:00:00+00,9574,0,4640,18735,614,1622,2295,134,1164,230,39008,111,27448,25153,20513,9574
2022-11-10 11:30:00+00,9668,0,4636,18855,610,1610,2298,135,1172,52,39036,111,27571,25273,20637,9668
2022-11-10 12:00:00+00,9660,0,4643,19407,729,1740,2297,125,1245,0,39846,110,28321,26024,21381,9660
2022-11-10 12:30:00+00,9613,0,4637,19413,721,1702,2295,125,1041,0,39547,110,28107,25812,21175,9613
2022-11-10 13:00:00+00,10131,5,4638,19536,642,1748,2311,130,982,138,40261,114,28109,25798,21160,10136
2022-11-10 13:30:00+00,10286,10,4636,19603,653,1640,2335,127,777,0,40067,116,28004,25669,21033,10296
2022-11-10 14:00:00+00,10316,16,4637,19505,585,1760,2347,131,592,134,40023,118,27666,25319,20682,10332
2022-11-10 14:30:00+00,10630,21,4640,19443,588,1766,2366,128,438,0,40020,121,27475,25109,20469,10651
2022-11-10 15:00:00+00,10437,26,4637,19274,610,1720,2355,131,183,224,39597,120,27059,24704,20067,10463
2022-11-10 15:30:00+00,10863,183,4637,19162,615,1706,2348,138,32,538,40222,126,26794,24446,19809,11046
2022-11-10 16:00:00+00,11682,230,4638,19140,662,1554,2324,293,0,658,41181,131,26764,24440,19802,11912
2022-11-10 16:30:00+00,12294,285,4637,19287,680,1658,2312,456,0,812,42421,136,26916,24604,19967,12579
2022-11-10 17:00:00+00,12045,282,4639,19542,694,1619,2304,553,0,644,42322,134,27179,24875,20236,12327
2022-11-10 17:30:00+00,11851,230,4635,19514,676,1590,2311,595,0,900,42303,131,27136,24825,20190,12081
2022-11-10 18:00:00+00,11605,229,4640,19577,633,1563,2313,567,0,820,41947,129,27163,24850,20210,11834
2022-11-10 18:30:00+00,10736,229,4633,19639,623,1592,2320,349,0,894,41015,122,27215,24895,20262,10965
2022-11-10 19:00:00+00,9919,230,4635,19793,621,1812,2317,281,0,802,40410,118,27366,25049,20414,10149
2022-11-10 19:30:00+00,9367,230,4638,19491,598,1849,2304,212,0,686,39375,115,27031,24727,20089,9597
2022-11-10 20:00:00+00,8286,230,4636,19122,587,2016,2296,174,0,572,37919,110,26641,24345,19709,8516
2022-11-10 20:30:00+00,7356,230,4634,18855,585,2101,2290,158,0,404,36613,105,26364,24074,19440,7586
2022-11-10 21:00:00+00,6154,126,4631,18698,569,2286,2286,153,0,0,34903,96,26184,23898,19267,6280
2022-11-10 21:30:00+00,5010,0,4635,18582,591,2354,2269,145,0,0,33586,83,26077,23808,19173,5010
2022-11-10 22:00:00+00,4753,0,4631,18224,587,1979,2279,139,0,0,32592,78,25721,23442,18811,4753
2022-11-10 22:30:00+00,4676,0,4634,17692,584,1660,2267,129,0,0,31642,76,25177,22910,18276,4676
2022-11-10 23:00:00+00,4731,0,4630,17139,562,1580,2284,170,0,0,31096,78,24615,22331,17701,4731
2022-11-10 23:30:00+00,4405,0,4632,17171,523,1324,2289,133,0,0,30477,71,24615,22326,17694,4405
2022-11-11 00:00:00+00,4022,0,4636,17653,525,804,2279,136,0,0,30055,64,25093,22814,18178,4022
2022-11-11 00:30:00+00,4045,0,4632,17905,526,774,2282,145,0,0,30309,64,25345,23063,18431,4045
2022-11-11 01:00:00+00,4003,0,4636,17922,525,520,2277,140,0,0,30023,66,25360,23083,18447,4003
2022-11-11 01:30:00+00,3935,0,4636,17885,514,384,2243,122,0,0,29719,64,25278,23035,18399,3935
2022-11-11 02:00:00+00,3963,0,4635,17381,500,280,2271,126,0,0,29156,68,24787,22516,17881,3963
2022-11-11 02:30:00+00,3934,0,4642,17315,502,212,2245,123,0,0,28973,67,24704,22459,17817,3934
2022-11-11 03:00:00+00,3923,0,4635,17053,515,314,2257,134,0,0,28831,69,24460,22203,17568,3923
2022-11-11 03:30:00+00,3940,0,4636,16665,518,334,2257,133,0,0,28483,71,24076,21819,17183,3940
2022-11-11 04:00:00+00,3946,0,4640,16379,519,346,2264,123,0,0,28217,69,23802,21538,16898,3946
2022-11-11 04:30:00+00,3961,0,4639,16097,519,324,2264,133,0,0,27937,69,23519,21255,16616,3961
2022-11-11 05:00:00+00,4197,0,4635,16217,519,662,2272,136,0,0,28638,70,23643,21371,16736,4197
2022-11-11 05:30:00+00,4519,0,4636,16550,521,880,2262,135,0,0,29503,74,23969,21707,17071,4519
2022-11-11 06:00:00+00,4704,0,4642,16863,554,1478,2244,144,0,0,30629,77,24303,22059,17417,4704
2022-11-11 06:30:00+00,5490,0,4640,17511,554,1798,2258,156,0,0,32407,87,24963,22705,18065,5490
2022-11-11 07:00:00+00,7112,0,4636,17903,588,1966,2267,168,0,216,34856,101,25394,23127,18491,7112
2022-11-11 07:30:00+00,8182,0,4642,17903,589,2000,2254,239,19,314,36142,110,25407,23153,18511,8182
2022-11-11 08:00:00+00,8340,0,4640,18201,672,1942,2269,214,111,628,37017,108,25893,23624,18984,8340
2022-11-11 08:30:00+00,8268,0,4640,18512,759,1934,2275,207,231,446,37272,107,26417,24142,19502,8268
2022-11-11 09:00:00+00,8290,0,4629,18669,760,1850,2275,176,433,582,37664,104,26766,24491,19862,8290
2022-11-11 09:30:00+00,8146,0,4630,19194,759,1730,2280,142,672,404,37957,100,27535,25255,20625,8146
2022-11-11 10:00:00+00,7818,0,4629,19413,759,1966,2276,150,952,184,38147,96,28029,25753,21124,7818
2022-11-11 10:30:00+00,7664,0,4635,19472,729,1994,2272,129,1224,70,38189,94,28332,26060,21425,7664
2022-11-11 11:00:00+00,7825,0,4634,19410,706,1749,2241,141,1369,72,38147,96,28360,26119,21485,7825
2022-11-11 11:30:00+00,8039,0,4635,19245,728,1834,2201,133,1633,92,38540,99,28442,26241,21606,8039
2022-11-11 12:00:00+00,8409,0,4637,19104,727,1817,2179,129,1867,84,38953,101,28514,26335,21698,8409
2022-11-11 12:30:00+00,8498,1,4636,18969,581,1676,2152,130,1901,138,38682,101,28239,26087,21451,8499
2022-11-11 13:00:00+00,8236,2,4637,18999,690,1942,2096,141,1889,16,38648,101,28311,26215,21578,8238
2022-11-11 13:30:00+00,8248,93,4637,18848,699,1750,2044,141,1797,0,38257,102,28025,25981,21344,8341
2022-11-11 14:00:00+00,8025,229,4638,18551,589,1702,2039,135,1592,28,37528,103,27409,25370,20732,8254
2022-11-11 14:30:00+00,8462,229,4638,18292,604,1412,2043,157,1095,24,36956,106,26672,24629,19991,8691
2022-11-11 15:00:00+00,9379,229,4639,18054,606,1268,2053,139,593,202,37162,113,25945,23892,19253,9608
2022-11-11 15:30:00+00,10674,229,4638,17905,614,1294,2053,130,152,240,37929,125,25362,23309,18671,10903
2022-11-11 16:00:00+00,12114,326,4638,17875,724,1272,2056,212,3,728,39948,135,25296,23240,18602,12440
2022-11-11 16:30:00+00,12865,462,4639,17989,787,1250,2050,595,0,1142,41779,142,25465,23415,18776,13327
2022-11-11 17:00:00+00,12612,277,4632,17774,794,1228,2071,740,0,1510,41638,137,25271,23200,18568,12889
2022-11-11 17:30:00+00,12848,230,4639,17525,806,1206,2066,694,0,1520,41534,138,25036,22970,18331,13078
2022-11-11 18:00:00+00,13400,230,4634,16828,802,1184,2068,685,0,1468,41299,144,24332,22264,17630,13630
2022-11-11 18:30:00+00,13320,230,4639,16416,800,1162,2067,524,0,1018,40176,146,23922,21855,17216,13550
2022-11-11 19:00:00+00,13337,231,4631,15942,802,1140,2080,415,0,956,39534,148,23455,21375,16744,13568
2022-11-11 19:30:00+00,13433,230,4633,15036,802,1118,2071,426,0,750,38499,153,22542,20471,15838,13663
2022-11-11 20:00:00+00,13754,243,4630,14442,800,1096,2070,439,0,584,38058,159,21942,19872,15242,13997
2022-11-11 20:30:00+00,13761,287,4633,13433,798,1096,2077,154,0,558,36797,163,20941,18864,14231,14048
2022-11-11 21:00:00+00,13515,339,4626,12444,807,1096,2081,167,0,734,35809,166,19958,17877,13251,13854
2022-11-11 21:30:00+00,13132,263,4630,11647,926,1096,2080,141,0,734,34649,165,19283,17203,12573,13395
2022-11-11 22:00:00+00,12750,337,4629,10698,881,1096,2079,133,0,472,33075,170,18287,16208,11579,13087
2022-11-11 22:30:00+00,12430,312,4633,10131,880,1096,2081,134,0,156,31853,172,17725,15644,11011,12742
2022-11-11 23:00:00+00,12025,231,4634,9637,705,1096,2082,128,0,0,30538,172,17058,14976,10342,12256
2022-11-11 23:30:00+00,11382,237,4635,9072,691,1096,2081,139,0,0,29333,171,16479,14398,9763,11619
2022-11-12 00:00:00+00,11511,73,4634,8196,798,1096,2083,179,0,0,28570,172,15711,13628,8994,11584
2022-11-12 00:30:00+00,11805,36,4631,7521,819,1096,2085,185,0,0,28179,177,15056,12971,8340,11842
2022-11-12 01:00:00+00,11497,0,4638,7175,810,1096,2079,132,0,18,27445,176,14702,12623,7985,11497
2022-11-12 01:30:00+00,11231,0,4636,7031,698,1096,2085,124,0,0,26901,175,14450,12365,7729,11231
2022-11-12 02:00:00+00,11231,0,4642,7010,698,1096,2083,124,0,0,26884,175,14433,12350,7708,11231
2022-11-12 02:30:00+00,11009,0,4640,6737,697,1130,2083,127,0,0,26423,176,14157,12074,7434,11009
2022-11-12 03:00:00+00,10413,0,4646,6736,697,1376,2041,128,0,0,26037,171,14120,12079,7433,10413
2022-11-12 03:30:00+00,10439,0,4641,6552,694,1480,1791,137,0,0,25734,174,13678,11887,7246,10439
2022-11-12 04:00:00+00,10950,0,4646,6253,688,1638,1432,137,0,0,25744,183,13019,11587,6941,10950
2022-11-12 04:30:00+00,10946,0,4648,6248,688,1722,1438,124,0,0,25814,184,13022,11584,6936,10946
2022-11-12 05:00:00+00,11086,0,4641,5994,684,1774,1442,133,0,0,25754,187,12761,11319,6678,11086
2022-11-12 05:30:00+00,11492,0,4647,6346,686,1814,1443,123,0,0,26551,188,13122,11679,7032,11492
2022-11-12 06:00:00+00,12050,0,4637,6763,807,1800,1443,132,0,0,27632,189,13650,12207,7570,12050
2022-11-12 06:30:00+00,12880,0,4637,6704,816,1764,1441,130,0,0,28372,195,13598,12157,7520,12880
2022-11-12 07:00:00+00,14378,0,4639,6739,832,1720,1438,135,0,0,29881,204,13648,12210,7571,14378
2022-11-12 07:30:00+00,15106,0,4636,6843,849,1722,1441,143,31,0,30771,208,13800,12359,7723,15106
2022-11-12 08:00:00+00,16128,0,4638,6930,839,1738,1439,132,287,0,32131,211,14133,12694,8056,16128
2022-11-12 08:30:00+00,16572,0,4636,6854,839,1750,1442,184,683,246,33206,210,14454,13012,8376,16572
2022-11-12 09:00:00+00,16817,0,4636,7184,979,1582,1445,173,1079,248,34143,205,15323,13878,9242,16817
2022-11-12 09:30:00+00,16805,0,4639,7434,989,1566,1438,132,1534,292,34829,200,16034,14596,9957,16805
2022-11-12 10:00:00+00,16861,0,4615,7384,983,1564,1439,130,2171,252,35399,198,16592,15153,10538,16861
2022-11-12 10:30:00+00,16714,0,4612,7564,773,1592,1433,125,2595,132,35540,196,16977,15544,10932,16714
2022-11-12 11:00:00+00,16443,0,4607,7513,751,1630,1427,130,3040,214,35755,192,17338,15911,11304,16443
2022-11-12 11:30:00+00,16586,0,4615,7392,746,1580,1429,125,3732,124,36329,190,17914,16485,11870,16586
2022-11-12 12:00:00+00,16271,0,4611,7305,744,1480,1422,133,3891,16,35873,188,17973,16551,11940,16271
2022-11-12 12:30:00+00,16425,0,4609,6924,743,1484,1427,129,3766,20,35527,191,17469,16042,11433,16425
2022-11-12 13:00:00+00,16957,0,4609,6761,742,1660,1422,150,3534,122,35957,197,17068,15646,11037,16957
2022-11-12 13:30:00+00,17081,0,4612,6829,741,1658,1420,124,3139,92,35696,200,16741,15321,10709,17081
2022-11-12 14:00:00+00,17240,0,4609,6645,745,1686,1420,167,2541,136,35189,205,15960,14540,9931,17240
2022-11-12 14:30:00+00,17649,0,4607,6571,737,1574,1424,142,1745,228,34677,211,15084,13660,9053,17649
2022-11-12 15:00:00+00,17560,1,4607,7133,804,1610,1423,127,914,350,34529,211,14881,13458,8851,17561
2022-11-12 15:30:00+00,17517,101,4609,8034,809,1664,1424,128,218,380,34884,212,15094,13670,9062,17618
2022-11-12 16:00:00+00,16942,229,4608,8500,828,1748,1428,304,3,532,35122,210,15367,13939,9331,17171
2022-11-12 16:30:00+00,17757,230,4605,8537,972,1778,1423,663,0,1224,37189,211,15537,14114,9509,17987
2022-11-12 17:00:00+00,18448,231,4606,8837,991,1612,1424,958,0,1262,38369,212,15858,14434,9828,18679
2022-11-12 17:30:00+00,18875,230,4604,8829,993,1478,1422,870,0,1092,38393,214,15848,14426,9822,19105
2022-11-12 18:00:00+00,18727,232,4603,8635,981,1524,1554,716,0,1364,38336,212,15773,14219,9616,18959
2022-11-12 18:30:00+00,18527,234,4605,8643,768,1504,1777,380,0,1008,37446,213,15793,14016,9411,18761
2022-11-12 19:00:00+00,18530,243,4603,8616,767,1236,2016,253,0,498,36762,215,16002,13986,9383,18773
2022-11-12 19:30:00+00,17765,298,4606,8305,766,1280,2071,167,0,296,35554,216,15748,13677,9071,18063
2022-11-12 20:00:00+00,17293,344,4604,7882,817,1476,2071,147,0,530,35164,216,15374,13303,8699,17637
2022-11-12 20:30:00+00,16853,311,4607,7674,988,1606,2073,142,0,316,34570,216,15342,13269,8662,17164
2022-11-12 21:00:00+00,16242,189,4604,7702,824,1854,2075,150,0,22,33662,215,15205,13130,8526,16431
2022-11-12 21:30:00+00,15587,0,4602,7418,740,1990,2074,149,0,184,32744,209,14834,12760,8158,15587
2022-11-12 22:00:00+00,14839,0,4604,7296,718,1930,2075,154,0,160,31776,205,14693,12618,8014,14839
2022-11-12 22:30:00+00,14084,0,4605,7226,714,1996,2070,135,0,26,30856,203,14615,12545,7940,14084
2022-11-12 23:00:00+00,12812,0,4607,7474,540,2130,2073,128,0,0,29764,193,14694,12621,8014,12812
2022-11-12 23:30:00+00,11936,0,4607,7523,537,2162,2047,136,0,0,28948,187,14714,12667,8060,11936
2022-11-13 00:00:00+00,11281,0,4612,7486,535,2162,2077,123,0,0,28276,182,14710,12633,8021,11281
2022-11-13 00:30:00+00,11448,0,4607,7067,534,2162,2087,140,0,106,28151,186,14295,12208,7601,11448
2022-11-13 01:00:00+00,11446,0,4603,6697,515,2162,2087,124,0,0,27634,189,13902,11815,7212,11446
2022-11-13 01:30:00+00,10796,0,4613,6813,516,2162,2086,121,0,0,27107,183,14028,11942,7329,10796
2022-11-13 02:00:00+00,10262,0,4609,7082,516,2162,2085,124,0,0,26840,177,14292,12207,7598,10262
2022-11-13 02:30:00+00,10066,0,4613,7246,515,2162,2089,129,0,0,26820,174,14462,12374,7760,10066
2022-11-13 03:00:00+00,9705,0,4614,7382,515,2162,2090,136,0,0,26604,170,14601,12511,7897,9705
2022-11-13 03:30:00+00,8622,0,4614,7957,516,2162,2086,124,0,0,26081,157,15173,13087,8473,8622
2022-11-13 04:00:00+00,8309,0,4610,8162,530,2162,2091,129,0,0,25993,153,15393,13302,8692,8309
2022-11-13 04:30:00+00,7995,0,4614,8707,530,2162,2083,124,0,0,26215,147,15934,13851,9237,7995
2022-11-13 05:00:00+00,8007,0,4627,8983,531,2162,2090,160,0,0,26560,146,16231,14141,9514,8007
2022-11-13 05:30:00+00,8548,0,4628,9082,534,2162,2074,124,0,0,27152,150,16318,14244,9616,8548
2022-11-13 06:00:00+00,9239,0,4626,9057,601,2162,2085,123,0,0,27893,156,16369,14284,9658,9239
2022-11-13 06:30:00+00,9643,0,4610,9252,603,2162,2090,135,0,0,28495,158,16555,14465,9855,9643
2022-11-13 07:00:00+00,10038,0,4605,9546,633,2162,2082,133,0,0,29199,160,16866,14784,10179,10038
2022-11-13 07:30:00+00,10380,0,4607,9529,654,2162,2089,169,28,0,29618,162,16907,14818,10211,10380
2022-11-13 08:00:00+00,10327,0,4603,9499,658,2162,2093,176,215,0,29733,161,17068,14975,10372,10327
2022-11-13 08:30:00+00,11358,0,4605,9131,658,2162,2093,213,673,6,30899,169,17160,15067,10462,11358
2022-11-13 09:00:00+00,11698,0,4606,9204,783,2160,2093,249,1140,74,32007,167,17826,15733,11127,11698
2022-11-13 09:30:00+00,12028,0,4606,9255,788,2136,2091,251,1583,126,32864,167,18323,16232,11626,12028
2022-11-13 10:00:00+00,11736,0,4605,8818,794,2538,2092,245,2011,182,33021,168,18320,16228,11623,11736
2022-11-13 10:30:00+00,12252,0,4610,8482,793,2504,2089,233,2391,38,33392,172,18365,16276,11666,12252
2022-11-13 11:00:00+00,11778,0,4611,8518,639,2332,2089,235,2900,0,33102,165,18757,16668,12057,11778
2022-11-13 11:30:00+00,11965,0,4616,8225,644,2230,2091,223,3194,188,33376,164,18770,16679,12063,11965
2022-11-13 12:00:00+00,11696,0,4619,7996,713,2614,2089,276,3357,324,33684,165,18774,16685,12066,11696
2022-11-13 12:30:00+00,11799,0,4615,8006,708,2558,2089,278,3420,272,33745,165,18838,16749,12134,11799
2022-11-13 13:00:00+00,12245,0,4616,8234,701,2518,2087,293,3084,252,34030,167,18722,16635,12019,12245
2022-11-13 13:30:00+00,12581,0,4617,8439,713,2440,2083,287,2787,158,34105,169,18639,16556,11939,12581
2022-11-13 14:00:00+00,13203,0,4617,8981,713,1912,2086,280,2202,0,33994,171,18599,16513,11896,13203
2022-11-13 14:30:00+00,13461,0,4616,9687,720,1830,2083,200,1540,0,34137,172,18646,16563,11947,13461
2022-11-13 15:00:00+00,14713,0,4610,10119,721,1360,2084,335,695,12,34649,179,18229,16145,11535,14713
2022-11-13 15:30:00+00,15626,0,4611,10358,631,1346,2088,462,151,148,35421,186,17839,15751,11140,15626
2022-11-13 16:00:00+00,16331,0,4613,10764,781,1258,2087,603,0,720,37157,185,18245,16158,11545,16331
2022-11-13 16:30:00+00,16889,0,4626,10887,834,1258,2089,832,0,1328,38743,185,18436,16347,11721,16889
2022-11-13 17:00:00+00,17808,0,4613,11121,854,1258,2088,1182,0,1048,39972,192,18676,16588,11975,17808
2022-11-13 17:30:00+00,17682,0,4610,11403,874,1258,2079,1185,0,988,40079,190,18966,16887,12277,17682
2022-11-13 18:00:00+00,17393,0,4610,11478,817,1258,2082,1079,0,1178,39895,187,18987,16905,12295,17393
2022-11-13 18:30:00+00,16875,0,4610,11408,801,1244,2086,895,0,1106,39024,185,18904,16818,12208,16875
2022-11-13 19:00:00+00,16281,0,4606,11310,801,1238,2088,596,0,470,37390,185,18805,16717,12111,16281
2022-11-13 19:30:00+00,16066,0,4613,11259,800,1188,2090,411,0,232,36659,184,18762,16672,12059,16066
2022-11-13 20:00:00+00,16031,0,4610,11266,662,1142,2089,303,0,6,36109,185,18627,16538,11928,16031
2022-11-13 20:30:00+00,15618,0,4612,10971,663,1096,2087,253,0,0,35300,184,18333,16246,11634,15618
2022-11-13 21:00:00+00,15404,0,4611,10737,751,1096,2085,254,0,0,34938,183,18184,16099,11488,15404
2022-11-13 21:30:00+00,14678,0,4612,10241,803,1096,2081,190,0,0,33701,181,17737,15656,11044,14678
2022-11-13 22:00:00+00,14003,0,4613,9998,793,1096,2090,251,0,0,32844,178,17494,15404,10791,14003
2022-11-13 22:30:00+00,13285,0,4616,9906,747,1108,2090,303,0,0,32055,174,17359,15269,10653,13285
2022-11-13 23:00:00+00,12889,0,4610,9560,585,1244,2089,225,0,0,31202,173,16844,14755,10145,12889
2022-11-13 23:30:00+00,12249,0,4615,9497,585,1258,2089,125,0,0,30418,168,16786,14697,10082,12249
2022-11-14 00:00:00+00,11991,0,4608,8913,564,1258,2088,177,0,0,29599,170,16173,14085,9477,11991
2022-11-14 00:30:00+00,11993,0,4623,8145,569,1258,2091,500,0,0,29179,176,15428,13337,8714,11993
2022-11-14 01:00:00+00,11968,0,4616,7513,598,1258,2089,669,0,0,28711,181,14816,12727,8111,11968
2022-11-14 01:30:00+00,11883,0,4615,7424,519,1258,2089,662,0,0,28450,181,14647,12558,7943,11883
2022-11-14 02:00:00+00,11642,0,4617,7441,517,1258,2088,331,0,0,27894,177,14663,12575,7958,11642
2022-11-14 02:30:00+00,11657,0,4613,7575,517,1258,2089,155,0,0,27864,176,14794,12705,8092,11657
2022-11-14 03:00:00+00,11680,0,4617,7631,512,1258,2082,123,0,0,27903,175,14842,12760,8143,11680
2022-11-14 03:30:00+00,11542,0,4621,7626,511,1258,2087,124,0,0,27769,174,14845,12758,8137,11542
2022-11-14 04:00:00+00,11701,0,4618,7654,527,1258,2089,128,0,0,27975,175,14888,12799,8181,11701
2022-11-14 04:30:00+00,11888,0,4618,7491,526,1258,2088,129,0,0,27998,178,14723,12635,8017,11888
2022-11-14 05:00:00+00,12273,12,4619,7661,524,1258,2085,125,0,0,28557,180,14889,12804,8185,12285
2022-11-14 05:30:00+00,12951,37,4618,7681,524,1258,2087,128,0,0,29284,186,14910,12823,8205,12988
2022-11-14 06:00:00+00,14851,100,4615,7541,558,1258,2071,144,0,0,31138,200,14785,12714,8099,14951
2022-11-14 06:30:00+00,17187,279,4615,7816,638,1258,2078,129,0,0,34000,216,15147,13069,8454,17466
2022-11-14 07:00:00+00,18777,487,4614,8063,764,1258,2084,187,0,62,36296,225,15525,13441,8827,19264
2022-11-14 07:30:00+00,18680,617,4610,8382,759,1268,2082,349,26,0,36772,226,15859,13777,9167,19296
2022-11-14 08:00:00+00,18583,708,4614,8404,756,1916,2085,234,159,0,37459,224,16018,13933,9319,19291
2022-11-14 08:30:00+00,18931,749,4613,8418,747,1944,2087,235,416,0,38140,225,16281,14194,9581,19680
2022-11-14 09:00:00+00,19650,639,4610,8251,747,1960,2086,184,708,0,38835,227,16402,14316,9706,20289
2022-11-14 09:30:00+00,19671,497,4613,8303,753,1968,2051,175,1145,0,39176,222,16865,14814,10201,20168
2022-11-14 10:00:00+00,19130,462,4611,8368,727,2160,2056,188,1133,0,38835,218,16895,14839,10228,19592
2022-11-14 10:30:00+00,18836,459,4608,8274,714,2160,2085,208,1280,0,38624,217,16961,14876,10268,19295
2022-11-14 11:00:00+00,19033,462,4605,7852,668,2166,2086,224,1156,0,38252,220,16367,14281,9676,19495
2022-11-14 11:30:00+00,19203,470,4610,7553,689,2200,2086,205,1164,0,38180,223,16102,14016,9406,19673
2022-11-14 12:00:00+00,19667,477,4608,7318,709,2044,2085,218,1157,0,38283,227,15877,13792,9184,20144
2022-11-14 12:30:00+00,20206,463,4614,6606,724,2208,2085,190,1285,0,38381,233,15314,13229,8615,20669
2022-11-14 13:00:00+00,19952,464,4610,6508,758,2586,2083,198,1427,0,38586,233,15386,13303,8693,20416
2022-11-14 13:30:00+00,20145,465,4612,6033,784,2702,2082,196,1105,0,38124,239,14616,12534,7922,20610
2022-11-14 14:00:00+00,20103,570,4614,5708,786,2654,2073,326,668,0,37502,246,13849,11776,7162,20673
2022-11-14 14:30:00+00,19795,709,4617,5609,764,2860,2081,403,448,0,37286,251,13519,11438,6821,20504
2022-11-14 15:00:00+00,19732,597,4617,5730,733,2698,2023,381,205,292,37008,247,13308,11285,6668,20329
2022-11-14 15:30:00+00,19769,473,4610,6109,766,2772,2045,558,63,942,38107,240,13593,11548,6938,20242
2022-11-14 16:00:00+00,19647,466,4606,5978,781,3284,2092,750,0,1200,38804,241,13457,11365,6759,20113
2022-11-14 16:30:00+00,20372,477,4609,6042,907,3332,2098,973,0,1202,40012,243,13656,11558,6949,20849
2022-11-14 17:00:00+00,19965,490,4610,6630,929,3078,2127,1123,0,1310,40262,239,14296,12169,7559,20455
2022-11-14 17:30:00+00,19870,488,4612,7361,930,3092,2127,1061,0,1250,40791,235,15030,12903,8291,20358
2022-11-14 18:00:00+00,19872,485,4608,7039,930,3581,2122,1016,0,1210,40863,235,14699,12577,7969,20357
2022-11-14 18:30:00+00,19411,544,4608,7140,930,3566,2121,875,0,650,39845,237,14799,12678,8070,19955
2022-11-14 19:00:00+00,19384,800,4609,7503,930,2932,2119,586,0,664,39527,242,15161,13042,8433,20184
2022-11-14 19:30:00+00,18998,785,4608,7472,930,2809,2119,377,0,424,38522,241,15129,13010,8402,19783
2022-11-14 20:00:00+00,19213,800,4609,7510,916,2162,2117,355,0,276,37958,240,15152,13035,8426,20013
2022-11-14 20:30:00+00,18090,698,4614,7842,836,2148,2120,270,0,0,36618,233,15412,13292,8678,18788
2022-11-14 21:00:00+00,17834,625,4608,8137,688,2012,2119,181,0,130,36334,230,15552,13433,8825,18459
2022-11-14 21:30:00+00,16438,463,4610,8580,675,2000,2113,153,0,0,35032,218,15978,13865,9255,16901
2022-11-14 22:00:00+00,14183,523,4607,9196,607,1998,2114,182,0,124,33534,203,16524,14410,9803,14706
2022-11-14 22:30:00+00,12191,527,4607,9795,615,1902,2104,194,0,0,31935,187,17121,15017,10410,12718
2022-11-14 23:00:00+00,9630,185,4606,10300,588,1912,2103,167,0,0,29491,158,17597,15494,10888,9815
2022-11-14 23:30:00+00,7776,92,4606,11142,575,2000,2101,159,0,0,28451,136,18424,16323,11717,7868
2022-11-15 00:00:00+00,7053,0,4611,12079,559,1950,2100,160,0,0,28512,122,19349,17249,12638,7053
2022-11-15 00:30:00+00,7042,0,4611,12195,538,1792,2095,157,0,0,28430,119,19439,17344,12733,7042
2022-11-15 01:00:00+00,7084,0,4613,12399,505,1522,2082,142,0,0,28347,116,19599,17517,12904,7084
2022-11-15 01:30:00+00,6315,0,4612,12927,503,1258,2087,145,0,0,27847,103,20129,18042,13430,6315
2022-11-15 02:00:00+00,6314,0,4615,13106,503,1290,2084,161,0,0,28073,103,20308,18224,13609,6314
2022-11-15 02:30:00+00,6466,0,4612,12754,504,1186,2075,148,0,0,27745,104,19945,17870,13258,6466
2022-11-15 03:00:00+00,6711,0,4617,12989,504,1096,2078,123,0,0,28118,104,20188,18110,13493,6711
2022-11-15 03:30:00+00,6020,0,4614,13296,505,1096,2094,133,0,0,27758,96,20509,18415,13801,6020
2022-11-15 04:00:00+00,5808,0,4612,13609,515,1096,2087,124,0,0,27851,93,20823,18736,14124,5808
2022-11-15 04:30:00+00,5262,0,4611,14004,508,1096,2092,130,0,0,27703,86,21215,19123,14512,5262
2022-11-15 05:00:00+00,5404,0,4612,14323,521,1096,2091,130,0,0,28177,86,21547,19456,14844,5404
2022-11-15 05:30:00+00,6296,0,4613,14699,525,1096,2086,121,0,0,29436,94,21923,19837,15224,6296
2022-11-15 06:00:00+00,7231,0,4607,15087,571,1096,2091,179,0,0,30862,102,22356,20265,15658,7231
2022-11-15 06:30:00+00,9355,3,4607,16023,578,1096,2086,147,0,0,33895,118,23294,21208,16601,9358
2022-11-15 07:00:00+00,11638,173,4602,16489,604,1096,2088,194,0,0,36884,137,23783,21695,17093,11811
2022-11-15 07:30:00+00,13359,229,4607,16338,611,1096,2073,179,11,0,38503,150,23640,21567,16960,13588
2022-11-15 08:00:00+00,14722,230,4600,16322,603,1096,2085,207,32,34,39931,159,23642,21557,16957,14952
2022-11-15 08:30:00+00,15469,246,4594,15886,543,1096,2090,221,81,172,40398,165,23194,21104,16510,15715
2022-11-15 09:00:00+00,16121,241,4595,15671,525,1096,2109,208,178,28,40772,169,23078,20969,16374,16362
2022-11-15 09:30:00+00,16220,414,4594,15572,518,1096,2114,217,255,0,41000,173,23053,20939,16345,16634
2022-11-15 10:00:00+00,16492,476,4592,15057,508,1096,2116,210,366,80,40993,177,22639,20523,15931,16968
2022-11-15 10:30:00+00,17079,551,4595,14283,506,1096,2105,248,569,30,41062,185,22058,19953,15358,17630
2022-11-15 11:00:00+00,17244,502,4599,14330,509,1096,2104,347,808,0,41539,184,22350,20246,15647,17746
2022-11-15 11:30:00+00,17248,459,4600,14303,533,1096,2109,356,1036,0,41740,182,22581,20472,15872,17707
2022-11-15 12:00:00+00,17178,462,4598,14234,530,1096,2106,452,1266,84,42006,181,22734,20628,16030,17640
2022-11-15 12:30:00+00,17306,500,4594,13921,590,1096,2111,534,1198,210,42060,183,22414,20303,15709,17806
2022-11-15 13:00:00+00,18283,472,4601,13500,593,1096,2090,555,1123,216,42529,190,21907,19817,15216,18755
2022-11-15 13:30:00+00,18311,498,4602,13274,595,1096,2090,370,1142,0,41978,192,21703,19613,15011,18809
2022-11-15 14:00:00+00,18047,536,4599,13094,591,1096,2085,284,927,70,41329,192,21296,19211,14612,18583
2022-11-15 14:30:00+00,18227,469,4599,12902,575,1096,2089,212,735,214,41118,193,20900,18811,14212,18696
2022-11-15 15:00:00+00,18226,470,4600,12968,600,1096,2096,207,474,176,40913,194,20738,18642,14042,18696
2022-11-15 15:30:00+00,17998,557,4602,12903,672,1096,2096,447,120,784,41275,194,20393,18297,13695,18555
2022-11-15 16:00:00+00,17722,493,4598,12817,759,1096,2095,645,0,782,41007,193,20269,18174,13576,18215
2022-11-15 16:30:00+00,18524,481,4596,12586,781,1096,2054,853,0,1364,42335,195,20017,17963,13367,19005
2022-11-15 17:00:00+00,18872,463,4599,12246,880,1096,2059,1196,0,1514,42925,198,19784,17725,13126,19335
2022-11-15 17:30:00+00,18990,461,4598,11853,874,1096,2067,1387,0,1410,42736,201,19392,17325,12727,19451
2022-11-15 18:00:00+00,18490,468,4601,11692,871,1276,2064,1225,0,1464,42151,199,19228,17164,12563,18958
2022-11-15 18:30:00+00,18385,480,4598,11307,881,1282,2066,1085,0,1378,41462,200,18852,16786,12188,18865
2022-11-15 19:00:00+00,18658,458,4601,10662,912,1096,2064,790,0,802,40043,207,18239,16175,11574,19116
2022-11-15 19:30:00+00,18931,466,4601,9739,914,1096,2090,470,0,664,38971,213,17344,15254,10653,19397
2022-11-15 20:00:00+00,19561,746,4602,9621,1009,1096,2075,397,0,624,39731,221,17307,15232,10630,20307
2022-11-15 20:30:00+00,19067,793,4603,9603,986,1096,2076,259,0,238,38721,222,17268,15192,10589,19860
2022-11-15 21:00:00+00,18032,545,4602,9841,891,1096,2085,232,0,38,37362,213,17419,15334,10732,18577
2022-11-15 21:30:00+00,17233,323,4598,9373,804,1096,2089,217,0,224,35957,206,16864,14775,10177,17556
2022-11-15 22:00:00+00,15488,222,4487,9613,785,1096,2087,163,0,348,34289,193,16972,14885,10398,15710
2022-11-15 22:30:00+00,14144,0,4278,9158,839,1108,2086,163,0,562,32338,182,16361,14275,9997,14144
2022-11-15 23:00:00+00,12109,0,3998,8987,823,1316,2080,146,0,6,29465,172,15888,13808,9810,12109
2022-11-15 23:30:00+00,11018,0,3985,9109,818,1360,2068,145,0,0,28503,163,15980,13912,9927,11018
2022-11-16 00:00:00+00,10665,0,3987,9250,721,1258,2076,148,0,0,28105,160,16034,13958,9971,10665
2022-11-16 00:30:00+00,10357,0,3984,9524,715,1258,2077,146,0,0,28061,156,16300,14223,10239,10357
2022-11-16 01:00:00+00,9744,0,3972,9737,711,1486,2065,160,0,0,27875,149,16485,14420,10448,9744
2022-11-16 01:30:00+00,9443,0,3971,9702,690,1488,2050,147,0,0,27491,147,16413,14363,10392,9443
2022-11-16 02:00:00+00,8079,0,3984,10401,691,1740,2032,146,0,0,27073,130,17108,15076,11092,8079
2022-11-16 02:30:00+00,7368,0,3989,10598,698,1740,2039,145,0,0,26577,121,17324,15285,11296,7368
2022-11-16 03:00:00+00,7264,0,3989,10727,684,1514,2033,147,0,0,26358,120,17433,15400,11411,7264
2022-11-16 03:30:00+00,7114,0,3987,10744,685,1512,2028,151,0,0,26221,119,17444,15416,11429,7114
2022-11-16 04:00:00+00,8446,0,3987,10160,677,1258,2045,149,0,0,26722,136,16869,14824,10837,8446
2022-11-16 04:30:00+00,8958,0,3988,9950,668,1258,2055,151,0,0,27028,142,16661,14606,10618,8958
2022-11-16 05:00:00+00,9605,1,3990,10098,683,1258,2043,171,0,0,27849,147,16814,14771,10781,9606
2022-11-16 05:30:00+00,10264,162,3993,10223,685,1258,2016,145,0,0,28746,156,16917,14901,10908,10426
2022-11-16 06:00:00+00,12939,234,3997,10761,802,1258,2041,178,0,0,32210,175,17601,15560,11563,13173
2022-11-16 06:30:00+00,15321,407,3992,10614,758,1258,2057,227,0,190,34824,194,17421,15364,11372,15728
2022-11-16 07:00:00+00,17630,461,3993,9729,832,1258,2046,263,0,414,36626,210,16600,14554,10561,18091
2022-11-16 07:30:00+00,18476,479,3990,9354,829,1258,2049,527,38,364,37364,218,16260,14211,10221,18955
2022-11-16 08:00:00+00,18756,464,3991,8962,736,1152,2046,557,255,580,37499,221,15990,13944,9953,19220
2022-11-16 08:30:00+00,18858,473,3987,8335,731,1370,2051,710,703,790,38008,221,15807,13756,9769,19331
2022-11-16 09:00:00+00,18770,468,3988,8300,717,1258,2050,739,1431,812,38533,216,16486,14436,10448,19238
2022-11-16 09:30:00+00,18512,461,3989,8455,719,1048,2048,733,2058,698,38721,212,17269,15221,11232,18973
2022-11-16 10:00:00+00,18827,483,3988,8339,697,1416,2052,778,2519,714,39813,212,17595,15543,11555,19310
2022-11-16 10:30:00+00,18842,483,3992,8505,674,1402,2054,751,2889,550,40142,210,18114,16060,12068,19325
2022-11-16 11:00:00+00,18469,641,3990,8381,652,972,2054,816,2868,762,39605,216,17945,15891,11901,19110
2022-11-16 11:30:00+00,18814,631,3997,8501,660,1608,2049,730,2862,586,40438,217,18069,16020,12023,19445
2022-11-16 12:00:00+00,18789,611,4000,9252,640,1614,2042,759,2647,610,40964,212,18581,16539,12539,19400
2022-11-16 12:30:00+00,18171,553,3996,10295,644,1620,2049,633,2344,622,40927,204,19328,17279,13283,18724
2022-11-16 13:00:00+00,16957,531,3998,10534,655,1530,2048,511,1867,600,39231,198,19102,17054,13056,17488
2022-11-16 13:30:00+00,16838,563,3997,10722,667,1558,2051,493,1459,382,38730,200,18896,16845,12848,17401
2022-11-16 14:00:00+00,17692,546,4001,10471,666,1096,2048,495,826,600,38441,205,18012,15964,11963,18238
2022-11-16 14:30:00+00,17680,554,3999,10550,653,1096,2052,530,356,430,37900,209,17610,15558,11559,18234
2022-11-16 15:00:00+00,18787,584,4002,10555,674,1232,2044,411,149,236,38674,216,17424,15380,11378,19371
2022-11-16 15:30:00+00,18590,584,3997,11364,715,1248,2049,520,10,422,39499,210,18135,16086,12089,19174
2022-11-16 16:00:00+00,16985,522,3998,12278,777,1866,2042,480,0,794,39742,193,19095,17053,13055,17507
2022-11-16 16:30:00+00,17267,518,3992,12933,823,1882,2044,635,0,1018,41112,190,19792,17748,13756,17785
2022-11-16 17:00:00+00,17416,565,3994,12967,878,1942,2040,669,0,1294,41765,191,19879,17839,13845,17981
2022-11-16 17:30:00+00,17003,590,3990,13079,881,1950,2037,858,0,1510,41898,189,19987,17950,13960,17593
2022-11-16 18:00:00+00,16477,590,3995,13103,815,2204,2038,1052,0,1498,41772,189,19951,17913,13918,17067
2022-11-16 18:30:00+00,15884,653,3995,13052,813,2212,1995,884,0,1434,40922,187,19855,17860,13865,16537
2022-11-16 19:00:00+00,16677,681,4024,12815,811,1736,1988,755,0,850,40337,196,19638,17650,13626,17358
2022-11-16 19:30:00+00,16627,381,4025,12760,825,1726,2007,559,0,386,39296,192,19617,17610,13585,17008
2022-11-16 20:00:00+00,16747,45,4025,12468,826,1778,1995,276,0,946,39106,182,19314,17319,13294,16792
2022-11-16 20:30:00+00,15908,0,4026,12471,825,1780,2013,242,0,524,37789,179,19335,17322,13296,15908
2022-11-16 21:00:00+00,14211,0,4038,12443,812,1894,2027,186,0,392,36003,170,19320,17293,13255,14211
2022-11-16 21:30:00+00,12893,0,4058,12568,807,1898,2014,173,0,20,34431,162,19447,17433,13375,12893
2022-11-16 22:00:00+00,9279,0,4070,12802,718,2516,2019,177,0,0,31581,139,19609,17590,13520,9279
2022-11-16 22:30:00+00,7250,0,4075,12608,653,2588,2015,236,0,88,29513,123,19351,17336,13261,7250
2022-11-16 23:00:00+00,4461,0,4077,12434,486,4470,2022,191,0,0,28141,93,19019,16997,12920,4461
2022-11-16 23:30:00+00,3614,0,4073,12200,476,4586,1999,173,0,0,27121,84,18748,16749,12676,3614
2022-11-17 00:00:00+00,3834,0,4069,12288,471,4040,2024,177,0,0,26903,84,18852,16828,12759,3834
2022-11-17 00:30:00+00,3797,0,4064,12494,470,4018,2021,187,0,0,27051,83,19049,17028,12964,3797
2022-11-17 01:00:00+00,4169,0,4060,12092,468,3882,2020,185,0,0,26876,89,18640,16620,12560,4169
2022-11-17 01:30:00+00,4391,0,4083,11585,468,3844,2017,182,0,0,26570,93,18153,16136,12053,4391
2022-11-17 02:00:00+00,4759,0,4103,11659,466,2858,2017,176,0,0,26038,94,18245,16228,12125,4759
2022-11-17 02:30:00+00,4332,0,4127,11678,464,2826,2022,176,0,0,25625,89,18291,16269,12142,4332
2022-11-17 03:00:00+00,4484,0,4151,11910,461,2820,2019,174,0,0,26019,94,18541,16522,12371,4484
2022-11-17 03:30:00+00,4320,0,4169,11909,449,2786,2011,174,0,0,25818,92,18538,16527,12358,4320
2022-11-17 04:00:00+00,4068,0,4187,12208,458,2362,2018,173,0,0,25474,85,18871,16853,12666,4068
2022-11-17 04:30:00+00,4127,0,4210,12234,466,2304,2024,174,0,0,25539,85,18934,16910,12700,4127
2022-11-17 05:00:00+00,5230,0,4214,11982,469,2206,2024,200,0,0,26325,102,18689,16665,12451,5230
2022-11-17 05:30:00+00,6301,0,4221,12181,469,2120,2032,174,0,0,27498,111,18903,16870,12650,6301
2022-11-17 06:00:00+00,7808,0,4224,12346,506,1538,2043,214,0,0,28680,119,19119,17076,12852,7808
2022-11-17 06:30:00+00,9166,0,4226,12483,630,1538,2054,356,0,0,30453,131,19394,17339,13113,9166
2022-11-17 07:00:00+00,10432,0,4231,12598,651,1296,2059,459,0,120,31847,142,19539,17480,13249,10432
2022-11-17 07:30:00+00,11252,0,4235,12705,650,1381,2057,767,14,170,33231,150,19662,17604,13369,11252
2022-11-17 08:00:00+00,11834,0,4235,12843,592,1658,2051,790,138,30,34171,154,19859,17808,13573,11834
2022-11-17 08:30:00+00,12233,0,4234,13053,530,1672,2045,672,454,150,35043,154,20316,18271,14037,12233
2022-11-17 09:00:00+00,12539,0,4223,13295,495,1802,2036,466,884,260,36001,152,20933,18897,14674,12539
2022-11-17 09:30:00+00,12758,0,4210,13521,497,1806,2021,379,1315,0,36508,151,21564,19543,15333,12758
2022-11-17 10:00:00+00,13001,0,4211,13755,497,1694,2011,245,1585,110,37108,149,22058,20048,15837,13001
2022-11-17 10:30:00+00,13226,0,4216,13996,83,1604,2000,34,1789,22,36971,150,22085,20084,15868,13226
2022-11-17 11:00:00+00,13521,0,4228,14248,248,1464,1993,105,1798,0,37604,150,22515,20522,16294,13521
2022-11-17 11:30:00+00,13745,0,4236,14481,473,1288,1983,207,1865,0,38278,150,23038,21055,16819,13745
2022-11-17 12:00:00+00,13990,0,4242,14704,429,1096,1975,206,1961,0,38603,151,23311,21336,17094,13990
2022-11-17 12:30:00+00,14126,0,4246,14912,430,1145,1965,146,1752,0,38723,152,23306,21341,17094,14126
2022-11-17 13:00:00+00,14353,0,4250,15110,429,1194,1957,155,1548,26,39022,153,23294,21337,17087,14353
2022-11-17 13:30:00+00,14528,0,4254,15302,435,1198,1947,134,1298,30,39126,154,23236,21288,17035,14528
2022-11-17 14:00:00+00,14799,0,4255,15486,478,1096,1941,146,935,44,39181,156,23095,21154,16899,14799
2022-11-17 14:30:00+00,15192,90,4260,15643,497,1096,1936,133,811,0,39657,160,23147,21211,16951,15282
2022-11-17 15:00:00+00,15689,230,4263,15762,547,1096,1931,151,417,232,40317,166,22919,20988,16726,15919
2022-11-17 15:30:00+00,16449,234,4267,15848,569,1096,1929,377,92,496,41357,171,22705,20776,16509,16683
2022-11-17 16:00:00+00,17165,238,4268,15910,597,1096,1927,659,0,920,42780,174,22702,20775,16507,17403
2022-11-17 16:30:00+00,17688,239,4271,15698,604,1096,1919,997,0,1444,43956,176,22492,20573,16302,17927
2022-11-17 17:00:00+00,18484,240,4268,15163,603,1096,1928,1054,0,1510,44346,182,21962,20034,15766,18724
2022-11-17 17:30:00+00,19055,328,4274,14106,596,1096,1946,1000,0,1508,43909,191,20922,18976,14702,19383
2022-11-17 18:00:00+00,19014,384,4277,13921,521,1096,1943,1009,0,1524,43689,192,20662,18719,14442,19398
2022-11-17 18:30:00+00,18584,328,4272,13827,525,1237,1916,793,0,1460,42942,190,20540,18624,14352,18912
2022-11-17 19:00:00+00,18092,321,4272,13849,533,1422,1889,574,0,530,41482,192,20543,18654,14382,18413
2022-11-17 19:30:00+00,17378,246,4270,14203,532,1404,1890,400,0,352,40675,185,20895,19005,14735,17624
2022-11-17 20:00:00+00,17064,215,4273,14533,531,1156,1946,187,0,110,40015,181,21283,19337,15064,17279
2022-11-17 20:30:00+00,15734,0,4270,14873,530,1306,1952,132,0,80,38877,169,21625,19673,15403,15734
2022-11-17 21:00:00+00,14090,0,4272,15044,517,1490,1916,135,0,72,37536,160,21749,19833,15561,14090
2022-11-17 21:30:00+00,12063,0,4274,15116,512,1667,1909,140,0,222,35903,147,21811,19902,15628,12063
2022-11-17 22:00:00+00,10295,0,4274,15275,492,1866,1946,142,0,60,34350,136,21987,20041,15767,10295
2022-11-17 22:30:00+00,8366,0,4277,15792,491,1786,1950,150,0,18,32830,118,22510,20560,16283,8366
2022-11-17 23:00:00+00,7066,0,4276,15707,490,1486,1947,145,0,0,31117,104,22420,20473,16197,7066
2022-11-17 23:30:00+00,6503,0,4271,15476,490,1340,1946,129,0,0,30155,98,22183,20237,15966,6503
2022-11-18 00:00:00+00,6427,0,4269,15546,478,1440,1950,130,0,0,30240,98,22243,20293,16024,6427
2022-11-18 00:30:00+00,6750,0,4270,15363,478,1544,1951,135,0,0,30491,103,22062,20111,15841,6750
2022-11-18 01:00:00+00,6777,0,4273,15312,446,1598,1937,123,0,0,30466,104,21968,20031,15758,6777
2022-11-18 01:30:00+00,6178,0,4277,15547,447,1464,1944,131,0,0,29988,96,22215,20271,15994,6178
2022-11-18 02:00:00+00,5640,0,4284,15581,447,1376,1951,125,0,0,29404,89,22263,20312,16028,5640
2022-11-18 02:30:00+00,5624,0,4294,15558,447,1266,1948,128,0,0,29265,88,22247,20299,16005,5624
2022-11-18 03:00:00+00,5544,0,4298,15590,447,1360,1948,129,0,0,29316,88,22283,20335,16037,5544
2022-11-18 03:30:00+00,5435,0,4309,15650,443,1268,1965,124,0,0,29194,86,22367,20402,16093,5435
2022-11-18 04:00:00+00,5493,0,4312,15583,443,1300,1955,131,0,0,29217,87,22293,20338,16026,5493
2022-11-18 04:30:00+00,5526,0,4318,15354,443,1312,1944,131,0,0,29028,88,22059,20115,15797,5526
2022-11-18 05:00:00+00,5965,0,4325,15227,457,1566,2006,136,0,0,29682,96,22015,20009,15684,5965
2022-11-18 05:30:00+00,7296,0,4332,14847,453,1686,2016,156,0,0,30786,112,21648,19632,15300,7296
2022-11-18 06:00:00+00,9166,0,4339,14270,453,1540,2016,143,0,0,31927,129,21078,19062,14723,9166
2022-11-18 06:30:00+00,11591,0,4348,13812,489,1468,2014,142,0,0,33864,148,20663,18649,14301,11591
2022-11-18 07:00:00+00,14142,0,4353,13435,560,1318,2017,136,0,0,35961,166,20365,18348,13995,14142
2022-11-18 07:30:00+00,15630,0,4355,13191,560,1184,2011,399,25,0,37355,176,20142,18131,13776,15630
2022-11-18 08:00:00+00,17062,0,4351,13093,532,1096,2018,440,320,0,38912,183,20314,18296,13945,17062
2022-11-18 08:30:00+00,17285,0,4355,13060,512,1096,2016,441,884,0,39649,181,20827,18811,14456,17285
2022-11-18 09:00:00+00,17820,0,4354,13097,554,1096,2017,369,1416,0,40723,181,21438,19421,15067,17820
2022-11-18 09:30:00+00,17457,0,4375,12868,635,1096,2018,273,2040,0,40762,177,21936,19918,15543,17457
2022-11-18 10:00:00+00,17489,0,4375,12704,528,1096,2015,174,2629,0,41010,175,22251,20236,15861,17489
2022-11-18 10:30:00+00,17553,0,4371,12507,528,1096,2017,221,3155,8,41456,174,22578,20561,16190,17553
2022-11-18 11:00:00+00,17830,0,4376,12076,530,1156,2017,244,3187,0,41416,178,22186,20169,15793,17830
2022-11-18 11:30:00+00,17888,0,4374,11753,535,1128,2018,150,3079,0,40925,180,21759,19741,15367,17888
2022-11-18 12:00:00+00,17943,0,4374,11631,524,1096,2016,170,2758,0,40512,182,21303,19287,14913,17943
2022-11-18 12:30:00+00,18231,0,4378,11387,509,1112,2019,245,2688,80,40649,185,20981,18962,14584,18231
2022-11-18 13:00:00+00,18386,1,4389,11177,596,1130,2019,248,2310,6,40262,188,20491,18472,14083,18387
2022-11-18 13:30:00+00,18377,108,4389,10945,545,1148,2015,282,1760,20,39589,194,19654,17639,13250,18485
2022-11-18 14:00:00+00,18178,231,4398,10739,491,1202,2017,271,1383,0,38910,199,19028,17011,12613,18409
2022-11-18 14:30:00+00,18416,270,4397,10481,492,1160,2019,276,984,0,38495,204,18373,16354,11957,18686
2022-11-18 15:00:00+00,18384,357,4403,10359,517,1308,2018,262,368,0,37976,211,17665,15647,11244,18741
2022-11-18 15:30:00+00,18367,444,4405,10499,625,1344,2020,419,82,294,38499,212,17631,15611,11206,18811
2022-11-18 16:00:00+00,18765,461,4412,10475,587,1470,2021,728,0,680,39599,212,17495,15474,11062,19226
2022-11-18 16:30:00+00,19651,630,4414,10444,573,1368,2020,1141,0,828,41069,219,17451,15431,11017,20281
2022-11-18 17:00:00+00,19841,834,4416,10487,741,1104,2025,1264,0,848,41560,223,17669,15644,11228,20675
2022-11-18 17:30:00+00,19818,769,4415,10270,824,1103,2024,1239,0,1038,41500,221,17533,15509,11094,20587
2022-11-18 18:00:00+00,20117,712,4414,9805,817,1101,2034,1230,0,1180,41410,223,17070,15036,10622,20829
2022-11-18 18:30:00+00,20093,808,4419,9767,814,1100,2047,976,0,858,40882,226,17047,15000,10581,20901
2022-11-18 19:00:00+00,19951,566,4414,9866,896,1099,2045,630,0,254,39721,222,17221,15176,10762,20517
2022-11-18 19:30:00+00,19126,585,4416,10228,905,1097,2044,551,0,0,38952,218,17593,15549,11133,19711
2022-11-18 20:00:00+00,19089,472,4421,10206,906,1096,2045,484,0,4,38723,216,17578,15533,11112,19561
2022-11-18 20:30:00+00,18483,458,4421,10200,881,1096,2046,171,0,0,37756,212,17548,15502,11081,18941
2022-11-18 21:00:00+00,17668,223,4422,10422,657,1096,2047,143,0,0,36678,204,17548,15501,11079,17891
2022-11-18 21:30:00+00,16336,0,4419,11202,644,1096,2042,136,0,0,35875,188,18307,16265,11846,16336
2022-11-18 22:00:00+00,15185,0,4419,11373,627,1096,2028,145,0,0,34873,180,18447,16419,12000,15185
2022-11-18 22:30:00+00,14177,0,4425,11302,622,1058,2044,165,0,42,33835,174,18393,16349,11924,14177
2022-11-18 23:00:00+00,13506,0,4428,11002,601,694,2034,161,0,0,32426,173,18065,16031,11603,13506
2022-11-18 23:30:00+00,13219,0,4433,10411,601,646,2037,147,0,0,31494,175,17482,15445,11012,13219
2022-11-19 00:00:00+00,13417,0,4434,10255,602,596,2037,132,0,0,31473,177,17328,15291,10857,13417
2022-11-19 00:30:00+00,13512,0,4429,9987,603,590,2038,140,0,0,31299,179,17057,15019,10590,13512
2022-11-19 01:00:00+00,13240,0,4429,9977,539,590,2036,138,0,0,30949,178,16981,14945,10516,13240
2022-11-19 01:30:00+00,12778,0,4432,10074,546,588,2031,126,0,0,30575,174,17083,15052,10620,12778
2022-11-19 02:00:00+00,12541,0,4429,10143,541,542,2016,134,0,0,30346,172,17129,15113,10684,12541
2022-11-19 02:30:00+00,11754,0,4433,10438,540,536,2031,125,0,0,29857,165,17442,15411,10978,11754
2022-11-19 03:00:00+00,11437,0,4429,10209,542,468,2021,162,0,0,29268,164,17201,15180,10751,11437
2022-11-19 03:30:00+00,11574,0,4434,9825,542,454,1736,150,0,0,28715,168,16537,14801,10367,11574
2022-11-19 04:00:00+00,11797,0,4427,9837,543,298,1403,168,0,0,28473,171,16210,14807,10380,11797
2022-11-19 04:30:00+00,11585,0,4432,10163,543,272,1403,143,0,0,28541,167,16541,15138,10706,11585
2022-11-19 05:00:00+00,11975,0,4428,10169,539,46,1399,137,0,0,28693,172,16535,15136,10708,11975
2022-11-19 05:30:00+00,12283,0,4433,10066,540,34,1376,144,0,0,28876,175,16415,15039,10606,12283
2022-11-19 06:00:00+00,12962,0,4434,9870,539,404,1371,154,0,0,29734,179,16214,14843,10409,12962
2022-11-19 06:30:00+00,13937,0,4434,9754,539,410,1374,145,0,0,30593,186,16101,14727,10293,13937
2022-11-19 07:00:00+00,15432,0,4437,9746,537,42,1373,139,0,0,31706,198,16093,14720,10283,15432
2022-11-19 07:30:00+00,16478,0,4441,10004,538,0,1367,124,8,0,32960,203,16358,14991,10550,16478
2022-11-19 08:00:00+00,17721,0,4442,10072,609,26,1369,123,182,0,34544,208,16674,15305,10863,17721
2022-11-19 08:30:00+00,18429,0,4438,10160,662,166,1367,124,627,0,35973,210,17254,15887,11449,18429
2022-11-19 09:00:00+00,18499,0,4441,10192,749,508,1367,125,1197,0,37078,206,17946,16579,12138,18499
2022-11-19 09:30:00+00,18655,0,4436,10057,748,636,1372,149,1663,0,37716,205,18276,16904,12468,18655
2022-11-19 10:00:00+00,18722,0,4443,9900,733,858,1365,125,1993,0,38139,204,18434,17069,12626,18722
2022-11-19 10:30:00+00,18457,0,4439,9772,606,1032,1366,126,2255,0,38053,204,18438,17072,12633,18457
2022-11-19 11:00:00+00,18120,0,4434,9713,583,1268,1368,130,2575,0,38191,201,18673,17305,12871,18120
2022-11-19 11:30:00+00,18062,0,4439,9743,564,1436,1367,137,2872,0,38620,200,18985,17618,13179,18062
2022-11-19 12:00:00+00,18123,0,4436,9551,565,1552,1367,156,2755,20,38525,202,18674,17307,12871,18123
2022-11-19 12:30:00+00,18325,0,4438,9445,544,1560,1372,155,2273,0,38112,206,18072,16700,12262,18325
2022-11-19 13:00:00+00,18214,0,4439,9228,544,1564,1369,143,1812,20,37333,209,17392,16023,11584,18214
2022-11-19 13:30:00+00,18681,0,4438,8940,557,1562,1367,141,1446,0,37132,215,16748,15381,10943,18681
2022-11-19 14:00:00+00,19179,1,4441,8510,559,1456,1369,159,1093,40,36807,222,15972,14603,10162,19180
2022-11-19 14:30:00+00,19690,1,4440,8154,558,1456,1371,142,669,48,36529,229,15192,13821,9381,19691
2022-11-19 15:00:00+00,20044,1,4438,8290,593,1590,1371,165,241,228,36961,231,14933,13562,9124,20045
2022-11-19 15:30:00+00,20324,118,4439,8556,616,1616,1372,268,49,224,37582,234,15032,13660,9221,20442
2022-11-19 16:00:00+00,20353,237,4444,9052,634,1966,1371,476,0,368,38901,231,15501,14130,9686,20590
2022-11-19 16:30:00+00,20711,235,4441,9303,758,2000,1369,884,0,744,40445,228,15871,14502,10061,20946
2022-11-19 17:00:00+00,20887,240,4436,9313,777,2000,1372,904,0,1124,41053,227,15898,14526,10090,21127
2022-11-19 17:30:00+00,20773,309,4442,9435,780,1974,1365,809,0,1172,41059,227,16022,14657,10215,21082
2022-11-19 18:00:00+00,20733,269,4437,9745,741,1732,1556,695,0,784,40692,227,16479,14923,10486,21002
2022-11-19 18:30:00+00,20320,230,4440,10088,632,1684,1892,256,0,422,39964,224,17052,15160,10720,20550
2022-11-19 19:00:00+00,20163,234,4435,10323,624,1496,2035,199,0,70,39579,224,17417,15382,10947,20397
2022-11-19 19:30:00+00,19324,230,4439,10483,644,1398,2032,123,0,0,38673,220,17598,15566,11127,19554
2022-11-19 20:00:00+00,18658,231,4433,10582,660,728,2035,127,0,0,37454,216,17710,15675,11242,18889
2022-11-19 20:30:00+00,17450,230,4440,10823,659,640,2027,126,0,0,36395,209,17949,15922,11482,17680
2022-11-19 21:00:00+00,16706,224,4432,10753,574,514,2035,178,0,0,35416,206,17794,15759,11327,16930
2022-11-19 21:30:00+00,15844,0,4438,10874,551,566,2018,148,0,0,34439,196,17881,15863,11425,15844
2022-11-19 22:00:00+00,14837,0,4441,10481,541,1014,2026,147,0,0,33487,191,17489,15463,11022,14837
2022-11-19 22:30:00+00,13950,0,4440,10555,512,976,2035,131,0,0,32599,184,17542,15507,11067,13950
2022-11-19 23:00:00+00,13429,0,4436,10559,497,474,2038,149,0,0,31582,182,17530,15492,11056,13429
2022-11-19 23:30:00+00,12649,0,4443,10955,493,236,2025,127,0,0,30928,173,17916,15891,11448,12649
2022-11-20 00:00:00+00,12761,0,4441,10866,505,40,2028,132,0,0,30773,173,17840,15812,11371,12761
2022-11-20 00:30:00+00,12911,0,4440,10857,525,0,2031,159,0,0,30923,174,17853,15822,11382,12911
2022-11-20 01:00:00+00,13004,0,4425,10888,487,118,2031,142,0,0,31095,176,17831,15800,11375,13004
2022-11-20 01:30:00+00,12777,0,4444,10978,473,76,2028,112,0,0,30888,173,17923,15895,11451,12777
2022-11-20 02:00:00+00,12418,0,4441,10895,455,64,2049,117,0,0,30439,171,17840,15791,11350,12418
2022-11-20 02:30:00+00,12098,0,4444,10846,462,56,2048,118,0,0,30072,169,17800,15752,11308,12098
2022-11-20 03:00:00+00,11855,0,4443,10482,499,112,2045,135,0,0,29571,169,17469,15424,10981,11855
2022-11-20 03:30:00+00,11677,0,4439,10124,511,110,2042,141,0,0,29044,170,17116,15074,10635,11677
2022-11-20 04:00:00+00,11768,0,4442,9999,510,6,2051,135,0,0,28911,170,17002,14951,10509,11768
2022-11-20 04:30:00+00,11620,0,4442,10101,512,4,2043,129,0,0,28851,169,17098,15055,10613,11620
2022-11-20 05:00:00+00,11297,0,4443,10520,523,112,2035,130,0,0,29060,165,17521,15486,11043,11297
2022-11-20 05:30:00+00,11152,0,4441,10796,524,124,2045,130,0,0,29212,162,17806,15761,11320,11152
2022-11-20 06:00:00+00,11438,0,4449,11192,556,32,2041,131,0,0,29839,161,18238,16197,11748,11438
2022-11-20 06:30:00+00,11576,0,4448,11778,559,66,2038,131,0,0,30596,159,18823,16785,12337,11576
2022-11-20 07:00:00+00,12264,0,4443,11922,561,0,2033,149,0,0,31372,163,18959,16926,12483,12264
2022-11-20 07:30:00+00,12874,0,4447,11986,562,0,2016,167,9,0,32061,167,19020,17004,12557,12874
2022-11-20 08:00:00+00,13778,0,4443,12235,566,0,2039,191,215,0,33467,171,19498,17459,13016,13778
2022-11-20 08:30:00+00,15004,0,4444,11725,567,60,2043,222,804,0,34869,179,19583,17540,13096,15004
2022-11-20 09:00:00+00,16391,0,4447,10833,723,270,2039,199,1444,58,36404,189,19486,17447,13000,16391
2022-11-20 09:30:00+00,16675,0,4448,10640,725,452,2041,205,2333,42,37561,189,20187,18146,13698,16675
2022-11-20 10:00:00+00,17027,0,4443,10192,738,538,2042,188,3133,58,38359,189,20548,18506,14063,17027
2022-11-20 10:30:00+00,17459,0,4445,9591,765,566,2042,177,3483,16,38544,193,20326,18284,13839,17459
2022-11-20 11:00:00+00,18058,0,4443,9371,774,480,2011,231,3861,8,39237,195,20460,18449,14006,18058
2022-11-20 11:30:00+00,18487,0,4438,9579,776,574,1723,411,4121,0,40109,197,20637,18914,14476,18487
2022-11-20 12:00:00+00,19000,0,4441,9707,740,596,1528,397,3723,0,40132,201,20139,18611,14170,19000
2022-11-20 12:30:00+00,19016,0,4442,9917,742,738,1403,305,3279,0,39842,203,19783,18380,13938,19016
2022-11-20 13:00:00+00,18384,1,4443,10626,728,700,1396,226,2402,0,38906,200,19595,18199,13756,18385
2022-11-20 13:30:00+00,18330,2,4441,11029,730,662,1394,231,1896,0,38715,201,19490,18096,13655,18332
2022-11-20 14:00:00+00,18549,3,4441,10704,735,778,1391,226,1493,56,38376,206,18764,17373,12932,18552
2022-11-20 14:30:00+00,19702,110,4438,10036,737,652,1363,234,931,46,38249,220,17505,16142,11704,19812
2022-11-20 15:00:00+00,20445,229,4445,9906,764,480,1357,214,407,0,38247,227,16879,15522,11077,20674
2022-11-20 15:30:00+00,20938,315,4440,9832,773,618,1395,314,70,130,38825,233,16510,15115,10675,21253
2022-11-20 16:00:00+00,20985,452,4447,9468,942,772,1398,829,0,570,39863,232,16255,14857,10410,21437
2022-11-20 16:30:00+00,21602,486,4446,9230,960,804,1395,1127,0,1344,41394,231,16031,14636,10190,22088
2022-11-20 17:00:00+00,21330,460,4446,9132,963,1080,1400,1238,0,1700,41749,226,15941,14541,10095,21790
2022-11-20 17:30:00+00,21252,460,4446,8926,965,1062,1408,1128,0,1784,41431,226,15745,14337,9891,21712
2022-11-20 18:00:00+00,20918,459,4451,8898,964,660,1454,716,0,1784,40304,225,15767,14313,9862,21377
2022-11-20 18:30:00+00,20669,467,4446,8694,965,586,1836,491,0,1174,39328,228,15941,14105,9659,21136
2022-11-20 19:00:00+00,20721,459,4449,8869,944,212,2025,396,0,1014,39089,229,16287,14262,9813,21180
2022-11-20 19:30:00+00,20091,460,4443,8484,936,160,2013,307,0,866,37760,230,15876,13863,9420,20551
2022-11-20 20:00:00+00,20656,450,4441,7389,934,70,1996,268,0,816,37020,241,14760,12764,8323,21106
2022-11-20 20:30:00+00,21193,230,4438,6701,920,218,1970,211,0,188,36069,249,14029,12059,7621,21423
2022-11-20 21:00:00+00,21156,322,4443,6486,767,502,2053,238,0,248,36215,254,13749,11696,7253,21478
2022-11-20 21:30:00+00,20153,236,4444,6264,766,688,2055,185,0,6,34797,252,13529,11474,7030,20389
2022-11-20 22:00:00+00,19374,223,4443,6110,755,824,2056,169,0,18,33972,251,13364,11308,6865,19597
2022-11-20 22:30:00+00,18667,112,4443,6078,742,724,2056,172,0,0,32993,245,13319,11263,6820,18778
2022-11-20 23:00:00+00,18078,0,4443,5449,710,622,2056,166,0,66,31590,244,12658,10602,6159,18078
2022-11-20 23:30:00+00,17792,0,4440,4944,708,584,2055,170,0,0,30693,247,12147,10092,5652,17792
2022-11-21 00:00:00+00,18207,0,4445,4363,681,750,2054,183,0,0,30683,255,11543,9489,5044,18207
2022-11-21 00:30:00+00,18751,0,4442,3900,679,884,2056,181,0,0,30893,262,11077,9021,4579,18751
2022-11-21 01:00:00+00,18870,0,4446,3458,577,904,2053,173,0,0,30481,267,10534,8481,4035,18870
2022-11-21 01:30:00+00,18627,0,4442,3462,528,904,2050,172,0,0,30185,267,10482,8432,3990,18627
2022-11-21 02:00:00+00,18382,0,4445,3566,526,904,2047,170,0,0,30040,265,10584,8537,4092,18382
2022-11-21 02:30:00+00,18124,0,4447,3770,525,904,2053,170,0,0,29993,262,10795,8742,4295,18124
2022-11-21 03:00:00+00,18010,0,4443,4103,525,904,2047,164,0,0,30196,258,11118,9071,4628,18010
2022-11-21 03:30:00+00,17793,0,4442,4313,523,904,2043,164,0,0,30182,256,11321,9278,4836,17793
2022-11-21 04:00:00+00,17699,0,4443,4607,531,904,2045,164,0,0,30393,253,11626,9581,5138,17699
2022-11-21 04:30:00+00,17599,46,4446,4990,528,904,2039,165,0,0,30717,250,12003,9964,5518,17645
2022-11-21 05:00:00+00,16717,93,4444,5259,532,904,2051,170,0,0,30170,245,12286,10235,5791,16810
2022-11-21 05:30:00+00,17216,139,4449,5510,529,904,2045,167,0,0,30959,246,12533,10488,6039,17355
2022-11-21 06:00:00+00,16667,230,4446,6408,529,904,2046,185,0,0,31415,239,13429,11383,6937,16897
2022-11-21 06:30:00+00,17936,375,4453,7086,535,904,2048,285,0,0,33622,243,14122,12074,7621,18311
2022-11-21 07:00:00+00,18086,595,4449,7341,665,993,2045,569,0,0,34743,247,14500,12455,8006,18681
2022-11-21 07:30:00+00,18445,679,4454,7931,737,1074,2041,510,1,300,36172,243,15164,13123,8669,19124
2022-11-21 08:00:00+00,18394,579,4449,8331,797,1492,2033,584,47,658,37364,238,15657,13624,9175,18973
2022-11-21 08:30:00+00,18354,540,4457,8811,801,1510,2042,678,166,670,38029,234,16277,14235,9778,18894
2022-11-21 09:00:00+00,19517,551,4452,9415,798,1010,2043,786,251,754,39577,232,16959,14916,10464,20068
2022-11-21 09:30:00+00,19479,556,4455,10040,785,1010,2039,803,289,624,40080,229,17608,15569,11114,20035
2022-11-21 10:00:00+00,20390,558,4453,10680,767,906,2042,804,402,196,41198,230,18344,16302,11849,20948
2022-11-21 10:30:00+00,20532,555,4451,11149,726,874,2038,789,516,132,41762,228,18880,16842,12391,21087
2022-11-21 11:00:00+00,20562,562,4450,11837,826,616,2041,720,625,104,42343,221,19779,17738,13288,21124
2022-11-21 11:30:00+00,19817,564,4450,12482,862,444,2038,670,688,168,42183,213,20520,18482,14032,20381
2022-11-21 12:00:00+00,20242,583,4447,13252,701,314,2047,669,644,126,43025,212,21091,19044,14597,20825
2022-11-21 12:30:00+00,20172,545,4444,13605,801,218,2042,632,611,140,43210,208,21503,19461,15017,20717
2022-11-21 13:00:00+00,20922,461,4449,14296,662,356,2035,336,631,4,44152,207,22073,20038,15589,21383
2022-11-21 13:30:00+00,20493,459,4443,14584,609,354,2041,272,573,0,43828,204,22250,20209,15766,20952
2022-11-21 14:00:00+00,20481,458,4451,14930,622,243,2025,280,417,98,44005,202,22445,20420,15969,20939
2022-11-21 14:30:00+00,19512,458,4448,15279,672,199,2027,276,314,0,43186,197,22740,20713,16265,19970
2022-11-21 15:00:00+00,19738,363,4451,15380,742,40,2033,247,183,72,43249,195,22789,20756,16305,20101
2022-11-21 15:30:00+00,19791,230,4451,15504,757,106,2039,462,43,554,43937,192,22794,20755,16304,20021
2022-11-21 16:00:00+00,19013,234,4454,15890,779,186,2045,579,0,616,43796,187,23168,21122,16668,19247
2022-11-21 16:30:00+00,18841,230,4459,16230,780,400,2043,796,0,1600,45379,182,23512,21469,17010,19071
2022-11-21 17:00:00+00,19037,230,4456,15891,808,198,2043,1264,0,1710,45637,184,23198,21155,16699,19267
2022-11-21 17:30:00+00,19253,238,4459,15438,924,256,2046,1182,0,1478,45274,187,22867,20821,16362,19491
2022-11-21 18:00:00+00,18857,239,4460,14915,930,452,2048,972,0,1342,44215,190,22353,20305,15845,19096
2022-11-21 18:30:00+00,18802,242,4462,14753,853,456,2050,698,0,1092,43408,191,22118,20068,15606,19044
2022-11-21 19:00:00+00,19677,0,4464,14839,822,654,2050,642,0,590,43738,194,22175,20125,15661,19677
2022-11-21 19:30:00+00,19504,0,4465,14525,742,642,2044,374,0,334,42630,196,21776,19732,15267,19504
2022-11-21 20:00:00+00,19856,0,4457,13948,743,600,2029,301,0,292,42226,200,21177,19148,14691,19856
2022-11-21 20:30:00+00,19131,0,4456,14034,729,560,2002,200,0,0,41112,197,21221,19219,14763,19131
2022-11-21 21:00:00+00,18530,0,4453,14377,684,560,2038,192,0,60,40894,192,21552,19514,15061,18530
2022-11-21 21:30:00+00,17036,0,4454,14273,681,450,2051,167,0,0,39112,184,21459,19408,14954,17036
2022-11-21 22:00:00+00,15615,0,4456,14141,660,392,2049,162,0,0,37475,177,21306,19257,14801,15615
2022-11-21 22:30:00+00,13828,0,4458,14148,620,274,2039,165,0,0,35532,165,21265,19226,14768,13828
2022-11-21 23:00:00+00,12022,0,4453,13748,582,136,2051,172,0,0,33164,154,20834,18783,14330,12022
2022-11-21 23:30:00+00,11920,0,4453,13336,582,14,2046,178,0,0,32530,154,20418,18372,13918,11920
2022-11-22 00:00:00+00,11900,0,4453,12725,581,0,2019,172,0,0,31850,156,19778,17759,13306,11900
2022-11-22 00:30:00+00,12529,0,4456,12190,579,60,2040,181,0,0,32035,164,19265,17225,12769,12529
2022-11-22 01:00:00+00,12329,0,4458,11516,482,164,2041,167,0,0,31157,168,18497,16456,11998,12329
2022-11-22 01:30:00+00,12146,0,4458,10988,473,40,2044,218,0,0,30367,168,17963,15919,11461,12146
2022-11-22 02:00:00+00,11263,0,4460,10620,457,2,2042,178,0,0,29022,163,17579,15537,11077,11263
2022-11-22 02:30:00+00,11053,0,4456,10370,456,2,2047,179,0,0,28563,163,17329,15282,10826,11053
2022-11-22 03:00:00+00,11677,0,4463,10337,455,0,2023,162,0,0,29117,168,17278,15255,10792,11677
2022-11-22 03:30:00+00,12572,0,4461,9911,455,0,2018,162,0,0,29579,177,16845,14827,10366,12572
2022-11-22 04:00:00+00,13611,0,4459,9520,455,66,2020,170,0,0,30301,188,16454,14434,9975,13611
2022-11-22 04:30:00+00,14031,0,4461,9290,452,84,2017,171,0,0,30506,192,16220,14203,9742,14031
2022-11-22 05:00:00+00,14063,0,4460,9289,444,272,2003,168,0,0,30699,194,16196,14193,9733,14063
2022-11-22 05:30:00+00,14614,0,4460,9499,447,196,2020,174,0,0,31410,196,16426,14406,9946,14614
2022-11-22 06:00:00+00,15284,130,4462,9652,465,356,2033,168,0,0,32550,203,16612,14579,10117,15414
2022-11-22 06:30:00+00,18147,305,4457,9298,489,546,1776,173,0,0,35191,226,16020,14244,9787,18452
2022-11-22 07:00:00+00,20403,399,4460,9037,627,536,1755,404,0,18,37639,236,15879,14124,9664,20802
2022-11-22 07:30:00+00,21340,633,4459,8342,677,414,1796,526,1,446,38634,244,15275,13479,9020,21973
2022-11-22 08:00:00+00,21180,629,4457,7792,730,940,1796,567,99,702,38892,243,14874,13078,8621,21809
2022-11-22 08:30:00+00,21645,583,4458,7566,840,1016,1796,512,481,624,39521,242,15141,13345,8887,22228
2022-11-22 09:00:00+00,21877,616,4458,6696,865,1366,1881,371,1081,862,40073,241,14981,13100,8642,22493
2022-11-22 09:30:00+00,22167,618,4460,6362,861,1406,1898,561,1801,840,40974,240,15382,13484,9024,22785
2022-11-22 10:00:00+00,21781,639,4457,6154,876,1234,1961,888,2339,796,41125,236,15787,13826,9369,22420
2022-11-22 10:30:00+00,21772,637,4455,5888,875,1254,1982,965,2678,930,41436,235,15878,13896,9441,22409
2022-11-22 11:00:00+00,20984,646,4457,5574,713,1530,1980,902,2771,912,40469,233,15495,13515,9058,21630
2022-11-22 11:30:00+00,21228,625,4454,5149,708,1548,1978,929,2633,1004,40256,236,14922,12944,8490,21853
2022-11-22 12:00:00+00,19785,616,4458,4678,740,2666,1976,899,2597,754,39169,232,14449,12473,8015,20401
2022-11-22 12:30:00+00,19808,521,4454,4538,717,2726,1978,889,2581,876,39088,231,14268,12290,7836,20329
2022-11-22 13:00:00+00,19708,569,4445,4304,702,2668,1979,895,2353,906,38529,236,13783,11804,7359,20277
2022-11-22 13:30:00+00,19825,628,4451,3972,732,2684,1979,882,2016,868,38037,241,13150,11171,6720,20453
2022-11-22 14:00:00+00,19354,635,4446,3881,865,3508,1979,885,1403,590,37546,243,12574,10595,6149,19989
2022-11-22 14:30:00+00,19612,622,4452,3726,900,3552,2018,825,809,526,37042,248,11905,9887,5435,20234
2022-11-22 15:00:00+00,19484,613,4452,3457,801,4500,2024,676,311,864,37182,247,11045,9021,4569,20097
2022-11-22 15:30:00+00,19408,677,4456,3415,784,4538,2023,1009,42,1354,37706,248,10720,8697,4241,20085
2022-11-22 16:00:00+00,19462,610,4457,3422,840,6002,2023,1123,0,1294,39233,242,10742,8719,4262,20072
2022-11-22 16:30:00+00,20071,622,4460,3441,979,6082,2023,1187,0,1444,40309,243,10903,8880,4420,20693
2022-11-22 17:00:00+00,20667,576,4461,3380,969,6346,2039,1327,0,1432,41197,243,10849,8810,4349,21243
2022-11-22 17:30:00+00,20799,477,4468,3272,967,6360,2045,1280,0,1686,41354,241,10752,8707,4239,21276
2022-11-22 18:00:00+00,20676,292,4463,3332,967,6330,2046,996,0,1682,40784,236,10808,8762,4299,20968
2022-11-22 18:30:00+00,20517,303,4463,3468,966,6328,2047,1050,0,1262,40404,238,10944,8897,4434,20820
2022-11-22 19:00:00+00,20599,300,4465,3603,1002,4508,2046,1201,0,746,38470,249,11116,9070,4605,20899
2022-11-22 19:30:00+00,19941,253,4463,3745,953,4432,2043,787,0,956,37573,244,11204,9161,4698,20194
2022-11-22 20:00:00+00,20615,295,4463,3858,804,3404,2044,720,0,786,36989,255,11169,9125,4662,20910
2022-11-22 20:30:00+00,19571,302,4459,4148,854,3614,2042,564,0,738,36292,250,11503,9461,5002,19873
2022-11-22 21:00:00+00,20289,384,4459,4514,780,2958,2046,799,0,362,36592,256,11800,9754,5294,20673
2022-11-22 21:30:00+00,19088,302,4459,4891,701,3144,2044,368,0,0,34997,252,12095,10051,5592,19390
2022-11-22 22:00:00+00,19239,301,4456,4926,629,2194,2030,213,0,102,34090,253,12041,10011,5555,19540
2022-11-22 22:30:00+00,17930,125,4461,4607,626,2202,2019,188,0,292,32450,245,11713,9694,5233,18055
2022-11-22 23:00:00+00,17246,0,4467,4669,517,2008,2031,175,0,378,31491,236,11684,9653,5186,17246
2022-11-22 23:30:00+00,16575,0,4465,4951,513,1720,2044,182,0,0,30450,231,11973,9929,5464,16575
2022-11-23 00:00:00+00,15392,0,4466,5429,509,1612,2044,169,0,0,29621,220,12448,10404,5938,15392
2022-11-23 00:30:00+00,14976,0,4464,5873,504,1700,2021,171,0,0,29709,215,12862,10841,6377,14976
2022-11-23 01:00:00+00,14255,0,4462,6021,476,2056,2017,182,0,0,29469,213,12976,10959,6497,14255
2022-11-23 01:30:00+00,13572,0,4466,6246,457,2094,2018,171,0,0,29024,208,13187,11169,6703,13572
2022-11-23 02:00:00+00,13534,0,4468,6862,447,1740,2014,170,0,0,29235,206,13791,11777,7309,13534
2022-11-23 02:30:00+00,12408,0,4467,7861,445,1692,2016,162,0,0,29051,193,14789,12773,8306,12408
2022-11-23 03:00:00+00,12086,0,4466,8575,444,1300,2020,172,0,0,29063,188,15505,13485,9019,12086
2022-11-23 03:30:00+00,11328,0,4468,9297,443,1146,2031,159,0,0,28872,177,16239,14208,9740,11328
2022-11-23 04:00:00+00,11642,0,4469,10035,443,842,2017,160,0,0,29608,178,16964,14947,10478,11642
2022-11-23 04:30:00+00,11311,0,4469,10795,442,690,2011,159,0,0,29877,169,17717,15706,11237,11311
2022-11-23 05:00:00+00,11914,0,4463,11362,430,600,2019,185,0,0,30973,170,18274,16255,11792,11914
2022-11-23 05:30:00+00,12169,0,4471,12273,361,542,2006,168,0,0,31990,167,19111,17105,12634,12169
2022-11-23 06:00:00+00,13615,0,4468,13337,371,298,2011,170,0,0,34270,169,20187,18176,13708,13615
2022-11-23 06:30:00+00,14331,0,4466,14842,436,122,2010,191,0,0,36398,165,21754,19744,15278,14331
2022-11-23 07:00:00+00,15728,0,4467,16289,449,12,2003,180,0,0,39128,166,23208,21205,16738,15728
2022-11-23 07:30:00+00,16296,0,4468,17638,408,0,2008,178,3,0,40999,164,24525,22517,18049,16296
2022-11-23 08:00:00+00,15892,0,4466,18759,425,0,2012,159,70,0,41783,157,25732,23720,19254,15892
2022-11-23 08:30:00+00,15574,4,4465,19276,463,0,1992,180,244,0,42198,152,26440,24448,19983,15578
2022-11-23 09:00:00+00,15617,174,4464,19376,480,260,1333,190,655,0,42549,156,26308,24975,20511,15791
2022-11-23 09:30:00+00,15769,229,4467,19138,481,274,1346,155,1184,0,43043,157,26616,25270,20803,15998
2022-11-23 10:00:00+00,16268,282,4302,18795,525,16,1362,424,1728,0,43702,160,26712,25350,21048,16550
2022-11-23 10:30:00+00,16377,234,4469,18582,454,74,1357,167,2657,0,44371,156,27519,26162,21693,16611
2022-11-23 11:00:00+00,16484,244,4468,18033,413,202,1357,171,3088,0,44460,158,27359,26002,21534,16728
2022-11-23 11:30:00+00,16579,233,4469,17541,402,264,1357,160,3649,0,44654,159,27418,26061,21592,16812
2022-11-23 12:00:00+00,16364,229,4469,17226,382,388,1448,170,3849,0,44525,159,27374,25926,21457,16593
2022-11-23 12:30:00+00,16231,229,4467,17150,380,458,1807,163,3590,0,44475,159,27394,25587,21120,16460
2022-11-23 13:00:00+00,15209,230,4465,17093,379,660,1972,183,3034,0,43225,157,26943,24971,20506,15439
2022-11-23 13:30:00+00,15221,229,4468,16948,390,746,1977,174,2483,0,42636,160,26266,24289,19821,15450
2022-11-23 14:00:00+00,14734,229,4459,16741,404,906,1978,182,1428,0,41061,164,25010,23032,18573,14963
2022-11-23 14:30:00+00,15256,229,4459,16424,406,948,1977,184,1127,0,41010,169,24393,22416,17957,15485
2022-11-23 15:00:00+00,15716,230,4462,16220,478,876,1982,161,457,0,40582,173,23599,21617,17155,15946
2022-11-23 15:30:00+00,16058,230,4459,16321,602,952,1986,203,55,50,40916,175,23423,21437,16978,16288
2022-11-23 16:00:00+00,15350,231,4463,16704,685,1366,1989,299,0,340,41427,168,23841,21852,17389,15581
2022-11-23 16:30:00+00,15660,229,4462,17186,771,1298,2010,833,0,956,43405,165,24429,22419,17957,15889
2022-11-23 17:00:00+00,15657,228,4464,17128,788,1562,2012,939,0,1288,44066,162,24392,22380,17916,15885
2022-11-23 17:30:00+00,15563,230,4467,17496,766,1478,2010,868,0,1188,44066,160,24739,22729,18262,15793
2022-11-23 18:00:00+00,16268,229,4469,17453,742,1242,2012,734,0,904,44053,167,24676,22664,18195,16497
2022-11-23 18:30:00+00,16322,226,4469,17103,743,1288,2016,530,0,602,43299,170,24331,22315,17846,16548
2022-11-23 19:00:00+00,16324,0,4472,16989,744,1040,2015,389,0,74,42047,170,24220,22205,17733,16324
2022-11-23 19:30:00+00,15558,0,4473,16712,744,918,2013,257,0,0,40675,167,23942,21929,17456,15558
2022-11-23 20:00:00+00,14609,0,4473,17230,686,726,2009,255,0,0,39988,160,24398,22389,17916,14609
2022-11-23 20:30:00+00,12983,0,4477,17826,649,604,2008,264,0,0,38811,147,24960,22952,18475,12983
2022-11-23 21:00:00+00,11444,0,4475,17783,497,772,2018,309,0,64,37362,136,24773,22755,18280,11444
2022-11-23 21:30:00+00,10068,0,4478,17923,467,710,2010,246,0,0,35902,125,24878,22868,18390,10068
2022-11-23 22:00:00+00,9566,0,4474,17982,403,582,2015,235,0,0,35257,123,24874,22859,18385,9566
2022-11-23 22:30:00+00,8204,0,4476,18280,388,536,2018,234,0,0,34136,111,25162,23144,18668,8204
2022-11-23 23:00:00+00,6210,0,4476,17754,355,892,2021,238,0,0,31946,93,24606,22585,18109,6210
2022-11-23 23:30:00+00,5288,0,4478,17556,353,1026,2024,227,0,0,30952,86,24411,22387,17909,5288
2022-11-24 00:00:00+00,4042,0,4477,17863,353,766,2020,224,0,0,29745,75,24713,22693,18216,4042
2022-11-24 00:30:00+00,4126,0,4476,17889,353,848,2011,242,0,0,29945,77,24729,22718,18242,4126
2022-11-24 01:00:00+00,4564,0,4477,17667,349,758,1996,184,0,0,29995,81,24489,22493,18016,4564
2022-11-24 01:30:00+00,4364,0,4478,17475,352,632,1992,181,0,0,29474,78,24297,22305,17827,4364
2022-11-24 02:00:00+00,4600,0,4480,17196,369,620,2000,173,0,0,29438,81,24045,22045,17565,4600
2022-11-24 02:30:00+00,4621,0,4481,16936,367,572,2019,183,0,0,29179,82,23803,21784,17303,4621
2022-11-24 03:00:00+00,4526,0,4478,16858,364,794,1990,178,0,0,29188,84,23690,21700,17222,4526
2022-11-24 03:30:00+00,4206,0,4481,16937,368,734,1983,172,0,0,28881,79,23769,21786,17305,4206
2022-11-24 04:00:00+00,4778,0,4479,16684,368,872,1984,172,0,0,29337,88,23515,21531,17052,4778
2022-11-24 04:30:00+00,5432,0,4478,16196,370,904,1983,182,0,0,29545,96,23027,21044,16566,5432
2022-11-24 05:00:00+00,6122,0,4479,16012,375,904,1992,179,0,0,30063,104,22858,20866,16387,6122
2022-11-24 05:30:00+00,6954,0,4476,16024,374,904,2005,189,0,0,30926,112,22879,20874,16398,6954
2022-11-24 06:00:00+00,9506,0,4476,16091,374,904,1998,183,0,0,33532,133,22939,20941,16465,9506
2022-11-24 06:30:00+00,11567,0,4475,16471,383,904,1998,189,0,8,35995,146,23327,21329,16854,11567
2022-11-24 07:00:00+00,13309,96,4475,16483,454,904,2009,291,0,144,38165,159,23421,21412,16937,13405
2022-11-24 07:30:00+00,13789,224,4475,17036,495,904,2004,423,4,128,39482,163,24014,22010,17535,14013
2022-11-24 08:00:00+00,13753,229,4472,17037,535,904,2027,422,224,272,39875,161,24295,22268,17796,13982
2022-11-24 08:30:00+00,14096,230,4481,16961,516,904,2024,359,531,206,40308,162,24513,22489,18008,14326
2022-11-24 09:00:00+00,14774,229,4478,17010,527,904,1998,274,916,128,41238,164,24929,22931,18453,15003
2022-11-24 09:30:00+00,15014,229,4474,16807,526,904,1999,251,1168,250,41622,165,24974,22975,18501,15243
2022-11-24 10:00:00+00,15314,229,4480,16917,517,904,1994,206,1463,378,42402,164,25371,23377,18897,15543
2022-11-24 10:30:00+00,14987,230,4479,17019,582,882,2014,230,1393,286,42102,162,25487,23473,18994,15217
2022-11-24 11:00:00+00,15034,229,4483,17534,687,902,2009,286,2002,340,43506,158,26715,24706,20223,15263
2022-11-24 11:30:00+00,14526,230,4479,18404,675,904,2011,291,1746,330,43596,153,27315,25304,20825,14756
2022-11-24 12:00:00+00,14575,230,4481,19560,621,904,2015,302,1513,250,44451,151,28190,26175,21694,14805
2022-11-24 12:30:00+00,15279,229,4484,20172,534,896,2010,254,1278,0,45136,154,28478,26468,21984,15508
2022-11-24 13:00:00+00,15546,231,4478,20369,500,854,2015,230,953,0,45176,156,28315,26300,21822,15777
2022-11-24 13:30:00+00,15888,271,4476,19884,499,904,2012,202,821,124,45081,160,27692,25680,21204,16159
2022-11-24 14:00:00+00,16559,382,4479,19711,514,904,2039,189,645,0,45422,167,27388,25349,20870,16941
2022-11-24 14:30:00+00,16409,264,4477,19489,522,904,2045,200,624,54,44988,165,27157,25112,20635,16673
2022-11-24 15:00:00+00,16131,289,4476,19300,544,814,2013,237,313,70,44187,165,26646,24633,20157,16420
2022-11-24 15:30:00+00,16138,344,4477,19416,557,834,2013,422,37,54,44292,168,26500,24487,20010,16482
2022-11-24 16:00:00+00,15947,238,4477,19117,584,714,2013,496,0,38,43624,166,26191,24178,19701,16185
2022-11-24 16:30:00+00,16213,241,4473,18716,598,710,2004,803,0,644,44402,167,25791,23787,19314,16454
2022-11-24 17:00:00+00,16690,230,4472,18506,618,756,2010,998,0,562,44842,169,25606,23596,19124,16920
2022-11-24 17:30:00+00,16740,228,4470,18550,617,652,2010,1040,0,368,44675,169,25647,23637,19167,16968
2022-11-24 18:00:00+00,15883,241,4474,18753,659,412,2016,974,0,690,44102,163,25902,23886,19412,16124
2022-11-24 18:30:00+00,15902,239,4478,18846,663,324,2017,759,0,518,43746,162,26004,23987,19509,16141
2022-11-24 19:00:00+00,16343,192,4480,19061,655,398,2016,575,0,136,43856,165,26212,24196,19716,16535
2022-11-24 19:30:00+00,16048,0,4477,18723,621,326,2019,419,0,62,42695,160,25840,23821,19344,16048
2022-11-24 20:00:00+00,15341,0,4482,18590,592,180,2010,335,0,4,41534,156,25674,23664,19182,15341
2022-11-24 20:30:00+00,14223,0,4484,18250,553,172,2010,294,0,0,39986,150,25297,23287,18803,14223
2022-11-24 21:00:00+00,13093,0,4481,18001,537,38,2016,200,0,0,38366,143,25035,23019,18538,13093
2022-11-24 21:30:00+00,11563,0,4484,17371,531,66,2016,192,0,0,36223,135,24402,22386,17902,11563
2022-11-24 22:00:00+00,11033,0,4476,16640,506,216,2017,201,0,0,35089,135,23639,21622,17146,11033
2022-11-24 22:30:00+00,9766,0,4477,16436,506,202,2017,186,0,0,33590,126,23436,21419,16942,9766
2022-11-24 23:00:00+00,7864,0,4481,16420,462,308,2013,198,0,0,31746,112,23376,21363,16882,7864
2022-11-24 23:30:00+00,6644,0,4482,16432,461,600,2004,181,0,0,30804,103,23379,21375,16893,6644
2022-11-25 00:00:00+00,5461,0,4482,16978,452,1136,2013,187,0,0,30709,91,23925,21912,17430,5461
2022-11-25 00:30:00+00,5902,0,4479,16790,455,1258,2019,210,0,0,31113,97,23743,21724,17245,5902
2022-11-25 01:00:00+00,6077,0,4479,16890,457,832,2018,208,0,0,30961,99,23844,21826,17347,6077
2022-11-25 01:30:00+00,5316,0,4482,17115,456,694,2016,199,0,0,30278,90,24069,22053,17571,5316
2022-11-25 02:00:00+00,5077,0,4478,17069,440,744,2016,187,0,0,30011,88,24003,21987,17509,5077
2022-11-25 02:30:00+00,4727,0,4485,17267,394,716,2012,177,0,0,29778,83,24158,22146,17661,4727
2022-11-25 03:00:00+00,4297,0,4482,17256,389,712,2016,177,0,0,29329,79,24143,22127,17645,4297
2022-11-25 03:30:00+00,4194,0,4449,17191,389,594,2009,180,0,0,29006,77,24038,22029,17580,4194
2022-11-25 04:00:00+00,4532,0,4437,17113,405,664,2015,185,0,0,29351,81,23970,21955,17518,4532
2022-11-25 04:30:00+00,5079,0,4433,16639,405,740,2010,185,0,0,29491,89,23487,21477,17044,5079
2022-11-25 05:00:00+00,5427,0,4459,16781,398,878,2000,170,0,0,30113,94,23638,21638,17179,5427
2022-11-25 05:30:00+00,6377,0,4474,16751,397,828,2015,178,0,0,31020,103,23637,21622,17148,6377
2022-11-25 06:00:00+00,7882,0,4472,16915,446,880,2003,176,0,0,32774,116,23836,21833,17361,7882
2022-11-25 06:30:00+00,10115,0,4469,17187,442,794,2005,191,0,0,35203,132,24103,22098,17629,10115
2022-11-25 07:00:00+00,12816,0,4472,17278,473,632,2011,205,0,38,37925,149,24234,22223,17751,12816
2022-11-25 07:30:00+00,13763,0,4472,17419,479,582,1994,230,2,0,38941,154,24366,22372,17900,13763
2022-11-25 08:00:00+00,13558,0,4464,17425,519,1020,2017,350,231,144,39728,153,24656,22639,18175,13558
2022-11-25 08:30:00+00,14272,0,4471,17299,568,1064,2013,304,1044,0,41035,155,25395,23382,18911,14272
2022-11-25 09:00:00+00,15233,0,4475,17197,571,724,2013,302,2120,0,42635,156,26376,24363,19888,15233
2022-11-25 09:30:00+00,15124,0,4478,17144,551,668,2001,202,3085,0,43253,152,27259,25258,20780,15124
2022-11-25 10:00:00+00,15003,0,4473,17234,533,534,2010,204,3844,0,43835,147,28094,26084,21611,15003
2022-11-25 10:30:00+00,14926,0,4473,16800,515,548,2014,216,4348,0,43840,147,28150,26136,21663,14926
2022-11-25 11:00:00+00,14914,0,4481,16460,499,562,2015,253,4538,8,43730,148,27993,25978,21497,14914
2022-11-25 11:30:00+00,15329,0,4485,15989,476,522,2014,237,4621,0,43673,151,27585,25571,21086,15329
2022-11-25 12:00:00+00,16021,0,4485,15680,464,464,2010,225,4580,0,43929,156,27219,25209,20724,16021
2022-11-25 12:30:00+00,15846,0,4492,15928,463,414,2004,225,4253,0,43625,155,27140,25136,20644,15846
2022-11-25 13:00:00+00,16085,27,4493,15919,505,450,2011,201,3853,0,43545,158,26781,24770,20277,16112
2022-11-25 13:30:00+00,16042,54,4491,16034,502,400,2006,206,3284,0,43020,159,26317,24311,19820,16096
2022-11-25 14:00:00+00,15511,82,4489,16230,486,382,2009,240,2442,82,41953,159,25656,23647,19158,15593
2022-11-25 14:30:00+00,15990,109,4488,16032,487,288,2014,239,1445,186,41278,166,24466,22452,17964,16099
2022-11-25 15:00:00+00,16700,230,4486,15846,484,124,2014,227,535,160,40806,175,23365,21351,16865,16930
2022-11-25 15:30:00+00,17591,230,4486,15742,487,170,2012,230,51,314,41313,182,22778,20766,16280,17821
2022-11-25 16:00:00+00,18537,232,4489,15370,457,482,2010,262,0,254,42093,187,22326,20316,15827,18769
2022-11-25 16:30:00+00,18615,236,4485,15398,458,582,2018,595,0,642,43029,186,22359,20341,15856,18851
2022-11-25 17:00:00+00,18396,234,4482,15470,502,916,2016,904,0,818,43738,183,22470,20454,15972,18630
2022-11-25 17:30:00+00,18364,234,4482,15686,513,948,2014,841,0,1014,44096,180,22695,20681,16199,18598
2022-11-25 18:00:00+00,18068,235,4483,15627,659,950,2018,557,0,936,43533,179,22787,20769,16286,18303
2022-11-25 18:30:00+00,17691,231,4486,15244,681,1068,2013,432,0,576,42422,180,22424,20411,15925,17922
2022-11-25 19:00:00+00,16528,229,4485,15263,543,1258,2014,388,0,592,41300,176,22305,20291,15806,16757
2022-11-25 19:30:00+00,15670,232,4490,15209,517,1438,2005,359,0,334,40254,174,22221,20216,15726,15902
2022-11-25 20:00:00+00,15446,231,4486,14809,515,1224,2014,276,0,324,39325,177,21824,19810,15324,15677
2022-11-25 20:30:00+00,14850,232,4466,14128,514,1220,2013,234,0,400,38057,177,21121,19108,14642,15082
2022-11-25 21:00:00+00,15494,155,4465,13484,471,754,2014,195,0,464,37496,184,20434,18420,13955,15649
2022-11-25 21:30:00+00,14636,77,4447,13076,489,840,2016,200,0,80,35861,182,20028,18012,13565,14713
2022-11-25 22:00:00+00,13955,0,4444,12912,563,756,2018,187,0,130,34965,176,19937,17919,13475,13955
2022-11-25 22:30:00+00,13167,0,4414,12615,556,836,2018,294,0,64,33964,174,19603,17585,13171,13167
2022-11-25 23:00:00+00,11929,0,4411,12370,464,732,2015,254,0,216,32391,165,19260,17245,12834,11929
2022-11-25 23:30:00+00,11232,0,4384,12116,463,558,2012,186,0,312,31263,159,18975,16963,12579,11232
2022-11-26 00:00:00+00,11473,0,4376,12236,461,760,1539,176,0,2,31023,164,18612,17073,12697,11473
2022-11-26 00:30:00+00,11758,0,4357,12457,450,828,1348,178,0,0,31376,166,18612,17264,12907,11758
2022-11-26 01:00:00+00,11532,0,4353,12345,441,904,1354,176,0,0,31105,166,18493,17139,12786,11532
2022-11-26 01:30:00+00,11243,0,4333,12796,441,904,1350,176,0,264,31507,161,18920,17570,13237,11243
2022-11-26 02:00:00+00,11082,0,4330,13186,426,904,1211,174,0,428,31741,157,19153,17942,13612,11082
2022-11-26 02:30:00+00,10963,0,4327,13251,426,904,779,173,0,238,31062,157,18783,18004,13677,10963
2022-11-26 03:00:00+00,10856,0,4304,13142,427,904,482,173,0,74,30362,158,18355,17873,13569,10856
2022-11-26 03:30:00+00,10646,0,4295,12813,426,904,499,175,0,70,29827,158,18033,17534,13239,10646
2022-11-26 04:00:00+00,10687,0,4297,12796,423,904,500,164,0,0,29771,159,18016,17516,13219,10687
2022-11-26 04:30:00+00,10769,0,4270,12980,423,904,502,166,0,0,30014,159,18175,17673,13403,10769
2022-11-26 05:00:00+00,11307,4,4266,13117,424,904,531,170,0,0,30723,162,18338,17807,13541,11311
2022-11-26 05:30:00+00,12013,7,4238,13178,424,904,551,168,0,0,31483,167,18391,17840,13602,12020
2022-11-26 06:00:00+00,13142,177,4241,13537,424,904,587,178,0,0,33190,177,18789,18202,13961,13319
2022-11-26 06:30:00+00,14112,230,4210,13698,424,904,587,186,0,0,34351,184,18919,18332,14122,14342
2022-11-26 07:00:00+00,14956,230,4211,13829,627,904,559,201,0,70,35587,187,19226,18667,14456,15186
2022-11-26 07:30:00+00,15357,229,4213,13910,648,904,566,202,1,0,36030,189,19338,18772,14559,15586
2022-11-26 08:00:00+00,15566,229,4210,14221,508,904,636,202,198,68,36742,188,19773,19137,14927,15795
2022-11-26 08:30:00+00,15627,230,4182,14545,492,904,648,209,618,192,37647,184,20485,19837,15655,15857
2022-11-26 09:00:00+00,15612,230,4178,14903,503,876,645,231,944,96,38218,181,21173,20528,16350,15842
2022-11-26 09:30:00+00,15471,230,4164,15358,494,830,638,232,1153,92,38662,177,21807,21169,17005,15701
2022-11-26 10:00:00+00,15318,229,3965,16035,507,722,636,254,1382,160,39209,172,22525,21889,17924,15547
2022-11-26 10:30:00+00,15124,230,3979,16398,507,620,635,240,1490,246,39469,167,23009,22374,18395,15354
2022-11-26 11:00:00+00,14982,228,3984,16893,508,412,623,229,1549,430,39838,162,23557,22934,18950,15210
2022-11-26 11:30:00+00,14758,229,4017,17526,508,362,619,168,1473,432,40092,158,24143,23524,19507,14987
2022-11-26 12:00:00+00,14557,230,4030,17696,478,380,618,209,1400,232,39830,157,24222,23604,19574,14787
2022-11-26 12:30:00+00,14444,228,4038,17876,480,482,618,189,1263,246,39864,157,24275,23657,19619,14672
2022-11-26 13:00:00+00,14252,230,4035,18477,466,320,663,186,1293,0,39922,153,24934,24271,20236,14482
2022-11-26 13:30:00+00,13572,230,4034,18770,462,330,792,229,930,364,39713,148,24988,24196,20162,13802
2022-11-26 14:00:00+00,13615,230,4044,18940,473,364,1066,194,471,74,39471,150,24994,23928,19884,13845
2022-11-26 14:30:00+00,13489,229,4048,19041,493,278,1172,195,216,0,39161,150,24970,23798,19750,13718
2022-11-26 15:00:00+00,13595,230,4046,19091,493,212,1181,173,70,0,39091,150,24881,23700,19654,13825
2022-11-26 15:30:00+00,13614,230,4046,19455,515,300,1328,251,1,0,39740,150,25345,24017,19971,13844
2022-11-26 16:00:00+00,13917,229,4071,19409,555,378,1489,459,0,0,40507,153,25524,24035,19964,14146
2022-11-26 16:30:00+00,13858,230,4074,19670,556,484,1714,545,0,166,41297,152,26014,24300,20226,14088
2022-11-26 17:00:00+00,14091,230,4126,19813,578,506,1789,551,0,474,42158,150,26306,24517,20391,14321
2022-11-26 17:30:00+00,14015,249,4176,19948,585,470,1794,524,0,478,42239,149,26503,24709,20533,14264
2022-11-26 18:00:00+00,13962,249,4182,19993,583,412,1796,387,0,262,41826,150,26554,24758,20576,14211
2022-11-26 18:30:00+00,13178,229,4180,20208,590,436,1794,251,0,0,40866,144,26772,24978,20798,13407
2022-11-26 19:00:00+00,11741,230,4179,20432,591,490,1791,279,0,64,39797,135,26993,25202,21023,11971
2022-11-26 19:30:00+00,10476,229,4178,20479,562,642,1791,279,0,86,38722,127,27010,25219,21041,10705
2022-11-26 20:00:00+00,9816,229,4177,20469,526,792,1791,273,0,204,38277,124,26963,25172,20995,10045
2022-11-26 20:30:00+00,9066,229,4065,20580,509,832,1791,289,0,124,37485,119,26945,25154,21089,9295
2022-11-26 21:00:00+00,8445,228,3934,20469,472,836,1792,270,0,146,36592,115,26667,24875,20941,8673
2022-11-26 21:30:00+00,7565,175,3943,20397,470,904,1784,275,0,0,35513,109,26594,24810,20867,7740
2022-11-26 22:00:00+00,6581,88,3941,20428,456,890,1790,258,0,0,34431,98,26615,24825,20884,6668
2022-11-26 22:30:00+00,5671,0,3942,20125,450,832,1792,261,0,12,33085,88,26309,24517,20575,5671
2022-11-26 23:00:00+00,4519,0,3940,20062,449,736,1695,251,0,0,31652,76,26146,24451,20511,4519
2022-11-26 23:30:00+00,4349,0,3941,20070,447,552,1773,209,0,0,31341,72,26231,24458,20517,4349
2022-11-27 00:00:00+00,4308,0,3934,20162,457,366,1534,212,0,0,30973,68,26087,24553,20619,4308
2022-11-27 00:30:00+00,4404,0,3937,19879,460,450,1653,210,0,0,30993,71,25929,24276,20339,4404
2022-11-27 01:00:00+00,4459,0,3935,19288,464,552,1790,212,0,0,30700,75,25477,23687,19752,4459
2022-11-27 01:30:00+00,4266,0,3934,18922,463,584,1594,217,0,0,29980,74,24913,23319,19385,4266
2022-11-27 02:00:00+00,4278,0,3938,18537,458,584,1471,222,0,0,29488,74,24404,22933,18995,4278
2022-11-27 02:30:00+00,4340,0,3939,17821,453,584,1510,239,0,0,28886,77,23723,22213,18274,4340
2022-11-27 03:00:00+00,4291,0,3943,17760,448,584,1463,211,0,0,28700,77,23614,22151,18208,4291
2022-11-27 03:30:00+00,4391,0,3940,17522,447,584,1113,217,0,0,28214,78,23022,21909,17969,4391
2022-11-27 04:00:00+00,4618,0,3943,17325,447,584,896,243,0,0,28056,81,22611,21715,17772,4618
2022-11-27 04:30:00+00,4458,0,3942,17080,457,584,962,246,0,0,27729,80,22441,21479,17537,4458
2022-11-27 05:00:00+00,4308,0,3943,16394,462,592,772,246,0,0,26717,80,21571,20799,16856,4308
2022-11-27 05:30:00+00,4401,0,3941,15860,464,604,934,250,0,0,26454,83,21199,20265,16324,4401
2022-11-27 06:00:00+00,4673,0,3942,15371,471,604,1022,240,0,0,26323,88,20806,19784,15842,4673
2022-11-27 06:30:00+00,5517,0,3939,14930,474,604,1166,240,0,0,26870,99,20509,19343,15404,5517
2022-11-27 07:00:00+00,8085,70,3943,14831,473,604,1305,251,0,0,29561,127,20552,19247,15304,8154
2022-11-27 07:30:00+00,9466,139,3944,14093,473,604,1306,211,0,22,30258,144,19816,18510,14566,9605
2022-11-27 08:00:00+00,9479,232,3942,13805,520,612,1305,232,12,0,30139,148,19584,18279,14337,9711
2022-11-27 08:30:00+00,10699,257,3941,13542,529,682,1312,295,106,170,31533,159,19430,18118,14177,10956
2022-11-27 09:00:00+00,11455,285,3944,12747,578,1110,1318,281,309,54,32081,166,18896,17578,13634,11740
2022-11-27 09:30:00+00,11718,417,3944,12778,578,1318,1328,350,605,0,33036,171,19233,17905,13961,12135
2022-11-27 10:00:00+00,12374,562,3941,12305,795,1466,1346,406,883,0,34078,178,19270,17924,13983,12936
2022-11-27 10:30:00+00,13105,659,3941,11856,799,1508,1348,484,997,0,34697,187,18941,17593,13652,13764
2022-11-27 11:00:00+00,13984,714,3947,11555,635,1836,1343,532,1163,40,35749,195,18643,17300,13353,14698
2022-11-27 11:30:00+00,14284,627,3945,11459,632,1854,1349,521,1247,136,36054,193,18632,17283,13338,14911
2022-11-27 12:00:00+00,14787,503,3944,11177,616,2218,1347,589,1319,292,36792,192,18403,17056,13112,15290
2022-11-27 12:30:00+00,15151,495,3947,11343,627,2258,1347,537,1207,0,36912,195,18471,17124,13177,15646
2022-11-27 13:00:00+00,15257,463,3942,10903,722,2182,1349,357,1048,160,36383,196,17964,16615,12673,15720
2022-11-27 13:30:00+00,15822,460,3941,10580,741,2194,1350,274,781,258,36401,202,17393,16043,12102,16282
2022-11-27 14:00:00+00,16975,546,3948,10331,857,2148,1345,246,515,0,36911,213,16996,15651,11703,17521
2022-11-27 14:30:00+00,17135,476,3946,10645,946,2128,1348,249,263,0,37136,212,17148,15800,11854,17611
2022-11-27 15:00:00+00,17797,485,3946,10890,1000,1578,1345,283,100,138,37562,216,17281,15936,11990,18282
2022-11-27 15:30:00+00,18319,491,3941,11063,1024,1576,1350,480,15,204,38463,218,17393,16043,12102,18810
2022-11-27 16:00:00+00,19509,510,3940,10982,961,1942,1350,597,0,586,40377,221,17233,15883,11943,20019
2022-11-27 16:30:00+00,20412,829,3944,10654,954,1986,1358,707,0,752,41596,231,16910,15552,11608,21241
2022-11-27 17:00:00+00,20940,995,3940,10341,852,2012,1362,825,0,846,42113,237,16495,15133,11193,21935
2022-11-27 17:30:00+00,20947,999,3944,10368,813,1948,1357,810,0,814,42000,237,16482,15125,11181,21946
2022-11-27 18:00:00+00,20779,999,3943,10045,804,1446,1362,758,0,870,41006,239,16154,14792,10849,21778
2022-11-27 18:30:00+00,20628,1000,3950,9683,805,1394,1361,564,0,896,40281,240,15799,14438,10488,21628
2022-11-27 19:00:00+00,20439,998,3951,10049,806,1426,1359,400,0,442,39870,241,16165,14806,10855,21437
2022-11-27 19:30:00+00,19728,998,3946,10378,802,1198,1483,344,0,468,39345,234,16609,15126,11180,20726
2022-11-27 20:00:00+00,19449,881,3948,10643,646,816,1561,253,0,386,38583,232,16798,15237,11289,20330
2022-11-27 20:30:00+00,19007,639,3949,10379,647,652,1723,221,0,94,37311,228,16698,14975,11026,19646
2022-11-27 21:00:00+00,18490,888,3953,10256,594,642,1966,208,0,286,37283,230,16769,14803,10850,19378
2022-11-27 21:30:00+00,17770,972,3953,9789,575,544,1996,198,0,0,35797,233,16313,14317,10364,18742
2022-11-27 22:00:00+00,16705,772,3952,9577,545,478,1950,199,0,0,34178,229,16024,14074,10122,17477
2022-11-27 22:30:00+00,15888,847,3949,9412,532,344,1951,215,0,52,33190,226,15844,13893,9944,16735
2022-11-27 23:00:00+00,15129,992,3954,9358,438,214,1991,217,0,0,32293,226,15741,13750,9796,16121
2022-11-27 23:30:00+00,14103,999,3953,9341,424,188,2033,203,0,0,31244,220,15751,13718,9765,15102
2022-11-28 00:00:00+00,13503,998,3947,9031,423,394,2029,201,0,0,30526,218,15430,13401,9454,14501
2022-11-28 00:30:00+00,14033,997,3951,8725,431,588,2029,198,0,0,30952,224,15136,13107,9156,15030
2022-11-28 01:00:00+00,13308,999,3947,8555,415,790,2039,218,0,0,30271,221,14956,12917,8970,14307
2022-11-28 01:30:00+00,13259,996,3954,8049,415,684,2034,206,0,0,29597,224,14452,12418,8464,14255
2022-11-28 02:00:00+00,12813,997,3956,7931,410,704,2024,191,0,0,29026,222,14321,12297,8341,13810
2022-11-28 02:30:00+00,12309,900,3955,7937,398,714,2036,195,0,0,28444,217,14326,12290,8335,13209
2022-11-28 03:00:00+00,12775,961,3956,7126,397,400,2035,183,0,0,27833,231,13514,11479,7523,13736
2022-11-28 03:30:00+00,13038,995,3955,6725,395,390,2031,182,0,0,27711,236,13106,11075,7120,14033
2022-11-28 04:00:00+00,14119,953,3953,6334,382,324,2032,195,0,0,28292,244,12701,10669,6716,15072
2022-11-28 04:30:00+00,14056,891,3955,6426,383,351,2036,194,0,0,28292,242,12800,10764,6809,14947
2022-11-28 05:00:00+00,15316,996,3952,6018,379,648,2040,193,0,0,29542,252,12389,10349,6397,16312
2022-11-28 05:30:00+00,16811,886,3955,5701,376,708,2040,207,0,0,30684,259,12072,10032,6077,17697
2022-11-28 06:00:00+00,18923,863,3954,5207,410,1346,2036,220,0,0,32959,270,11607,9571,5617,19786
2022-11-28 06:30:00+00,20521,1080,3954,4974,445,1572,2036,229,0,186,34997,280,11409,9373,5419,21601
2022-11-28 07:00:00+00,20596,1202,3950,4290,739,2374,2033,394,0,140,35718,284,11012,8979,5029,21798
2022-11-28 07:30:00+00,21321,1327,3950,3163,760,2654,2035,769,0,530,36509,295,9908,7873,3923,22648
2022-11-28 08:00:00+00,21350,1386,3949,3094,848,2680,2036,911,93,492,36839,293,10020,7984,4035,22736
2022-11-28 08:30:00+00,21750,1482,3952,2955,851,2796,2027,778,594,480,37665,293,10379,8352,4400,23232
2022-11-28 09:00:00+00,21958,1494,3950,2502,852,2896,2035,955,1369,482,38493,289,10708,8673,4723,23452
2022-11-28 09:30:00+00,22030,1482,3954,2262,850,2802,2033,986,2096,482,38977,286,11195,9162,5208,23512
2022-11-28 10:00:00+00,22509,1487,3952,1969,872,2194,2037,915,2488,586,39009,282,11318,9281,5329,23996
2022-11-28 10:30:00+00,22338,1491,3953,1773,858,2236,2035,920,2764,478,38846,282,11383,9348,5395,23829
2022-11-28 11:00:00+00,22145,1493,3954,1752,861,2520,2037,897,2973,176,38808,285,11577,9540,5586,23638
2022-11-28 11:30:00+00,21927,1492,3965,1767,892,2754,2037,892,3073,166,38965,284,11734,9697,5732,23419
2022-11-28 12:00:00+00,21211,1491,3968,1587,893,3510,2040,899,2959,120,38678,285,11447,9407,5439,22702
2022-11-28 12:30:00+00,21675,1496,3961,1546,883,3576,2040,902,2892,6,38977,288,11322,9282,5321,23171
2022-11-28 13:00:00+00,21542,1495,3958,1541,883,3710,2039,936,2301,48,38453,290,10722,8683,4725,23037
2022-11-28 13:30:00+00,21385,1494,3962,1569,891,3752,2042,1054,1897,0,38046,292,10361,8319,4357,22879
2022-11-28 14:00:00+00,21443,1494,3958,1451,879,4044,2041,1099,1431,72,37912,295,9760,7719,3761,22937
2022-11-28 14:30:00+00,21618,1494,3964,1378,887,4042,2042,1099,824,6,37354,301,9095,7053,3089,23112
2022-11-28 15:00:00+00,21432,1492,3962,1281,916,3680,2045,1091,303,704,36906,299,8507,6462,2500,22924
2022-11-28 15:30:00+00,22115,1324,3961,790,954,3734,2044,1060,31,1328,37341,298,7780,5736,1775,23439
2022-11-28 16:00:00+00,21813,1008,3961,809,1010,5706,2044,1118,0,1316,38785,283,7824,5780,1819,22821
2022-11-28 16:30:00+00,22871,975,3960,729,1043,5634,2044,1279,0,1626,40161,283,7776,5732,1772,23846
2022-11-28 17:00:00+00,22961,992,3962,650,1024,5897,2050,1585,0,1288,40409,285,7686,5636,1674,23953
2022-11-28 17:30:00+00,22770,899,3958,582,1023,5909,2050,1530,0,1564,40285,282,7613,5563,1605,23669
2022-11-28 18:00:00+00,22715,906,3962,610,1000,5910,2051,1360,0,1546,40060,282,7622,5572,1610,23621
2022-11-28 18:30:00+00,22310,997,3962,607,905,5896,2050,1262,0,1310,39299,284,7524,5474,1512,23307
2022-11-28 19:00:00+00,22287,999,3963,597,885,5508,2051,1242,0,840,38372,291,7496,5445,1482,23286
2022-11-28 19:30:00+00,21854,1002,3959,605,883,5412,2050,1089,0,482,37336,293,7497,5447,1488,22856
2022-11-28 20:00:00+00,22528,1000,3963,557,883,3842,2047,1084,0,90,35994,307,7450,5403,1440,23528
2022-11-28 20:30:00+00,21230,1002,3957,536,881,3708,2046,1053,0,296,34709,303,7420,5374,1417,22232
2022-11-28 21:00:00+00,21532,999,3963,543,835,2679,2042,1008,0,192,33793,309,7383,5341,1378,22531
2022-11-28 21:30:00+00,20759,1000,3967,554,814,2226,2048,793,0,76,32237,309,7383,5335,1368,21759
2022-11-28 22:00:00+00,21309,1000,3966,557,759,1756,2135,640,0,58,32180,311,7417,5282,1316,22309
2022-11-28 22:30:00+00,20213,1000,3965,574,651,1676,2152,433,0,50,30714,309,7342,5190,1225,21213
2022-11-28 23:00:00+00,19521,999,3964,573,552,1442,2216,359,0,0,29626,305,7305,5089,1125,20520
2022-11-28 23:30:00+00,18271,1002,3961,586,531,1592,2342,473,0,0,28758,301,7420,5078,1117,19273
2022-11-29 00:00:00+00,18363,1002,3964,624,524,1524,2299,419,0,0,28719,301,7411,5112,1148,19365
2022-11-29 00:30:00+00,18728,1000,3965,762,630,1630,2048,477,0,0,29240,302,7405,5357,1392,19728
2022-11-29 01:00:00+00,18551,1000,3962,1012,531,1714,2044,363,0,0,29177,300,7549,5505,1543,19551
2022-11-29 01:30:00+00,18242,1000,3958,1012,509,1604,2047,289,0,0,28660,299,7526,5479,1521,19242
2022-11-29 02:00:00+00,18064,993,3960,1076,414,1560,2046,233,0,0,28346,298,7496,5450,1490,19057
2022-11-29 02:30:00+00,17929,988,3958,1119,408,1490,2045,227,0,0,28163,297,7530,5485,1527,18917
2022-11-29 03:00:00+00,17817,998,3958,962,407,1512,2048,251,0,0,27953,298,7375,5327,1369,18815
2022-11-29 03:30:00+00,17615,997,3958,928,406,1502,2046,230,0,0,27682,298,7338,5292,1334,18612
2022-11-29 04:00:00+00,17682,996,3959,927,406,1658,2008,245,0,0,27881,299,7300,5292,1333,18678
2022-11-29 04:30:00+00,17799,1001,3960,920,404,1620,1995,239,0,0,27937,300,7278,5284,1324,18800
2022-11-29 05:00:00+00,18358,998,3962,954,416,1544,1984,282,0,0,28498,301,7316,5332,1370,19356
2022-11-29 05:30:00+00,19081,1000,3967,954,416,1704,1976,394,0,0,29493,304,7313,5337,1370,20081
2022-11-29 06:00:00+00,20279,827,3969,996,608,2190,1971,397,0,0,31237,303,7544,5573,1604,21106
2022-11-29 06:30:00+00,21275,869,3965,982,747,2192,1970,337,0,0,32337,306,7664,5694,1729,22144
2022-11-29 07:00:00+00,22341,993,3967,923,860,3178,1971,428,0,504,35165,304,7721,5750,1783,23334
2022-11-29 07:30:00+00,22870,992,3969,932,808,3216,1970,673,0,440,35870,306,7679,5709,1740,23862
2022-11-29 08:00:00+00,23107,997,3963,915,815,3920,1975,723,17,472,36904,304,7685,5710,1747,24104
2022-11-29 08:30:00+00,23169,992,3966,851,819,4022,1974,670,134,310,36907,305,7744,5770,1804,24161
2022-11-29 09:00:00+00,23133,998,3961,865,854,4506,1973,678,380,232,37580,299,8033,6060,2099,24131
2022-11-29 09:30:00+00,23057,997,3959,883,852,4538,1975,701,665,162,37789,297,8334,6359,2400,24054
2022-11-29 10:00:00+00,22973,1001,3957,884,853,5162,1969,584,832,162,38377,293,8495,6526,2569,23974
2022-11-29 10:30:00+00,22893,992,3953,916,814,5192,1964,547,995,454,38720,290,8642,6678,2725,23885
2022-11-29 11:00:00+00,22822,995,3956,946,805,5012,1972,542,1075,274,38398,290,8754,6782,2826,23817
2022-11-29 11:30:00+00,22666,996,3958,966,817,5042,1971,533,1035,358,38342,290,8747,6776,2818,23662
2022-11-29 12:00:00+00,22890,996,3961,951,863,4678,1973,635,986,804,38737,287,8734,6761,2800,23886
2022-11-29 12:30:00+00,22386,998,3981,901,959,4774,1973,761,930,870,38533,286,8744,6771,2790,23384
2022-11-29 13:00:00+00,21830,996,3650,942,885,5256,1969,638,756,1294,38216,286,8202,6233,2583,22826
2022-11-29 13:30:00+00,21700,991,3961,960,801,5270,2019,715,548,1146,38111,286,8289,6270,2309,22691
2022-11-29 14:00:00+00,22018,986,3964,1016,874,5292,2037,692,346,814,38039,290,8237,6200,2236,23004
2022-11-29 14:30:00+00,21899,992,3962,1056,893,5404,2043,589,172,1008,38018,289,8126,6083,2121,22891
2022-11-29 15:00:00+00,22089,993,3964,1093,908,5170,2034,708,46,1068,38073,291,8045,6011,2047,23082
2022-11-29 15:30:00+00,22264,995,3963,1153,943,5192,2044,859,2,1384,38799,288,8105,6061,2098,23259
2022-11-29 16:00:00+00,22731,992,3963,1299,1054,6176,2051,875,0,1406,40547,283,8367,6316,2353,23723
2022-11-29 16:30:00+00,22894,991,3961,1349,1061,6172,2051,977,0,1574,41030,282,8422,6371,2410,23885
2022-11-29 17:00:00+00,22950,995,3963,1381,1104,6356,2050,1257,0,1538,41594,281,8498,6448,2485,23945
2022-11-29 17:30:00+00,22885,991,3963,1413,1103,6362,2049,1232,0,1460,41458,281,8528,6479,2516,23876
2022-11-29 18:00:00+00,23175,983,3967,1539,1103,5990,2050,1039,0,1230,41076,283,8659,6609,2642,24158
2022-11-29 18:30:00+00,22489,997,3966,1630,1102,5978,2049,870,0,1182,40263,280,8747,6698,2732,23486
2022-11-29 19:00:00+00,22111,999,3969,1649,1040,5620,2044,854,0,508,38794,288,8702,6658,2689,23110
2022-11-29 19:30:00+00,21337,998,3967,1746,859,5668,2047,651,0,460,37733,287,8619,6572,2605,22335
2022-11-29 20:00:00+00,21246,999,3970,1861,894,4876,2043,641,0,60,36590,295,8768,6725,2755,22245
2022-11-29 20:30:00+00,21110,997,3967,1962,781,4676,2046,416,0,42,35998,295,8756,6710,2743,22108
2022-11-29 21:00:00+00,21015,1000,3969,2064,827,3232,2040,425,0,88,34660,298,8900,6860,2891,22015
2022-11-29 21:30:00+00,20283,1001,3970,2144,804,3024,2050,383,0,0,33659,295,8968,6918,2948,21284
2022-11-29 22:00:00+00,20376,1000,3979,2211,698,2212,2048,391,0,0,32915,298,8936,6888,2909,21376
2022-11-29 22:30:00+00,19340,1000,3986,2366,637,2076,2048,312,0,0,31765,294,9037,6989,3003,20340
2022-11-29 23:00:00+00,18666,1001,4029,2467,564,1478,2047,303,0,0,30555,294,9107,7060,3031,19667
2022-11-29 23:30:00+00,17991,1001,4062,2439,545,1440,2049,329,0,0,29856,293,9095,7046,2984,18992
2022-11-30 00:00:00+00,17815,996,4060,2434,520,1158,2045,324,0,0,29352,297,9059,7014,2954,18811
2022-11-30 00:30:00+00,18148,991,4061,2454,605,1128,2048,319,0,0,29754,297,9168,7120,3059,19139
2022-11-30 01:00:00+00,17986,1000,4068,2456,538,1520,2048,298,0,0,29914,300,9110,7062,2994,18986
2022-11-30 01:30:00+00,17702,999,4077,2543,394,1550,2040,297,0,0,29602,300,9054,7014,2937,18701
2022-11-30 02:00:00+00,17544,1001,4079,2550,389,1404,2046,244,0,0,29257,298,9064,7018,2939,18545
2022-11-30 02:30:00+00,17424,1001,4082,2565,386,1326,2048,229,0,0,29061,297,9081,7033,2951,18425
2022-11-30 03:00:00+00,17327,999,4080,2552,385,1056,2049,226,0,0,28673,296,9066,7017,2937,18326
2022-11-30 03:30:00+00,17138,1000,4087,2702,384,1036,2050,211,0,0,28608,294,9223,7173,3086,18138
2022-11-30 04:00:00+00,17211,1000,4097,2754,383,924,2036,258,0,0,28663,295,9270,7234,3137,18211
2022-11-30 04:30:00+00,17328,1000,4107,2836,386,904,2013,258,0,0,28832,295,9342,7329,3222,18328
2022-11-30 05:00:00+00,17903,1002,4119,2874,382,856,1995,304,0,0,29435,296,9370,7375,3256,18905
2022-11-30 05:30:00+00,18639,999,4123,3046,381,804,1997,306,0,0,30294,296,9547,7550,3427,19638
2022-11-30 06:00:00+00,19834,1000,4131,3166,819,924,2016,333,0,0,32223,295,10132,8116,3985,20834
2022-11-30 06:30:00+00,20834,1000,4130,3085,883,966,2048,369,0,48,33363,298,10146,8098,3968,21834
2022-11-30 07:00:00+00,21743,999,4130,2932,909,1516,2043,725,0,514,35510,300,10014,7971,3841,22742
2022-11-30 07:30:00+00,22230,1001,4126,3047,904,1596,2032,1070,0,608,36615,300,10109,8077,3951,23231
2022-11-30 08:00:00+00,22453,999,4124,3264,918,2220,2042,881,13,434,37349,298,10361,8319,4195,23452
2022-11-30 08:30:00+00,22584,999,4123,3213,950,2254,2044,774,128,332,37401,298,10458,8414,4291,23583
2022-11-30 09:00:00+00,22615,997,4120,3105,968,2720,2042,760,355,280,37962,296,10590,8548,4428,23612
2022-11-30 09:30:00+00,22568,1001,4151,3091,960,2746,2044,863,662,170,38256,294,10908,8864,4713,23569
2022-11-30 10:00:00+00,22435,1001,4177,3080,960,3210,1986,782,883,170,38684,291,11086,9100,4923,23436
2022-11-30 10:30:00+00,22324,1002,4190,3071,963,3238,1935,698,1157,170,38748,289,11316,9381,5191,23326
2022-11-30 11:00:00+00,22289,1002,4199,3062,959,4002,1920,661,1288,124,39507,283,11428,9508,5309,23291
2022-11-30 11:30:00+00,22133,1000,4199,3001,964,4038,1949,585,1600,0,39469,281,11713,9764,5565,23133
2022-11-30 12:00:00+00,22290,997,4212,2959,915,4044,1940,709,1706,0,39772,282,11732,9792,5580,23287
2022-11-30 12:30:00+00,22165,998,4227,2906,906,4048,1920,669,1325,0,39164,285,11284,9364,5137,23163
2022-11-30 13:00:00+00,22336,998,4230,2848,907,3406,1963,902,924,0,38514,290,10872,8909,4679,23334
2022-11-30 13:30:00+00,22186,996,4232,2874,900,3402,1982,750,749,0,38071,290,10737,8755,4523,23182
2022-11-30 14:00:00+00,22215,995,4233,2833,879,3406,2012,784,505,0,37862,291,10462,8450,4217,23210
2022-11-30 14:30:00+00,22176,995,4233,2792,871,3412,1989,890,267,0,37625,294,10152,8163,3930,23171
2022-11-30 15:00:00+00,21957,995,4233,2883,876,2950,2012,1040,90,896,37932,285,10094,8082,3849,22952
2022-11-30 15:30:00+00,22161,995,4230,3077,919,3044,2016,1183,6,1168,38799,282,10248,8232,4002,23156
2022-11-30 16:00:00+00,21969,993,4229,3318,1040,4252,2015,1159,0,1272,40247,272,10602,8587,4358,22962
2022-11-30 16:30:00+00,22533,988,4243,3374,1037,4486,2015,1473,0,1288,41437,273,10669,8654,4411,23521
2022-11-30 17:00:00+00,22525,991,4246,3402,1044,4450,2011,1721,0,1334,41724,272,10703,8692,4446,23516
2022-11-30 17:30:00+00,22482,991,4241,3359,1044,4372,2009,1609,0,1382,41489,272,10653,8644,4403,23473
2022-11-30 18:00:00+00,21774,994,4242,3196,1045,4946,2017,1415,0,1382,41011,273,10500,8483,4241,22768
2022-11-30 18:30:00+00,21566,994,4254,3252,1044,4900,2017,1223,0,1322,40572,272,10567,8550,4296,22560
2022-11-30 19:00:00+00,21781,1071,4293,3302,971,4664,2006,1056,0,648,39792,283,10572,8566,4273,22852
2022-11-30 19:30:00+00,21341,1208,4297,3414,971,4548,2018,797,0,0,38594,287,10700,8682,4385,22549
2022-11-30 20:00:00+00,21204,1380,4296,3482,976,3144,1942,570,0,420,37414,294,10696,8754,4458,22584
2022-11-30 20:30:00+00,20785,1478,4295,3666,975,2778,1770,586,0,0,36333,297,10706,8936,4641,22263
2022-11-30 21:00:00+00,21066,1494,4300,3690,865,1490,1770,652,0,22,35349,303,10625,8855,4555,22560
2022-11-30 21:30:00+00,19778,1498,4298,3719,784,1416,1768,494,0,0,33755,301,10569,8801,4503,21276
2022-11-30 22:00:00+00,19912,1497,4299,3895,542,1086,1767,400,0,0,33398,302,10503,8736,4437,21409
2022-11-30 22:30:00+00,18325,1499,4295,4050,498,988,1765,395,0,0,31815,295,10608,8843,4548,19824
2022-11-30 23:00:00+00,16986,1497,4296,4024,431,566,1769,353,0,0,29922,290,10520,8751,4455,18483
2022-11-30 23:30:00+00,16553,1498,4300,4028,423,256,1768,357,0,0,29183,287,10519,8751,4451,18051
2022-12-01 00:00:00+00,16613,1501,4296,4071,414,252,1765,386,0,0,29298,287,10546,8781,4485,18114
2022-12-01 00:30:00+00,16735,1495,4296,4038,402,478,1769,327,0,0,29540,289,10505,8736,4440,18230
2022-12-01 01:00:00+00,15920,1498,4298,4028,392,798,1764,238,0,0,28936,286,10482,8718,4420,17418
2022-12-01 01:30:00+00,15197,1359,4298,4010,390,786,1765,304,0,0,28109,280,10463,8698,4400,16556
2022-12-01 02:00:00+00,14046,1316,4295,3874,389,824,1765,282,0,0,26791,275,10323,8558,4263,15362
2022-12-01 02:30:00+00,13795,1314,4294,3711,389,854,1769,218,0,0,26344,275,10163,8394,4100,15109
2022-12-01 03:00:00+00,13333,1316,4292,3575,388,1306,1772,214,0,0,26196,273,10027,8255,3963,14649
2022-12-01 03:30:00+00,13545,1314,4294,3406,387,1170,1890,197,0,0,26203,274,9977,8087,3793,14859
2022-12-01 04:00:00+00,15299,1316,4297,3392,386,1052,2012,200,0,0,27954,277,10087,8075,3778,16615
2022-12-01 04:30:00+00,15440,1316,4335,3300,387,1066,2017,211,0,0,28072,278,10039,8022,3687,16756
2022-12-01 05:00:00+00,17228,1317,4377,3374,403,578,2020,187,0,0,29484,287,10174,8154,3777,18545
2022-12-01 05:30:00+00,18175,1317,4417,3427,504,634,2013,192,0,0,30679,290,10361,8348,3931,19492
2022-12-01 06:00:00+00,19019,1317,4427,3406,683,946,2012,214,0,0,32024,294,10528,8516,4089,20336
2022-12-01 06:30:00+00,20720,1317,4437,3333,698,1098,2014,195,0,90,33902,299,10482,8468,4031,22037
2022-12-01 07:00:00+00,21983,1320,4451,3158,763,1414,2014,370,0,404,35877,303,10386,8372,3921,23303
2022-12-01 07:30:00+00,22698,1320,4454,3105,810,1450,2010,804,0,592,37243,303,10379,8369,3915,24018
2022-12-01 08:00:00+00,22802,1319,4455,3014,869,1868,2005,755,28,534,37649,303,10371,8366,3911,24121
2022-12-01 08:30:00+00,22746,1319,4452,2989,911,1908,2020,767,204,674,37990,300,10576,8556,4104,24065
2022-12-01 09:00:00+00,22305,1320,4454,2910,945,2630,2039,793,464,852,38712,294,10812,8773,4319,23625
2022-12-01 09:30:00+00,22774,1319,4451,2840,953,2640,2046,820,732,466,39041,297,11022,8976,4525,24093
2022-12-01 10:00:00+00,22889,1321,4465,2893,953,2462,2045,797,953,610,39388,295,11309,9264,4799,24210
2022-12-01 10:30:00+00,22776,1318,4485,2973,938,2446,2045,691,1171,570,39413,293,11612,9567,5082,24094
2022-12-01 11:00:00+00,22670,1320,4486,2909,932,2986,2044,556,1325,298,39526,292,11696,9652,5166,23990
2022-12-01 11:30:00+00,22870,1318,4486,2835,931,3022,2042,477,1405,172,39558,293,11699,9657,5171,24188
2022-12-01 12:00:00+00,22645,1317,4486,2776,792,3730,2040,289,1436,136,39647,291,11530,9490,5004,23962
2022-12-01 12:30:00+00,22724,1313,4488,2695,751,3738,2047,334,1353,136,39579,293,11334,9287,4799,24037
2022-12-01 13:00:00+00,22814,1315,4485,2581,885,3046,2044,683,1169,140,39162,297,11164,9120,4635,24129
2022-12-01 13:30:00+00,22769,1316,4487,2578,913,3026,2038,631,949,132,38839,299,10965,8927,4440,24085
2022-12-01 14:00:00+00,22864,1318,4481,2631,934,3074,2038,571,694,0,38605,301,10778,8740,4259,24182
2022-12-01 14:30:00+00,22793,1318,4485,2637,874,3082,2043,764,385,26,38407,304,10424,8381,3896,24111
2022-12-01 15:00:00+00,22443,1318,4499,2619,854,3270,2044,938,130,542,38657,298,10146,8102,3603,23761
2022-12-01 15:30:00+00,22646,1317,4531,2572,976,3346,2042,997,12,1134,39573,293,10133,8091,3560,23963
2022-12-01 16:00:00+00,22540,1314,4537,2537,1083,4830,2047,983,0,1132,41003,285,10204,8157,3620,23854
2022-12-01 16:30:00+00,22485,1312,4538,2682,1049,4996,2051,1234,0,1580,41927,281,10320,8269,3731,23797
2022-12-01 17:00:00+00,22701,1315,4536,2680,1072,4662,2038,1481,0,1580,42065,283,10326,8288,3752,24016
2022-12-01 17:30:00+00,22957,1317,4539,2706,1053,4650,2045,1409,0,1518,42194,284,10343,8298,3759,24274
2022-12-01 18:00:00+00,23184,1317,4561,2698,1043,3882,2047,1290,0,1494,41516,287,10349,8302,3741,24501
2022-12-01 18:30:00+00,22975,1318,4560,2639,1031,3808,2041,1051,0,1580,41003,286,10271,8230,3670,24293
2022-12-01 19:00:00+00,22815,1319,4558,2650,973,3772,2043,955,0,820,39905,291,10224,8181,3623,24134
2022-12-01 19:30:00+00,22499,1315,4558,2582,962,3676,2049,589,0,320,38550,293,10151,8102,3544,23814
2022-12-01 20:00:00+00,22342,1314,4555,2540,815,3576,2051,370,0,376,37939,296,9961,7910,3355,23656
2022-12-01 20:30:00+00,21936,1315,4559,2504,796,3326,2049,212,0,0,36697,298,9908,7859,3300,23251
2022-12-01 21:00:00+00,22091,1313,4557,2509,780,1994,2049,228,0,12,35533,306,9895,7846,3289,23404
2022-12-01 21:30:00+00,21300,1314,4559,2505,593,1804,2045,175,0,0,34295,306,9702,7657,3098,22614
2022-12-01 22:00:00+00,20359,1315,4560,2762,503,1114,2040,164,0,0,32817,301,9865,7825,3265,21674
2022-12-01 22:30:00+00,19191,1316,4558,2836,459,914,2024,183,0,0,31481,296,9877,7853,3295,20507
2022-12-01 23:00:00+00,16250,1318,4566,2977,405,1964,1970,169,0,0,29619,281,9918,7948,3382,17568
2022-12-01 23:30:00+00,15473,1319,4574,2963,407,2040,1958,162,0,0,28896,278,9902,7944,3370,16792
2022-12-02 00:00:00+00,15091,1318,4575,3043,408,2410,1950,161,0,0,28956,271,9976,8026,3451,16409
2022-12-02 00:30:00+00,15072,1319,4579,3183,391,2534,2002,170,0,0,29250,270,10155,8153,3574,16391
2022-12-02 01:00:00+00,14537,1316,4580,3200,391,2324,1951,182,0,0,28481,267,10122,8171,3591,15853
2022-12-02 01:30:00+00,14186,1315,4580,3228,389,2194,1812,202,0,0,27906,265,10009,8197,3617,15501
2022-12-02 02:00:00+00,13599,1318,4588,3306,385,2268,1729,167,0,0,27360,264,10008,8279,3691,14917
2022-12-02 02:30:00+00,13171,1317,4587,3376,383,2238,1680,166,0,0,26918,261,10026,8346,3759,14488
2022-12-02 03:00:00+00,13774,1317,4589,3418,381,1782,1664,171,0,0,27096,264,10052,8388,3799,15091
2022-12-02 03:30:00+00,13678,1319,4591,3371,381,1736,1677,187,0,0,26940,265,10020,8343,3752,14997
2022-12-02 04:00:00+00,14788,1320,4596,3596,380,1330,1675,176,0,0,27861,270,10247,8572,3976,16108
2022-12-02 04:30:00+00,14894,1320,4596,3744,381,1280,1800,187,0,0,28202,269,10521,8721,4125,16214
2022-12-02 05:00:00+00,16355,1317,4600,3750,425,410,2019,163,0,0,29039,275,10794,8775,4175,17672
2022-12-02 05:30:00+00,16885,1320,4603,3839,432,512,2018,160,0,0,29769,278,10892,8874,4271,18205
2022-12-02 06:00:00+00,17701,1320,4603,4263,518,964,2033,170,0,0,31572,275,11417,9384,4781,19021
2022-12-02 06:30:00+00,19478,1318,4601,4474,520,1234,2034,176,0,76,33911,280,11629,9595,4994,20796
2022-12-02 07:00:00+00,21315,1318,4604,4729,565,1542,2028,270,0,90,36461,281,11926,9898,5294,22633
2022-12-02 07:30:00+00,21689,1317,4605,4986,739,1652,2030,763,0,130,37911,279,12360,10330,5725,23006
2022-12-02 08:00:00+00,21600,1314,4607,5315,797,1998,2029,633,130,210,38633,272,12878,10849,6242,22914
2022-12-02 08:30:00+00,21866,1318,4607,5855,751,2040,2031,683,375,226,39752,267,13619,11588,6981,23184
2022-12-02 09:00:00+00,21667,1318,4610,6421,667,2294,2030,817,464,196,40484,262,14192,12162,7552,22985
2022-12-02 09:30:00+00,21542,1319,4608,6852,630,2340,2030,688,766,62,40837,258,14886,12856,8248,22861
2022-12-02 10:00:00+00,21585,1318,4607,6941,625,2450,2032,616,960,0,41134,255,15165,13133,8526,22903
2022-12-02 10:30:00+00,21417,1305,4610,7171,629,2448,2034,522,1248,0,41384,251,15692,13658,9048,22722
2022-12-02 11:00:00+00,21317,1219,4606,7357,597,2610,2043,428,1437,66,41680,246,16040,13997,9391,22536
2022-12-02 11:30:00+00,21098,1219,4610,7410,584,2632,2028,332,1353,142,41408,245,15986,13958,9348,22317
2022-12-02 12:00:00+00,21444,1214,4606,7409,570,2448,2032,238,1414,146,41521,248,16031,13999,9393,22658
2022-12-02 12:30:00+00,21275,1213,4603,7247,596,2328,2031,224,1380,102,40999,248,15857,13826,9223,22488
2022-12-02 13:00:00+00,21456,1270,4601,7548,591,2466,2023,190,1253,0,41398,249,16016,13993,9392,22726
2022-12-02 13:30:00+00,21181,1295,4600,7585,592,2480,2023,226,1063,0,41045,249,15863,13840,9240,22476
2022-12-02 14:00:00+00,20864,1163,4606,8002,415,2876,2023,200,762,0,40911,248,15808,13785,9179,22027
2022-12-02 14:30:00+00,20987,1164,4606,7929,396,2746,2025,183,457,0,40493,251,15413,13388,8782,22151
2022-12-02 15:00:00+00,21106,1255,4605,8172,507,2204,2031,266,187,0,40333,251,15502,13471,8866,22361
2022-12-02 15:30:00+00,21029,1308,4608,8576,631,2294,2032,314,15,50,40857,249,15862,13830,9222,22337
2022-12-02 16:00:00+00,20403,1311,4610,9091,655,2868,2040,366,0,394,41738,241,16396,14356,9746,21714
2022-12-02 16:30:00+00,20493,1310,4609,9449,801,2926,2028,588,0,506,42710,239,16887,14859,10250,21803
2022-12-02 17:00:00+00,20162,1311,4605,10038,823,2818,2029,607,0,450,42843,235,17495,15466,10861,21473
2022-12-02 17:30:00+00,20069,1310,4612,10442,760,2824,2005,517,0,464,43003,233,17819,15814,11202,21379
2022-12-02 18:00:00+00,19581,1312,4611,10969,478,2882,2000,294,0,180,42307,231,18058,16058,11447,20893
2022-12-02 18:30:00+00,18766,1313,4609,11295,385,2880,2000,219,0,198,41665,226,18289,16289,11680,20079
2022-12-02 19:00:00+00,18565,1310,4606,11321,367,3166,1994,330,0,70,41729,226,18288,16294,11688,19875
2022-12-02 19:30:00+00,17878,1308,4607,11164,366,3150,2001,232,0,82,40788,224,18138,16137,11530,19186
2022-12-02 20:00:00+00,16587,1307,4611,10967,348,2678,1995,199,0,0,38692,221,17921,15926,11315,17894
2022-12-02 20:30:00+00,15319,1309,4607,10998,345,2668,2001,206,0,0,37453,215,17951,15950,11343,16628
2022-12-02 21:00:00+00,14177,1308,4606,11053,341,2624,2001,258,0,34,36402,209,18001,16000,11394,15485
2022-12-02 21:30:00+00,12971,1308,4608,11147,340,2624,2000,209,0,38,35245,202,18095,16095,11487,14279
2022-12-02 22:00:00+00,11239,1310,4608,10984,339,2406,2002,222,0,88,33198,190,17932,15930,11322,12549
2022-12-02 22:30:00+00,10084,1291,4606,11048,327,2380,2002,218,0,0,31956,183,17983,15981,11375,11375
2022-12-02 23:00:00+00,9083,999,4606,10888,298,2658,2009,225,0,0,30766,169,17801,15792,11186,10082
2022-12-02 23:30:00+00,8080,993,4607,10776,296,2678,2008,244,0,0,29682,162,17687,15679,11072,9073
2022-12-03 00:00:00+00,7230,990,4605,10596,295,2642,2007,247,0,0,28612,153,17503,15496,10891,8220
2022-12-03 00:30:00+00,7221,994,4605,10351,294,2656,2013,222,0,26,28382,154,17263,15250,10645,8215
2022-12-03 01:00:00+00,6601,992,4609,10236,293,3290,2004,190,0,0,28215,154,17142,15138,10529,7593
2022-12-03 01:30:00+00,5920,993,4609,10192,293,3320,1996,197,0,0,27520,148,17090,15094,10485,6913
2022-12-03 02:00:00+00,5364,988,4607,10159,293,3520,2003,197,0,0,27131,143,17062,15059,10452,6352
2022-12-03 02:30:00+00,4870,990,4607,10306,292,3526,1916,200,0,0,26707,138,17121,15205,10598,5860
2022-12-03 03:00:00+00,4600,802,4605,9830,293,3860,1931,209,0,0,26130,131,16659,14728,10123,5402
2022-12-03 03:30:00+00,4168,852,4609,10108,294,3874,1715,194,0,0,25814,127,16726,15011,10402,5020
2022-12-03 04:00:00+00,4540,975,4609,10037,295,3442,1357,210,0,0,25465,136,16298,14941,10332,5515
2022-12-03 04:30:00+00,4512,717,4608,10309,298,3412,1180,211,0,0,25247,126,16395,15215,10607,5229
2022-12-03 05:00:00+00,5238,632,4610,10578,327,3190,1149,211,0,0,25935,129,16664,15515,10905,5870
2022-12-03 05:30:00+00,5533,731,4608,10588,330,3182,1066,219,0,0,26257,135,16592,15526,10918,6264
2022-12-03 06:00:00+00,6212,878,4608,10700,363,2824,1239,315,0,0,27139,146,16910,15671,11063,7090
2022-12-03 06:30:00+00,7670,737,4607,11204,366,2804,1257,196,0,0,28841,151,17434,16177,11570,8407
2022-12-03 07:00:00+00,10677,958,4610,11554,380,980,1357,191,0,0,30707,175,17901,16544,11934,11635
2022-12-03 07:30:00+00,12582,995,4609,11027,349,926,1366,192,0,0,32046,192,17351,15985,11376,13577
2022-12-03 08:00:00+00,13965,985,4610,10822,312,1414,1363,180,11,0,33662,202,17118,15755,11145,14950
2022-12-03 08:30:00+00,15096,993,4608,10776,306,1480,1369,198,170,0,34996,208,17229,15860,11252,16089
2022-12-03 09:00:00+00,15848,994,4609,10632,277,1778,1368,196,474,0,36176,209,17360,15992,11383,16842
2022-12-03 09:30:00+00,16455,991,4610,10293,283,1810,1368,185,763,24,36782,212,17317,15949,11339,17446
2022-12-03 10:00:00+00,16715,984,4615,10039,262,1672,1364,222,1055,0,36928,211,17335,15971,11356,17699
2022-12-03 10:30:00+00,16673,993,4611,9803,262,1674,1367,395,1245,0,37023,212,17288,15921,11310,17666
2022-12-03 11:00:00+00,16617,990,4611,9677,261,1964,1366,255,1351,58,37150,211,17266,15900,11289,17607
2022-12-03 11:30:00+00,16784,987,4612,9471,261,1970,1363,263,1384,32,37127,213,17091,15728,11116,17771
2022-12-03 12:00:00+00,16264,994,4610,9453,276,2386,1369,271,1370,44,37037,211,17078,15709,11099,17258
2022-12-03 12:30:00+00,16489,984,4612,9598,270,2394,1361,232,1336,0,37276,211,17177,15816,11204,17473
2022-12-03 13:00:00+00,16382,994,4609,9525,271,2346,1366,223,1131,12,36859,210,16902,15536,10927,17376
2022-12-03 13:30:00+00,16299,989,4610,9664,270,2354,1364,198,901,0,36649,210,16809,15445,10835,17288
2022-12-03 14:00:00+00,16227,992,4608,9826,284,2012,1366,204,671,36,36226,211,16755,15389,10781,17219
2022-12-03 14:30:00+00,15954,992,4610,10237,341,2008,1368,208,411,60,36189,208,16967,15599,10989,16946
2022-12-03 15:00:00+00,16366,1059,4611,10434,434,1962,1370,210,130,0,36576,212,16979,15609,10998,17425
2022-12-03 15:30:00+00,16021,1276,4610,10431,448,1992,1370,227,13,266,36654,214,16872,15502,10892,17297
2022-12-03 16:00:00+00,16596,1313,4609,10543,591,2708,1369,294,0,364,38387,213,17112,15743,11134,17909
2022-12-03 16:30:00+00,16926,1314,4612,10436,598,2858,1370,780,0,542,39436,215,17016,15646,11034,18240
2022-12-03 17:00:00+00,17029,1311,4612,10489,599,2670,1370,682,0,582,39344,215,17070,15700,11088,18340
2022-12-03 17:30:00+00,16843,1311,4612,10512,622,2678,1370,734,0,666,39348,213,17116,15746,11134,18154
2022-12-03 18:00:00+00,16748,1313,4615,10502,588,2196,1451,569,0,804,38786,216,17156,15705,11090,18061
2022-12-03 18:30:00+00,16428,1313,4670,10532,547,2190,1705,237,0,770,38392,213,17454,15749,11079,17741
2022-12-03 19:00:00+00,15372,1310,4664,10583,367,3070,1904,191,0,298,37759,214,17518,15614,10950,16682
2022-12-03 19:30:00+00,14635,1308,4663,9991,367,3110,2006,190,0,196,36466,214,17027,15021,10358,15943
2022-12-03 20:00:00+00,14986,1312,4663,9959,350,2190,2002,172,0,58,35692,217,16974,14972,10309,16298
2022-12-03 20:30:00+00,13715,1316,4660,10131,345,2146,2001,204,0,96,34614,209,17137,15136,10476,15031
2022-12-03 21:00:00+00,12873,1310,4660,9899,327,2356,2002,174,0,0,33601,208,16888,14886,10226,14183
2022-12-03 21:30:00+00,11789,1293,4657,9567,321,2268,2003,180,0,86,32164,202,16548,14545,9888,13082
2022-12-03 22:00:00+00,10778,1302,4657,8898,313,2182,2003,184,0,228,30545,199,15871,13868,9211,12080
2022-12-03 22:30:00+00,10541,1311,4659,8320,313,2112,2002,195,0,8,29461,203,15294,13292,8633,11852
2022-12-03 23:00:00+00,8761,1294,4658,8157,312,1964,1998,189,0,0,27333,190,15125,13127,8469,10055
2022-12-03 23:30:00+00,7415,1300,4698,7857,297,2206,1991,163,0,0,25927,182,14843,12852,8154,8715
2022-12-04 00:00:00+00,6207,1289,4727,7906,273,3466,1995,172,0,0,26035,173,14901,12906,8179,7496
2022-12-04 00:30:00+00,6151,1303,4726,8253,271,3496,1990,168,0,0,26358,171,15240,13250,8524,7454
2022-12-04 01:00:00+00,5334,1203,4718,8902,271,3226,1983,323,0,0,25960,155,15874,13891,9173,6537
2022-12-04 01:30:00+00,4424,1185,4724,9203,271,3186,1882,171,0,0,25046,143,16080,14198,9474,5609
2022-12-04 02:00:00+00,4061,1306,4745,9017,271,3308,1736,210,0,0,24654,144,15769,14033,9288,5367
2022-12-04 02:30:00+00,4059,1286,4777,9275,271,3412,1893,163,0,0,25136,143,16216,14323,9546,5345
2022-12-04 03:00:00+00,3837,1279,4777,9979,271,2872,1967,159,0,0,25141,138,16994,15027,10250,5116
2022-12-04 03:30:00+00,3301,1133,4776,10433,270,2832,1977,164,0,0,24886,125,17456,15479,10703,4434
2022-12-04 04:00:00+00,3282,1254,4775,10551,271,2588,1985,168,0,0,24874,126,17582,15597,10822,4536
2022-12-04 04:30:00+00,3487,1312,4776,10194,269,2584,1986,202,0,0,24810,132,17225,15239,10463,4799
2022-12-04 05:00:00+00,3822,1295,4777,10380,279,2302,1997,172,0,0,25024,133,17433,15436,10659,5117
2022-12-04 05:30:00+00,3443,1233,4779,10791,283,2358,1986,181,0,0,25054,126,17839,15853,11074,4676
2022-12-04 06:00:00+00,4182,1303,4828,10926,310,2648,1983,193,0,0,26373,137,18047,16064,11236,5485
2022-12-04 06:30:00+00,4959,1290,4880,11122,316,2642,1976,164,0,0,27349,143,18294,16318,11438,6249
2022-12-04 07:00:00+00,6247,1314,4877,11365,331,1694,2006,194,0,0,28028,149,18579,16573,11696,7561
2022-12-04 07:30:00+00,7235,1317,4878,11501,330,1708,2007,164,0,0,29140,157,18716,16709,11831,8552
2022-12-04 08:00:00+00,9043,1314,4876,11611,330,1386,2014,171,1,0,30746,168,18832,16818,11942,10357
2022-12-04 08:30:00+00,9924,1313,4878,12007,330,1536,2013,165,41,140,32347,173,19269,17256,12378,11237
2022-12-04 09:00:00+00,10043,1301,4875,12402,358,1872,2008,160,144,160,33323,171,19787,17779,12904,11344
2022-12-04 09:30:00+00,10971,1319,4873,12476,360,1976,2016,247,258,30,34526,178,19983,17967,13094,12290
2022-12-04 10:00:00+00,11376,1317,4877,12257,376,2638,2014,168,389,58,35470,183,19913,17899,13022,12693
2022-12-04 10:30:00+00,11932,1316,4870,12117,358,2684,2007,244,495,58,36081,187,19847,17840,12970,13248
2022-12-04 11:00:00+00,12367,1315,4869,11936,346,2542,2015,176,584,84,36234,187,19750,17735,12866,13682
2022-12-04 11:30:00+00,12706,1317,4866,11950,346,2672,2010,181,616,6,36670,190,19788,17778,12912,14023
2022-12-04 12:00:00+00,12862,1316,4863,12077,357,2882,1999,166,568,0,37090,188,19864,17865,13002,14178
2022-12-04 12:30:00+00,12797,1317,4862,12305,355,2980,2016,170,534,0,37336,188,20072,18056,13194,14114
2022-12-04 13:00:00+00,12757,1319,4866,12472,331,2962,2017,174,440,18,37356,187,20126,18109,13243,14076
2022-12-04 13:30:00+00,13268,1317,4870,11982,323,2850,2016,174,313,18,37131,192,19504,17488,12618,14585
2022-12-04 14:00:00+00,13643,1314,4871,12253,323,2470,2008,161,223,4,37270,195,19678,17670,12799,14957
2022-12-04 14:30:00+00,13563,1315,4868,12338,324,2348,2013,191,130,84,37174,193,19673,17660,12792,14878
2022-12-04 15:00:00+00,13781,1314,4869,12431,323,2326,2016,228,35,18,37341,194,19674,17658,12789,15095
2022-12-04 15:30:00+00,14319,1314,4867,12346,355,2346,2016,233,1,94,37891,197,19585,17569,12702,15633
2022-12-04 16:00:00+00,14824,1315,4869,12633,477,2286,2016,334,0,732,39486,195,19995,17979,13110,16139
2022-12-04 16:30:00+00,14491,1313,4864,12798,551,2430,2014,789,0,1206,40456,192,20227,18213,13349,15804
2022-12-04 17:00:00+00,15140,1314,4865,12820,575,2340,2013,867,0,1316,41250,196,20273,18260,13395,16454
2022-12-04 17:30:00+00,14970,1314,4863,13059,556,2270,2015,740,0,1052,40839,195,20493,18478,13615,16284
2022-12-04 18:00:00+00,14598,1315,4864,13206,489,1982,2015,607,0,1044,40120,192,20574,18559,13695,15913
2022-12-04 18:30:00+00,14423,1315,4865,13101,485,1822,2013,561,0,1102,39687,191,20464,18451,13586,15738
2022-12-04 19:00:00+00,13683,1315,4866,12989,482,2302,2011,449,0,352,38449,194,20348,18337,13471,14998
2022-12-04 19:30:00+00,13015,1306,4871,12989,453,2154,2012,259,0,374,37433,189,20325,18313,13442,14321
2022-12-04 20:00:00+00,12797,1314,4866,12967,336,2444,2016,233,0,88,37061,192,20185,18169,13303,14111
2022-12-04 20:30:00+00,11936,1310,4870,12644,318,2294,2016,234,0,82,35704,188,19848,17832,12962,13246
2022-12-04 21:00:00+00,12293,1309,4870,12188,318,2200,2015,237,0,294,35724,191,19391,17376,12506,13602
2022-12-04 21:30:00+00,11889,1305,4875,11778,317,2048,2012,217,0,162,34603,191,18982,16970,12095,13194
2022-12-04 22:00:00+00,11279,1304,4874,11278,314,1888,2012,213,0,0,33162,190,18478,16466,11592,12583
2022-12-04 22:30:00+00,10130,1299,4875,11303,313,1810,2013,224,0,0,31967,182,18504,16491,11616,11429
2022-12-04 23:00:00+00,9208,1306,4871,10960,296,1756,2017,237,0,0,30651,175,18144,16127,11256,10514
2022-12-04 23:30:00+00,8911,1303,4872,10484,287,1648,2015,226,0,0,29746,175,17658,15643,10771,10214
2022-12-05 00:00:00+00,8948,1291,4874,10521,235,1698,2010,214,0,0,29791,175,17640,15630,10756,10239
2022-12-05 00:30:00+00,8987,1309,4872,10812,235,1846,2017,227,0,0,30305,176,17936,15919,11047,10296
2022-12-05 01:00:00+00,7999,1311,4871,10821,235,2022,2014,217,0,0,29490,170,17941,15927,11056,9310
2022-12-05 01:30:00+00,7532,1298,4875,10887,235,1960,2016,212,0,0,29015,165,18013,15997,11122,8830
2022-12-05 02:00:00+00,7463,1315,4874,10627,236,1840,2015,203,0,0,28573,165,17752,15737,10863,8778
2022-12-05 02:30:00+00,7500,1299,4874,10527,235,1826,2017,164,0,0,28442,165,17653,15636,10762,8799
2022-12-05 03:00:00+00,7498,1305,4875,10665,235,1876,2012,161,0,0,28627,168,17787,15775,10900,8803
2022-12-05 03:30:00+00,7429,1310,4870,10569,235,1850,2017,172,0,0,28452,168,17691,15674,10804,8739
2022-12-05 04:00:00+00,7833,1308,4877,10751,235,1170,2018,161,0,0,28353,170,17881,15863,10986,9141
2022-12-05 04:30:00+00,7912,1298,4876,10966,236,1020,2019,166,0,0,28493,169,18097,16078,11202,9210
2022-12-05 05:00:00+00,9212,1308,4875,11017,267,526,2040,204,0,0,29449,181,18199,16159,11284,10520
2022-12-05 05:30:00+00,10522,1296,4875,10907,272,492,2123,170,0,0,30657,190,18177,16054,11179,11818
2022-12-05 06:00:00+00,13034,1300,4877,11171,317,456,2132,176,0,0,33463,205,18497,16365,11488,14334
2022-12-05 06:30:00+00,14775,1312,4874,11345,318,468,2228,194,0,0,35514,214,18765,16537,11663,16087
2022-12-05 07:00:00+00,17786,1308,4879,11259,359,708,2317,191,0,386,39193,227,18814,16497,11618,19094
2022-12-05 07:30:00+00,19784,1308,4876,11375,364,854,2316,195,0,284,41356,236,18931,16615,11739,21092
2022-12-05 08:00:00+00,20322,1313,4877,11349,365,762,2318,189,4,348,41847,237,18913,16595,11718,21635
2022-12-05 08:30:00+00,21088,1313,4882,11552,371,816,2316,167,91,206,42802,239,19212,16896,12014,22401
2022-12-05 09:00:00+00,21237,1313,4969,11394,366,1034,2294,285,262,354,43508,236,19285,16991,12022,22550
2022-12-05 09:30:00+00,21727,1317,4969,11169,366,1126,2293,176,438,268,43849,239,19235,16942,11973,23044
2022-12-05 10:00:00+00,21637,1315,4968,10790,327,1418,2318,252,619,412,44056,238,19022,16704,11736,22952
2022-12-05 10:30:00+00,21571,1316,4968,11039,314,1476,2322,210,770,418,44404,235,19413,17091,12123,22887
2022-12-05 11:00:00+00,21845,1315,4968,10936,314,1284,2331,172,870,312,44347,237,19419,17088,12120,23160
2022-12-05 11:30:00+00,22186,1315,4967,10651,328,1418,2318,184,993,250,44610,240,19257,16939,11972,23501
2022-12-05 12:00:00+00,22016,1322,4964,10594,312,1564,2324,178,1090,354,44718,238,19284,16960,11996,23338
2022-12-05 12:30:00+00,21946,1319,4963,10203,311,1574,2329,179,1067,350,44241,240,18873,16544,11581,23265
2022-12-05 13:00:00+00,21885,1318,4964,10228,312,1518,2323,177,946,270,43941,241,18773,16450,11486,23203
2022-12-05 13:30:00+00,21880,1319,4965,10206,303,1468,2323,169,776,276,43685,242,18573,16250,11285,23199
2022-12-05 14:00:00+00,21912,1317,4961,10299,315,1360,2326,174,537,312,43513,244,18438,16112,11151,23229
2022-12-05 14:30:00+00,22062,1320,4961,10391,320,1332,2323,181,292,240,43422,246,18287,15964,11003,23382
2022-12-05 15:00:00+00,21955,1319,4960,10574,364,1116,2324,272,93,544,43521,244,18315,15991,11031,23274
2022-12-05 15:30:00+00,22138,1318,4961,10497,422,1206,2326,361,3,826,44058,244,18209,15883,10922,23456
2022-12-05 16:00:00+00,22168,1316,4962,10889,530,1311,2329,543,0,908,44957,241,18710,16381,11419,23484
2022-12-05 16:30:00+00,22422,1313,4963,10753,545,1381,2335,964,0,902,45578,243,18596,16261,11298,23735
2022-12-05 17:00:00+00,22460,1311,4965,10901,590,1332,2320,1048,0,1138,46065,239,18776,16456,11491,23771
2022-12-05 17:30:00+00,22178,1313,4965,11166,593,1260,2323,1082,0,1172,46052,237,19047,16724,11759,23491
2022-12-05 18:00:00+00,22448,1316,4961,10787,458,1112,2384,978,0,1250,45694,241,18590,16206,11245,23764
2022-12-05 18:30:00+00,22228,1313,4966,10816,442,1046,2381,539,0,1164,44895,239,18605,16224,11258,23541
2022-12-05 19:00:00+00,22040,1316,4990,11123,401,918,2324,331,0,316,43759,243,18838,16514,11524,23356
2022-12-05 19:30:00+00,21546,1315,5165,10581,386,786,2350,222,0,344,42695,243,18482,16132,10967,22861
2022-12-05 20:00:00+00,21162,1317,5165,10584,353,718,2330,180,0,0,41809,244,18432,16102,10937,22479
2022-12-05 20:30:00+00,20070,1320,5168,10679,348,500,2318,161,0,0,40564,239,18513,16195,11027,21390
2022-12-05 21:00:00+00,19185,1320,5169,11038,328,170,2329,180,0,0,39719,232,18864,16535,11366,20505
2022-12-05 21:30:00+00,18214,1251,5171,10165,327,40,2320,161,0,100,37749,230,17983,15663,10492,19465
2022-12-05 22:00:00+00,17044,1227,5171,9871,310,86,2324,168,0,0,36201,226,17676,15352,10181,18271
2022-12-05 22:30:00+00,16148,1229,5187,9324,308,130,2342,176,0,0,34844,225,17161,14819,9632,17377
2022-12-05 23:00:00+00,14214,1216,5243,8988,295,790,2317,167,0,0,33230,216,16843,14526,9283,15430
2022-12-05 23:30:00+00,12910,1002,5251,9301,295,944,2310,174,0,0,32187,203,17157,14847,9596,13912
2022-12-06 00:00:00+00,12004,998,5265,8594,254,1750,2323,186,0,0,31374,202,16436,14113,8848,13002
2022-12-06 00:30:00+00,12647,998,5262,8151,253,1918,2306,175,0,0,31710,210,15972,13666,8404,13645
2022-12-06 01:00:00+00,12564,998,5263,8025,253,2230,2295,161,0,0,31789,209,15836,13541,8278,13562
2022-12-06 01:30:00+00,12566,998,5258,7575,254,2122,2306,173,0,0,31252,211,15393,13087,7829,13564
2022-12-06 02:00:00+00,12273,998,5261,7320,254,1918,2285,137,0,0,30446,213,15120,12835,7574,13271
2022-12-06 02:30:00+00,12321,997,5256,6952,253,1892,2307,150,0,0,30128,217,14768,12461,7205,13318
2022-12-06 03:00:00+00,13005,1000,5259,6494,253,1460,2305,156,0,0,29932,222,14311,12006,6747,14005
2022-12-06 03:30:00+00,12413,1002,5264,7189,254,1292,2288,134,0,0,29836,213,14995,12707,7443,13415
2022-12-06 04:00:00+00,12365,1001,5260,8002,254,856,2296,138,0,0,30172,208,15812,13516,8256,13366
2022-12-06 04:30:00+00,12257,999,5261,8089,255,692,2292,136,0,0,29981,207,15897,13605,8344,13256
2022-12-06 05:00:00+00,13308,998,5259,8101,267,408,2295,150,0,0,30786,215,15922,13627,8368,14306
2022-12-06 05:30:00+00,14077,997,5258,8498,270,440,2290,146,0,0,31976,217,16316,14026,8768,15074
2022-12-06 06:00:00+00,16962,997,5258,8533,311,460,2296,167,0,0,34984,233,16398,14102,8844,17959
2022-12-06 06:30:00+00,19116,994,5258,8513,317,526,2301,267,0,56,37348,243,16389,14088,8830,20110
2022-12-06 07:00:00+00,20641,997,5262,8568,364,482,2296,585,0,0,39195,248,16490,14194,8932,21638
2022-12-06 07:30:00+00,21473,996,5261,8477,364,656,2354,820,0,236,40637,252,16456,14102,8841,22469
2022-12-06 08:00:00+00,22135,994,5260,8612,364,588,2436,850,19,564,41822,250,16691,14255,8995,23129
2022-12-06 08:30:00+00,22461,992,5262,8511,364,678,2503,922,249,600,42542,251,16889,14386,9124,23453
2022-12-06 09:00:00+00,22462,994,5260,8516,360,968,2525,927,744,728,43484,248,17405,14880,9620,23456
2022-12-06 09:30:00+00,22518,993,5259,8270,336,982,2558,860,1283,628,43687,246,17706,15148,9889,23511
2022-12-06 10:00:00+00,22386,993,5258,7685,334,1284,2551,809,1741,384,43425,246,17569,15018,9760,23379
2022-12-06 10:30:00+00,22290,996,5258,7435,332,1214,2559,775,2136,172,43167,245,17720,15161,9903,23286
2022-12-06 11:00:00+00,22231,997,5254,7280,333,1286,2565,781,2465,178,43370,245,17897,15332,10078,23228
2022-12-06 11:30:00+00,22039,999,5256,7382,322,1406,2559,826,2743,144,43676,243,18262,15704,10448,23038
2022-12-06 12:00:00+00,21904,1001,5252,7768,320,1488,2390,668,2791,156,43738,239,18521,16131,10879,22905
2022-12-06 12:30:00+00,21976,999,5256,7902,319,1490,2274,816,2715,82,43829,239,18466,16192,10936,22975
2022-12-06 13:00:00+00,21906,1000,5252,8105,315,1386,2269,857,2407,22,43519,239,18348,16079,10827,22906
2022-12-06 13:30:00+00,21530,998,5251,8428,298,1416,2271,822,2021,0,43035,239,18269,15998,10747,22528
2022-12-06 14:00:00+00,21874,1001,5253,8409,325,668,2280,894,1440,280,42424,240,17707,15427,10174,22875
2022-12-06 14:30:00+00,21779,998,5254,9069,345,646,2454,768,796,96,42205,240,17918,15464,10210,22777
2022-12-06 15:00:00+00,20723,997,5254,9934,355,856,2628,719,260,1010,42736,228,18431,15803,10549,21720
2022-12-06 15:30:00+00,21230,998,5255,10179,400,964,2629,787,18,1126,43586,230,18481,15852,10597,22228
2022-12-06 16:00:00+00,21946,988,5255,10186,486,564,2628,1042,0,1282,44377,232,18555,15927,10672,22934
2022-12-06 16:30:00+00,22460,990,5258,10167,484,518,2627,1283,0,1406,45193,234,18536,15909,10651,23450
2022-12-06 17:00:00+00,22353,997,5260,10345,477,776,2629,1440,0,1322,45599,231,18711,16082,10822,23350
2022-12-06 17:30:00+00,21580,1144,5261,10785,475,824,2635,1379,0,1302,45385,228,19156,16521,11260,22724
2022-12-06 18:00:00+00,21094,1244,5260,10732,410,1404,2506,1001,0,1494,45145,228,18908,16402,11142,22338
2022-12-06 18:30:00+00,21419,1245,5262,10368,383,1448,2292,766,0,1274,44457,232,18305,16013,10751,22664
2022-12-06 19:00:00+00,21903,1248,5262,10006,336,1282,2390,708,0,1228,44363,236,17994,15604,10342,23151
2022-12-06 19:30:00+00,21957,1249,5261,9942,337,1276,2389,686,0,154,43251,243,17929,15540,10279,23206
2022-12-06 20:00:00+00,21616,1233,5261,9854,328,1628,2292,289,0,166,42667,241,17735,15443,10182,22849
2022-12-06 20:30:00+00,20675,1244,5260,9614,320,1636,2300,190,0,250,41489,238,17494,15194,9934,21919
2022-12-06 21:00:00+00,20186,1248,5259,9520,302,1336,2303,159,0,272,40585,235,17384,15081,9822,21434
2022-12-06 21:30:00+00,18768,1247,5263,9439,298,1330,2291,136,0,0,38772,232,17291,15000,9737,20015
2022-12-06 22:00:00+00,17553,1246,5260,9337,298,1272,2293,137,0,0,37396,228,17188,14895,9635,18799
2022-12-06 22:30:00+00,15864,1242,5264,9363,297,1266,2300,143,0,0,35739,220,17224,14924,9660,17106
2022-12-06 23:00:00+00,13218,1241,5262,9202,282,1556,2299,147,0,0,33207,208,17045,14746,9484,14459
2022-12-06 23:30:00+00,12411,1240,5259,9130,268,1570,2304,166,0,0,32348,204,16961,14657,9398,13651
2022-12-07 00:00:00+00,12012,1243,5260,9001,237,1926,2295,161,0,0,32135,204,16793,14498,9238,13255
2022-12-07 00:30:00+00,12075,1247,5263,9105,235,1952,2294,270,0,0,32441,205,16897,14603,9340,13322
2022-12-07 01:00:00+00,11345,1244,5261,9594,217,1937,2295,245,0,0,32138,197,17368,15072,9812,12589
2022-12-07 01:30:00+00,10901,1246,5260,9324,216,1924,2306,160,0,0,31337,195,17106,14800,9540,12147
2022-12-07 02:00:00+00,10447,1246,5259,8977,198,2066,2289,149,0,0,30632,194,16723,14434,9175,11693
2022-12-07 02:30:00+00,10381,1241,5261,8973,199,2061,2290,140,0,0,30546,194,16723,14433,9172,11622
2022-12-07 03:00:00+00,10204,1243,5261,9120,201,1986,2291,133,0,0,30439,192,16873,14582,9321,11447
2022-12-07 03:30:00+00,10277,1247,5260,8890,200,1942,2304,143,0,0,30263,194,16654,14350,9090,11524
2022-12-07 04:00:00+00,10507,1248,5263,9163,200,1843,2291,137,0,0,30651,193,16917,14626,9363,11755
2022-12-07 04:30:00+00,10456,1246,5259,9074,200,1805,2302,158,0,0,30501,193,16835,14533,9274,11702
2022-12-07 05:00:00+00,10837,1247,5259,9506,251,1570,2297,143,0,0,31109,194,17313,15016,9757,12084
2022-12-07 05:30:00+00,12484,1242,5258,9163,254,1526,2288,157,0,0,32372,206,16963,14675,9417,13726
2022-12-07 06:00:00+00,15777,1246,5256,9002,297,1188,2303,192,0,0,35261,227,16858,14555,9299,17023
2022-12-07 06:30:00+00,18517,1243,5256,9020,301,1181,2292,157,0,0,37967,239,16869,14577,9321,19760
2022-12-07 07:00:00+00,20213,1243,5255,8750,314,1560,2303,287,0,318,40243,244,16622,14319,9064,21456
2022-12-07 07:30:00+00,21689,1233,5258,8325,316,1646,2279,712,0,180,41637,253,16178,13899,8641,22922
2022-12-07 08:00:00+00,22035,1237,5256,8101,344,2086,2297,926,25,452,42759,252,16023,13726,8470,23272
2022-12-07 08:30:00+00,22186,1243,5257,7856,344,2172,2282,973,337,496,43146,252,16076,13794,8537,23429
2022-12-07 09:00:00+00,22139,1235,5257,8155,349,2200,2285,985,958,182,43746,248,17004,14719,9462,23374
2022-12-07 09:30:00+00,22393,1250,5255,7847,350,2170,2285,885,1665,412,44512,245,17402,15117,9862,23643
2022-12-07 10:00:00+00,22645,1240,5256,7419,357,2178,2332,880,2236,372,44915,245,17600,15268,10012,23885
2022-12-07 10:30:00+00,22483,1238,5256,7884,331,2179,2405,930,2639,140,45485,241,18515,16110,10854,23721
2022-12-07 11:00:00+00,22636,1213,5254,7771,313,2182,2455,555,2945,430,45754,239,18738,16283,11029,23849
2022-12-07 11:30:00+00,22670,1203,5255,7545,297,2170,2534,520,3065,112,45371,241,18696,16162,10907,23873
2022-12-07 12:00:00+00,22510,1237,5254,7612,293,2122,2591,733,3026,0,45378,241,18776,16185,10931,23747
2022-12-07 12:30:00+00,22432,1269,5254,7735,295,2096,2576,687,2958,116,45418,240,18818,16242,10988,23701
2022-12-07 13:00:00+00,22343,1265,5253,7830,291,1520,2620,720,2702,220,44764,238,18696,16076,10823,23608
2022-12-07 13:30:00+00,22360,1266,5254,8331,286,1512,2584,648,2317,0,44558,239,18772,16188,10934,23626
2022-12-07 14:00:00+00,22627,1280,5255,9060,284,1296,2508,558,1711,138,44717,238,18818,16310,11055,23907
2022-12-07 14:30:00+00,22671,1290,5256,9321,290,1276,2450,518,1008,190,44270,240,18325,15875,10619,23961
2022-12-07 15:00:00+00,22722,1281,5258,9226,368,1108,2439,791,340,426,43959,244,17631,15192,9934,24003
2022-12-07 15:30:00+00,22782,1287,5254,9482,409,1134,2432,830,24,694,44328,243,17601,15169,9915,24069
2022-12-07 16:00:00+00,22816,1282,5257,9608,528,1640,2400,931,0,1246,45708,241,17793,15393,10136,24098
2022-12-07 16:30:00+00,23212,1287,5259,9764,547,1802,2467,1284,0,1256,46878,242,18037,15570,10311,24499
2022-12-07 17:00:00+00,22959,1288,5255,9912,566,2264,2403,1454,0,1152,47253,242,18136,15733,10478,24247
2022-12-07 17:30:00+00,22769,1290,5255,10031,568,2322,2425,1405,0,1356,47421,240,18279,15854,10599,24059
2022-12-07 18:00:00+00,22908,1290,5257,9696,496,2626,2408,983,0,1298,46962,241,17857,15449,10192,24198
2022-12-07 18:30:00+00,22796,1288,5256,10232,462,2624,2404,775,0,336,46173,243,18354,15950,10694,24084
2022-12-07 19:00:00+00,22273,1287,5256,10360,379,2218,2442,473,0,252,44940,241,18437,15995,10739,23560
2022-12-07 19:30:00+00,21683,1286,5254,10224,374,2206,2458,368,0,638,44491,237,18310,15852,10598,22969
2022-12-07 20:00:00+00,21689,1290,5255,10333,362,1942,2475,237,0,406,43989,239,18425,15950,10695,22979
2022-12-07 20:30:00+00,21277,1290,5258,10235,354,1852,2412,143,0,24,42845,240,18259,15847,10589,22567
2022-12-07 21:00:00+00,20600,1290,5259,10372,308,1010,2324,136,0,0,41299,239,18263,15939,10680,21890
2022-12-07 21:30:00+00,19219,1291,5254,10022,271,908,2324,155,0,108,39552,235,17871,15547,10293,20510
2022-12-07 22:00:00+00,18115,1288,5259,9853,254,924,2310,133,0,0,38136,234,17676,15366,10107,19403
2022-12-07 22:30:00+00,16606,1287,5258,9907,243,912,2309,146,0,0,36668,227,17717,15408,10150,17893
2022-12-07 23:00:00+00,16253,1285,5261,9790,217,536,2086,149,0,0,35577,224,17354,15268,10007,17538
2022-12-07 23:30:00+00,15594,1288,5258,9636,217,558,2010,155,0,0,34716,222,17121,15111,9853,16882
2022-12-08 00:00:00+00,14722,1290,5260,9581,219,1046,2011,144,0,0,34273,218,17071,15060,9800,16012
2022-12-08 00:30:00+00,14944,1290,5260,9220,219,1086,2016,154,0,0,34189,222,16715,14699,9439,16234
2022-12-08 01:00:00+00,14256,1290,5263,9072,219,1708,2020,135,0,0,33963,221,16574,14554,9291,15546
2022-12-08 01:30:00+00,13305,1281,5263,9126,218,1732,2019,135,0,0,33079,216,16626,14607,9344,14586
2022-12-08 02:00:00+00,12255,1287,5260,9084,204,1646,2023,161,0,0,31920,212,16571,14548,9288,13542
2022-12-08 02:30:00+00,12620,1286,5263,8588,200,1620,2025,139,0,0,31741,217,16076,14051,8788,13906
2022-12-08 03:00:00+00,12927,1286,5263,8576,200,634,2023,149,0,0,31058,217,16062,14039,8776,14213
2022-12-08 03:30:00+00,13036,1285,5261,8167,200,572,2027,146,0,0,30694,220,15655,13628,8367,14321
2022-12-08 04:00:00+00,13799,1277,5265,8138,200,620,2014,137,0,0,31450,225,15617,13603,8338,15076
2022-12-08 04:30:00+00,13128,1286,5265,8494,200,628,2126,147,0,0,31274,218,16085,13959,8694,14414
2022-12-08 05:00:00+00,15045,1286,5262,8296,233,180,2162,148,0,0,32612,230,15953,13791,8529,16331
2022-12-08 05:30:00+00,15926,1289,5260,8815,233,192,2154,139,0,0,34008,231,16462,14308,9048,17215
2022-12-08 06:00:00+00,17576,1291,5260,8861,233,622,2161,164,0,0,36168,239,16515,14354,9094,18867
2022-12-08 06:30:00+00,19775,1281,5260,8964,233,934,2117,136,0,0,38700,249,16574,14457,9197,21056
2022-12-08 07:00:00+00,20525,1286,5258,9562,268,1320,2095,361,0,0,40675,246,17183,15088,9830,21811
2022-12-08 07:30:00+00,21989,1285,5259,9654,270,1204,2026,476,0,202,42365,248,17209,15183,9924,23274
2022-12-08 08:00:00+00,22234,1289,5256,9581,338,1410,2028,504,23,138,42801,247,17226,15198,9942,23523
2022-12-08 08:30:00+00,22556,1282,5260,9439,333,1418,2032,541,393,238,43492,246,17457,15425,10165,23838
2022-12-08 09:00:00+00,22759,1288,5260,9257,338,1848,2042,571,1168,238,44769,243,18065,16023,10763,24047
2022-12-08 09:30:00+00,22796,1289,5260,8779,341,1912,2046,551,2021,270,45265,241,18447,16401,11141,24085
2022-12-08 10:00:00+00,22704,1290,5259,8604,328,2132,2042,526,2794,220,45899,239,19027,16985,11726,23994
2022-12-08 10:30:00+00,22393,1289,5260,8491,324,2120,2128,505,3354,36,45900,236,19557,17429,12169,23682
2022-12-08 11:00:00+00,22044,1288,5259,8233,250,1974,2145,314,3646,56,45209,236,19533,17388,12129,23332
2022-12-08 11:30:00+00,22140,1287,5259,8248,243,1942,2143,228,3798,0,45288,235,19691,17548,12289,23427
2022-12-08 12:00:00+00,22102,1298,5257,7967,232,1792,2127,259,3741,164,44939,235,19324,17197,11940,23400
2022-12-08 12:30:00+00,22442,1303,5260,7802,237,1752,2107,300,3569,0,44772,239,18975,16868,11608,23745
2022-12-08 13:00:00+00,22593,1303,5259,7353,237,1140,2106,435,3231,244,43901,244,18186,16080,10821,23896
2022-12-08 13:30:00+00,22798,1288,5262,7105,234,1104,2116,579,2657,36,43179,250,17374,15258,9996,24086
2022-12-08 14:00:00+00,22675,1282,5262,7191,264,1350,2109,518,1899,0,42550,255,16725,14616,9354,23957
2022-12-08 14:30:00+00,23038,1280,5260,6961,283,1318,2122,554,1050,74,41940,262,15676,13554,8294,24318
2022-12-08 15:00:00+00,23205,1283,5259,6934,357,1608,2118,492,326,546,42128,263,14994,12876,7617,24488
2022-12-08 15:30:00+00,23259,1284,5260,6547,403,1744,2114,725,24,1056,42416,264,14348,12234,6974,24543
2022-12-08 16:00:00+00,23027,1283,5260,6427,550,3422,2124,831,0,1080,44004,257,14361,12237,6977,24310
2022-12-08 16:30:00+00,23118,1284,5260,6373,576,3706,2117,1264,0,1188,44886,256,14326,12209,6949,24402
2022-12-08 17:00:00+00,23622,1286,5263,6448,586,3906,2105,1426,0,788,45430,262,14402,12296,7034,24908
2022-12-08 17:30:00+00,23758,1284,5264,6667,602,3916,2115,1394,0,1006,46007,260,14648,12533,7269,25042
2022-12-08 18:00:00+00,23705,1282,5264,6523,564,3566,2108,939,0,1200,45151,259,14459,12351,7087,24987
2022-12-08 18:30:00+00,23581,1284,5263,6552,535,3558,2126,801,0,994,44695,260,14476,12350,7087,24865
2022-12-08 19:00:00+00,23267,1282,5265,6757,449,3362,2161,734,0,464,43742,262,14632,12471,7206,24549
2022-12-08 19:30:00+00,22805,1287,5266,6346,426,3358,2158,437,0,0,42083,265,14196,12038,6772,24092
2022-12-08 20:00:00+00,22189,1284,5268,6477,309,2604,2155,261,0,0,40547,262,14209,12054,6786,23473
2022-12-08 20:30:00+00,21385,1289,5265,6176,292,2536,2160,174,0,34,39311,261,13893,11733,6468,22674
2022-12-08 21:00:00+00,20597,1289,5266,5930,283,2057,2166,249,0,74,37910,263,13645,11479,6213,21886
2022-12-08 21:30:00+00,19463,1288,5264,5620,283,1754,2162,149,0,10,35993,261,13329,11167,5903,20751
2022-12-08 22:00:00+00,18356,1288,5262,5225,283,1028,2165,200,0,12,33819,262,12935,10770,5508,19644
2022-12-08 22:30:00+00,17358,1288,5262,5249,225,964,2161,138,0,0,32645,258,12897,10736,5474,18646
2022-12-08 23:00:00+00,16629,1288,5259,5498,225,626,2158,171,0,0,31854,256,13140,10982,5723,17917
2022-12-08 23:30:00+00,16284,1278,5261,5151,225,584,2141,375,0,0,31299,258,12778,10637,5376,17562
2022-12-09 00:00:00+00,16278,1262,5262,5377,225,966,2117,469,0,0,31956,261,12981,10864,5602,17540
2022-12-09 00:30:00+00,16338,1259,5264,6381,225,992,2114,419,0,0,32992,253,13984,11870,6606,17597
2022-12-09 01:00:00+00,16195,1280,5262,6871,225,958,2122,153,0,0,33066,244,14480,12358,7096,17475
2022-12-09 01:30:00+00,15979,1276,5263,6874,225,994,2098,142,0,0,32852,242,14460,12362,7099,17255
2022-12-09 02:00:00+00,15899,1288,5260,6784,208,1060,2006,185,0,0,32690,243,14258,12252,6992,17187
2022-12-09 02:30:00+00,15868,1286,5259,6962,207,1028,2002,144,0,0,32756,242,14430,12428,7169,17154
2022-12-09 03:00:00+00,15849,1290,5259,7189,207,480,2004,162,0,0,32440,240,14659,12655,7396,17139
2022-12-09 03:30:00+00,15738,1290,5259,7310,207,420,1998,141,0,0,32363,239,14774,12776,7517,17028
2022-12-09 04:00:00+00,15907,1293,5258,7377,188,32,2008,142,0,0,32205,241,14831,12823,7565,17200
2022-12-09 04:30:00+00,16134,1292,5259,7596,186,0,2009,163,0,0,32639,241,15050,13041,7782,17426
2022-12-09 05:00:00+00,16819,1287,5257,7914,213,350,2103,139,0,0,34082,243,15487,13384,8127,18106
2022-12-09 05:30:00+00,17666,1287,5260,7946,213,598,2150,167,0,0,35287,248,15569,13419,8159,18953
2022-12-09 06:00:00+00,18926,1288,5262,7585,214,1094,2346,172,0,0,36886,254,15407,13061,7799,20214
2022-12-09 06:30:00+00,20019,1286,5261,6989,237,1138,2505,164,0,0,37599,261,14992,12487,7226,21305
2022-12-09 07:00:00+00,21043,1283,5261,6750,291,1918,2490,254,0,0,39290,261,14792,12302,7041,22326
2022-12-09 07:30:00+00,21561,1281,5260,6900,310,1896,2490,632,0,466,40796,258,14960,12470,7210,22842
2022-12-09 08:00:00+00,21925,1285,5261,6840,420,1672,2425,675,11,380,40894,260,14957,12532,7271,23210
2022-12-09 08:30:00+00,22111,1279,5264,6453,427,1658,2333,773,268,494,41060,261,14745,12412,7148,23390
2022-12-09 09:00:00+00,22241,1286,5260,6323,433,1944,2299,827,853,466,41932,257,15168,12869,7609,23527
2022-12-09 09:30:00+00,22272,1278,5264,6388,429,1958,2285,953,1546,382,42755,253,15912,13627,8363,23550
2022-12-09 10:00:00+00,22200,1279,5261,6341,281,2370,2307,966,2135,312,43452,249,16325,14018,8757,23479
2022-12-09 10:30:00+00,22187,1283,5261,6290,278,1848,2301,612,2662,308,43030,249,16792,14491,9230,23470
2022-12-09 11:00:00+00,22214,1286,5261,5725,243,2704,2297,334,3013,278,43354,248,16539,14242,8981,23500
2022-12-09 11:30:00+00,22081,1256,5264,5221,250,2814,2311,477,3223,180,43077,249,16269,13958,8694,23337
2022-12-09 12:00:00+00,23161,1131,5265,5088,254,1668,2247,692,3288,222,43016,252,16142,13895,8630,24292
2022-12-09 12:30:00+00,22801,1196,5254,5175,254,1652,2275,484,3249,206,42546,251,16207,13932,8678,23997
2022-12-09 13:00:00+00,22369,1282,5252,5120,257,2180,2299,324,2998,36,42117,253,15926,13627,8375,23651
2022-12-09 13:30:00+00,22443,1279,5254,5176,261,2180,2288,250,2541,226,41898,254,15520,13232,7978,23722
2022-12-09 14:00:00+00,23236,1283,5251,4981,280,1646,2292,338,1950,228,41485,263,14754,12462,7211,24519
2022-12-09 14:30:00+00,23374,1282,5246,4675,287,1682,2290,426,1113,330,40705,271,13611,11321,6075,24656
2022-12-09 15:00:00+00,22514,1283,5243,4816,330,2242,2364,417,359,1048,40616,265,13112,10748,5505,23797
2022-12-09 15:30:00+00,23213,1286,5244,4365,377,2334,2285,675,26,1192,40997,271,12297,10012,4768,24499
2022-12-09 16:00:00+00,23488,1286,5243,4386,523,3896,2112,798,0,1278,43010,267,12264,10152,4909,24774
2022-12-09 16:30:00+00,24228,1284,5236,4142,556,3984,2048,1046,0,1448,43972,269,11982,9934,4698,25512
2022-12-09 17:00:00+00,24413,1280,5233,4347,552,3498,2273,1322,0,1476,44394,268,12405,10132,4899,25693
2022-12-09 17:30:00+00,24527,1282,5231,4183,552,3508,2292,1475,0,1424,44475,270,12258,9966,4735,25809
2022-12-09 18:00:00+00,24490,1287,5232,3770,534,4224,2292,1183,0,1682,44694,268,11828,9536,4304,25777
2022-12-09 18:30:00+00,24343,1281,5235,3658,512,4246,2290,883,0,1490,43938,269,11695,9405,4170,25624
2022-12-09 19:00:00+00,24042,1286,5232,4196,431,4414,2100,761,0,800,43262,271,11959,9859,4627,25328
2022-12-09 19:30:00+00,23385,1280,5219,4598,408,4433,1993,677,0,614,42606,267,12218,10225,5006,24665
2022-12-09 20:00:00+00,22860,1286,5210,4976,281,3788,1993,516,0,426,41336,266,12460,10467,5257,24146
2022-12-09 20:30:00+00,22088,1283,5216,4972,271,3688,1994,250,0,0,39761,267,12453,10459,5243,23371
2022-12-09 21:00:00+00,21260,1281,5220,5047,234,2566,1991,198,0,80,37877,273,12492,10501,5281,22541
2022-12-09 21:30:00+00,20093,1285,5219,4909,232,2498,1991,151,0,162,36540,270,12351,10360,5141,21378
2022-12-09 22:00:00+00,18971,1284,5220,4677,233,1610,1990,173,0,416,34574,269,12120,10130,4910,20255
2022-12-09 22:30:00+00,17968,1286,5230,4655,233,1416,1993,168,0,0,32949,268,12111,10118,4888,19254
2022-12-09 23:00:00+00,17230,1287,5230,4703,214,1138,1992,157,0,0,31951,268,12139,10147,4917,18517
2022-12-09 23:30:00+00,16779,1281,5237,4731,214,1044,1988,140,0,0,31415,266,12170,10182,4945,18060
2022-12-10 00:00:00+00,16741,1280,5244,4730,214,506,1988,145,0,0,30848,267,12176,10188,4944,18021
2022-12-10 00:30:00+00,16797,1288,5249,4169,214,474,1992,187,0,0,30370,273,11624,9632,4383,18085
2022-12-10 01:00:00+00,16698,1289,5257,3875,214,1060,1991,147,0,0,30531,277,11337,9346,4089,17987
2022-12-10 01:30:00+00,16473,1289,5259,4122,214,1070,1991,138,0,0,30556,274,11586,9595,4336,17762
2022-12-10 02:00:00+00,16365,1287,5263,4185,197,950,1991,138,0,0,30376,272,11636,9645,4382,17652
2022-12-10 02:30:00+00,16297,1282,5045,4196,195,958,1992,139,0,0,30104,273,11428,9436,4391,17579
2022-12-10 03:00:00+00,16265,1229,5058,4277,195,448,1948,164,0,0,29584,269,11478,9530,4472,17494
2022-12-10 03:30:00+00,16143,1271,5088,4367,196,442,1610,150,0,0,29267,270,11261,9651,4563,17414
2022-12-10 04:00:00+00,16282,1288,5111,4313,196,518,1345,156,0,0,29209,270,10965,9620,4509,17570
2022-12-10 04:30:00+00,16183,1283,5109,4083,196,524,1337,155,0,0,28870,272,10725,9388,4279,17466
2022-12-10 05:00:00+00,17011,1288,5120,4173,227,242,1303,136,0,0,29500,278,10823,9520,4400,18299
2022-12-10 05:30:00+00,16990,1287,5116,4327,228,266,1338,146,0,0,29698,277,11009,9671,4555,18277
2022-12-10 06:00:00+00,17445,1288,5130,4394,228,834,1344,149,0,0,30812,281,11096,9752,4622,18733
2022-12-10 06:30:00+00,18203,1292,5167,4387,244,914,1337,134,0,0,31678,284,11135,9798,4631,19495
2022-12-10 07:00:00+00,19550,1287,5213,4393,247,690,1339,140,0,0,32859,286,11192,9853,4640,20837
2022-12-10 07:30:00+00,20300,1282,5218,4351,246,884,1329,161,0,0,33771,290,11144,9815,4597,21582
2022-12-10 08:00:00+00,21167,1286,5217,4121,246,1070,1344,156,14,14,34635,290,10942,9598,4381,22453
2022-12-10 08:30:00+00,21992,1291,5216,3956,261,1334,1343,290,285,24,35992,292,11061,9718,4502,23283
2022-12-10 09:00:00+00,22007,1286,5221,3926,265,2752,1325,358,870,82,38092,285,11607,10282,5061,23293
2022-12-10 09:30:00+00,22083,1288,5224,3767,257,2866,1311,424,1618,0,38838,281,12177,10866,5642,23371
2022-12-10 10:00:00+00,21994,1268,5224,3761,274,3116,1310,346,2260,0,39553,275,12829,11519,6295,23262
2022-12-10 10:30:00+00,22053,1282,5227,3811,272,3026,1310,226,2640,22,39869,272,13260,11950,6723,23335
2022-12-10 11:00:00+00,21696,1285,5221,3640,215,3506,1328,177,2890,0,39958,265,13294,11966,6745,22981
2022-12-10 11:30:00+00,21722,1288,5230,3578,211,3444,1345,155,2961,0,39934,264,13325,11980,6750,23010
2022-12-10 12:00:00+00,21892,1290,5252,3624,192,3362,1344,163,2900,26,40045,265,13312,11968,6716,23182
2022-12-10 12:30:00+00,21942,1288,5265,3693,192,3364,1343,162,2757,0,40006,265,13250,11907,6642,23230
2022-12-10 13:00:00+00,21929,1292,5338,3694,197,2932,1338,161,2561,76,39518,264,13128,11790,6452,23221
2022-12-10 13:30:00+00,21898,1291,5517,3595,213,2916,1338,158,2130,174,39230,266,12793,11455,5938,23189
2022-12-10 14:00:00+00,21929,1289,5520,3394,213,3284,1339,185,1513,52,38718,273,11979,10640,5120,23218
2022-12-10 14:30:00+00,22169,1290,5521,3376,213,3292,1343,257,848,44,38353,279,11301,9958,4437,23459
2022-12-10 15:00:00+00,22167,1285,5537,3513,311,4188,1352,229,277,4,38863,281,10990,9638,4101,23452
2022-12-10 15:30:00+00,22159,1288,5556,3719,335,4406,1349,281,19,218,39330,280,10978,9629,4073,23447
2022-12-10 16:00:00+00,22196,1288,5567,3559,351,5548,1326,545,0,660,41040,272,10803,9477,3910,23484
2022-12-10 16:30:00+00,22588,1289,5583,3518,358,5694,1304,744,0,708,41786,274,10763,9459,3876,23877
2022-12-10 17:00:00+00,22965,1293,5579,3564,400,5600,1303,924,0,1214,42842,270,10846,9543,3964,24258
2022-12-10 17:30:00+00,22904,1290,5555,3450,400,5580,1336,1002,0,1004,42522,272,10742,9406,3850,24194
2022-12-10 18:00:00+00,22851,1289,5556,3193,371,5252,1347,681,0,1122,41662,271,10467,9120,3564,24140
2022-12-10 18:30:00+00,22219,1289,5558,3143,363,5149,1350,507,0,1148,40726,269,10414,9064,3506,23508
2022-12-10 19:00:00+00,21640,1286,5555,3263,323,5128,1358,408,0,410,39371,274,10499,9141,3586,22926
2022-12-10 19:30:00+00,21250,1283,5556,3394,296,5022,1365,181,0,462,38809,272,10611,9246,3690,22533
2022-12-10 20:00:00+00,21767,1278,5554,3478,256,3808,1392,138,0,186,37857,283,10680,9288,3734,23045
2022-12-10 20:30:00+00,20875,1278,5555,3213,249,3626,1401,139,0,120,36456,284,10418,9017,3462,22153
2022-12-10 21:00:00+00,21783,1283,5556,3122,230,2362,1408,187,0,80,36011,295,10316,8908,3352,23066
2022-12-10 21:30:00+00,21384,1288,5554,3007,228,2208,1412,183,0,58,35322,295,10201,8789,3235,22672
2022-12-10 22:00:00+00,22108,1286,5554,3117,218,1448,1404,163,0,102,35400,300,10293,8889,3335,23394
2022-12-10 22:30:00+00,21035,1285,5553,3120,229,1458,1356,192,0,194,34422,296,10258,8902,3349,22320
2022-12-10 23:00:00+00,17874,1287,5554,3173,229,2130,1372,146,0,0,31765,282,10328,8956,3402,19161
2022-12-10 23:30:00+00,16879,1284,5553,2880,229,2214,1396,155,0,0,30590,280,10058,8662,3109,18163
2022-12-11 00:00:00+00,16761,1289,5553,2543,228,2802,1413,148,0,0,30737,280,9737,8324,2771,18050
2022-12-11 00:30:00+00,17404,1285,5554,2129,228,2820,1422,154,0,0,30996,286,9333,7911,2357,18689
2022-12-11 01:00:00+00,17434,1290,5547,2177,228,2718,1421,159,0,0,30974,287,9373,7952,2405,18724
2022-12-11 01:30:00+00,17316,1289,5547,1923,226,2696,1419,145,0,0,30561,289,9115,7696,2149,18605
2022-12-11 02:00:00+00,17006,1283,5553,2058,209,2502,1420,164,0,0,30194,289,9240,7820,2266,18289
2022-12-11 02:30:00+00,16349,1283,5556,2236,210,2482,1429,177,0,0,29722,285,9431,8002,2446,17632
2022-12-11 03:00:00+00,16159,1287,5556,1885,210,2450,1434,155,0,0,29136,288,9085,7651,2095,17446
2022-12-11 03:30:00+00,16100,1286,5559,1891,210,2452,1433,148,0,0,29079,288,9093,7660,2101,17386
2022-12-11 04:00:00+00,16242,1288,5557,1766,210,2248,1432,169,0,0,28912,291,8965,7533,1976,17530
2022-12-11 04:30:00+00,16435,1287,5559,1691,210,2234,1434,149,0,0,28999,292,8894,7460,1901,17722
2022-12-11 05:00:00+00,17078,1287,5561,1712,226,2216,1423,155,0,0,29658,294,8922,7499,1938,18365
2022-12-11 05:30:00+00,17889,1285,5567,1802,226,2208,1418,154,0,0,30549,295,9013,7595,2028,19174
2022-12-11 06:00:00+00,19118,1292,5579,1857,226,1954,1377,171,0,0,31574,300,9039,7662,2083,20410
2022-12-11 06:30:00+00,20190,1291,5578,1718,227,1888,1374,158,0,0,32424,305,8897,7523,1945,21481
2022-12-11 07:00:00+00,21152,1288,5581,1509,245,746,1373,153,0,0,32046,311,8708,7335,1754,22440
2022-12-11 07:30:00+00,21775,1289,5581,1408,245,812,1372,195,0,0,32677,315,8606,7234,1653,23064
2022-12-11 08:00:00+00,22030,1289,5584,1449,244,1648,1430,190,4,0,33868,312,8711,7281,1697,23319
2022-12-11 08:30:00+00,22227,1283,5593,1525,246,1914,1433,402,126,16,34765,311,8923,7490,1897,23510
2022-12-11 09:00:00+00,22369,1290,5606,1392,260,4476,1438,222,375,126,37554,297,9071,7633,2027,23659
2022-12-11 09:30:00+00,22388,1243,5621,1348,266,4840,1438,186,752,0,38082,294,9425,7987,2366,23631
2022-12-11 10:00:00+00,22475,1276,5637,1352,292,5126,1436,223,1080,0,38897,287,9797,8361,2724,23751
2022-12-11 10:30:00+00,22392,1243,5653,1295,293,5240,1435,329,1345,0,39225,284,10021,8586,2933,23635
2022-12-11 11:00:00+00,22474,1280,5666,1199,232,5678,1437,324,1493,0,39783,282,10027,8590,2924,23754
2022-12-11 11:30:00+00,22474,1291,5677,1138,227,5764,1438,355,1590,0,39954,282,10070,8632,2955,23765
2022-12-11 12:00:00+00,22498,1286,5677,1006,212,5936,1437,265,1568,84,39969,281,9900,8463,2786,23784
2022-12-11 12:30:00+00,22408,1278,5685,960,205,5930,1438,361,1451,96,39812,281,9739,8301,2616,23686
2022-12-11 13:00:00+00,22405,1282,5690,1083,192,6572,1433,321,1264,46,40288,280,9662,8229,2539,23687
2022-12-11 13:30:00+00,22356,1290,5691,1202,193,6446,1433,289,972,30,39901,281,9491,8058,2367,23646
2022-12-11 14:00:00+00,22413,1290,5693,1252,195,6292,1434,279,739,24,39611,284,9313,7879,2186,23703
2022-12-11 14:30:00+00,22583,1287,5694,1191,198,6326,1437,360,439,24,39539,287,8959,7522,1828,23870
2022-12-11 15:00:00+00,22553,1287,5691,1134,231,6562,1436,425,150,0,39470,287,8642,7206,1516,23840
2022-12-11 15:30:00+00,23109,1285,5693,1011,271,6668,1438,541,12,76,40104,290,8425,6987,1294,24394
2022-12-11 16:00:00+00,23670,1287,5692,953,321,6578,1439,840,0,860,41640,287,8405,6966,1274,24957
2022-12-11 16:30:00+00,23885,1288,5697,921,369,6586,1437,1132,0,1514,42829,283,8424,6987,1290,25173
2022-12-11 17:00:00+00,24227,1291,5702,861,388,6510,1437,1373,0,1684,43473,283,8388,6951,1249,25518
2022-12-11 17:30:00+00,24344,1289,5700,861,385,6504,1435,1349,0,1578,43445,284,8381,6946,1246,25633
2022-12-11 18:00:00+00,24200,1287,5700,866,360,6364,1425,1004,0,1448,42654,285,8351,6926,1226,25487
2022-12-11 18:30:00+00,23847,1287,5699,949,360,6328,1433,845,0,944,41692,287,8441,7008,1309,25134
2022-12-11 19:00:00+00,23503,1283,5699,1135,329,6022,1424,775,0,384,40554,290,8587,7163,1464,24786
2022-12-11 19:30:00+00,23115,1284,5700,1273,298,5920,1438,468,0,12,39508,290,8709,7271,1571,24399
2022-12-11 20:00:00+00,23358,1288,5699,1395,248,4740,1429,348,0,230,38735,297,8771,7342,1643,24646
2022-12-11 20:30:00+00,22944,1289,5701,1426,227,4532,1427,229,0,172,37947,297,8781,7354,1653,24233
2022-12-11 21:00:00+00,23283,1285,5712,1353,197,2760,1437,322,0,60,36409,311,8699,7262,1550,24568
2022-12-11 21:30:00+00,22435,1284,5709,1362,196,2630,1439,207,0,54,35316,309,8706,7267,1558,23719
2022-12-11 22:00:00+00,22386,1282,5715,1479,181,2036,1443,152,0,142,34816,311,8818,7375,1660,23668
2022-12-11 22:30:00+00,21414,1290,5722,1392,179,2034,1443,156,0,12,33642,310,8736,7293,1571,22704
2022-12-11 23:00:00+00,21799,1287,5728,1278,178,1140,1545,144,0,0,33099,311,8729,7184,1456,23086
2022-12-11 23:30:00+00,21381,1290,5730,1142,178,1142,1579,158,0,0,32600,311,8629,7050,1320,22671
2022-12-12 00:00:00+00,21181,1287,5730,1188,180,1474,1734,138,0,0,32912,308,8832,7098,1368,22468
2022-12-12 00:30:00+00,21579,1289,5729,1254,181,1494,1730,163,0,0,33419,308,8894,7164,1435,22868
2022-12-12 01:00:00+00,21398,1289,5730,1226,184,1782,1747,147,0,0,33503,306,8887,7140,1410,22687
2022-12-12 01:30:00+00,21081,1285,5743,1222,184,1790,1747,152,0,0,33204,305,8896,7149,1406,22366
2022-12-12 02:00:00+00,20889,1286,5744,1287,184,1652,1766,146,0,0,32954,307,8981,7215,1471,22175
2022-12-12 02:30:00+00,20734,1287,5745,1370,184,1614,1809,138,0,0,32880,306,9108,7299,1554,22021
2022-12-12 03:00:00+00,20603,1286,5753,1446,184,1250,1834,157,0,0,32513,308,9217,7383,1630,21889
2022-12-12 03:30:00+00,20382,1288,5756,1534,184,1184,1858,147,0,0,32333,307,9332,7474,1718,21670
2022-12-12 04:00:00+00,20426,1290,5755,1520,184,490,1928,142,0,0,31736,306,9387,7459,1704,21716
2022-12-12 04:30:00+00,20517,1288,5756,1420,185,521,2099,154,0,0,31939,306,9460,7361,1605,21805
2022-12-12 05:00:00+00,21054,1289,5757,1512,196,740,2341,144,0,0,33033,301,9806,7465,1708,22343
2022-12-12 05:30:00+00,21748,1287,5761,1561,197,1074,2486,180,0,0,34294,302,10005,7519,1758,23035
2022-12-12 06:00:00+00,22861,1278,5764,1514,214,2552,2484,280,0,0,36947,306,9976,7492,1728,24139
2022-12-12 06:30:00+00,23833,1280,5768,1486,259,2772,2488,486,0,0,38371,308,10001,7513,1745,25113
2022-12-12 07:00:00+00,24885,1288,5758,1443,693,3590,2457,889,0,300,41303,300,10351,7894,2136,26173
2022-12-12 07:30:00+00,25290,1286,5751,1446,670,3566,2489,1046,0,582,42126,299,10356,7867,2116,26576
2022-12-12 08:00:00+00,25582,1289,5753,1407,749,3238,2487,1047,1,720,42273,299,10397,7910,2157,26871
2022-12-12 08:30:00+00,25636,1288,5759,1420,781,3266,2491,1219,60,1102,43022,295,10511,8020,2261,26924
2022-12-12 09:00:00+00,25625,1290,5764,1502,848,4766,2487,926,290,1008,44506,286,10891,8404,2640,26915
2022-12-12 09:30:00+00,25540,1289,5769,1558,852,4816,2481,789,545,810,44449,285,11205,8724,2955,26829
2022-12-12 10:00:00+00,25401,1286,5769,1578,876,4924,2483,688,758,884,44647,282,11464,8981,3212,26687
2022-12-12 10:30:00+00,25175,1287,5767,1685,967,4916,2477,656,943,882,44755,279,11839,9362,3595,26462
2022-12-12 11:00:00+00,25007,1288,5778,1845,913,5872,2480,709,1110,594,45595,275,12126,9646,3868,26295
2022-12-12 11:30:00+00,24821,1288,5793,1738,814,5908,2470,725,1192,798,45547,274,12007,9537,3744,26109
2022-12-12 12:00:00+00,24903,1290,5791,1685,781,6060,2482,770,1166,1014,45942,273,11905,9423,3632,26193
2022-12-12 12:30:00+00,24766,1290,5792,1717,800,6070,2483,792,1089,972,45771,273,11881,9398,3606,26056
2022-12-12 13:00:00+00,24560,1289,5789,1613,796,5802,2482,845,907,998,45081,275,11587,9105,3316,25849
2022-12-12 13:30:00+00,24212,1287,5788,1564,712,5792,2481,835,667,1166,44504,275,11212,8731,2943,25499
2022-12-12 14:00:00+00,24054,1286,5787,1683,712,5830,2488,902,438,1030,44210,276,11108,8620,2833,25340
2022-12-12 14:30:00+00,23851,1286,5785,1878,737,5830,2516,924,226,1258,44290,274,11142,8626,2840,25137
2022-12-12 15:00:00+00,24335,1288,5786,2025,840,6166,2512,836,60,1230,45078,274,11223,8711,2925,25623
2022-12-12 15:30:00+00,24567,1284,5785,1958,1001,6184,2694,860,4,1200,45537,274,11442,8748,2963,25851
2022-12-12 16:00:00+00,25180,1288,5786,1956,1094,6060,2727,846,0,1288,46225,276,11563,8836,3050,26468
2022-12-12 16:30:00+00,25259,1288,5785,1987,1097,6066,2734,1420,0,1472,47108,275,11603,8869,3084,26547
2022-12-12 17:00:00+00,25667,1283,5791,2195,1105,6092,2733,1677,0,1278,47821,276,11824,9091,3300,26950
2022-12-12 17:30:00+00,25938,1287,5798,2520,1093,6096,2731,1766,0,1242,48471,275,12142,9411,3613,27225
2022-12-12 18:00:00+00,25968,1288,5803,2793,1096,5684,2731,897,0,1224,47484,274,12423,9692,3889,27256
2022-12-12 18:30:00+00,25889,1287,5801,2810,1117,5674,2728,482,0,1352,47140,272,12456,9728,3927,27176
2022-12-12 19:00:00+00,25712,1288,5804,2910,1040,6080,2734,478,0,716,46762,274,12488,9754,3950,27000
2022-12-12 19:30:00+00,25495,1288,5806,2770,823,6090,2704,686,0,232,45893,280,12103,9399,3593,26783
2022-12-12 20:00:00+00,24889,1289,5805,2784,482,6024,2434,656,0,0,44363,281,11505,9071,3266,26178
2022-12-12 20:30:00+00,24209,1288,5803,2834,419,6190,2081,372,0,0,43196,281,11137,9056,3253,25497
2022-12-12 21:00:00+00,23496,1286,5805,3040,300,4768,2081,308,0,114,41198,284,11226,9145,3340,24782
2022-12-12 21:30:00+00,22476,1289,5811,3064,278,4390,2082,276,0,0,39666,282,11235,9153,3342,23765
2022-12-12 22:00:00+00,21502,1289,5815,3042,281,2264,2083,269,0,0,36545,290,11221,9138,3323,22791
2022-12-12 22:30:00+00,20638,1288,5816,2933,275,2000,2087,197,0,0,35234,288,11111,9024,3208,21926
2022-12-12 23:00:00+00,20044,1288,5815,2844,244,1442,2083,178,0,0,33938,290,10986,8903,3088,21332
2022-12-12 23:30:00+00,19745,1290,5825,2656,241,1386,2080,152,0,0,33375,291,10802,8722,2897,21035
2022-12-13 00:00:00+00,19873,1292,5832,2530,239,1140,2082,150,0,0,33138,295,10683,8601,2769,21165
2022-12-13 00:30:00+00,20107,1287,5829,2445,236,1106,2084,171,0,0,33264,297,10594,8510,2681,21394
2022-12-13 01:00:00+00,20176,1287,5829,2317,234,958,2080,152,0,0,33034,299,10460,8380,2551,21463
2022-12-13 01:30:00+00,20118,1287,5836,2213,231,958,2078,148,0,0,32869,299,10358,8280,2444,21405
2022-12-13 02:00:00+00,20195,1286,5838,2135,182,1180,2082,147,0,0,33045,300,10237,8155,2317,21481
2022-12-13 02:30:00+00,20318,1284,5838,2086,172,1180,2084,155,0,0,33117,301,10180,8096,2258,21602
2022-12-13 03:00:00+00,20465,1287,5841,2246,171,866,2084,149,0,0,33109,300,10342,8258,2417,21752
2022-12-13 03:30:00+00,20520,1282,5841,2347,170,862,2078,166,0,0,33266,300,10436,8358,2517,21802
2022-12-13 04:00:00+00,21308,1287,5841,2362,170,312,2083,161,0,0,33524,299,10456,8373,2532,22595
2022-12-13 04:30:00+00,21026,1292,5840,2491,170,334,2084,142,0,0,33379,298,10585,8501,2661,22318
2022-12-13 05:00:00+00,21415,1288,5842,2853,205,718,2088,147,0,0,34556,297,10988,8900,3058,22703
2022-12-13 05:30:00+00,20861,1287,5843,3642,209,986,2087,192,0,0,35107,290,11781,9694,3851,22148
2022-12-13 06:00:00+00,20323,1289,5841,4198,224,1752,2264,270,0,0,36161,286,12527,10263,4422,21612
2022-12-13 06:30:00+00,21197,1290,5845,4381,224,1976,2518,553,0,298,38282,284,12968,10450,4605,22487
2022-12-13 07:00:00+00,22134,1288,5844,4444,287,2188,2603,853,0,236,39877,284,13178,10575,4731,23422
2022-12-13 07:30:00+00,22740,1287,5841,4610,360,2158,2624,1174,0,600,41394,280,13435,10811,4970,24027
2022-12-13 08:00:00+00,23688,1289,5841,4391,365,2064,2601,874,2,1112,42227,278,13200,10599,4758,24977
2022-12-13 08:30:00+00,24260,1287,5841,4378,661,2102,2601,977,93,998,43198,278,13574,10973,5132,25547
2022-12-13 09:00:00+00,24161,1288,5841,4454,607,3156,2645,970,277,1024,44423,275,13824,11179,5338,25449
2022-12-13 09:30:00+00,24290,1287,5844,4587,664,3222,2691,993,537,828,44943,273,14323,11632,5788,25577
2022-12-13 10:00:00+00,24466,1283,5843,4420,584,3564,2671,976,793,686,45286,273,14311,11640,5797,25749
2022-12-13 10:30:00+00,24549,1288,5842,4375,527,3604,2684,1047,963,778,45657,272,14391,11707,5865,25837
2022-12-13 11:00:00+00,24421,1288,5843,4180,330,4402,2641,903,1110,604,45722,272,14104,11463,5620,25709
2022-12-13 11:30:00+00,24464,1288,5841,3980,307,4436,2637,828,1186,664,45631,273,13951,11314,5473,25752
2022-12-13 12:00:00+00,24810,1285,5839,3680,296,4118,2673,772,1168,806,45447,275,13656,10983,5144,26095
2022-12-13 12:30:00+00,24877,1290,5837,3613,321,4110,2644,761,1115,890,45458,276,13530,10886,5049,26167
2022-12-13 13:00:00+00,24607,1288,5841,3592,410,4218,2620,674,1022,878,45150,276,13485,10865,5024,25895
2022-12-13 13:30:00+00,24463,1289,5837,3529,450,4180,2573,692,862,1000,44875,276,13251,10678,4841,25752
2022-12-13 14:00:00+00,24444,1290,5840,3527,487,4262,2607,780,595,834,44666,279,13056,10449,4609,25734
2022-12-13 14:30:00+00,24568,1290,5841,3348,493,4250,2593,836,320,870,44409,282,12595,10002,4161,25858
2022-12-13 15:00:00+00,24855,1286,5841,3146,651,3782,2645,951,100,840,44097,282,12383,9738,3897,26141
2022-12-13 15:30:00+00,24751,1287,5840,2984,739,3778,2749,936,7,1402,44473,278,12319,9570,3730,26038
2022-12-13 16:00:00+00,25019,1286,5843,3259,916,4284,2749,1003,0,1496,45855,273,12767,10018,4175,26305
2022-12-13 16:30:00+00,25493,1291,5844,3374,945,4308,2746,1356,0,1500,46857,274,12909,10163,4319,26784
2022-12-13 17:00:00+00,24653,1291,5843,3630,807,4998,2704,1653,0,1312,46891,272,12984,10280,4437,25944
2022-12-13 17:30:00+00,24381,1293,5842,4071,805,5044,2677,1608,0,1104,46825,270,13395,10718,4876,25674
2022-12-13 18:00:00+00,24209,1290,5845,4297,720,5064,2622,1254,0,1116,46417,268,13484,10862,5017,25499
2022-12-13 18:30:00+00,24081,1290,5847,4211,539,5062,2618,886,0,1094,45628,268,13215,10597,4750,25371
2022-12-13 19:00:00+00,23197,1289,5845,4603,369,5546,2675,600,0,520,44644,266,13492,10817,4972,24486
2022-12-13 19:30:00+00,22486,1291,5848,4819,295,5622,2461,434,0,228,43484,266,13423,10962,5114,23777
2022-12-13 20:00:00+00,22232,1289,5842,5067,219,5114,2406,401,0,230,42800,267,13534,11128,5286,23521
2022-12-13 20:30:00+00,22505,1290,5845,5097,214,4996,2402,254,0,48,42651,270,13558,11156,5311,23795
2022-12-13 21:00:00+00,22778,1286,5846,5058,214,3422,2403,296,0,74,41377,278,13521,11118,5272,24064
2022-12-13 21:30:00+00,21658,1285,5841,5110,211,3356,2340,219,0,4,40024,275,13502,11162,5321,22943
2022-12-13 22:00:00+00,20982,1283,5843,5023,193,2806,2077,263,0,122,38592,275,13136,11059,5216,22265
2022-12-13 22:30:00+00,19671,1286,5843,5065,192,2672,1998,204,0,0,36931,271,13098,11100,5257,20957
2022-12-13 23:00:00+00,19336,1285,5846,5032,188,2242,2004,198,0,0,36131,271,13070,11066,5220,20621
2022-12-13 23:30:00+00,18888,1287,5844,5185,187,1942,1906,186,0,0,35425,267,13122,11216,5372,20175
2022-12-14 00:00:00+00,18316,1286,5842,5321,187,1904,1887,148,0,0,34891,263,13237,11350,5508,19602
2022-12-14 00:30:00+00,18485,1287,5845,5331,187,2098,1925,171,0,0,35329,264,13288,11363,5518,19772
2022-12-14 01:00:00+00,18115,1288,5844,5393,185,2086,1944,153,0,0,35008,261,13366,11422,5578,19403
2022-12-14 01:30:00+00,17801,1288,5856,5634,182,1914,1932,146,0,0,34753,258,13604,11672,5816,19089
2022-12-14 02:00:00+00,17506,1289,5853,5829,164,1554,1960,138,0,0,34293,258,13806,11846,5993,18795
2022-12-14 02:30:00+00,17375,1289,5840,5689,162,1510,1959,152,0,0,33976,259,13650,11691,5851,18664
2022-12-14 03:00:00+00,17424,1286,5842,5812,161,1194,1966,166,0,0,33851,262,13781,11815,5973,18710
2022-12-14 03:30:00+00,17286,1289,5844,5969,160,1090,1935,155,0,0,33728,260,13908,11973,6129,18575
2022-12-14 04:00:00+00,17749,1287,5843,6210,160,1008,1946,139,0,0,34342,260,14159,12213,6370,19036
2022-12-14 04:30:00+00,17656,1284,5842,6393,160,946,1960,148,0,0,34389,258,14355,12395,6553,18940
2022-12-14 05:00:00+00,18436,1285,5842,6459,173,948,1970,141,0,0,35254,261,14444,12474,6632,19721
2022-12-14 05:30:00+00,18849,1288,5843,6587,173,1048,2122,138,0,0,36048,261,14725,12603,6760,20137
2022-12-14 06:00:00+00,19965,1284,5843,6910,185,874,2262,190,0,0,37513,261,15200,12938,7095,21249
2022-12-14 06:30:00+00,20244,1290,5842,7422,208,904,2444,341,0,0,38695,258,15916,13472,7630,21534
2022-12-14 07:00:00+00,20656,1290,5840,7756,445,2370,2302,337,0,154,41150,260,16343,14041,8201,21946
2022-12-14 07:30:00+00,21447,1287,5839,7888,511,2650,2250,618,0,544,43034,260,16488,14238,8399,22734
2022-12-14 08:00:00+00,21702,1288,5840,7971,575,2628,2263,526,5,394,43192,261,16654,14391,8551,22990
2022-12-14 08:30:00+00,21900,1290,5841,8224,593,2563,2268,658,226,508,44072,258,17152,14884,9043,23190
2022-12-14 09:00:00+00,23217,1286,5838,8177,410,2733,2276,716,733,588,45975,258,17434,15158,9320,24503
2022-12-14 09:30:00+00,23498,1291,5841,8453,375,2709,2267,824,1311,310,46879,256,18247,15980,10139,24789
2022-12-14 10:00:00+00,23194,1285,5840,8834,270,2583,2267,893,1808,142,47116,252,19019,16752,10912,24479
2022-12-14 10:30:00+00,22350,1283,5844,9611,251,2570,2257,845,2180,96,47287,244,20143,17886,12042,23633
2022-12-14 11:00:00+00,22072,1275,5838,10129,241,2136,2274,647,2403,0,47015,237,20885,18611,12773,23347
2022-12-14 11:30:00+00,21591,1271,5843,11124,201,2121,2278,538,2493,0,47460,230,21939,19661,13818,22862
2022-12-14 12:00:00+00,20908,1281,5843,11270,200,2168,2276,552,2479,0,46977,228,22068,19792,13949,22189
2022-12-14 12:30:00+00,21140,1279,5842,11126,218,2166,2272,519,2395,0,46957,230,21853,19581,13739,22419
2022-12-14 13:00:00+00,23016,1277,5840,10595,227,1578,2288,505,2177,14,47517,237,21127,18839,12999,24293
2022-12-14 13:30:00+00,23393,1279,5841,10429,235,1560,2275,580,1776,34,47401,241,20556,18281,12440,24672
2022-12-14 14:00:00+00,23033,1277,5844,10754,303,1744,2280,682,1219,16,47152,242,20400,18120,12276,24310
2022-12-14 14:30:00+00,23249,1282,5837,10239,302,1750,2291,796,668,40,46454,249,19337,17046,11209,24531
2022-12-14 15:00:00+00,23315,1280,5841,10459,342,1662,2274,767,205,550,46695,247,19121,16847,11006,24595
2022-12-14 15:30:00+00,23569,1280,5835,10715,399,1672,2288,854,16,706,47334,247,19253,16965,11130,24849
2022-12-14 16:00:00+00,23720,1279,5839,10749,423,2242,2290,899,0,750,48191,249,19301,17011,11172,24999
2022-12-14 16:30:00+00,23581,1284,5839,10813,535,2140,2302,1372,0,762,48627,248,19489,17187,11348,24865
2022-12-14 17:00:00+00,23466,1283,5841,10879,572,2164,2320,1327,0,808,48661,247,19612,17292,11451,24749
2022-12-14 17:30:00+00,23768,1285,5840,10599,457,2161,2346,1253,0,770,48478,249,19242,16896,11056,25053
2022-12-14 18:00:00+00,24094,1284,5844,10123,353,2053,2315,965,0,938,47970,252,18635,16320,10476,25378
2022-12-14 18:30:00+00,23715,1281,5843,10271,348,2074,2321,758,0,974,47585,250,18783,16462,10619,24996
2022-12-14 19:00:00+00,22901,1284,5844,10541,227,2564,2310,591,0,322,46584,249,18922,16612,10768,24185
2022-12-14 19:30:00+00,21916,1282,5839,10236,219,2580,2330,454,0,144,45000,249,18624,16294,10455,23198
2022-12-14 20:00:00+00,22131,1280,5842,10508,196,1836,2165,339,0,82,44379,249,18711,16546,10704,23411
2022-12-14 20:30:00+00,21265,1279,5844,10565,195,1642,2022,258,0,0,43070,246,18626,16604,10760,22544
2022-12-14 21:00:00+00,22231,1284,5841,10031,192,944,2026,232,0,340,43121,248,18090,16064,10223,23515
2022-12-14 21:30:00+00,21571,1283,5844,9588,187,624,2025,150,0,0,41272,249,17644,15619,9775,22854
2022-12-14 22:00:00+00,20919,1286,5845,9646,193,424,2021,136,0,0,40470,245,17705,15684,9839,22205
2022-12-14 22:30:00+00,19340,1289,5845,9894,192,420,2027,157,0,0,39164,238,17958,15931,10086,20629
2022-12-14 23:00:00+00,18277,1287,5843,10063,192,244,2028,164,0,0,38098,231,18126,16098,10255,19564
2022-12-14 23:30:00+00,17495,1288,5844,10012,192,232,2030,165,0,0,37258,228,18078,16048,10204,18783
2022-12-15 00:00:00+00,17558,1284,5845,9824,192,0,2029,153,0,0,36885,228,17890,15861,10016,18842
2022-12-15 00:30:00+00,17887,1283,5843,9761,192,0,2028,155,0,0,37149,230,17824,15796,9953,19170
2022-12-15 01:00:00+00,16983,1178,5844,9706,185,314,2027,140,0,0,36377,226,17762,15735,9891,18161
2022-12-15 01:30:00+00,16287,1020,5844,9667,173,348,2021,138,0,0,35498,220,17705,15684,9840,17307
2022-12-15 02:00:00+00,15656,1016,5846,9560,159,568,2028,157,0,0,34990,219,17593,15565,9719,16672
2022-12-15 02:30:00+00,15535,1107,5844,9472,157,566,2030,147,0,0,34858,221,17503,15473,9629,16642
2022-12-15 03:00:00+00,15929,1232,5846,9096,157,74,2023,139,0,0,34496,224,17122,15099,9253,17161
2022-12-15 03:30:00+00,16465,1255,5845,8822,156,36,2024,144,0,0,34747,229,16847,14823,8978,17720
2022-12-15 04:00:00+00,17680,1284,5843,8446,154,0,2026,148,0,0,35581,238,16469,14443,8600,18964
2022-12-15 04:30:00+00,18029,1285,5844,8244,154,0,2025,196,0,0,35777,241,16267,14242,8398,19314
2022-12-15 05:00:00+00,18624,1282,5845,8175,156,0,2028,459,0,0,36569,245,16204,14176,8331,19906
2022-12-15 05:30:00+00,19367,1282,5848,8207,155,114,2037,426,0,0,37436,248,16247,14210,8362,20649
2022-12-15 06:00:00+00,20469,1283,5848,8216,158,442,2048,349,0,0,38813,253,16270,14222,8374,21752
2022-12-15 06:30:00+00,21498,1281,5847,8174,178,700,2060,388,0,190,40315,257,16258,14199,8352,22779
2022-12-15 07:00:00+00,22432,1279,5848,8111,228,986,2066,530,0,320,41800,261,16253,14187,8339,23711
2022-12-15 07:30:00+00,22889,1281,5850,8075,330,1010,2065,909,0,986,43395,259,16320,14255,8405,24170
2022-12-15 08:00:00+00,23170,1281,5848,8053,532,1526,2061,1002,4,836,44313,261,16497,14436,8589,24451
2022-12-15 08:30:00+00,23307,1280,5844,8029,692,1532,2060,1028,220,768,44759,260,16844,14784,8941,24587
2022-12-15 09:00:00+00,23375,1277,5830,8007,716,2310,2059,931,905,862,46271,252,17517,15458,9628,24652
2022-12-15 09:30:00+00,23308,1278,5815,7988,716,2390,2051,895,1771,856,47068,247,18341,16290,10475,24586
2022-12-15 10:00:00+00,23139,1278,5814,7977,468,3088,2047,890,2573,608,47882,242,18879,16832,11018,24417
2022-12-15 10:30:00+00,23014,770,5816,7947,242,3130,2043,545,3183,424,47113,233,19231,17188,11372,23784
2022-12-15 11:00:00+00,23048,1286,5826,7924,213,3538,2042,891,3620,286,48674,237,19625,17584,11757,24334
2022-12-15 11:30:00+00,22919,1284,5832,7916,280,3552,2038,870,3846,280,48818,235,19912,17875,12042,24203
2022-12-15 12:00:00+00,22768,1279,5837,7916,280,3562,2035,879,3933,530,49019,232,20001,17966,12129,24047
2022-12-15 12:30:00+00,22577,1282,5839,7901,287,3544,2031,876,3809,302,48448,233,19867,17836,11997,23859
2022-12-15 13:00:00+00,22519,1281,5841,7869,282,3016,2029,884,3462,356,47539,234,19483,17454,11613,23800
2022-12-15 13:30:00+00,22387,1275,5842,7830,299,2972,2026,878,2905,268,46682,237,18902,16877,11034,23662
2022-12-15 14:00:00+00,22459,1279,5843,7796,327,2620,2025,792,2182,300,45623,242,18173,16148,10305,23738
2022-12-15 14:30:00+00,22580,1278,5846,7762,275,2590,2025,640,1254,484,44734,247,17162,15137,9291,23858
2022-12-15 15:00:00+00,22804,1278,5848,7739,342,2184,2027,686,410,434,43751,252,16366,14339,8491,24082
2022-12-15 15:30:00+00,23277,1274,5851,7744,390,2258,2031,963,30,1004,44822,252,16046,14014,8164,24551
2022-12-15 16:00:00+00,23676,1272,5852,7752,506,3344,2035,1017,0,1156,46610,250,16145,14110,8258,24948
2022-12-15 16:30:00+00,24212,1279,5853,7326,686,3460,2026,1317,0,1424,47583,251,15891,13865,8012,25491
2022-12-15 17:00:00+00,24011,1276,5852,7352,751,4294,2025,1347,0,1204,48112,250,15980,13955,8103,25287
2022-12-15 17:30:00+00,23938,1274,5853,7400,701,4336,2026,1339,0,1092,47959,251,15980,13954,8101,25212
2022-12-15 18:00:00+00,23636,1280,5851,7345,444,4558,2044,1182,0,1400,47740,250,15684,13640,7789,24916
2022-12-15 18:30:00+00,23576,1281,5853,7123,444,4612,2050,1025,0,1088,47052,252,15470,13420,7567,24857
2022-12-15 19:00:00+00,23362,1278,5852,6472,291,5662,2049,793,0,436,46195,254,14664,12615,6763,24640
2022-12-15 19:30:00+00,23317,1275,5854,6286,298,5720,2050,471,0,276,45547,255,14488,12438,6584,24592
2022-12-15 20:00:00+00,23026,1276,5853,6294,471,4516,2052,501,0,0,43989,258,14670,12618,6765,24302
2022-12-15 20:30:00+00,22502,1276,5848,6388,217,4392,2054,383,0,18,43078,258,14507,12453,6605,23778
2022-12-15 21:00:00+00,22172,1277,5849,6386,210,3230,2055,449,0,0,41628,265,14500,12445,6596,23449
2022-12-15 21:30:00+00,20909,1280,5847,6217,210,3144,2045,376,0,26,40054,262,14319,12274,6427,22189
2022-12-15 22:00:00+00,20517,1281,5850,5858,208,1898,2024,349,0,0,37985,268,13940,11916,6066,21798
2022-12-15 22:30:00+00,19705,1280,5849,5756,207,1836,2020,270,0,0,36923,267,13832,11812,5963,20985
2022-12-15 23:00:00+00,19942,1280,5850,5544,187,734,2022,152,0,0,35711,270,13603,11581,5731,21222
2022-12-15 23:30:00+00,19263,1283,5851,5253,186,714,2026,142,0,0,34718,269,13316,11290,5439,20546
2022-12-16 00:00:00+00,19050,1282,5848,4870,186,542,2022,153,0,0,33953,272,12926,10904,5056,20332
2022-12-16 00:30:00+00,19571,1283,5848,4514,184,638,2010,185,0,0,34233,278,12556,10546,4698,20854
2022-12-16 01:00:00+00,19100,1281,5845,4163,163,789,2026,174,0,0,33541,278,12197,10171,4326,20381
2022-12-16 01:30:00+00,18406,1278,5848,4431,161,782,2004,149,0,0,33059,273,12444,10440,4592,19684
2022-12-16 02:00:00+00,18359,1282,5846,4147,162,622,2002,187,0,0,32607,273,12157,10155,4309,19641
2022-12-16 02:30:00+00,18316,1278,5849,3912,164,612,2030,138,0,0,32299,274,11955,9925,4076,19594
2022-12-16 03:00:00+00,18689,1281,5848,3738,163,830,2033,137,0,0,32719,281,11782,9749,3901,19970
2022-12-16 03:30:00+00,18795,1282,5849,3869,160,832,2032,135,0,0,32954,280,11910,9878,4029,20077
2022-12-16 04:00:00+00,19972,1281,5843,3805,160,628,2033,138,0,0,33860,285,11841,9808,3965,21253
2022-12-16 04:30:00+00,19895,1281,5844,3892,159,628,2026,137,0,0,33862,284,11921,9895,4051,21176
2022-12-16 05:00:00+00,20305,1282,5843,3864,175,394,2031,158,0,0,34052,284,11913,9882,4039,21587
2022-12-16 05:30:00+00,20834,1278,5849,3678,176,955,2016,147,0,0,34933,288,11719,9703,3854,22112
2022-12-16 06:00:00+00,19585,1275,5852,3731,268,2132,1994,154,0,0,34991,287,11845,9851,3999,20860
2022-12-16 06:30:00+00,20385,1279,5849,3772,446,2354,1997,313,0,360,36755,286,12064,10067,4218,21664
2022-12-16 07:00:00+00,20540,1284,5849,3782,485,3360,1995,615,0,504,38414,280,12111,10116,4267,21824
2022-12-16 07:30:00+00,21586,1269,5851,3876,614,3460,1985,1077,0,696,40414,279,12326,10341,4490,22855
2022-12-16 08:00:00+00,22537,1301,5851,4083,709,3864,1988,1094,7,768,42202,277,12638,10650,4799,23838
2022-12-16 08:30:00+00,22836,1344,5848,4228,767,3864,1990,1297,276,884,43334,274,13109,11119,5271,24180
2022-12-16 09:00:00+00,22808,1357,5851,4396,713,5130,1984,1067,921,948,45175,264,13865,11881,6030,24165
2022-12-16 09:30:00+00,22612,1384,5852,4447,719,5136,1921,1137,1656,860,45724,260,14595,12674,6822,23996
2022-12-16 10:00:00+00,22639,1408,5852,4672,609,4520,1877,1080,2351,920,45928,258,15361,13484,7632,24047
2022-12-16 10:30:00+00,22258,1543,5855,4927,575,4484,1870,592,2884,654,45642,256,16111,14241,8386,23801
2022-12-16 11:00:00+00,22102,1580,5853,4946,474,4352,1876,420,3259,900,45762,253,16408,14532,8679,23682
2022-12-16 11:30:00+00,22001,1572,5860,5176,363,4320,1853,451,3443,644,45683,252,16695,14842,8982,23573
2022-12-16 12:00:00+00,22026,1568,5859,5454,357,3732,1869,784,3498,416,45563,252,17037,15168,9309,23594
2022-12-16 12:30:00+00,21387,1579,5855,5838,380,3854,1778,556,3392,478,45097,249,17243,15465,9610,22966
2022-12-16 13:00:00+00,20941,1486,5854,6265,455,4102,1772,455,3098,376,44804,243,17444,15672,9818,22427
2022-12-16 13:30:00+00,20990,1278,5856,6721,483,4114,1775,459,2528,340,44544,241,17363,15588,9732,22268
2022-12-16 14:00:00+00,21194,1275,5853,7192,450,3298,1774,439,1801,546,43822,244,17070,15296,9443,22469
2022-12-16 14:30:00+00,21159,1279,5848,7364,471,3254,1778,465,1050,730,43398,246,16511,14733,8885,22438
2022-12-16 15:00:00+00,21092,1273,5855,7586,601,3378,1775,413,378,1014,43365,248,16195,14420,8565,22365
2022-12-16 15:30:00+00,21274,1277,5859,7865,611,3320,1806,481,31,1286,43810,247,16172,14366,8507,22551
2022-12-16 16:00:00+00,21161,1279,5858,8172,622,3800,1805,747,0,1216,44660,244,16457,14652,8794,22440
2022-12-16 16:30:00+00,21236,1281,5857,8214,626,3798,1809,1017,0,1488,45326,242,16506,14697,8840,22517
2022-12-16 17:00:00+00,21921,1280,5853,8267,659,3366,1955,1262,0,1308,45871,245,16734,14779,8926,23201
2022-12-16 17:30:00+00,21808,1285,5850,8331,601,3346,2062,1213,0,1502,45998,243,16844,14782,8932,23093
2022-12-16 18:00:00+00,22484,1281,5854,8606,554,2486,2051,1028,0,1262,45606,251,17065,15014,9160,23765
2022-12-16 18:30:00+00,22334,1282,5856,8546,522,2440,2061,504,0,1064,44609,252,16985,14924,9068,23616
2022-12-16 19:00:00+00,22199,1284,5855,8548,436,2652,2060,352,0,290,43676,253,16899,14839,8984,23483
2022-12-16 19:30:00+00,21433,1284,5856,8478,298,2720,2061,164,0,46,42340,254,16693,14632,8776,22717
2022-12-16 20:00:00+00,21872,1284,5856,8513,246,1705,2062,158,0,50,41746,257,16677,14615,8759,23156
2022-12-16 20:30:00+00,21090,1286,5858,8550,201,1511,2057,148,0,48,40749,254,16666,14609,8751,22376
2022-12-16 21:00:00+00,20793,1284,5855,8687,196,1686,2057,220,0,114,40892,251,16795,14738,8883,22077
2022-12-16 21:30:00+00,19178,1284,5858,8907,194,1594,2061,150,0,0,39226,244,17020,14959,9101,20462
2022-12-16 22:00:00+00,18272,1285,5855,8907,192,1382,2064,154,0,0,38111,239,17018,14954,9099,19557
2022-12-16 22:30:00+00,16979,1284,5855,9216,189,1192,2063,159,0,34,36971,230,17323,15260,9405,18263
2022-12-16 23:00:00+00,12773,1280,5854,9662,188,1250,2063,143,0,0,33213,205,17767,15704,9850,14053
2022-12-16 23:30:00+00,11306,1284,5856,10035,185,1194,2055,139,0,0,32054,194,18131,16076,10220,12590
2022-12-17 00:00:00+00,11365,1284,5854,10214,184,888,2049,143,0,0,31981,196,18301,16252,10398,12649
2022-12-17 00:30:00+00,11716,1288,5856,10371,182,1024,2052,174,0,0,32663,199,18461,16409,10553,13004
2022-12-17 01:00:00+00,11059,1283,5856,10825,181,990,2060,152,0,0,32406,191,18922,16862,11006,12342
2022-12-17 01:30:00+00,10405,1282,5857,11249,180,888,2058,153,0,0,32072,184,19344,17286,11429,11687
2022-12-17 02:00:00+00,10634,1281,5859,11505,178,704,2054,138,0,0,32353,185,19596,17542,11683,11915
2022-12-17 02:30:00+00,10483,1276,5858,11645,178,690,2028,155,0,0,32313,183,19709,17681,11823,11759
2022-12-17 03:00:00+00,10104,1277,5836,12097,178,636,1977,133,0,0,32238,176,20088,18111,12275,11381
2022-12-17 03:30:00+00,9532,1280,5708,12435,178,648,1743,162,0,0,31686,171,20064,18321,12613,10812
2022-12-17 04:00:00+00,9743,1284,5719,12482,178,816,1418,162,0,0,31802,175,19797,18379,12660,11027
2022-12-17 04:30:00+00,9507,1283,5712,12608,180,848,1417,170,0,0,31725,173,19917,18500,12788,10790
2022-12-17 05:00:00+00,10025,1282,5709,12486,191,1044,1418,197,0,0,32352,174,19804,18386,12677,11307
2022-12-17 05:30:00+00,10207,1285,5709,12437,191,1114,1414,140,0,0,32497,175,19751,18337,12628,11492
2022-12-17 06:00:00+00,10456,1282,5710,12528,191,1765,1412,136,0,0,33480,177,19841,18429,12719,11738
2022-12-17 06:30:00+00,10751,1282,5711,12669,194,1794,1416,157,0,0,33974,178,19990,18574,12863,12033
2022-12-17 07:00:00+00,12225,1282,5710,12505,228,1284,1419,158,0,6,34817,187,19862,18443,12733,13507
2022-12-17 07:30:00+00,13238,1282,5713,12753,253,1432,1412,151,0,0,36234,193,20131,18719,13006,14520
2022-12-17 08:00:00+00,13776,1276,5712,13028,345,1806,1416,163,2,42,37566,191,20503,19087,13375,15052
2022-12-17 08:30:00+00,14841,1279,5710,13282,363,2048,1418,178,166,40,39325,196,20939,19521,13811,16120
2022-12-17 09:00:00+00,14467,1282,5709,13697,364,2330,1387,207,503,30,39976,193,21660,20273,14564,15749
2022-12-17 09:30:00+00,14685,1283,5709,13906,364,2232,1409,231,872,34,40725,190,22260,20851,15142,15968
2022-12-17 10:00:00+00,15287,1281,5710,13821,327,2032,1413,147,1215,56,41289,191,22486,21073,15363,16568
2022-12-17 10:30:00+00,15121,1281,5710,14028,286,2030,1416,145,1489,0,41506,188,22929,21513,15803,16402
2022-12-17 11:00:00+00,15164,1278,5710,14037,254,2114,1418,188,1836,0,41999,187,23255,21837,16127,16442
2022-12-17 11:30:00+00,14985,1277,5709,14216,255,2110,1418,151,1979,0,42100,185,23577,22159,16450,16262
2022-12-17 12:00:00+00,14936,1277,5711,14149,272,2106,1418,155,2012,0,42036,185,23562,22144,16433,16213
2022-12-17 12:30:00+00,14912,1272,5693,13787,275,2102,1419,148,1851,26,41485,187,23025,21606,15913,16184
2022-12-17 13:00:00+00,15120,1271,5693,13849,275,2014,1415,138,1524,0,41299,190,22756,21341,15648,16391
2022-12-17 13:30:00+00,15162,1278,5692,13660,276,1976,1414,139,1202,46,40845,192,22244,20830,15138,16440
2022-12-17 14:00:00+00,15339,1279,5692,13452,283,1610,1416,145,936,50,40202,195,21779,20363,14671,16618
2022-12-17 14:30:00+00,15677,1280,5789,13029,337,1596,1416,184,569,50,39927,200,21140,19724,13935,16957
2022-12-17 15:00:00+00,15257,1276,5790,12647,427,2400,1416,144,226,0,39583,198,20506,19090,13300,16533
2022-12-17 15:30:00+00,15769,1279,5789,12172,437,2684,1416,173,20,0,39739,205,19834,18418,12629,17048
2022-12-17 16:00:00+00,14999,1285,5790,12011,534,4334,1416,277,0,460,41106,198,19751,18335,12545,16284
2022-12-17 16:30:00+00,15532,1284,5789,11687,532,4486,1416,673,0,846,42245,201,19424,18008,12219,16816
2022-12-17 17:00:00+00,16260,1284,5861,11265,544,4806,1417,804,0,810,43051,206,19087,17670,11809,17544
2022-12-17 17:30:00+00,16377,1281,5863,10943,549,4814,1418,740,0,732,42717,208,18773,17355,11492,17658
2022-12-17 18:00:00+00,16191,1282,5859,10933,505,3980,1416,651,0,1184,42001,209,18713,17297,11438,17473
2022-12-17 18:30:00+00,16212,1282,5862,10537,500,4022,1415,339,0,1368,41537,210,18314,16899,11037,17494
2022-12-17 19:00:00+00,15671,1283,5861,10608,462,4466,1528,409,0,138,40426,214,18459,16931,11070,16954
2022-12-17 19:30:00+00,15163,1285,5860,10427,398,4316,1741,197,0,130,39517,211,18426,16685,10825,16448
2022-12-17 20:00:00+00,14541,1280,5862,10672,308,4190,1816,149,0,0,38818,207,18658,16842,10980,15821
2022-12-17 20:30:00+00,13270,1283,5864,10774,253,4198,1816,132,0,0,37590,200,18707,16891,11027,14553
2022-12-17 21:00:00+00,12369,1283,5860,10662,252,4112,1819,158,0,0,36515,199,18593,16774,10914,13652
2022-12-17 21:30:00+00,11611,1283,5856,10519,248,3980,1824,152,0,0,35473,195,18447,16623,10767,12894
2022-12-17 22:00:00+00,10827,1284,5858,10482,231,3578,1823,150,0,0,34233,192,18394,16571,10713,12111
2022-12-17 22:30:00+00,9903,1283,5857,9908,225,3652,1837,199,0,0,32864,191,17827,15990,10133,11186
2022-12-17 23:00:00+00,7556,1281,5857,9307,199,4776,1826,149,0,0,30951,167,17189,15363,9506,8837
2022-12-17 23:30:00+00,6572,1281,5858,8990,222,4724,1829,236,0,0,29712,158,16899,15070,9212,7853
2022-12-18 00:00:00+00,6210,1003,5860,8686,203,5684,1814,135,0,0,29595,157,16563,14749,8889,7213
2022-12-18 00:30:00+00,6599,1110,5859,8252,274,5912,1818,214,0,0,30038,167,16203,14385,8526,7709
2022-12-18 01:00:00+00,6089,1275,5852,8125,185,6334,1817,133,0,0,29810,167,15979,14162,8310,7364
2022-12-18 01:30:00+00,5570,1277,5859,8187,179,6358,1818,143,0,0,29391,163,16043,14225,8366,6847
2022-12-18 02:00:00+00,5161,1194,5862,8141,178,6634,1816,187,0,0,29173,157,15997,14181,8319,6355
2022-12-18 02:30:00+00,4860,1048,5859,7971,178,6642,1819,154,0,0,28531,151,15827,14008,8149,5908
2022-12-18 03:00:00+00,4363,1067,5864,8564,162,6244,1817,132,0,0,28213,145,16407,14590,8726,5430
2022-12-18 03:30:00+00,3692,860,5863,9491,159,6228,1639,132,0,0,28064,128,17152,15513,9650,4552
2022-12-18 04:00:00+00,3492,1134,5857,9968,159,5048,1628,187,0,0,27473,136,17612,15984,10127,4626
2022-12-18 04:30:00+00,3286,1065,5858,10189,158,5010,1643,138,0,0,27347,130,17848,16205,10347,4351
2022-12-18 05:00:00+00,3836,1263,5858,10642,169,3602,1797,146,0,0,27313,140,18466,16669,10811,5099
2022-12-18 05:30:00+00,3735,1272,5860,11596,169,3558,1641,137,0,0,27968,135,19266,17625,11765,5007
2022-12-18 06:00:00+00,3500,1239,5861,12849,170,3326,1667,136,0,0,28748,127,20547,18880,13019,4739
2022-12-18 06:30:00+00,3477,1025,5862,13970,186,3288,1628,146,0,0,29582,116,21646,20018,14156,4502
2022-12-18 07:00:00+00,4023,1155,5861,14426,284,2622,1762,192,0,0,30325,118,22333,20571,14710,5178
2022-12-18 07:30:00+00,4285,1187,5860,15076,340,2606,1751,159,0,0,31264,118,23027,21276,15416,5472
2022-12-18 08:00:00+00,5007,1265,5860,15269,377,2536,1811,186,0,24,32335,123,23317,21506,15646,6272
2022-12-18 08:30:00+00,5426,1276,5861,15911,350,2610,1815,526,6,242,34023,126,23943,22128,16267,6702
2022-12-18 09:00:00+00,5101,1282,5861,16821,336,4232,1580,437,50,40,35740,124,24648,23068,17207,6383
2022-12-18 09:30:00+00,5595,1282,5858,17439,339,4314,1644,255,127,326,37179,123,25407,23763,17905,6877
2022-12-18 10:00:00+00,5620,1279,5858,17713,335,5398,1669,184,216,510,38782,120,25791,24122,18264,6899
2022-12-18 10:30:00+00,6454,1281,5861,18094,318,5488,1804,154,277,68,39799,126,26354,24550,18689,7735
2022-12-18 11:00:00+00,6947,1280,5855,18357,285,5146,1830,166,318,18,40202,128,26645,24815,18960,8227
2022-12-18 11:30:00+00,6987,1282,5858,18761,319,5158,1832,158,335,42,40732,126,27105,25273,19415,8269
2022-12-18 12:00:00+00,6825,1282,5858,19366,332,5520,1822,182,308,136,41631,118,27686,25864,20006,8107
2022-12-18 12:30:00+00,7044,1281,5863,19522,306,5594,1814,144,257,0,41825,119,27762,25948,20085,8325
2022-12-18 13:00:00+00,7317,1278,5865,19642,288,5612,1815,121,186,0,42124,121,27796,25981,20116,8595
2022-12-18 13:30:00+00,7155,1277,5868,19875,288,5534,1813,117,123,0,42050,119,27967,26154,20286,8432
2022-12-18 14:00:00+00,7147,1275,5866,19886,294,5320,1830,145,66,0,41829,120,27942,26112,20246,8422
2022-12-18 14:30:00+00,7482,1273,5866,20009,328,5186,1828,148,24,0,42144,121,28055,26227,20361,8755
2022-12-18 15:00:00+00,7669,1280,5865,20102,379,5130,1838,176,6,0,42445,122,28190,26352,20487,8949
2022-12-18 15:30:00+00,7675,1282,5866,19964,421,5246,1822,160,0,0,42436,123,28073,26251,20385,8957
2022-12-18 16:00:00+00,7857,1277,5862,20005,505,5906,1934,185,0,276,43807,124,28306,26372,20510,9134
2022-12-18 16:30:00+00,7730,1281,5863,19926,491,5912,2017,250,0,320,43790,124,28297,26280,20417,9011
2022-12-18 17:00:00+00,8037,1278,5867,19839,491,5820,2005,523,0,474,44334,128,28202,26197,20330,9315
2022-12-18 17:30:00+00,7854,1270,5867,19759,524,5800,1990,448,0,0,43512,128,28140,26150,20283,9124
2022-12-18 18:00:00+00,7268,1280,5865,19676,493,5478,2024,374,0,448,42906,124,28058,26034,20169,8548
2022-12-18 18:30:00+00,6742,1159,5864,19724,466,5374,2026,340,0,312,42007,119,28080,26054,20190,7901
2022-12-18 19:00:00+00,7573,1089,5862,19631,405,3820,2027,189,0,298,40894,127,27925,25898,20036,8662
2022-12-18 19:30:00+00,6887,1047,5864,19604,347,3738,2024,190,0,0,39701,122,27839,25815,19951,7934
2022-12-18 20:00:00+00,5707,790,5865,19630,254,4600,2020,134,0,0,39000,106,27769,25749,19884,6497
2022-12-18 20:30:00+00,4357,789,5865,19597,205,4588,2018,132,0,0,37551,96,27685,25667,19802,5146
2022-12-18 21:00:00+00,3639,788,5859,19305,195,4042,2026,155,0,0,36009,93,27385,25359,19500,4427
2022-12-18 21:30:00+00,2976,738,5860,19231,193,3910,1961,142,0,0,35011,86,27245,25284,19424,3714
2022-12-18 22:00:00+00,2674,571,5858,19266,192,3026,1610,159,0,0,33356,76,26926,25316,19458,3245
2022-12-18 22:30:00+00,2935,432,5859,19111,191,2856,1158,118,0,0,32660,73,26319,25161,19302,3367
2022-12-18 23:00:00+00,3545,465,5858,19295,187,1384,1479,156,0,0,32369,73,26819,25340,19482,4010
2022-12-18 23:30:00+00,3032,494,5859,19442,177,1336,1225,132,0,0,31697,68,26703,25478,19619,3526
2022-12-19 00:00:00+00,3009,492,5858,19495,179,1344,1156,139,0,0,31672,72,26688,25532,19674,3501
2022-12-19 00:30:00+00,3080,498,5855,19583,178,1428,1361,173,0,0,32156,75,26977,25616,19761,3578
2022-12-19 01:00:00+00,2883,491,5857,19640,176,1052,1236,122,0,0,31457,71,26909,25673,19816,3374
2022-12-19 01:30:00+00,2726,332,5859,19492,176,986,1152,132,0,0,30855,65,26679,25527,19668,3058
2022-12-19 02:00:00+00,2714,343,5857,19801,175,808,1152,140,0,0,30990,63,26985,25833,19976,3057
2022-12-19 02:30:00+00,2552,255,5858,19930,175,602,1149,123,0,0,30644,55,27112,25963,20105,2807
2022-12-19 03:00:00+00,2601,229,5858,20087,175,992,1171,145,0,0,31258,59,27291,26120,20262,2830
2022-12-19 03:30:00+00,2602,230,5861,19785,176,862,1124,144,0,0,30784,58,26946,25822,19961,2832
2022-12-19 04:00:00+00,2695,261,5859,19311,187,926,1161,178,0,0,30578,63,26518,25357,19498,2956
2022-12-19 04:30:00+00,2892,421,5862,18971,186,912,1192,180,0,0,30616,70,26211,25019,19157,3313
2022-12-19 05:00:00+00,3217,272,5861,18856,185,1212,1129,138,0,0,30870,72,26031,24902,19041,3489
2022-12-19 05:30:00+00,4066,244,5861,18707,189,1230,1172,146,0,0,31615,81,25929,24757,18896,4310
2022-12-19 06:00:00+00,5089,275,5864,18112,193,1534,1368,158,0,0,32593,96,25537,24169,18305,5364
2022-12-19 06:30:00+00,6212,287,5863,18139,197,1486,1888,122,0,0,34194,105,26087,24199,18336,6499
2022-12-19 07:00:00+00,6696,261,5861,17971,235,1582,1882,121,0,0,34609,103,25949,24067,18206,6957
2022-12-19 07:30:00+00,7317,255,5859,18441,328,1424,1993,322,0,0,35939,105,26621,24628,18769,7572
2022-12-19 08:00:00+00,7484,246,5860,18466,397,3076,1923,321,0,0,37773,103,26646,24723,18863,7730
2022-12-19 08:30:00+00,7670,340,5859,19101,376,3202,1933,392,3,0,38876,105,27272,25339,19480,8010
2022-12-19 09:00:00+00,7708,445,5859,19104,410,4158,1914,361,27,76,40062,104,27314,25400,19541,8153
2022-12-19 09:30:00+00,7724,526,5865,19181,446,4230,1978,348,84,154,40536,105,27554,25576,19711,8250
2022-12-19 10:00:00+00,7415,444,5865,19286,435,4548,1983,353,156,10,40495,100,27725,25742,19877,7859
2022-12-19 10:30:00+00,7413,568,5866,19528,381,4598,1971,207,216,0,40748,101,27962,25991,20125,7981
2022-12-19 11:00:00+00,7205,578,5868,19766,349,4618,1898,177,278,368,41105,99,28159,26261,20393,7783
2022-12-19 11:30:00+00,7017,658,5859,20112,359,4602,1811,192,336,314,41260,99,28477,26666,20807,7675
2022-12-19 12:00:00+00,7210,634,5858,20234,337,4396,1981,183,401,294,41528,100,28811,26830,20972,7844
2022-12-19 12:30:00+00,7195,686,5859,20152,338,4388,1980,159,417,280,41454,102,28746,26766,20907,7881
2022-12-19 13:00:00+00,7195,699,5858,20106,339,4382,1977,215,369,118,41258,102,28649,26672,20814,7894
2022-12-19 13:30:00+00,7018,717,5860,20135,336,4382,1963,165,282,0,40858,102,28576,26613,20753,7735
2022-12-19 14:00:00+00,7025,804,5855,20060,350,3928,1971,198,218,0,40409,104,28454,26483,20628,7829
2022-12-19 14:30:00+00,6923,845,5850,20029,375,3954,1967,187,123,0,40253,105,28344,26377,20527,7768
2022-12-19 15:00:00+00,6764,755,5850,19924,429,3740,1969,177,40,548,40196,100,28212,26243,20393,7519
2022-12-19 15:30:00+00,7000,750,5852,19781,436,3752,1964,211,2,902,40650,102,28035,26071,20219,7750
2022-12-19 16:00:00+00,7218,749,5851,19845,521,4264,1957,191,0,1096,41692,103,28174,26217,20366,7967
2022-12-19 16:30:00+00,7466,746,5851,19880,520,4322,1954,303,0,1288,42330,105,28205,26251,20400,8212
2022-12-19 17:00:00+00,7326,720,5853,19455,519,5322,1961,566,0,1148,42870,105,27788,25827,19974,8046
2022-12-19 17:30:00+00,7146,699,5856,19412,503,5328,1972,500,0,1152,42568,103,27743,25771,19915,7845
2022-12-19 18:00:00+00,7270,796,5853,19072,505,4592,1978,272,0,1286,41624,107,27408,25430,19577,8066
2022-12-19 18:30:00+00,6780,841,5850,18732,496,4582,1978,209,0,1258,40726,105,27056,25078,19228,7621
2022-12-19 19:00:00+00,5667,842,5852,18410,454,5242,1978,202,0,914,39561,98,26694,24716,18864,6509
2022-12-19 19:30:00+00,5031,834,5855,18366,448,5200,2034,223,0,504,38495,94,26703,24669,18814,5865
2022-12-19 20:00:00+00,4862,697,5849,18015,439,4372,2042,186,0,868,37330,91,26345,24303,18454,5559
2022-12-19 20:30:00+00,4430,531,5854,17841,427,4230,2047,171,0,524,36055,85,26169,24122,18268,4961
2022-12-19 21:00:00+00,3888,234,5851,17451,403,4178,1975,199,0,166,34345,76,25680,23705,17854,4122
2022-12-19 21:30:00+00,3223,338,5853,17276,405,4118,1591,184,0,120,33108,72,25125,23534,17681,3561
2022-12-19 22:00:00+00,3845,470,5859,17212,417,1738,1791,173,0,198,31703,87,25279,23488,17629,4315
2022-12-19 22:30:00+00,2905,321,5857,17307,417,1404,1924,165,0,0,30300,71,25505,23581,17724,3226
2022-12-19 23:00:00+00,2845,272,5856,17468,417,730,1711,200,0,0,29499,63,25452,23741,17885,3117
2022-12-19 23:30:00+00,2605,255,5856,17466,409,822,1193,179,0,0,28785,60,24924,23731,17875,2860
2022-12-20 00:00:00+00,2526,229,5858,17412,409,1118,1109,165,0,0,28826,62,24788,23679,17821,2755
2022-12-20 00:30:00+00,2595,230,5859,17464,409,1212,1105,178,0,0,29052,64,24837,23732,17873,2825
2022-12-20 01:00:00+00,2649,230,5862,17039,409,1488,1086,186,0,0,28949,64,24396,23310,17448,2879
2022-12-20 01:30:00+00,2659,231,5860,16525,413,1358,1089,169,0,0,28304,63,23887,22798,16938,2890
2022-12-20 02:00:00+00,2728,233,5856,16251,405,1136,1183,226,0,0,28018,63,23695,22512,16656,2961
2022-12-20 02:30:00+00,2900,252,5857,16187,402,1056,1186,203,0,0,28043,64,23632,22446,16589,3152
2022-12-20 03:00:00+00,2901,358,5857,16183,376,674,1177,214,0,0,27740,67,23593,22416,16559,3259
2022-12-20 03:30:00+00,2830,364,5855,16314,371,652,1121,178,0,0,27685,65,23661,22540,16685,3194
2022-12-20 04:00:00+00,2659,319,5857,16525,361,690,1114,174,0,0,27699,61,23857,22743,16886,2978
2022-12-20 04:30:00+00,2648,230,5857,16494,359,736,1100,168,0,0,27592,58,23810,22710,16853,2878
2022-12-20 05:00:00+00,2620,417,5856,16408,346,1282,1221,215,0,0,28365,71,23831,22610,16754,3037
2022-12-20 05:30:00+00,2417,653,5856,16474,343,1474,1507,185,0,0,28909,79,24180,22673,16817,3070
2022-12-20 06:00:00+00,2684,733,5857,16235,341,1774,1865,189,0,0,29678,87,24298,22433,16576,3417
2022-12-20 06:30:00+00,3546,784,5857,15595,344,1912,2013,202,0,292,30545,98,23809,21796,15939,4330
2022-12-20 07:00:00+00,4170,696,5855,15202,368,4182,1928,189,0,172,32762,102,23353,21425,15570,4866
2022-12-20 07:30:00+00,5834,835,5852,14191,364,4318,2012,228,0,530,34164,120,22419,20407,14555,6669
2022-12-20 08:00:00+00,6093,937,5855,13736,389,6132,1996,203,0,330,35671,121,21976,19980,14125,7030
2022-12-20 08:30:00+00,5863,940,5855,14218,411,6286,1995,353,123,636,36680,117,22602,20607,14752,6803
2022-12-20 09:00:00+00,6000,897,5855,14863,450,6250,1991,258,678,764,38006,111,23837,21846,15991,6897
2022-12-20 09:30:00+00,5553,872,5854,15209,458,6210,2010,204,1409,816,38595,104,24940,22930,17076,6425
2022-12-20 10:00:00+00,5401,868,5854,15572,463,6248,1919,187,2175,234,38921,101,25983,24064,18210,6269
2022-12-20 10:30:00+00,5147,732,5854,15805,465,6206,1659,192,2813,106,38979,94,26596,24937,19083,5879
2022-12-20 11:00:00+00,5550,759,5852,15558,417,5328,1847,184,3200,0,38695,99,26874,25027,19175,6309
2022-12-20 11:30:00+00,5045,892,5854,15961,400,5288,1729,190,3293,0,38652,97,27237,25508,19654,5937
2022-12-20 12:00:00+00,6047,894,5852,16099,405,4252,1844,204,3333,0,38930,106,27533,25689,19837,6941
2022-12-20 12:30:00+00,6085,896,5856,15900,412,4210,1971,246,3041,0,38617,108,27180,25209,19353,6981
2022-12-20 13:00:00+00,6669,955,5852,15997,399,3808,2022,186,2585,0,38473,114,26855,24833,18981,7624
2022-12-20 13:30:00+00,6606,978,5852,16124,436,3792,1969,235,1983,0,37975,116,26364,24395,18543,7584
2022-12-20 14:00:00+00,7288,978,5851,15852,440,3808,2018,206,1362,0,37803,122,25523,23505,17654,8266
2022-12-20 14:30:00+00,7970,970,5855,15620,454,3750,2009,132,834,0,37594,129,24772,22763,16908,8940
2022-12-20 15:00:00+00,7772,971,5851,15186,480,4360,2023,129,333,624,37729,130,23873,21850,15999,8743
2022-12-20 15:30:00+00,8509,964,5852,15425,493,4604,1922,118,39,486,38412,138,23731,21809,15957,9473
2022-12-20 16:00:00+00,8953,964,5851,15774,510,5330,1937,257,0,804,40380,133,24072,22135,16284,9917
2022-12-20 16:30:00+00,9284,961,5849,15819,545,5234,2006,687,0,1026,41411,135,24219,22213,16364,10245
2022-12-20 17:00:00+00,9317,959,5849,15689,534,5702,1999,699,0,1162,41910,135,24071,22072,16223,10276
2022-12-20 17:30:00+00,9250,961,5849,15926,534,5662,1996,625,0,1128,41931,133,24305,22309,16460,10211
2022-12-20 18:00:00+00,9366,941,5862,15948,535,4940,1972,632,0,1172,41368,138,24317,22345,16483,10307
2022-12-20 18:30:00+00,9093,899,5854,15839,535,4958,1966,273,0,1280,40697,134,24194,22228,16374,9992
2022-12-20 19:00:00+00,9312,951,5851,15696,497,4462,1987,224,0,1004,39984,136,24031,22044,16193,10263
2022-12-20 19:30:00+00,9079,959,5851,15427,488,4384,1992,173,0,530,38883,137,23758,21766,15915,10038
2022-12-20 20:00:00+00,8691,961,5851,15431,511,3864,1989,177,0,304,37779,137,23782,21793,15942,9652
2022-12-20 20:30:00+00,7731,922,5852,15431,485,3638,1983,185,0,232,36459,128,23751,21768,15916,8653
2022-12-20 21:00:00+00,6984,913,5855,15113,419,3356,1984,184,0,328,35136,127,23371,21387,15532,7897
2022-12-20 21:30:00+00,6090,959,5856,14714,377,3178,1977,165,0,124,33440,122,22924,20947,15091,7049
2022-12-20 22:00:00+00,6053,842,5853,14113,377,2700,1991,192,0,152,32273,123,22334,20343,14490,6895
2022-12-20 22:30:00+00,5359,663,5851,13616,371,2840,1982,181,0,160,31023,116,21820,19838,13987,6022
2022-12-20 23:00:00+00,5141,499,5835,13031,327,2048,1964,197,0,0,29042,113,21157,19193,13358,5640
2022-12-20 23:30:00+00,4852,481,5814,12768,323,1992,1966,176,0,0,28372,111,20871,18905,13091,5333
2022-12-21 00:00:00+00,4546,481,5821,13108,321,1940,1960,164,0,0,28341,111,21210,19250,13429,5027
2022-12-21 00:30:00+00,4396,480,5819,13585,321,2008,1967,198,0,0,28774,109,21692,19725,13906,4876
2022-12-21 01:00:00+00,4062,480,5824,13601,321,1830,1962,180,0,0,28260,108,21708,19746,13922,4542
2022-12-21 01:30:00+00,3497,481,5826,14022,322,1778,1754,164,0,0,27844,100,21924,20170,14344,3978
2022-12-21 02:00:00+00,3614,480,5819,14665,329,904,1712,164,0,0,27687,92,22525,20813,14994,4094
2022-12-21 02:30:00+00,3496,481,5828,15049,331,904,1413,167,0,0,27669,89,22621,21208,15380,3977
2022-12-21 03:00:00+00,3768,481,5844,15462,317,904,1737,186,0,0,28699,91,23360,21623,15779,4249
2022-12-21 03:30:00+00,3557,480,5853,16061,313,904,1846,181,0,0,29195,87,24073,22227,16374,4037
2022-12-21 04:00:00+00,3640,479,5855,16480,309,904,1937,287,0,0,29891,88,24581,22644,16789,4119
2022-12-21 04:30:00+00,3772,480,5858,16628,308,904,2028,192,0,0,30170,88,24822,22794,16936,4252
2022-12-21 05:00:00+00,4793,479,5860,16837,321,904,2014,174,0,0,31382,97,25032,23018,17158,5272
2022-12-21 05:30:00+00,4771,479,5854,17565,331,904,1933,171,0,0,32008,95,25683,23750,17896,5250
2022-12-21 06:00:00+00,5471,480,5849,18176,408,904,2020,231,0,0,33539,99,26453,24433,18584,5951
2022-12-21 06:30:00+00,6652,479,5841,18556,432,904,2019,248,0,154,35285,108,26848,24829,18988,7131
2022-12-21 07:00:00+00,7980,479,5833,18931,507,904,2022,190,0,72,36918,117,27293,25271,19438,8459
2022-12-21 07:30:00+00,8963,482,5832,19126,499,1003,2016,285,0,84,38290,125,27473,25457,19625,9445
2022-12-21 08:00:00+00,8660,479,5832,19161,491,1080,1998,220,0,262,38183,122,27482,25484,19652,9139
2022-12-21 08:30:00+00,9283,480,5830,19507,581,1116,1984,252,56,52,39141,126,27958,25974,20144,9763
2022-12-21 09:00:00+00,8789,481,5830,19708,464,1708,1985,203,342,256,39766,121,28329,26344,20514,9270
2022-12-21 09:30:00+00,8665,480,5831,19711,455,1690,1982,190,778,296,40078,118,28757,26775,20944,9145
2022-12-21 10:00:00+00,8320,490,5830,19625,413,1712,1999,179,1262,356,40186,115,29129,27130,21300,8810
2022-12-21 10:30:00+00,8086,488,5830,19832,371,1572,2004,181,1609,480,40453,110,29646,27642,21812,8574
2022-12-21 11:00:00+00,8037,489,5833,19691,361,1708,1994,166,1676,316,40271,109,29555,27561,21728,8526
2022-12-21 11:30:00+00,8084,490,5830,19569,358,1600,2006,182,1752,202,40073,109,29515,27509,21679,8574
2022-12-21 12:00:00+00,8261,485,5831,19384,365,1674,2001,170,1930,190,40291,107,29511,27510,21679,8746
2022-12-21 12:30:00+00,8347,481,5829,18810,386,1572,2004,200,2043,214,39886,108,29072,27068,21239,8828
2022-12-21 13:00:00+00,8058,480,5829,18732,400,1584,2020,198,1923,414,39638,111,28904,26884,21055,8538
2022-12-21 13:30:00+00,8070,479,5828,18520,398,1600,2015,194,1614,488,39206,113,28375,26360,20532,8549
2022-12-21 14:00:00+00,7886,480,5827,18354,398,2264,2018,194,1247,278,38946,109,27844,25826,19999,8366
2022-12-21 14:30:00+00,8402,480,5831,17827,411,2246,2012,191,700,324,38424,115,26781,24769,18938,8882
2022-12-21 15:00:00+00,8521,479,5830,17043,428,3492,1992,195,219,478,38677,120,25512,23520,17690,9000
2022-12-21 15:30:00+00,9329,479,5826,16124,446,3492,1990,207,19,772,38684,128,24405,22415,16589,9808
2022-12-21 16:00:00+00,9258,479,5828,15911,624,4698,1984,243,0,942,39967,123,24347,22363,16535,9737
2022-12-21 16:30:00+00,9523,479,5828,15648,664,4806,1979,570,0,1514,41011,125,24119,22140,16312,10002
2022-12-21 17:00:00+00,9337,480,5827,15628,659,5886,1969,689,0,1862,42337,124,24083,22114,16287,9817
2022-12-21 17:30:00+00,9473,479,5827,15335,660,5934,1967,556,0,1834,42065,125,23789,21822,15995,9952
2022-12-21 18:00:00+00,9428,480,5828,15342,647,5996,2002,426,0,1496,41645,126,23819,21817,15989,9908
2022-12-21 18:30:00+00,9299,481,5828,15344,637,5996,2002,317,0,1258,41162,125,23811,21809,15981,9780
2022-12-21 19:00:00+00,9361,481,5830,14932,600,6138,2001,186,0,536,40065,129,23363,21362,15532,9842
2022-12-21 19:30:00+00,8972,480,5831,14716,499,6130,2012,160,0,308,39108,128,23058,21046,15215,9452
2022-12-21 20:00:00+00,8259,479,5832,14664,475,5966,2021,173,0,312,38181,123,22992,20971,15139,8738
2022-12-21 20:30:00+00,7504,480,5833,14562,473,5960,2006,142,0,146,37106,119,22874,20868,15035,7984
2022-12-21 21:00:00+00,6206,480,5831,14213,443,5962,2009,168,0,194,35506,110,22496,20487,14656,6686
2022-12-21 21:30:00+00,5165,479,5833,14026,416,5944,1860,153,0,0,33876,102,22135,20275,14442,5644
2022-12-21 22:00:00+00,4479,479,5834,13878,410,5158,1765,144,0,0,32147,97,21887,20122,14288,4958
2022-12-21 22:30:00+00,3726,480,5836,13728,377,5126,1504,146,0,0,30923,90,21445,19941,14105,4206
2022-12-21 23:00:00+00,2942,479,5835,12915,313,4514,1693,160,0,0,28851,77,20756,19063,13228,3421
2022-12-21 23:30:00+00,2729,480,5833,12291,314,4528,1865,151,0,0,28191,76,20303,18438,12605,3209
2022-12-22 00:00:00+00,2499,480,5833,11768,298,5492,1605,158,0,0,28133,77,19504,17899,12066,2979
2022-12-22 00:30:00+00,2837,487,5834,11369,294,5528,1756,169,0,0,28274,83,19253,17497,11663,3324
2022-12-22 01:00:00+00,2659,338,5833,10915,295,5736,1949,179,0,0,27904,79,18992,17043,11210,2997
2022-12-22 01:30:00+00,2531,267,5834,10529,298,5744,2011,153,0,0,27367,76,18672,16661,10827,2798
2022-12-22 02:00:00+00,2598,320,5833,9881,306,5762,2023,155,0,0,26878,80,18043,16020,10187,2918
2022-12-22 02:30:00+00,2879,399,5831,9158,305,5766,2027,151,0,0,26516,88,17321,15294,9463,3278
2022-12-22 03:00:00+00,3060,453,5823,8545,296,5844,2054,143,0,0,26218,93,16718,14664,8841,3513
2022-12-22 03:30:00+00,3108,445,5815,8281,294,5854,2040,138,0,0,25975,94,16430,14390,8575,3553
2022-12-22 04:00:00+00,3216,445,5806,8155,293,5672,2054,157,0,0,25798,96,16308,14254,8448,3661
2022-12-22 04:30:00+00,3749,430,5799,7840,294,5660,1982,145,0,0,25899,103,15915,13933,8134,4179
2022-12-22 05:00:00+00,4737,402,5787,7601,308,5294,1852,185,0,0,26166,116,15548,13696,7909,5139
2022-12-22 05:30:00+00,5960,280,5784,7228,426,5232,1705,144,0,0,26760,126,15144,13438,7654,6240
2022-12-22 06:00:00+00,7913,402,5773,6958,620,4434,1821,243,0,0,28164,152,15172,13351,7578,8315
2022-12-22 06:30:00+00,10119,493,5762,7196,439,4274,1755,176,0,0,30214,172,15152,13397,7635,10612
2022-12-22 07:00:00+00,14598,481,5754,7096,500,2328,1988,147,0,0,32892,210,15338,13350,7596,15079
2022-12-22 07:30:00+00,16290,369,5747,6759,595,2248,2050,162,0,0,34220,218,15151,13101,7354,16659
2022-12-22 08:00:00+00,17756,342,5737,6074,528,3616,2052,160,0,46,36311,226,14391,12339,6602,18098
2022-12-22 08:30:00+00,18753,463,5738,5833,544,3740,2052,197,31,60,37412,233,14198,12146,6408,19216
2022-12-22 09:00:00+00,18470,495,5691,5966,549,4561,2047,148,112,138,38177,227,14365,12318,6627,18965
2022-12-22 09:30:00+00,18113,496,5610,5939,720,4668,2051,317,215,734,38863,221,14535,12484,6874,18609
2022-12-22 10:00:00+00,17734,496,5611,5618,857,5286,2053,385,339,796,39175,217,14478,12425,6814,18230
2022-12-22 10:30:00+00,18485,499,5611,5243,870,5396,2040,264,438,310,39156,224,14202,12162,6551,18984
2022-12-22 11:00:00+00,18421,500,5608,4965,715,5769,2052,235,518,284,39067,224,13858,11806,6198,18921
2022-12-22 11:30:00+00,18281,483,5607,4984,722,5842,2058,283,549,422,39231,221,13920,11862,6255,18764
2022-12-22 12:00:00+00,18566,481,5610,4925,824,5674,2054,273,557,494,39458,220,13970,11916,6306,19047
2022-12-22 12:30:00+00,18723,479,5607,4521,841,5918,2057,404,571,320,39441,226,13597,11540,5933,19202
2022-12-22 13:00:00+00,18839,480,5610,3927,841,5948,2051,271,550,438,38955,229,12979,10928,5318,19319
2022-12-22 13:30:00+00,18876,479,5612,3945,842,5982,2048,370,504,582,39239,228,12951,10903,5291,19355
2022-12-22 14:00:00+00,18830,479,5624,3972,901,6013,2051,368,388,278,38904,230,12936,10885,5261,19309
2022-12-22 14:30:00+00,19122,480,5631,3824,900,6045,2058,378,235,376,39049,232,12648,10590,4959,19602
2022-12-22 15:00:00+00,19475,481,5644,3621,894,6077,2054,451,94,1070,39860,231,12307,10253,4609,19956
2022-12-22 15:30:00+00,19719,481,5659,3473,987,6108,2056,418,9,1098,40008,233,12184,10128,4469,20200
2022-12-22 16:00:00+00,19573,481,5663,3500,1006,6156,2027,676,0,1196,40278,231,12196,10169,4506,20054
2022-12-22 16:30:00+00,19646,480,5668,3601,1006,6185,2062,725,0,1744,41117,228,12337,10275,4607,20126
2022-12-22 17:00:00+00,19885,481,5670,3699,1004,6211,2057,1075,0,1824,41905,228,12430,10373,4703,20366
2022-12-22 17:30:00+00,19681,480,5668,4028,1004,6239,2067,845,0,1736,41748,226,12767,10700,5032,20161
2022-12-22 18:00:00+00,19452,479,5670,4189,939,6268,2063,448,0,1636,41144,224,12861,10798,5128,19931
2022-12-22 18:30:00+00,19391,480,5675,4288,772,6292,2065,368,0,1322,40653,225,12800,10735,5060,19871
2022-12-22 19:00:00+00,19412,478,5675,4343,729,6184,2059,201,0,440,39521,231,12806,10747,5072,19890
2022-12-22 19:30:00+00,18467,477,5676,4412,724,6168,2057,179,0,290,38450,227,12869,10812,5136,18944
2022-12-22 20:00:00+00,17906,480,5678,4310,452,6168,2055,157,0,42,37248,229,12495,10440,4762,18386
2022-12-22 20:30:00+00,16660,481,5679,4104,418,6168,2055,183,0,38,35786,224,12256,10201,4522,17141
2022-12-22 21:00:00+00,15375,477,5677,3903,371,6148,2046,204,0,42,34243,220,11997,9951,4274,15852
2022-12-22 21:30:00+00,13666,476,5677,3671,361,6148,2051,195,0,0,32245,212,11760,9709,4032,14142
2022-12-22 22:00:00+00,12296,478,5678,3475,318,6074,2054,229,0,114,30716,205,11525,9471,3793,12774
2022-12-22 22:30:00+00,11115,424,5682,3139,311,6098,2069,230,0,94,29162,198,11201,9132,3450,11539
2022-12-22 23:00:00+00,9814,253,5680,2992,262,6358,2056,240,0,70,27725,185,10990,8934,3254,10067
2022-12-22 23:30:00+00,9044,322,5685,2822,254,6382,2046,210,0,36,26801,182,10807,8761,3076,9366
2022-12-23 00:00:00+00,8935,471,5683,2764,252,6414,2049,223,0,0,26791,185,10748,8699,3016,9406
2022-12-23 00:30:00+00,8978,481,5684,2805,346,6416,2046,221,0,0,26977,185,10881,8835,3151,9459
2022-12-23 01:00:00+00,8602,479,5686,2755,346,6416,2009,262,0,0,26555,182,10796,8787,3101,9081
2022-12-23 01:30:00+00,8289,376,5683,2681,344,6416,1985,241,0,0,26015,177,10693,8708,3025,8665
2022-12-23 02:00:00+00,8230,259,5686,2637,249,6386,2051,227,0,0,25725,174,10623,8572,2886,8489
2022-12-23 02:30:00+00,8111,348,5685,2538,242,6374,2048,231,0,0,25577,177,10513,8465,2780,8459
2022-12-23 03:00:00+00,7979,394,5682,2468,240,5970,2051,245,0,0,25029,180,10441,8390,2708,8373
2022-12-23 03:30:00+00,7631,394,5683,2679,241,5872,2056,210,0,0,24766,176,10659,8603,2920,8025
2022-12-23 04:00:00+00,8047,419,5682,2930,224,4790,2052,207,0,0,24351,184,10888,8836,3154,8466
2022-12-23 04:30:00+00,8056,320,5684,3197,225,4636,1958,208,0,0,24284,179,11064,9106,3422,8376
2022-12-23 05:00:00+00,9065,318,5683,3352,257,3222,1961,264,0,0,24122,187,11253,9292,3609,9383
2022-12-23 05:30:00+00,9864,335,5683,3508,264,3084,1955,233,0,0,24926,193,11410,9455,3772,10199
2022-12-23 06:00:00+00,11875,326,5683,3787,309,1872,1991,322,0,0,26165,210,11770,9779,4096,12201
2022-12-23 06:30:00+00,13442,311,5684,4186,359,1772,2052,222,0,0,28028,216,12281,10229,4545,13753
2022-12-23 07:00:00+00,14054,359,5679,4605,629,2084,2057,220,0,0,29687,218,12970,10913,5234,14413
2022-12-23 07:30:00+00,14434,393,5680,5245,640,2170,2054,388,0,0,31004,217,13619,11565,5885,14827
2022-12-23 08:00:00+00,13738,399,5679,6066,616,4012,2054,241,0,0,32805,203,14415,12361,6682,14137
2022-12-23 08:30:00+00,13860,400,5679,6889,711,4182,2053,420,8,4,34206,199,15340,13287,7608,14260
2022-12-23 09:00:00+00,14279,412,5678,7588,731,3982,2052,252,101,598,35672,188,16150,14098,8420,14691
2022-12-23 09:30:00+00,14146,482,5681,8195,729,4028,2046,201,241,628,36377,185,16892,14846,9165,14628
2022-12-23 10:00:00+00,14014,482,5677,9365,672,3504,2049,348,425,736,37272,176,18188,16139,10462,14496
2022-12-23 10:30:00+00,13130,471,5680,10219,642,3642,2047,308,612,1028,37779,166,19200,17153,11473,13601
2022-12-23 11:00:00+00,11939,465,5680,10988,641,4188,2043,306,719,720,37689,156,20071,18028,12348,12404
2022-12-23 11:30:00+00,11337,469,5685,11404,641,4332,2045,279,845,594,37631,152,20620,18575,12890,11806
2022-12-23 12:00:00+00,11582,475,5681,11889,453,4636,2054,186,924,410,38290,151,21001,18947,13266,12057
2022-12-23 12:30:00+00,11511,466,5685,12356,444,4500,2043,159,1009,40,38213,149,21537,19494,13809,11977
2022-12-23 13:00:00+00,11129,476,5682,12822,420,4170,2052,229,939,0,37919,146,21915,19863,14181,11605
2022-12-23 13:30:00+00,11075,478,5681,12679,420,4174,2051,208,835,132,37733,146,21666,19615,13934,11553
2022-12-23 14:00:00+00,10928,454,5681,12837,420,4102,2050,174,664,142,37452,143,21652,19602,13921,11382
2022-12-23 14:30:00+00,11055,383,5681,12953,423,3980,2046,201,440,0,37162,143,21543,19497,13816,11438
2022-12-23 15:00:00+00,10828,308,5679,12920,471,3794,2057,184,176,570,36987,136,21303,19246,13567,11136
2022-12-23 15:30:00+00,10975,318,5685,13304,480,3750,2048,159,23,644,37386,136,21540,19492,13807,11293
2022-12-23 16:00:00+00,10692,310,5683,13468,672,3848,2057,248,0,978,37956,134,21880,19823,14140,11002
2022-12-23 16:30:00+00,11036,353,5681,13287,677,3862,2057,406,0,1494,38853,137,21702,19645,13964,11389
2022-12-23 17:00:00+00,11133,405,5683,12926,674,4530,2055,435,0,1460,39301,143,21338,19283,13600,11538
2022-12-23 17:30:00+00,11230,396,5685,13364,673,4548,2050,303,0,1266,39515,142,21772,19722,14037,11626
2022-12-23 18:00:00+00,10514,373,5685,13715,671,4352,2055,278,0,1072,38715,137,22126,20071,14386,10887
2022-12-23 18:30:00+00,9960,301,5684,13897,670,4350,2056,255,0,1028,38201,131,22307,20251,14567,10261
2022-12-23 19:00:00+00,7828,346,5685,14122,656,5356,2056,207,0,682,36938,118,22519,20463,14778,8174
2022-12-23 19:30:00+00,6118,375,5682,14305,853,5446,2052,215,0,686,35732,104,22892,20840,15158,6493
2022-12-23 20:00:00+00,4819,407,5680,14526,512,5928,2054,186,0,666,34778,94,22772,20718,15038,5226
2022-12-23 20:30:00+00,4140,418,5678,14341,472,5982,2055,181,0,386,33653,89,22546,20491,14813,4558
2022-12-23 21:00:00+00,3441,342,5683,14330,396,6124,2037,166,0,0,32519,82,22446,20409,14726,3783
2022-12-23 21:30:00+00,2950,295,5682,13849,358,6098,1695,167,0,148,31242,76,21584,19889,14207,3245
2022-12-23 22:00:00+00,3247,351,5683,13628,331,4528,2024,178,0,0,29970,81,21666,19642,13959,3598
2022-12-23 22:30:00+00,3274,233,5682,13152,327,4400,1772,170,0,0,29010,79,20933,19161,13479,3507
2022-12-23 23:00:00+00,3591,355,5682,13251,260,2964,1530,164,0,0,27797,85,20723,19193,13511,3946
2022-12-23 23:30:00+00,3278,420,5682,13549,257,2868,1132,167,0,0,27353,82,20620,19488,13806,3698
2022-12-24 00:00:00+00,2675,278,5685,13975,257,3566,881,165,0,0,27482,66,20798,19917,14232,2953
2022-12-24 00:30:00+00,2720,281,5685,14154,257,3550,829,193,0,0,27669,66,20925,20096,14411,3001
2022-12-24 01:00:00+00,2951,272,5686,14008,242,3174,757,161,0,0,27251,70,20693,19936,14250,3223
2022-12-24 01:30:00+00,2911,263,5690,13956,240,3166,718,147,0,0,27091,69,20604,19886,14196,3174
2022-12-24 02:00:00+00,2980,291,5684,13641,223,2692,731,156,0,0,26398,73,20279,19548,13864,3271
2022-12-24 02:30:00+00,2982,288,5682,13572,222,2594,735,158,0,0,26233,73,20211,19476,13794,3270
2022-12-24 03:00:00+00,3445,404,5682,13180,225,1506,824,172,0,0,25438,76,19911,19087,13405,3849
2022-12-24 03:30:00+00,3260,335,5682,13534,225,1468,803,145,0,0,25452,70,20244,19441,13759,3595
2022-12-24 04:00:00+00,3504,279,5680,13496,225,802,861,151,0,0,24998,73,20262,19401,13721,3783
2022-12-24 04:30:00+00,3251,286,5681,13665,221,766,784,162,0,0,24816,69,20351,19567,13886,3537
2022-12-24 05:00:00+00,2970,283,5680,13924,254,654,731,162,0,0,24658,69,20589,19858,14178,3253
2022-12-24 05:30:00+00,3185,283,5681,13862,255,668,790,168,0,0,24892,72,20588,19798,14117,3468
2022-12-24 06:00:00+00,2911,233,5681,13728,278,1758,730,159,0,0,25478,71,20417,19687,14006,3144
2022-12-24 06:30:00+00,2890,243,5681,13648,300,1884,739,183,0,0,25568,72,20368,19629,13948,3133
2022-12-24 07:00:00+00,2938,231,5683,13386,394,3588,724,146,0,0,27090,71,20187,19463,13780,3169
2022-12-24 07:30:00+00,3050,234,5683,13311,416,3654,757,152,0,0,27257,72,20167,19410,13727,3284
2022-12-24 08:00:00+00,3223,253,5678,13155,488,3888,983,169,0,226,28063,75,20304,19321,13643,3476
2022-12-24 08:30:00+00,3567,347,5677,13094,499,4092,1370,204,111,496,29457,84,20751,19381,13704,3914
2022-12-24 09:00:00+00,3958,279,5683,12944,498,4764,1409,204,481,674,30894,86,21015,19606,13923,4237
2022-12-24 09:30:00+00,4367,366,5685,13068,501,4860,1412,197,887,668,32010,91,21552,20140,14456,4733
2022-12-24 10:00:00+00,4439,443,5683,13325,509,4980,1398,165,1231,638,32810,89,22146,20748,15065,4882
2022-12-24 10:30:00+00,4178,417,5687,13766,516,4951,1405,163,1561,554,33198,84,22935,21530,15843,4595
2022-12-24 11:00:00+00,3896,391,5685,13761,449,5317,1408,166,1769,636,33478,82,23072,21664,15979,4287
2022-12-24 11:30:00+00,3907,310,5683,13496,455,5397,1409,224,1964,502,33347,81,23007,21598,15915,4217
2022-12-24 12:00:00+00,4287,330,5685,12780,461,5977,1410,186,1944,394,33453,87,22280,20870,15185,4617
2022-12-24 12:30:00+00,4378,343,5684,12125,554,6024,1409,209,1802,348,32877,90,21574,20165,14481,4721
2022-12-24 13:00:00+00,4723,364,5682,11518,574,5384,1410,293,1658,300,31906,97,20842,19432,13750,5087
2022-12-24 13:30:00+00,4691,354,5683,11566,578,5380,1407,204,1296,400,31559,97,20530,19123,13440,5045
2022-12-24 14:00:00+00,4564,355,5683,12212,579,5570,1403,170,951,332,31819,96,20828,19425,13742,4919
2022-12-24 14:30:00+00,4591,289,5679,12836,504,5454,1196,160,582,276,31567,93,20797,19601,13922,4880
2022-12-24 15:00:00+00,4586,288,5679,13751,528,4730,839,160,217,1032,31810,87,21014,20175,14496,4874
2022-12-24 15:30:00+00,4560,284,5682,14229,554,4702,773,236,25,1266,32311,86,21263,20490,14808,4844
2022-12-24 16:00:00+00,4749,324,5685,14591,659,4980,808,327,0,1274,33397,84,21743,20935,15250,5073
2022-12-24 16:30:00+00,4776,346,5686,15276,653,4866,1049,409,0,1496,34557,82,22664,21615,15929,5122
2022-12-24 17:00:00+00,4770,368,5687,15746,679,4926,1396,397,0,1174,35143,86,23508,22112,16425,5138
2022-12-24 17:30:00+00,4479,354,5684,16649,573,4894,1407,384,0,572,34996,83,24313,22906,17222,4833
2022-12-24 18:00:00+00,4843,310,5686,16371,539,3814,1407,292,0,1020,34282,83,24003,22596,16910,5153
2022-12-24 18:30:00+00,4131,341,5688,16866,529,3766,1370,232,0,584,33507,77,24453,23083,17395,4472
2022-12-24 19:00:00+00,3346,237,5685,16750,481,4202,1314,264,0,150,32429,68,24230,22916,17231,3583
2022-12-24 19:30:00+00,3186,231,5689,16716,477,4188,1041,202,0,0,31730,65,23923,22882,17193,3417
2022-12-24 20:00:00+00,3183,236,5686,16651,419,3856,1145,209,0,0,31385,70,23901,22756,17070,3419
2022-12-24 20:30:00+00,3190,232,5688,16377,405,3786,1035,193,0,0,30906,70,23505,22470,16782,3422
2022-12-24 21:00:00+00,3218,232,5685,16805,398,2662,1229,206,0,0,30435,71,24117,22888,17203,3450
2022-12-24 21:30:00+00,3177,231,5685,16519,387,2584,1180,201,0,0,29964,71,23771,22591,16906,3408
2022-12-24 22:00:00+00,3134,232,5683,16357,359,1220,1225,251,0,0,28461,66,23624,22399,16716,3366
2022-12-24 22:30:00+00,3116,232,5685,16249,353,1118,947,283,0,0,27983,66,23234,22287,16602,3348
2022-12-24 23:00:00+00,3208,232,5684,15814,306,1168,804,230,0,0,27446,71,22608,21804,16120,3440
2022-12-24 23:30:00+00,3328,232,5684,14936,306,1168,817,218,0,0,26689,75,21743,20926,15242,3560
2022-12-25 00:00:00+00,3390,244,5685,14981,305,494,761,213,0,0,26073,72,21732,20971,15286,3634
2022-12-25 00:30:00+00,3740,266,5685,14895,303,516,934,224,0,0,26563,78,21817,20883,15198,4006
2022-12-25 01:00:00+00,3561,231,5672,15016,290,676,845,233,0,0,26524,75,21823,20978,15306,3792
2022-12-25 01:30:00+00,3437,231,5678,15027,286,622,745,209,0,0,26235,72,21736,20991,15313,3668
2022-12-25 02:00:00+00,3419,232,5685,15079,286,368,745,194,0,0,26008,70,21795,21050,15365,3651
2022-12-25 02:30:00+00,3416,231,5683,14721,287,284,749,161,0,0,25532,69,21440,20691,15008,3647
2022-12-25 03:00:00+00,3466,231,5681,14779,290,218,762,161,0,0,25588,71,21512,20750,15069,3697
2022-12-25 03:30:00+00,3453,231,5684,14706,289,128,746,145,0,0,25382,70,21425,20679,14995,3684
2022-12-25 04:00:00+00,4181,300,5680,14678,299,188,1021,222,0,0,26569,83,21678,20657,14977,4481
2022-12-25 04:30:00+00,4143,351,5679,14453,299,184,976,255,0,0,26340,85,21407,20431,14752,4494
2022-12-25 05:00:00+00,4088,350,5681,14329,291,222,867,158,0,0,25986,84,21168,20301,14620,4438
2022-12-25 05:30:00+00,4192,347,5678,14320,297,208,951,205,0,0,26198,86,21246,20295,14617,4539
2022-12-25 06:00:00+00,3781,248,5679,14325,325,22,1035,181,0,0,25596,75,21364,20329,14650,4029
2022-12-25 06:30:00+00,4487,425,5679,13960,362,0,1218,161,0,0,26292,90,21219,20001,14322,4912
2022-12-25 07:00:00+00,3779,470,5681,13875,410,188,980,152,0,0,25535,82,20946,19966,14285,4249
2022-12-25 07:30:00+00,4389,443,5682,13609,436,226,858,179,0,0,25822,90,20585,19727,14045,4832
2022-12-25 08:00:00+00,3529,348,5681,13563,466,2002,772,200,0,0,26561,78,20482,19710,14029,3877
2022-12-25 08:30:00+00,3849,453,5683,13779,467,2102,777,208,23,0,27341,85,20729,19952,14269,4302
2022-12-25 09:00:00+00,3372,331,5685,13660,439,3830,767,199,133,122,28538,73,20684,19917,14232,3703
2022-12-25 09:30:00+00,3501,329,5686,13906,490,3948,677,194,261,310,29302,72,21020,20343,14657,3830
2022-12-25 10:00:00+00,3599,469,5691,13472,559,4812,446,283,441,730,30502,75,20609,20163,14472,4068
2022-12-25 10:30:00+00,3385,700,5690,13516,828,4904,444,335,640,944,31386,78,21118,20674,14984,4085
2022-12-25 11:00:00+00,3403,676,5692,13348,762,5752,447,403,816,1090,32389,81,21065,20618,14926,4079
2022-12-25 11:30:00+00,3831,802,5691,12801,800,5814,445,417,943,1564,33108,89,20680,20235,14544,4633
2022-12-25 12:00:00+00,4257,957,5692,12334,968,6142,446,436,1094,2036,34362,98,20534,20088,14396,5214
2022-12-25 12:30:00+00,4693,986,5690,12010,982,6146,545,489,1101,2172,34814,103,20328,19783,14093,5679
2022-12-25 13:00:00+00,4806,973,5692,11622,985,6078,588,744,1005,2156,34649,106,19892,19304,13612,5779
2022-12-25 13:30:00+00,4733,978,5693,11271,934,6023,473,722,850,2168,33845,107,19221,18748,13055,5711
2022-12-25 14:00:00+00,4680,985,5690,10660,941,5952,457,629,638,2172,32804,108,18386,17929,12239,5665
2022-12-25 14:30:00+00,4290,960,5690,10413,948,5904,454,581,382,2036,31658,105,17887,17433,11743,5250
2022-12-25 15:00:00+00,4072,625,5689,10679,950,5844,448,434,144,1712,30597,93,17910,17462,11773,4697
2022-12-25 15:30:00+00,4327,462,5687,10423,965,5797,448,275,16,1674,30075,90,17539,17091,11404,4789
2022-12-25 16:00:00+00,4120,459,5691,10461,893,5831,446,331,0,1510,29742,89,17491,17045,11354,4579
2022-12-25 16:30:00+00,3738,461,5688,10750,787,5783,447,319,0,1332,29305,85,17672,17225,11537,4199
2022-12-25 17:00:00+00,3292,462,5690,11077,593,5761,445,278,0,974,28572,80,17805,17360,11670,3754
2022-12-25 17:30:00+00,3146,457,5688,11123,575,5719,446,263,0,262,27679,80,17832,17386,11698,3603
2022-12-25 18:00:00+00,3100,266,5689,11510,523,5584,444,296,0,606,28018,73,18166,17722,12033,3366
2022-12-25 18:30:00+00,2929,229,5692,12087,525,5406,442,173,0,82,27565,67,18746,18304,12612,3158
2022-12-25 19:00:00+00,2960,229,5691,11920,510,4451,471,161,0,330,26723,68,18592,18121,12430,3189
2022-12-25 19:30:00+00,2843,229,5689,11819,511,4323,445,163,0,258,26280,66,18464,18019,12330,3072
2022-12-25 20:00:00+00,2898,229,5691,12226,478,3573,445,163,0,142,25845,67,18840,18395,12704,3127
2022-12-25 20:30:00+00,3012,230,5688,12417,472,3436,445,162,0,0,25862,67,19022,18577,12889,3242
2022-12-25 21:00:00+00,3261,229,5682,12469,419,2657,445,192,0,0,25354,70,19015,18570,12888,3490
2022-12-25 21:30:00+00,3143,230,5684,12878,430,2552,453,162,0,0,25532,67,19445,18992,13308,3373
2022-12-25 22:00:00+00,3608,328,5680,13362,429,1078,563,193,0,0,25241,77,20034,19471,13791,3936
2022-12-25 22:30:00+00,3182,303,5681,13621,407,989,729,179,0,0,25091,70,20438,19709,14028,3485
2022-12-25 23:00:00+00,3442,349,5679,14235,372,635,745,179,0,0,25636,73,21031,20286,14607,3791
2022-12-25 23:30:00+00,3082,318,5680,14898,368,574,745,179,0,0,25844,65,21691,20946,15266,3400
2022-12-26 00:00:00+00,3040,279,5680,14993,353,506,745,175,0,0,25771,63,21771,21026,15346,3319
2022-12-26 00:30:00+00,3451,316,5678,14722,349,480,746,202,0,0,25944,70,21495,20749,15071,3767
2022-12-26 01:00:00+00,3985,389,5682,14705,317,154,744,147,0,0,26123,79,21448,20704,15022,4374
2022-12-26 01:30:00+00,3912,341,5683,15225,313,146,745,142,0,0,26507,75,21966,21221,15538,4253
2022-12-26 02:00:00+00,3851,414,5681,15207,294,58,743,208,0,0,26456,78,21925,21182,15501,4265
2022-12-26 02:30:00+00,3652,393,5684,15306,290,54,742,156,0,0,26277,74,22022,21280,15596,4045
2022-12-26 03:00:00+00,3102,302,5684,15281,276,102,744,161,0,0,25652,64,21985,21241,15557,3404
2022-12-26 03:30:00+00,2983,230,5688,15627,272,100,740,139,0,0,25779,59,22327,21587,15899,3213
2022-12-26 04:00:00+00,2984,230,5688,16153,218,156,741,139,0,0,26309,60,22800,22059,16371,3214
2022-12-26 04:30:00+00,2987,229,5685,16198,212,158,737,166,0,0,26372,60,22832,22095,16410,3216
2022-12-26 05:00:00+00,3005,229,5683,16175,243,0,738,215,0,0,26288,59,22839,22101,16418,3234
2022-12-26 05:30:00+00,3052,269,5687,16364,259,0,737,206,0,0,26574,60,23047,22310,16623,3321
2022-12-26 06:00:00+00,3283,393,5688,17230,308,0,737,163,0,0,27802,65,23963,23226,17538,3676
2022-12-26 06:30:00+00,3413,398,5685,17410,352,0,737,171,0,0,28166,66,24184,23447,17762,3811
2022-12-26 07:00:00+00,3115,268,5686,17285,340,26,737,159,0,0,27616,58,24048,23311,17625,3383
2022-12-26 07:30:00+00,3265,350,5687,17294,351,50,700,206,0,0,27903,63,24032,23332,17645,3615
2022-12-26 08:00:00+00,2952,315,5684,17140,326,744,352,186,1,0,27700,59,23503,23151,17467,3267
2022-12-26 08:30:00+00,3196,334,5685,17198,333,770,134,205,186,0,28041,61,23536,23402,17717,3530
2022-12-26 09:00:00+00,3197,324,5687,16027,348,3140,133,169,813,0,29838,63,23008,22875,17188,3521
2022-12-26 09:30:00+00,3128,309,5684,16078,311,3226,134,164,1625,0,30659,61,23832,23698,18014,3437
2022-12-26 10:00:00+00,3144,358,5683,16554,317,2496,133,200,2415,0,31300,64,25102,24969,19286,3502
2022-12-26 10:30:00+00,2954,256,5687,17155,317,2444,127,160,2840,0,31940,57,26126,25999,20312,3210
2022-12-26 11:00:00+00,2937,5,5687,17503,311,2566,132,166,3138,0,32445,49,26771,26639,20952,2942
2022-12-26 11:30:00+00,2952,3,5686,17596,260,2574,133,176,3416,0,32795,48,27091,26958,21272,2954
2022-12-26 12:00:00+00,2874,0,5685,17721,254,2308,133,184,3433,56,32648,45,27226,27093,21408,2874
2022-12-26 12:30:00+00,2763,0,5690,18206,254,2294,134,170,3308,2,32821,43,27592,27458,21768,2763
2022-12-26 13:00:00+00,2900,0,5687,17794,254,2418,130,184,2892,210,32469,40,26757,26627,20940,2900
2022-12-26 13:30:00+00,3144,0,5686,18069,254,2468,134,149,2397,0,32301,43,26540,26406,20720,3144
2022-12-26 14:00:00+00,2734,0,5686,18170,293,2870,136,162,1822,0,31873,38,26107,25971,20285,2734
2022-12-26 14:30:00+00,2734,0,5683,18152,399,2978,139,190,1128,286,31689,39,25501,25362,19679,2734
2022-12-26 15:00:00+00,2664,0,5687,18116,453,3492,141,174,410,484,31621,38,24807,24666,18979,2664
2022-12-26 15:30:00+00,2972,0,5686,17953,488,3604,143,270,47,738,31901,43,24317,24174,18488,2972
2022-12-26 16:00:00+00,2295,0,5685,17769,545,5788,142,168,0,808,33200,41,24141,23999,18314,2295
2022-12-26 16:30:00+00,2147,0,5682,17851,523,6082,143,296,0,1146,33870,41,24199,24056,18374,2147
2022-12-26 17:00:00+00,2448,0,5685,17818,561,6096,146,451,0,1492,34697,45,24210,24064,18379,2448
2022-12-26 17:30:00+00,2467,0,5685,18262,582,6092,147,442,0,1078,34755,45,24676,24529,18844,2467
2022-12-26 18:00:00+00,2431,0,5688,17737,560,5886,149,276,0,1434,34161,43,24134,23985,18297,2431
2022-12-26 18:30:00+00,2337,0,5684,17389,566,5878,147,252,0,1132,33385,42,23786,23639,17955,2337
2022-12-26 19:00:00+00,2329,0,5686,16911,529,5968,146,235,0,972,32776,45,23272,23126,17440,2329
2022-12-26 19:30:00+00,2159,0,5685,16639,569,5914,146,233,0,600,31945,44,23039,22893,17208,2159
2022-12-26 20:00:00+00,2211,88,5683,16313,658,4962,146,245,0,932,31237,45,22800,22654,16971,2298
2022-12-26 20:30:00+00,2182,175,5684,16221,574,4854,271,162,0,258,30381,48,22750,22479,16795,2357
2022-12-26 21:00:00+00,2236,230,5685,16170,515,3822,428,190,0,406,29682,53,22798,22370,16685,2466
2022-12-26 21:30:00+00,2297,232,5684,15400,512,3742,550,146,0,220,28783,56,22146,21596,15912,2529
2022-12-26 22:00:00+00,2311,263,5681,15085,475,2836,642,164,0,22,27479,55,21883,21241,15560,2574
2022-12-26 22:30:00+00,2501,244,5679,14145,472,2758,747,206,0,174,26926,58,21043,20296,14617,2745
2022-12-26 23:00:00+00,3425,337,5681,14042,333,1526,747,178,0,0,26269,70,20803,20056,14375,3762
2022-12-26 23:30:00+00,3096,439,5681,14031,300,1562,747,150,0,0,26006,69,20759,20012,14331,3535
2022-12-27 00:00:00+00,3115,318,5680,13712,264,2516,746,163,0,0,26514,65,20402,19656,13976,3433
2022-12-27 00:30:00+00,3717,400,5683,13520,263,2562,747,207,0,0,27099,75,20213,19466,13783,4117
2022-12-27 01:00:00+00,3632,437,5686,13173,263,2140,746,144,0,0,26221,77,19868,19122,13436,4069
2022-12-27 01:30:00+00,3444,437,5688,12775,265,2173,746,162,0,0,25690,76,19474,18728,13040,3881
2022-12-27 02:00:00+00,3496,453,5686,12394,263,2018,744,156,0,0,25210,79,19087,18343,12657,3949
2022-12-27 02:30:00+00,3602,499,5687,12125,265,2067,745,144,0,0,25135,82,18822,18077,12390,4101
2022-12-27 03:00:00+00,3399,461,5687,11557,268,3167,745,151,0,0,25435,78,18257,17512,11825,3860
2022-12-27 03:30:00+00,3581,481,5686,10622,269,3271,746,167,0,0,24823,84,17323,16577,10891,4062
2022-12-27 04:00:00+00,3325,415,5687,10168,270,2671,745,140,0,0,23421,84,16870,16125,10438,3740
2022-12-27 04:30:00+00,3361,387,5686,9413,255,2904,748,151,0,0,22905,90,16102,15354,9668,3748
2022-12-27 05:00:00+00,3531,381,5687,8666,253,2915,791,178,0,0,22402,107,15397,14606,8919,3912
2022-12-27 05:30:00+00,3847,480,5687,8016,263,3184,819,175,0,0,22471,120,14785,13966,8279,4327
2022-12-27 06:00:00+00,3830,559,5688,7528,348,4730,843,170,0,288,23985,112,14407,13564,7876,4389
2022-12-27 06:30:00+00,3842,734,5682,7574,519,4934,881,180,0,382,24728,116,14656,13775,8093,4576
2022-12-27 07:00:00+00,3310,821,5681,7665,509,5586,1400,184,0,0,25156,112,15255,13855,8174,4131
2022-12-27 07:30:00+00,3495,791,5681,7846,402,5633,1827,179,0,20,25874,112,15756,13929,8248,4286
2022-12-27 08:00:00+00,3274,875,5683,8598,474,5761,1827,167,0,60,26719,109,16582,14755,9072,4149
2022-12-27 08:30:00+00,3259,971,5681,9324,518,5831,1825,187,112,260,27968,108,17460,15635,9954,4230
2022-12-27 09:00:00+00,3061,891,5679,10106,519,6395,1919,268,332,360,29529,103,18555,16636,10957,3952
2022-12-27 09:30:00+00,3315,728,5681,10624,616,6377,2051,245,575,406,30618,97,19547,17496,11815,4043
2022-12-27 10:00:00+00,3280,766,5682,11372,666,6162,2049,257,796,388,31418,92,20565,18516,12834,4046
2022-12-27 10:30:00+00,3183,799,5680,12039,642,6020,2046,247,1022,226,31904,88,21429,19383,13703,3982
2022-12-27 11:00:00+00,3017,708,5680,13022,579,6047,2058,273,1232,136,32752,81,22571,20513,14833,3725
2022-12-27 11:30:00+00,2571,634,5681,14251,495,6094,1980,252,1304,152,33414,71,23711,21731,16050,3205
2022-12-27 12:00:00+00,2293,603,5682,15046,405,6096,1820,252,1130,434,33761,66,24083,22263,16581,2896
2022-12-27 12:30:00+00,2165,533,5681,16030,391,6082,1648,244,939,304,34017,61,24689,23041,17360,2698
2022-12-27 13:00:00+00,2071,538,5680,16999,385,5946,1471,256,687,120,34153,60,25222,23751,18071,2609
2022-12-27 13:30:00+00,2167,473,5682,17262,384,5936,1348,256,481,168,34157,58,25157,23809,18127,2640
2022-12-27 14:00:00+00,2525,555,5686,17813,404,4560,1482,165,298,200,33688,61,25683,24201,18515,3080
2022-12-27 14:30:00+00,2011,465,5687,18159,443,4538,1766,186,134,290,33679,54,26189,24423,18736,2476
2022-12-27 15:00:00+00,2096,458,5687,18147,529,5104,1464,167,34,358,34044,54,25861,24397,18710,2554
2022-12-27 15:30:00+00,2149,391,5686,18238,574,5140,1365,183,2,782,34510,52,25865,24500,18814,2540
2022-12-27 16:00:00+00,2090,230,5683,18113,608,5754,1817,225,0,996,35516,50,26221,24404,18721,2320
2022-12-27 16:30:00+00,2240,230,5680,17827,758,5824,2034,385,0,1488,36466,52,26299,24265,18585,2470
2022-12-27 17:00:00+00,2193,230,5681,17648,844,6104,2055,617,0,1736,37108,53,26228,24173,18492,2423
2022-12-27 17:30:00+00,2237,234,5679,17263,781,6116,2055,665,0,1922,36952,54,25778,23723,18044,2471
2022-12-27 18:00:00+00,2356,230,5683,16749,857,6082,2046,688,0,1880,36571,56,25335,23289,17606,2586
2022-12-27 18:30:00+00,2109,231,5682,16721,758,6072,2050,344,0,1666,35633,52,25211,23161,17479,2340
2022-12-27 19:00:00+00,1842,229,5683,16893,708,5780,2050,269,0,1288,34742,50,25334,23284,17601,2071
2022-12-27 19:30:00+00,1643,229,5682,17104,666,5742,1941,278,0,892,34177,48,25393,23452,17770,1872
2022-12-27 20:00:00+00,1934,301,5682,17642,541,3832,2049,250,0,840,33071,47,25914,23865,18183,2235
2022-12-27 20:30:00+00,1657,237,5681,17716,437,3736,2064,217,0,674,32419,42,25898,23834,18153,1894
2022-12-27 21:00:00+00,2291,342,5683,17542,411,2878,1960,223,0,102,31432,52,25596,23636,17953,2633
2022-12-27 21:30:00+00,2153,277,5683,17020,401,2672,1852,219,0,192,30469,48,24956,23104,17421,2430
2022-12-27 22:00:00+00,2988,297,5687,16905,399,1852,1953,175,0,122,30378,59,24944,22991,17304,3285
2022-12-27 22:30:00+00,2734,263,5685,17227,411,1816,1724,193,0,0,30053,54,25047,23323,17638,2997
2022-12-27 23:00:00+00,3353,273,5686,17379,377,1044,1630,179,0,0,29921,62,25072,23442,17756,3626
2022-12-27 23:30:00+00,3119,231,5685,17503,282,1016,1439,168,0,0,29443,57,24909,23470,17785,3350
2022-12-28 00:00:00+00,3163,232,5687,17593,246,896,1200,163,0,0,29180,57,24726,23526,17839,3395
2022-12-28 00:30:00+00,3096,229,5688,17679,227,900,1452,165,0,0,29436,57,25046,23594,17906,3325
2022-12-28 01:00:00+00,2431,235,5688,17485,208,960,1356,160,0,0,28523,49,24737,23381,17693,2666
2022-12-28 01:30:00+00,2486,247,5688,16942,217,916,1210,198,0,0,27904,51,24057,22847,17159,2733
2022-12-28 02:00:00+00,2819,245,5689,16553,217,892,1298,208,0,0,27921,56,23757,22459,16770,3064
2022-12-28 02:30:00+00,2944,246,5688,16055,216,902,1316,187,0,0,27554,59,23275,21959,16271,3190
2022-12-28 03:00:00+00,2569,236,5688,15401,204,1200,1188,183,0,0,26669,55,22481,21293,15605,2805
2022-12-28 03:30:00+00,2488,236,5685,15194,206,1204,1188,171,0,0,26372,54,22273,21085,15400,2724
2022-12-28 04:00:00+00,2890,232,5688,14964,209,1024,1237,160,0,0,26404,60,22098,20861,15173,3122
2022-12-28 04:30:00+00,2657,244,5684,14383,195,996,1161,186,0,0,25506,59,21423,20262,14578,2901
2022-12-28 05:00:00+00,2728,231,5688,13935,225,1332,1294,143,0,0,25576,59,21142,19848,14160,2959
2022-12-28 05:30:00+00,2947,249,5685,13399,228,1416,1212,197,0,0,25333,64,20524,19312,13627,3196
2022-12-28 06:00:00+00,2919,232,5687,12734,260,2576,1120,151,0,0,25679,63,19801,18681,12994,3151
2022-12-28 06:30:00+00,2967,237,5684,12533,311,2640,1425,171,0,0,25968,65,19953,18528,12844,3204
2022-12-28 07:00:00+00,2821,235,5685,11877,367,4008,1344,187,0,0,26524,67,19273,17929,12244,3056
2022-12-28 07:30:00+00,2964,300,5683,11605,372,4180,1520,173,0,408,27205,70,19180,17660,11977,3264
2022-12-28 08:00:00+00,3308,295,5683,11432,426,5428,1901,144,0,114,28731,76,19442,17541,11858,3603
2022-12-28 08:30:00+00,3526,293,5684,11423,470,5554,1997,175,7,360,29489,78,19581,17584,11900,3819
2022-12-28 09:00:00+00,4018,361,5682,11158,567,5930,2029,474,38,760,31017,86,19474,17445,11763,4379
2022-12-28 09:30:00+00,4526,427,5684,11329,642,5974,2038,504,92,816,32032,92,19785,17747,12063,4953
2022-12-28 10:00:00+00,4584,577,5686,12091,871,6066,2030,598,158,550,33211,94,20836,18806,13120,5161
2022-12-28 10:30:00+00,4399,608,5684,13162,627,6076,1860,664,222,656,33958,91,21555,19695,14011,5007
2022-12-28 11:00:00+00,4480,585,5681,13871,630,6078,1776,711,303,708,34823,89,22261,20485,14804,5065
2022-12-28 11:30:00+00,4542,580,5685,14723,624,6078,1929,466,370,518,35515,86,23331,21402,15717,5122
2022-12-28 12:00:00+00,4364,552,5684,15212,512,6076,1842,469,426,718,35855,82,23676,21834,16150,4916
2022-12-28 12:30:00+00,4322,545,5683,15321,467,6078,1918,264,444,750,35792,81,23833,21915,16232,4867
2022-12-28 13:00:00+00,3978,495,5684,15613,433,6078,2014,241,437,646,35619,76,24181,22167,16483,4473
2022-12-28 13:30:00+00,3748,471,5679,15957,431,6078,1902,230,390,624,35510,73,24359,22457,16778,4219
2022-12-28 14:00:00+00,3566,463,5682,16161,446,6078,1834,175,312,448,35165,70,24435,22601,16919,4029
2022-12-28 14:30:00+00,3539,452,5680,16177,483,6078,1633,157,252,498,34949,69,24225,22592,16912,3991
2022-12-28 15:00:00+00,3566,236,5681,16238,527,5974,1641,160,122,814,34959,63,24209,22568,16887,3802
2022-12-28 15:30:00+00,3579,230,5681,16394,554,5974,1618,168,16,1014,35228,63,24263,22645,16964,3809
2022-12-28 16:00:00+00,3733,230,5681,16685,712,6086,1626,197,0,1138,36088,64,24704,23078,17397,3963
2022-12-28 16:30:00+00,4063,230,5680,17141,770,6090,1580,465,0,1584,37603,67,25171,23591,17911,4293
2022-12-28 17:00:00+00,4160,229,5681,17511,781,6098,1564,614,0,1546,38184,68,25537,23973,18292,4389
2022-12-28 17:30:00+00,4032,229,5680,17887,806,6076,1484,622,0,1754,38570,66,25857,24373,18693,4261
2022-12-28 18:00:00+00,3904,229,5681,18031,712,5876,1492,432,0,1626,37983,64,25916,24424,18743,4133
2022-12-28 18:30:00+00,3429,230,5686,18028,699,5814,1606,281,0,1568,37341,59,26019,24413,18727,3659
2022-12-28 19:00:00+00,2783,229,5686,18063,775,5438,1677,305,0,678,35634,55,26201,24524,18838,3012
2022-12-28 19:30:00+00,2462,229,5684,18133,621,5322,1328,280,0,376,34435,52,25766,24438,18754,2691
2022-12-28 20:00:00+00,2389,231,5681,18197,511,4068,1324,315,0,654,33370,52,25713,24389,18708,2620
2022-12-28 20:30:00+00,2059,229,5683,18228,438,4020,1331,264,0,116,32368,49,25680,24349,18666,2288
2022-12-28 21:00:00+00,2026,230,5681,18262,394,3976,1277,271,0,0,32117,49,25614,24337,18656,2256
2022-12-28 21:30:00+00,2050,232,5683,18329,373,3788,1256,239,0,0,31950,48,25641,24385,18702,2282
2022-12-28 22:00:00+00,2306,310,5680,18381,353,1794,1515,248,0,0,30587,49,25929,24414,18734,2616
2022-12-28 22:30:00+00,2224,238,5683,18376,345,1758,1350,215,0,0,30189,46,25754,24404,18721,2462
2022-12-28 23:00:00+00,2347,255,5682,18367,312,2528,1392,162,0,0,31045,51,25753,24361,18679,2602
2022-12-28 23:30:00+00,2301,233,5682,18395,300,2576,1348,165,0,0,31000,50,25725,24377,18695,2534
2022-12-29 00:00:00+00,2272,243,5681,18419,295,2906,1211,175,0,0,31202,49,25606,24395,18714,2515
2022-12-29 00:30:00+00,2234,242,5685,18383,299,2864,1070,167,0,0,30944,49,25437,24367,18682,2476
2022-12-29 01:00:00+00,2625,291,5683,18299,292,1514,789,162,0,0,29655,52,25063,24274,18591,2916
2022-12-29 01:30:00+00,2121,232,5688,18212,263,1410,765,144,0,0,28835,44,24928,24163,18475,2353
2022-12-29 02:00:00+00,2224,237,5686,18133,272,794,862,158,0,0,28366,47,24953,24091,18405,2461
2022-12-29 02:30:00+00,2108,232,5688,18079,278,730,941,157,0,0,28213,46,24986,24045,18357,2340
2022-12-29 03:00:00+00,2807,291,5685,18032,301,18,1248,157,0,0,28539,55,25266,24018,18333,3098
2022-12-29 03:30:00+00,2676,247,5682,17947,276,74,1219,174,0,0,28295,54,25124,23905,18223,2923
2022-12-29 04:00:00+00,2525,243,5687,17832,276,174,1173,159,0,0,28069,53,24968,23795,18108,2768
2022-12-29 04:30:00+00,2485,234,5694,17703,275,304,1147,143,0,0,27985,54,24819,23672,17978,2719
2022-12-29 05:00:00+00,2477,230,5693,17581,295,222,1137,143,0,0,27778,53,24706,23569,17876,2707
2022-12-29 05:30:00+00,2499,236,5693,17484,297,114,1150,166,0,0,27639,52,24624,23474,17781,2735
2022-12-29 06:00:00+00,2463,231,5693,17311,313,432,1130,143,0,0,27716,53,24447,23317,17624,2694
2022-12-29 06:30:00+00,2509,234,5692,17652,340,428,1231,157,0,0,28243,54,24915,23684,17992,2743
2022-12-29 07:00:00+00,2680,242,5689,18312,456,464,1086,163,0,0,29092,52,25543,24457,18768,2922
2022-12-29 07:30:00+00,3157,290,5693,18359,496,540,1071,152,0,206,29964,60,25619,24548,18855,3447
2022-12-29 08:00:00+00,2653,394,5691,18543,473,2146,1063,153,0,226,31342,54,25770,24707,19016,3047
2022-12-29 08:30:00+00,2751,383,5728,19183,467,2392,1070,167,140,300,32581,55,26588,25518,19790,3134
2022-12-29 09:00:00+00,2832,363,5723,18941,548,2240,1179,258,582,338,33004,54,26973,25794,20071,3195
2022-12-29 09:30:00+00,3047,282,5722,18924,576,2222,1391,257,1160,324,33905,52,27773,26382,20660,3329
2022-12-29 10:00:00+00,2777,270,5713,18773,578,2150,1407,267,1659,376,33970,49,28130,26723,21010,3047
2022-12-29 10:30:00+00,2546,301,5718,18730,875,2168,1403,270,2066,480,34557,46,28792,27389,21671,2847
2022-12-29 11:00:00+00,2464,250,5717,18729,596,2714,1343,263,2199,318,34593,45,28584,27241,21524,2714
2022-12-29 11:30:00+00,2209,274,5709,19173,538,2754,1164,278,2348,480,34927,42,28932,27768,22059,2483
2022-12-29 12:00:00+00,2021,346,5707,19241,523,2934,1132,286,2380,600,35170,41,28983,27851,22144,2367
2022-12-29 12:30:00+00,1802,399,5708,19047,533,2998,1194,308,2275,806,35070,41,28757,27563,21855,2201
2022-12-29 13:00:00+00,1791,246,5712,18840,538,4920,931,303,2032,332,35645,42,28053,27122,21410,2037
2022-12-29 13:30:00+00,1781,235,5711,18600,532,4996,929,317,1602,824,35527,42,27374,26445,20734,2016
2022-12-29 14:00:00+00,1771,244,5713,18894,524,5000,939,237,1244,970,35536,42,27314,26375,20662,2015
2022-12-29 14:30:00+00,1761,283,5716,19495,499,4996,963,192,760,906,35571,42,27433,26470,20754,2044
2022-12-29 15:00:00+00,1752,234,5716,20116,517,5014,986,161,341,1070,35907,39,27676,26690,20974,1986
2022-12-29 15:30:00+00,1742,246,5712,20315,667,5070,1021,190,53,1282,36298,40,27768,26747,21035,1988
2022-12-29 16:00:00+00,2518,255,5717,20033,720,5592,1077,232,0,1686,37830,48,27547,26470,20753,2773
2022-12-29 16:30:00+00,3421,376,5722,19416,748,5670,1301,710,0,1690,39054,63,27187,25886,20164,3797
2022-12-29 17:00:00+00,3399,424,5723,19166,944,6056,1251,942,0,1858,39763,65,27084,25833,20110,3823
2022-12-29 17:30:00+00,3475,426,5728,18564,1098,6096,1201,1099,0,1914,39601,67,26591,25390,19662,3901
2022-12-29 18:00:00+00,3347,382,5723,18411,1044,6096,1216,927,0,1702,38848,65,26394,25178,19455,3729
2022-12-29 18:30:00+00,3220,296,5724,18458,878,6086,1072,663,0,1916,38313,60,26132,25060,19336,3516
2022-12-29 19:00:00+00,3098,247,5718,18245,770,5726,1086,526,0,1828,37244,57,25819,24733,19015,3345
2022-12-29 19:30:00+00,3097,237,5722,17680,755,5648,1086,456,0,1376,36057,58,25243,24157,18435,3334
2022-12-29 20:00:00+00,3318,336,5717,17111,739,5280,1226,238,0,970,34935,63,24793,23567,17850,3654
2022-12-29 20:30:00+00,2897,399,5717,16528,646,5200,1086,166,0,788,33427,62,23977,22891,17174,3296
2022-12-29 21:00:00+00,2519,351,5715,16003,519,5006,1144,179,0,690,32126,59,23381,22237,16522,2870
2022-12-29 21:30:00+00,2109,234,5715,15779,504,4964,1075,160,0,362,30902,52,23073,21998,16283,2343
2022-12-29 22:00:00+00,1857,324,5722,15659,470,3822,1205,167,0,620,29846,52,23056,21851,16129,2181
2022-12-29 22:30:00+00,1834,238,5720,16046,409,3781,1212,163,0,0,29403,51,23387,22175,16455,2072
2022-12-29 23:00:00+00,1952,246,5723,16557,341,2286,1165,187,0,0,28457,50,23786,22621,16898,2198
2022-12-29 23:30:00+00,1939,234,5720,16452,321,2444,883,174,0,0,28167,52,23376,22493,16773,2173
2022-12-30 00:00:00+00,2110,231,5724,16879,304,1786,770,160,0,0,27964,56,23677,22907,17183,2341
2022-12-30 00:30:00+00,2260,248,5719,17126,305,1680,770,178,0,0,28286,57,23920,23150,17431,2508
2022-12-30 01:00:00+00,2600,277,5724,17163,288,1398,771,174,0,0,28395,61,23946,23175,17451,2877
2022-12-30 01:30:00+00,2269,236,5724,17392,279,1112,766,164,0,0,27942,53,24161,23395,17671,2505
2022-12-30 02:00:00+00,2786,300,5723,17622,275,540,754,154,0,0,28154,63,24374,23620,17897,3086
2022-12-30 02:30:00+00,2356,243,5720,18105,268,338,758,134,0,0,27922,52,24851,24093,18373,2599
2022-12-30 03:00:00+00,2600,255,5719,18685,278,416,761,143,0,0,28857,55,25443,24682,18963,2855
2022-12-30 03:30:00+00,2292,231,5720,19121,296,278,773,132,0,0,28843,48,25910,25137,19417,2523
2022-12-30 04:00:00+00,2278,230,5722,18782,314,366,776,132,0,0,28600,49,25594,24818,19096,2508
2022-12-30 04:30:00+00,2300,229,5719,18889,313,274,776,131,0,0,28631,48,25697,24921,19202,2529
2022-12-30 05:00:00+00,2398,230,5719,19271,332,202,777,130,0,0,29059,48,26099,25322,19603,2628
2022-12-30 05:30:00+00,2484,241,5715,19523,332,90,781,157,0,0,29323,47,26351,25570,19855,2725
2022-12-30 06:00:00+00,2992,280,5722,20052,369,0,780,157,0,0,30352,52,26923,26143,20421,3272
2022-12-30 06:30:00+00,3674,361,5720,20287,395,0,780,198,0,0,31415,62,27182,26402,20682,4035
2022-12-30 07:00:00+00,3598,399,5727,20407,457,806,780,153,0,0,32327,60,27371,26591,20864,3997
2022-12-30 07:30:00+00,3120,363,5720,20363,457,852,777,216,0,0,31868,55,27317,26540,20820,3483
2022-12-30 08:00:00+00,2997,298,5723,20270,470,1508,779,156,0,0,32201,51,27242,26463,20740,3295
2022-12-30 08:30:00+00,3708,472,5723,19683,542,1678,782,138,5,224,32955,63,26735,25953,20230,4180
2022-12-30 09:00:00+00,2730,549,5723,19568,673,3214,781,146,66,158,33608,53,26811,26030,20307,3279
2022-12-30 09:30:00+00,2958,669,5725,19602,575,3364,777,164,201,364,34399,58,26880,26103,20378,3627
2022-12-30 10:00:00+00,2589,717,5724,19528,681,4086,778,172,350,412,35037,56,27061,26283,20559,3306
2022-12-30 10:30:00+00,2838,657,5726,19354,596,4374,778,153,507,492,35475,59,26961,26183,20457,3495
2022-12-30 11:00:00+00,2893,626,5731,19105,576,4048,779,163,599,690,35210,60,26790,26011,20280,3519
2022-12-30 11:30:00+00,2734,661,5724,19349,513,4110,781,137,664,628,35301,60,27031,26250,20526,3395
2022-12-30 12:00:00+00,2498,554,5723,19587,499,5104,781,142,720,386,35994,55,27310,26529,20806,3052
2022-12-30 12:30:00+00,2487,535,5725,19742,531,4996,780,156,744,94,35790,53,27522,26742,21017,3022
2022-12-30 13:00:00+00,2591,552,5723,20119,491,4414,773,137,743,0,35543,55,27849,27076,21353,3143
2022-12-30 13:30:00+00,2440,544,5725,20379,459,4142,770,135,734,0,35328,51,28067,27297,21572,2984
2022-12-30 14:00:00+00,2285,459,5723,19894,471,4538,767,113,640,0,34890,47,27495,26728,21005,2744
2022-12-30 14:30:00+00,2310,460,5724,19752,472,4384,778,122,458,0,34460,46,27184,26406,20682,2770
2022-12-30 15:00:00+00,2414,471,5722,19955,482,4262,779,145,200,0,34430,48,27138,26359,20637,2885
2022-12-30 15:30:00+00,2358,525,5716,20311,509,4280,776,202,22,190,34889,48,27334,26558,20842,2883
2022-12-30 16:00:00+00,2270,474,5726,20443,523,5372,777,154,0,382,36121,47,27469,26692,20966,2744
2022-12-30 16:30:00+00,2596,603,5720,20851,514,5450,777,402,0,506,37419,55,27862,27085,21365,3199
2022-12-30 17:00:00+00,2413,724,5720,20827,528,6074,778,539,0,706,38309,59,27853,27075,21355,3137
2022-12-30 17:30:00+00,2583,728,5722,20781,535,6090,781,576,0,852,38648,60,27819,27038,21316,3311
2022-12-30 18:00:00+00,2535,638,5723,20813,543,6024,780,375,0,836,38267,57,27859,27079,21356,3173
2022-12-30 18:30:00+00,2223,569,5725,20918,549,5974,782,236,0,604,37580,52,27974,27192,21467,2792
2022-12-30 19:00:00+00,2059,680,5724,20764,550,5410,784,208,0,294,36473,53,27822,27038,21314,2739
2022-12-30 19:30:00+00,1870,565,5721,20709,532,5330,635,187,0,0,35549,48,27597,26962,21241,2435
2022-12-30 20:00:00+00,1839,561,5720,20696,526,4664,442,169,0,0,34617,46,27384,26942,21222,2400
2022-12-30 20:30:00+00,1801,550,5722,19750,508,4562,439,165,0,0,33497,47,26419,25980,20258,2351
2022-12-30 21:00:00+00,1891,615,5715,19190,457,3524,439,188,0,0,32019,51,25801,25362,19647,2506
2022-12-30 21:30:00+00,1904,554,5721,18427,457,3480,439,164,0,0,31146,50,25044,24605,18884,2458
2022-12-30 22:00:00+00,1880,582,5710,17685,442,2996,442,182,0,0,29919,51,24279,23837,18127,2462
2022-12-30 22:30:00+00,2000,580,5715,16832,421,2966,448,175,0,0,29137,54,23416,22968,17253,2580
2022-12-30 23:00:00+00,2561,736,5715,15437,410,2946,605,180,0,0,28590,70,22167,21562,15847,3297
2022-12-30 23:30:00+00,2555,718,5716,15135,409,2970,547,185,0,0,28235,70,21807,21260,15544,3273
2022-12-31 00:00:00+00,2322,633,5714,14289,354,3112,443,172,0,0,27039,63,20800,20357,14643,2955
2022-12-31 00:30:00+00,2671,762,5721,13695,349,3200,562,192,0,0,27152,73,20327,19765,14044,3433
2022-12-31 01:00:00+00,2770,755,5722,12788,331,3694,558,211,0,0,26829,75,19399,18841,13119,3525
2022-12-31 01:30:00+00,2733,659,5721,12106,344,3750,558,198,0,0,26069,73,18729,18171,12450,3392
2022-12-31 02:00:00+00,2707,617,5721,11548,336,3792,558,154,0,0,25433,72,18163,17605,11884,3324
2022-12-31 02:30:00+00,2546,568,5724,11345,330,3816,480,153,0,0,24962,69,17879,17399,11675,3114
2022-12-31 03:00:00+00,2576,526,5719,11236,326,3770,441,173,0,0,24767,68,17722,17281,11562,3102
2022-12-31 03:30:00+00,2586,477,5723,10942,326,3798,444,166,0,0,24462,67,17435,16991,11268,3063
2022-12-31 04:00:00+00,2736,501,5719,10930,323,3998,476,148,0,0,24831,70,17448,16972,11253,3237
2022-12-31 04:30:00+00,2566,460,5724,10950,322,4016,444,133,0,0,24615,66,17440,16996,11272,3026
2022-12-31 05:00:00+00,2617,497,5719,10960,334,3944,489,187,0,0,24747,68,17502,17013,11294,3114
2022-12-31 05:30:00+00,2634,481,5723,11315,335,3956,575,144,0,0,25163,67,17948,17373,11650,3115
2022-12-31 06:00:00+00,2590,483,5718,10865,360,4062,599,180,0,0,24857,67,17542,16943,11225,3073
2022-12-31 06:30:00+00,3015,654,5718,10153,385,4028,1002,132,0,52,25139,81,17258,16256,10538,3669
2022-12-31 07:00:00+00,3853,856,5720,9953,485,3660,1357,137,0,0,26021,100,17515,16158,10438,4709
2022-12-31 07:30:00+00,4414,829,5717,9926,492,3660,1433,139,0,0,26610,105,17568,16135,10418,5243
2022-12-31 08:00:00+00,4212,646,5719,10116,488,4186,1390,133,0,0,26890,95,17713,16323,10604,4858
2022-12-31 08:30:00+00,4452,873,5715,10144,558,4254,1433,167,8,88,27692,104,17858,16425,10710,5325
2022-12-31 09:00:00+00,4213,674,5718,9397,614,5872,1431,176,73,434,28602,99,17233,15802,10084,4887
2022-12-31 09:30:00+00,5161,724,5715,8422,603,6078,1433,184,189,556,29065,114,16362,14929,9214,5885
2022-12-31 10:00:00+00,6362,855,5720,7513,796,6076,1433,242,255,764,30016,131,15717,14284,8564,7217
2022-12-31 10:30:00+00,7018,978,5716,6952,820,6078,1430,444,284,954,30674,143,15202,13772,8056,7996
2022-12-31 11:00:00+00,7452,992,5717,6571,802,6078,1429,870,303,1012,31226,150,14822,13393,7676,8444
2022-12-31 11:30:00+00,8018,990,5718,6123,838,6078,1428,1072,308,1622,32195,155,14415,12987,7269,9008
2022-12-31 12:00:00+00,9023,990,5721,6373,837,6076,1433,1193,297,1260,33203,163,14661,13228,7507,10013
2022-12-31 12:30:00+00,9284,989,5730,6912,858,6076,1421,967,254,1118,33609,162,15175,13754,8024,10273
2022-12-31 13:00:00+00,9371,987,5727,7624,835,6076,1423,724,218,998,33983,158,15827,14404,8677,10358
2022-12-31 13:30:00+00,9161,988,5724,7840,825,6076,1426,592,178,1048,33858,155,15993,14567,8843,10149
2022-12-31 14:00:00+00,9528,988,5725,8183,704,6078,1425,265,118,616,33630,158,16155,14730,9005,10516
2022-12-31 14:30:00+00,9123,908,5728,9072,667,6076,1324,240,55,434,33627,150,16846,15522,9794,10031
2022-12-31 15:00:00+00,8864,753,5712,10196,637,6076,1141,220,21,550,34170,140,17707,16566,10854,9617
2022-12-31 15:30:00+00,8682,828,5716,10840,658,6076,1130,183,3,630,34746,137,18347,17217,11501,9510
2022-12-31 16:00:00+00,8338,877,5714,11153,699,6096,1124,216,0,1222,35439,132,18690,17566,11852,9215
2022-12-31 16:30:00+00,8632,953,5718,10909,718,6094,1092,357,0,1486,35959,136,18437,17345,11627,9585
2022-12-31 17:00:00+00,9215,995,5715,10069,707,6062,1304,462,0,1494,36023,145,17795,16491,10776,10210
2022-12-31 17:30:00+00,9238,996,5717,9667,694,6062,1407,484,0,1408,35673,147,17485,16078,10361,10234
2022-12-31 18:00:00+00,8718,991,5724,9834,698,6090,1423,305,0,1232,35015,143,17679,16256,10532,9709
2022-12-31 18:30:00+00,7807,994,5724,10064,688,6092,1424,216,0,1110,34119,135,17900,16476,10752,8801
2022-12-31 19:00:00+00,6779,991,5721,9971,693,6092,1367,151,0,1092,32857,127,17752,16385,10664,7770
2022-12-31 19:30:00+00,5771,994,5720,10341,682,6096,1286,133,0,1000,32023,118,18029,16743,11023,6765
2022-12-31 20:00:00+00,4774,803,5719,10892,572,6094,1232,178,0,566,30830,104,18415,17183,11464,5577
2022-12-31 20:30:00+00,3661,576,5719,11317,523,6096,1117,201,0,508,29718,86,18676,17559,11840,4237
2022-12-31 21:00:00+00,3288,698,5723,11165,500,6076,1004,139,0,212,28805,86,18392,17388,11665,3986
2022-12-31 21:30:00+00,3046,594,5723,11415,482,6028,585,153,0,0,28026,80,18205,17620,11897,3640
2022-12-31 22:00:00+00,3468,704,5722,12310,435,3814,537,164,0,10,27164,86,19004,18466,12744,4172
2022-12-31 22:30:00+00,2964,619,5722,13064,450,3642,479,140,0,0,27080,75,19715,19236,13514,3583
2022-12-31 23:00:00+00,2978,674,5723,13754,435,3536,444,148,0,0,27692,72,20356,19912,14189,3652
2022-12-31 23:30:00+00,2711,529,5722,14333,400,3508,449,133,0,0,27785,62,20904,20455,14733,3240
